player_id,first_name,last_name,last_season,current_club_id,country_of_birth,city_of_birth,country_of_citizenship,date_of_birth,sub_position,position,foot,height_in_cm,contract_expiration_date,agent_name,image_url,current_club_domestic_competition_id,current_club_name,market_value_in_eur,highest_market_value_in_eur,age,ca,pa,Corners,Crossing,Dribbling,Finishing,First Touch,Free Kick Taking,Heading,Long Shots,Long Throws,Marking,Passing,Penalty Taking,Tackling,Technique,Aggressiion,Anticipation,Bravery,Composure,Concentration,Vision,Decision,Determination,Flair,Leadership,Off The Ball,Position.1,Teamwork,Work Rate,Acceleration,Agility,Balance,Jumping Reach,Natural Fitness,Pace,Stamina,Strength,Stability,Foul,Contest performance,Injury,diversity,Aerial Reach,Command Of Area,Communication,Eccentricity,Handling,Kicking,One On Ones,Reflexes,Rushing Out,Punching,Throwing,Adaptation,Ambition,Argue,Loyal,Resistant to stress,Professional,Sportsmanship,Emotional control,GK,DL,DC,DR,WBL,WBR,DM,ML,MC,MR,AML,AMC,AMR,ST,Weight,Left Foot,Right Foot,Values,Current reputation,Domestic reputation,World reputation,Race,RCA,Number of national team appearances,Goals scored for the national team,Salary,Rental club,UID,Average Transfer Fee,number_of_transfers,country_of_birth_Encoded,city_of_birth_Encoded,country_of_citizenship_Encoded,position_Encoded,foot_Encoded,Race_Encoded,current_club_name_Encoded,sub_position_Encoded,Domestic reputation_Normalized,World reputation_Normalized,RCA_Normalized,Salary_Normalized,Number of national team appearances_Normalized,Goals scored for the national team_Normalized,market_value_in_eur_Normalized,highest_market_value_in_eur_Normalized,Average Transfer Fee_Normalized,number_of_transfers_Normalized,height_in_cm_Normalized,age_Normalized,total_appearances,total_goals,total_assists,total_yellow_cards,total_red_cards,total_minutes_played,total_injuries,total_games_missed,longest_injury_days,current_market_value,market_value_growth_rate,peak_market_value,biggest_market_drop,market_value_at_18,market_value_at_20,transfers_count,value_change_on_transfer,last_6_month_change,last_1_year_change
3333,James,Milner,2024,1237,England,Leeds,England,04-01-86,Central Midfield,Midfield,Right,175.0,30-06-25,Unknown,https://img.a.transfermarkt.technology/portrait/header/3333-1662621121.jpg?lm=1,GB1,Brighton and Hove Albion Football Club,1000000.0,21000000.0,38,143,157,13,12,10,11,15,9,9,7,13,13,14,16,13,14,15,13,17,14,14,12,13,19,9,17,12,13,18,18,11,10,13,8,19,10,17,15,14,11,15,12,18,3,3,2,3,2,2,2,2,1,4,3,18,17,7,16,17,20,15,18,1,15,1,15,16,16,18,14,20,14,8,6,8,6,70,8,20,2471213,7149,7149,6249,Northern_European,133,61,1,139190.0,Unknown,5106363,14800000.0,3.0,32,810,33,3,1,7,44,1,0.6962159301402487,0.6629946524064171,0.6176470588235294,0.1343955767004278,0.4013157894736842,0.0131578947368421,0.0047511877969492,0.1047761940485121,0.0821967276868801,0.2857142857142857,0.2790697674418605,0.8333333333333333,880,85,134,108,1,19595,26,129,183,1000000,-151162.7906976744,21000000.0,4000000.0,7500000.0,4700000.0,6,5550000,0.0,0.0
7161,Jonas,Hofmann,2024,15,Germany,Heidelberg,Germany,14-07-92,Attacking Midfield,Midfield,Right,176.0,30-06-27,Dr. Marco Gutfleisch,https://img.a.transfermarkt.technology/portrait/header/7161-1689710421.jpg?lm=1,L1,Bayer 04 Leverkusen FuÃŸball,7000000.0,16000000.0,32,148,152,17,13,12,13,13,14,7,11,12,11,14,13,12,13,13,16,13,13,13,15,13,17,13,12,17,11,16,17,14,12,12,7,14,14,16,11,16,6,14,11,19,1,2,2,3,3,4,1,3,2,2,2,8,14,6,12,16,18,15,16,1,1,1,14,10,14,10,10,17,15,14,15,20,10,73,12,20,26500880,7250,7250,6000,Northern_European,147,14,4,76711.0,Unknown,92027981,9000000.0,2.0,38,605,40,3,1,7,36,0,0.7095792537708389,0.6363636363636364,0.7205882352941175,0.0740647755374384,0.0921052631578947,0.0526315789473684,0.0347586896724181,0.0797699424856214,0.049973610378066,0.1428571428571428,0.3023255813953489,0.5833333333333333,487,106,98,32,0,6688,21,110,99,5000000,141428.57142857142,16000000.0,3000000.0,50000.0,500000.0,5,2500000,-0.5,-0.6153846153846154
7825,Pepe,Reina,2024,1047,Spain,Madrid,Spain,31-08-82,Goalkeeper,Goalkeeper,Right,188.0,30-06-25,Unknown,https://img.a.transfermarkt.technology/portrait/header/7825-1724826388.jpg?lm=1,IT1,Calcio Como,600000.0,22000000.0,42,129,175,3,2,2,1,10,8,6,2,2,1,13,4,3,12,10,18,13,16,10,14,12,20,7,17,3,12,14,14,8,8,12,14,20,9,13,13,12,9,13,6,13,11,15,17,13,12,17,12,13,18,13,17,20,20,9,14,14,20,19,12,20,1,1,1,1,1,1,1,1,1,1,1,1,1,92,14,20,235490,6450,7259,5717,Mediterranean_Hispanic,131,36,0,10968.0,Unknown,6701096,3887500.0,4.0,89,892,89,2,1,3,47,5,0.7107700449854459,0.606096256684492,0.6029411764705883,0.0105821996181949,0.2368421052631578,0.0,0.0027506876719179,0.1097774443610902,0.0215700436123225,0.4285714285714285,0.581395348837209,1.0,0,0,0,0,0,0,8,53,71,600000,-92857.14285714286,22000000.0,6000000.0,,,11,10800000,0.0,-0.14285714285714285
12282,Daley,Blind,2024,12321,Netherlands,Amsterdam,Netherlands,09-03-90,Centre-Back,Defender,Left,180.0,30-06-26,SEG,https://img.a.transfermarkt.technology/portrait/header/12282-1718096647.jpg?lm=1,ES1,Girona FÃºtbol Club S. A. D.,3000000.0,25000000.0,34,147,152,12,12,8,8,15,10,13,8,10,14,16,11,13,14,12,16,14,17,14,16,16,17,10,16,14,15,17,16,9,11,14,12,17,9,14,12,17,12,15,5,17,3,1,2,3,3,1,2,2,3,3,2,16,14,8,16,18,18,16,15,1,19,20,10,18,8,20,14,14,1,1,1,1,1,72,20,8,15971693,7500,7500,6500,Northern_European,140,91,2,49999.0,Unknown,37005632,16750000.0,2.0,67,64,68,1,0,7,107,2,0.7426567875099233,0.6898395721925134,0.6691176470588234,0.0482712071278004,0.5986842105263157,0.0263157894736842,0.0147536884221055,0.1247811952988247,0.0930303619544987,0.1428571428571428,0.3953488372093026,0.6666666666666665,568,22,36,55,0,16157,10,62,90,2000000,52777.77777777778,25000000.0,5000000.0,750000.0,1000000.0,5,6650000,-0.3333333333333333,-0.3333333333333333
12589,Craig,Gordon,2024,43,Scotland,Edinburgh,Scotland,31-12-82,Goalkeeper,Goalkeeper,Left,193.0,31-05-25,World in Motion,https://img.a.transfermarkt.technology/portrait/header/12589-1716378382.jpg?lm=1,SC1,Heart of Midlothian Football Club,150000.0,10000000.0,41,127,138,4,2,1,2,6,7,5,1,3,2,8,3,3,6,11,15,11,11,18,8,13,15,2,17,8,16,15,14,5,13,13,15,13,5,11,11,18,3,15,12,15,17,13,14,5,13,8,15,15,13,8,12,15,15,7,17,19,19,14,18,20,1,1,1,1,1,1,1,1,1,1,1,1,1,78,20,6,347975206,6344,6344,5494,Northern_European,127,70,0,4060.0,Unknown,5200647,10820000.0,1.0,82,446,83,2,0,7,112,5,0.5897062715003969,0.5822459893048127,0.5735294117647058,0.0039117155446033,0.4605263157894737,0.0,0.0005001250312578,0.0497624406101525,0.0600850023611766,0.0,0.6976744186046511,0.9583333333333331,0,0,0,0,0,0,13,191,792,100000,-17105.263157894737,10000000.0,2750000.0,,,4,6400000,-0.3333333333333333,-0.5
12907,Alessio,Cragno,2024,2919,Italy,Fiesole,Italy,28-06-94,Goalkeeper,Goalkeeper,Right,184.0,30-06-25,GB1,https://img.a.transfermarkt.technology/portrait/header/12907-1663659430.jpg?lm=1,IT1,Associazione Calcio Monza,1500000.0,20000000.0,30,128,146,4,3,5,2,6,2,5,1,3,1,8,2,2,9,10,11,12,13,14,5,12,14,2,10,2,15,10,10,12,13,12,12,14,8,10,8,14,4,14,14,1,13,15,14,13,15,12,14,16,12,11,10,12,15,2,15,14,15,14,12,20,1,1,1,1,1,1,1,1,1,1,1,1,1,78,8,20,2889943,6240,6740,5990,Mediterranean_Hispanic,126,2,0,35577.0,Brianza,43092903,2600000.0,2.0,52,490,54,2,1,3,28,5,0.6421010849431067,0.6352941176470588,0.5661764705882353,0.0343450749174155,0.0131578947368421,0.0,0.0072518129532383,0.0997749437359339,0.0144170671407539,0.1428571428571428,0.4883720930232553,0.5,0,0,0,0,0,0,10,78,178,1000000,28030.303030303032,20000000.0,4000000.0,400000.0,1800000.0,7,9700000,-0.3333333333333333,-0.6
14086,Ashley,Young,2024,29,England,Stevenage,England,09-07-85,Left-Back,Defender,Right,175.0,30-06-25,CAA Base Ltd,https://img.a.transfermarkt.technology/portrait/header/14086-1700736434.jpg?lm=1,GB1,Everton Football Club,500000.0,27000000.0,39,133,156,12,15,12,10,14,14,7,11,8,10,13,12,10,13,7,13,10,11,12,10,12,14,9,15,13,12,16,15,13,13,12,7,15,13,11,12,13,10,15,5,16,1,3,1,2,1,1,2,4,2,1,2,16,13,4,17,12,18,10,14,1,18,1,15,20,15,1,19,1,15,10,1,7,1,65,12,20,1625288,6650,6650,5750,African_Caribbean,124,39,7,92793.0,Unknown,5113149,10966666.67,3.0,32,1423,33,1,1,1,65,8,0.6301931727970362,0.6096256684491979,0.5514705882352942,0.0895938324093985,0.256578947368421,0.0921052631578947,0.0022505626406601,0.134783695923981,0.0608998398288841,0.2857142857142857,0.2790697674418605,0.875,740,86,105,128,3,12924,13,100,134,500000,10975.609756097561,27000000.0,6000000.0,,1500000.0,5,3400000,0.0,-0.16666666666666666
15452,Raúl,Albiol,2024,1050,Spain,Vilamarxant,Spain,04-09-85,Centre-Back,Defender,Right,190.0,30-06-25,Football Capital,https://img.a.transfermarkt.technology/portrait/header/15452-1664974689.jpg?lm=1,ES1,Villarreal Club de FÃºtbol S.A.D.,1500000.0,18000000.0,39,152,161,4,10,8,9,12,6,15,11,12,16,12,9,16,12,11,14,17,14,14,12,16,13,6,14,9,16,17,16,10,11,16,15,13,11,13,15,16,9,16,12,9,1,2,2,1,1,1,3,1,3,2,1,16,15,6,14,13,15,12,7,1,1,20,10,1,1,10,1,1,1,1,1,1,1,82,10,20,3403402,7600,7600,5900,Mediterranean_Hispanic,151,58,0,47492.0,Unknown,7452450,10333333.33,3.0,89,1595,89,1,1,3,216,2,0.755887801005557,0.6256684491978609,0.75,0.0458504046419153,0.381578947368421,0.0,0.0072518129532383,0.0897724431107777,0.057381223533987,0.2857142857142857,0.6279069767441858,0.875,754,22,12,160,3,13077,10,71,79,1300000,11111.111111111111,18000000.0,3000000.0,,2500000.0,4,9700000,-0.13333333333333333,-0.48
15570,Igor,Akinfeev,2024,2410,UdSSR,"Vidnoe, Moskau Oblast",Russia,08-04-86,Goalkeeper,Goalkeeper,Right,187.0,30-06-26,Unknown,https://img.a.transfermarkt.technology/portrait/header/15570-1629034528.png?lm=1,RU1,PFK CSKA Moskva,1000000.0,20000000.0,38,135,157,5,2,2,2,10,7,8,1,3,1,11,18,1,10,11,16,10,16,15,10,15,18,10,17,2,16,5,9,11,12,12,10,13,9,10,13,16,7,14,5,13,8,10,18,3,13,15,14,14,8,17,14,1,11,5,20,14,20,14,10,20,1,1,1,1,1,1,1,1,1,1,1,1,1,78,13,20,347975206,6727,6727,5736,Northern_European,135,111,0,29999.0,Unknown,8053234,9111392.0,2.0,101,1584,81,2,1,7,148,5,0.6403810531886742,0.6081283422459892,0.6323529411764706,0.0289588618076162,0.7302631578947368,0.0,0.0047511877969492,0.0997749437359339,0.0505924720131114,0.1428571428571428,0.5581395348837206,0.8333333333333333,0,0,0,0,0,0,6,89,218,1000000,-12820.51282051282,20000000.0,4000000.0,1500000.0,9500000.0,0,0,0.0,-0.3333333333333333
15956,Jesús,Navas,2024,368,Spain,Los Palacios y Villafranca,Spain,21-11-85,Right-Back,Defender,Right,170.0,31-12-24,BahÃ­a Internacional,https://img.a.transfermarkt.technology/portrait/header/15956-1694503739.jpg?lm=1,ES1,Sevilla FÃºtbol Club S.A.D.,2500000.0,30000000.0,39,145,161,8,14,14,9,13,7,5,11,4,10,11,7,11,13,9,13,11,12,14,11,13,16,13,13,15,14,15,18,15,15,13,6,16,16,15,8,17,10,14,12,12,3,4,1,1,2,3,2,2,3,3,2,5,14,10,19,11,18,14,13,1,1,1,20,1,19,1,1,1,18,1,1,16,1,60,11,20,347975206,7250,7250,6500,Mediterranean_Hispanic,130,46,5,86538.0,Unknown,7456721,20000000.0,1.0,89,864,89,1,1,3,181,11,0.7095792537708389,0.6898395721925134,0.5955882352941175,0.0835538964105109,0.3026315789473684,0.0657894736842105,0.0122530632658164,0.1497874468617154,0.1110864190671963,0.0,0.1627906976744184,0.875,888,47,154,98,3,17522,15,79,90,0,-1086.9565217391305,30000000.0,5000000.0,2500000.0,3500000.0,3,5500000,-1.0,-1.0
16136,Unknown,Dante,2024,417,Brazil,Salvador da Bahia,Brazil,18-10-83,Centre-Back,Defender,Left,188.0,30-06-25,Marcus Marin,https://img.a.transfermarkt.technology/portrait/header/16136-1603016168.jpg?lm=1,FR1,Olympique Gymnaste Club Nice CÃ´te d'Azur,500000.0,17000000.0,41,135,160,4,5,12,8,15,4,16,5,8,15,16,5,16,13,15,16,18,16,14,17,15,19,17,18,12,15,16,16,5,7,17,15,16,5,13,17,15,12,18,7,10,4,2,2,3,4,2,1,1,3,2,2,16,15,10,18,18,18,15,15,1,8,20,1,8,1,1,1,1,1,1,1,1,1,89,20,11,676927,6750,6750,5000,African_Caribbean,140,13,2,28747.0,Unknown,316742,2483333.333,6.0,10,1290,11,1,0,1,142,2,0.6434241862926701,0.5294117647058822,0.6691176470588234,0.0277499089905726,0.0855263157894736,0.0263157894736842,0.0022505626406601,0.0847711927981995,0.0137689009861385,0.7142857142857142,0.581395348837209,0.9583333333333331,726,29,27,149,5,14762,13,85,211,500000,6578.9473684210525,17000000.0,5000000.0,,250000.0,6,5250000,0.0,-0.16666666666666666
16306,Unknown,Casemiro,2024,985,Brazil,SÃ£o JosÃ© dos Campos,Brazil,23-02-92,Defensive Midfield,Midfield,Right,185.0,30-06-26,Best of You,https://img.a.transfermarkt.technology/portrait/header/16306-1699018876.jpg?lm=1,GB1,Manchester United Football Club,15000000.0,80000000.0,32,161,170,10,11,12,11,14,10,13,14,10,14,14,11,15,14,18,14,16,15,14,12,15,17,12,15,12,18,17,18,11,12,15,13,15,12,17,17,14,17,15,5,12,2,1,1,2,1,2,1,1,2,2,1,13,15,14,10,15,16,10,11,1,1,9,1,1,1,20,1,19,1,1,1,1,1,84,13,20,209616868,8050,8500,7600,Mixed_Race,161,63,5,347975.0,Unknown,19061518,24787500.0,4.0,10,1453,11,3,1,4,132,4,0.8749669224662608,0.8074866310160427,0.8235294117647058,0.3360019775841608,0.4144736842105262,0.0657894736842105,0.0747686921730432,0.3998499624906226,0.13768438012167,0.4285714285714285,0.5116279069767438,0.5833333333333333,611,62,56,165,2,17199,11,61,84,12000000,255681.81818181818,80000000.0,16000000.0,4000000.0,4500000.0,5,15000000,-0.4,-0.6
16911,Kasper,Schmeichel,2024,371,Denmark,Kopenhagen,Denmark,05-11-86,Goalkeeper,Goalkeeper,Right,189.0,30-06-25,Unknown,https://img.a.transfermarkt.technology/portrait/header/16911-1659600543.jpg?lm=1,SC1,The Celtic Football Club,1000000.0,12000000.0,38,144,150,3,3,1,1,8,7,13,3,1,3,8,4,3,10,17,13,15,12,12,13,13,16,2,16,3,13,14,14,12,14,8,12,15,11,12,10,12,10,12,4,15,12,14,14,16,15,14,16,15,16,16,16,16,17,13,14,12,14,13,6,20,1,1,1,1,1,1,1,1,1,1,1,1,1,84,14,20,347975206,7200,7850,6000,Northern_European,144,84,0,74999.0,Unknown,5114022,1340000.0,2.0,28,745,30,2,1,7,200,5,0.7889653347446415,0.6363636363636364,0.6985294117647058,0.0724116387780306,0.5526315789473684,0.0,0.0047511877969492,0.0597649412353088,0.007416872690908,0.1428571428571428,0.6046511627906974,0.8333333333333333,0,0,0,0,0,0,6,37,84,750000,15151.515151515152,12000000.0,2500000.0,,500000.0,5,3500000,-0.25,-0.25
17259,Manuel,Neuer,2024,27,Germany,Gelsenkirchen,Germany,27-03-86,Goalkeeper,Goalkeeper,Right,193.0,30-06-25,PRO Profil GmbH,https://img.a.transfermarkt.technology/portrait/header/17259-1702419450.jpg?lm=1,L1,FC Bayern MÃ¼nchen,4000000.0,45000000.0,38,175,193,2,6,12,7,12,8,11,7,12,9,15,13,11,12,13,16,15,20,15,15,15,18,12,18,13,16,13,16,11,13,14,17,19,11,12,16,17,4,19,8,5,15,16,14,18,14,18,16,16,20,8,18,8,16,12,18,20,18,12,18,20,1,1,1,1,1,1,1,1,1,1,1,1,1,93,12,20,347975206,8750,8750,8500,Northern_European,176,112,0,345204.0,Unknown,8718372,30000000.0,1.0,38,526,40,2,1,7,68,5,0.9080444562053454,0.9037433155080212,0.9338235294117648,0.3333262521400492,0.7368421052631579,0.0,0.0197549387346836,0.2248062015503876,0.1666435178754965,0.0,0.6976744186046511,0.8333333333333333,0,0,0,0,0,0,34,204,312,4000000,87222.22222222222,45000000.0,8000000.0,75000.0,1500000.0,2,2075000,0.0,-0.2
23951,Steve,Mandanda,2024,273,Zaire,Kinshasa,France,28-03-85,Goalkeeper,Goalkeeper,Right,187.0,30-06-25,Unknown,https://img.a.transfermarkt.technology/portrait/header/23951-1666698933.jpg?lm=1,FR1,Stade Rennais Football Club,800000.0,17000000.0,39,135,154,7,3,8,5,9,9,8,12,2,1,9,7,2,10,6,14,14,15,12,8,13,14,8,15,2,13,13,8,10,13,13,14,12,10,10,14,13,6,15,3,1,14,13,13,6,15,12,14,14,14,10,13,8,16,7,15,13,17,16,16,20,1,1,1,1,1,1,1,1,1,1,1,1,1,82,10,20,347975206,6750,6750,5500,African_Caribbean,134,34,0,59835.0,Unknown,8428461,2750000.0,2.0,111,729,36,2,1,1,195,5,0.6434241862926701,0.5828877005347594,0.625,0.057769018556267,0.2236842105263157,0.0,0.0037509377344336,0.0847711927981995,0.0152504236228784,0.1428571428571428,0.5581395348837206,0.875,0,0,0,0,0,0,12,60,154,700000,9090.90909090909,17000000.0,3000000.0,,450000.0,4,3550000,-0.125,-0.3
24846,Ricardo,Batista,2024,3268,Portugal,SetÃºbal,Angola,19-11-86,Goalkeeper,Goalkeeper,Left,192.0,30-06-25,Doyen Sports,https://img.a.transfermarkt.technology/portrait/header/24846-1663602421.png?lm=1,PO1,Casa Pia AtlÃ©tico Clube,100000.0,1000000.0,38,120,120,2,2,3,2,7,7,8,3,3,1,8,1,3,5,10,14,14,10,12,11,12,13,9,10,12,13,11,11,10,13,10,13,10,10,12,12,14,13,8,10,10,14,11,13,15,12,10,15,16,15,16,12,12,12,5,15,13,15,8,10,20,1,1,1,1,1,1,1,1,1,1,1,1,1,79,20,6,112676,6000,6000,4500,African_Caribbean,119,0,0,1849.0,Unknown,744635,100000.0,2.0,76,1363,3,2,0,1,48,5,0.5441915850754168,0.4759358288770053,0.5147058823529411,0.0017767357694569,0.0,0.0,0.0002500625156289,0.0047511877969492,0.0005277924386788,0.1428571428571428,0.6744186046511627,0.8333333333333333,0,0,0,0,0,0,4,6,32,100000,3703.703703703704,1000000.0,600000.0,1000000.0,,7,450000,0.0,0.0
25520,Remko,Pasveer,2024,610,Netherlands,Enschede,Netherlands,08-11-83,Goalkeeper,Goalkeeper,Right,188.0,30-06-25,Wasserman,https://img.a.transfermarkt.technology/portrait/header/25520-1666951851.jpg?lm=1,NL1,AFC Ajax Amsterdam,150000.0,1250000.0,41,135,136,1,3,3,1,8,3,3,2,2,1,11,3,2,9,5,14,13,15,15,7,14,17,7,17,8,14,15,15,9,11,16,13,15,8,14,11,16,5,14,7,14,13,15,14,11,13,15,14,15,13,14,14,11,13,7,15,16,17,16,15,20,1,1,1,1,1,1,1,1,1,1,1,1,1,91,5,20,313879,6746,6746,4996,Northern_European,137,0,0,11999.0,Unknown,859209,450000.0,1.0,67,465,68,2,1,7,6,5,0.6428949457528447,0.5289839572192513,0.6470588235294117,0.0115777510194504,0.0,0.0,0.0005001250312578,0.0060015003750937,0.0024722908969693,0.0,0.581395348837209,0.9583333333333331,0,0,0,0,0,0,6,52,150,150000,2272.7272727272725,1250000.0,250000.0,,75000.0,6,500000,0.0,-0.25
27706,Mikhail,Kerzhakov,2024,964,UdSSR,"Kingisepp, St. Petersburg Region",Russia,28-01-87,Goalkeeper,Goalkeeper,Right,190.0,30-06-25,prosm,https://img.a.transfermarkt.technology/portrait/header/27706-1721722570.png?lm=1,RU1,AO FK Zenit Sankt-Peterburg,400000.0,2000000.0,37,126,126,5,1,3,1,8,7,1,2,2,3,14,1,1,8,10,11,13,13,13,12,10,17,10,12,1,12,13,13,12,13,10,15,15,11,11,12,13,8,10,7,11,13,14,13,7,14,13,12,14,13,13,12,20,10,8,10,11,15,15,14,20,1,1,1,1,1,1,1,1,1,1,1,1,1,82,10,20,721311,6000,6000,4250,Northern_European,126,0,0,29489.0,Unknown,8077626,500000.0,1.0,101,727,81,2,1,7,7,5,0.5441915850754168,0.4491978609625668,0.5661764705882353,0.0284663970019515,0.0,0.0,0.0017504376094023,0.0097524381095273,0.0027500763910108,0.0,0.6279069767441858,0.7916666666666665,0,0,0,0,0,0,5,34,146,300000,5882.35294117647,2000000.0,800000.0,200000.0,350000.0,6,1600000,-0.25,-0.4
27992,Luka,Modric,2024,418,Jugoslawien (SFR),Zadar,Croatia,09-09-85,Central Midfield,Midfield,Right,172.0,30-06-25,Universal Twenty Two,https://img.a.transfermarkt.technology/portrait/header/27992-1687776160.jpg?lm=1,ES1,Real Madrid Club de FÃºtbol,6000000.0,55000000.0,39,179,180,16,16,17,9,20,13,8,14,7,8,19,14,11,19,12,17,14,18,18,19,18,17,13,14,15,15,17,16,12,14,13,7,13,13,13,8,15,12,16,11,16,2,2,1,3,3,1,1,2,1,2,1,10,15,5,17,17,20,19,17,1,1,1,1,1,1,14,8,20,5,1,15,1,1,67,13,20,30331138,9000,9265,9000,Northern_European,176,152,22,321918.0,Unknown,653054,28750000.0,2.0,55,1695,25,3,1,7,167,1,0.9761841757078592,0.9572192513368984,0.9338235294117648,0.3108408884837588,1.0,0.2894736842105263,0.0297574393598399,0.274818704676169,0.159698880524459,0.1428571428571428,0.2093023255813952,0.875,829,90,137,107,1,18153,30,116,113,5000000,110227.27272727272,55000000.0,15000000.0,,2500000.0,2,2000000,-0.16666666666666666,-0.5
28396,Edin,Dzeko,2024,36,Jugoslawien (SFR),Sarajevo,Bosnia-Herzegovina,17-03-86,Centre-Forward,Attack,Right,193.0,30-06-25,World Soccer Agency,https://img.a.transfermarkt.technology/portrait/header/28396-1728391796.JPG?lm=1,TR1,FenerbahÃ§e Spor KulÃ¼bÃ¼,2500000.0,32000000.0,38,150,168,4,11,10,16,16,8,17,12,4,5,15,13,7,15,8,16,14,13,14,14,15,17,12,14,13,6,17,13,11,9,17,16,19,11,13,17,14,10,14,4,5,1,2,1,1,2,2,2,3,3,3,4,10,17,8,13,13,20,13,10,1,1,1,1,1,1,1,1,1,1,1,1,1,20,94,18,20,1671771,7500,7750,6900,Northern_European,150,124,63,178076.0,Unknown,8502440,10976000.0,5.0,55,1341,10,0,1,7,84,3,0.7757343212490078,0.7326203208556149,0.7426470588235294,0.171944569706462,0.8157894736842105,0.8289473684210525,0.0122530632658164,0.1597899474868717,0.0609516931025861,0.5714285714285714,0.6976744186046511,0.8333333333333333,820,367,149,89,2,16407,16,43,25,2200000,42553.1914893617,32000000.0,9000000.0,,,5,2500000,-0.18518518518518517,-0.3888888888888889
29364,João,Moutinho,2024,1075,Portugal,PortimÃ£o,Portugal,08-09-86,Central Midfield,Midfield,Right,170.0,30-06-25,Gestifute,https://img.a.transfermarkt.technology/portrait/header/29364-1464083394.PNG?lm=1,PO1,Sporting Clube de Braga,800000.0,30000000.0,38,149,154,13,14,15,10,16,14,7,13,4,11,17,14,13,17,14,16,14,14,15,17,15,16,15,14,12,14,17,16,10,13,13,8,15,10,14,10,16,13,16,8,14,3,3,2,3,2,1,1,2,2,1,3,13,17,7,15,16,17,14,16,1,1,1,1,1,1,20,9,20,9,1,15,1,1,61,10,20,4464618,7450,7250,6500,Mediterranean_Hispanic,147,146,7,115992.0,Unknown,744539,13866666.67,3.0,76,1169,79,3,1,3,192,1,0.7095792537708389,0.6898395721925134,0.7205882352941175,0.1119951873635462,0.9605263157894736,0.0921052631578947,0.0037509377344336,0.1497874468617154,0.0770113984832912,0.2857142857142857,0.1627906976744184,0.8333333333333333,888,61,126,122,0,21149,8,58,56,600000,-4545.454545454545,30000000.0,10000000.0,6000000.0,8500000.0,4,3200000,-0.25,-0.25
29559,Guillermo,Ochoa,2024,110302,Mexico,Guadalajara,Mexico,13-07-85,Goalkeeper,Goalkeeper,Right,185.0,30-06-25,Promanage,https://img.a.transfermarkt.technology/portrait/header/29559-1668452843.jpg?lm=1,PO1,Avs Futebol SAD,1000000.0,8000000.0,39,140,148,5,1,3,1,11,7,10,3,10,7,11,10,13,9,7,15,14,17,15,9,11,16,7,15,5,13,14,8,13,16,8,12,12,12,12,13,13,7,16,7,1,10,12,12,15,13,13,16,17,7,15,11,13,16,12,12,15,17,18,14,20,1,1,1,1,1,1,1,1,1,1,1,1,1,78,8,20,617061,7500,7500,6008,Mediterranean_Hispanic,139,128,0,74999.0,Unknown,5666492,1000000.0,1.0,63,571,64,2,1,3,35,5,0.7426567875099233,0.6372192513368984,0.6617647058823528,0.0724116387780306,0.8421052631578947,0.0,0.0047511877969492,0.0397599399849962,0.0055279313314258,0.0,0.5116279069767438,0.875,0,0,0,0,0,0,7,30,49,800000,12820.51282051282,8000000.0,2000000.0,,,7,5500000,-0.2,-0.4666666666666667
29692,Lukasz,Fabianski,2024,379,Poland,Kostrzyn nad Odr?,Poland,18-04-85,Goalkeeper,Goalkeeper,Right,190.0,30-06-25,ROOF,https://img.a.transfermarkt.technology/portrait/header/29692-1685709486.jpg?lm=1,GB1,West Ham United Football Club,700000.0,9000000.0,39,140,154,2,3,2,1,8,7,11,3,3,7,11,4,13,7,10,13,12,16,18,10,12,15,5,8,4,15,14,13,9,15,12,15,13,8,10,13,17,3,15,10,11,13,13,14,7,15,12,15,16,14,12,14,16,14,6,13,10,18,18,19,20,1,1,1,1,1,1,1,1,1,1,1,1,1,83,5,20,2139468,7050,7700,6250,Northern_European,139,57,0,69595.0,Unknown,718272,3118750.0,4.0,75,749,78,2,1,7,220,5,0.7691188145011907,0.6631016042780749,0.6617647058823528,0.0671934430725168,0.375,0.0,0.0032508127031757,0.0447611902975743,0.0172990916414344,0.4285714285714285,0.6279069767441858,0.875,0,0,0,0,0,0,15,168,136,700000,9090.90909090909,9000000.0,4000000.0,,1500000.0,3,2500000,0.0,0.0
29712,John,Ruddy,2024,762,England,St Ives,England,24-10-86,Goalkeeper,Goalkeeper,Right,192.0,30-06-25,Wasserman,https://img.a.transfermarkt.technology/portrait/header/s_29712_1123_2013_03_06_1.jpg?lm=1,GB1,Newcastle United Football Club,200000.0,5000000.0,38,123,145,1,1,3,3,9,6,3,2,1,3,10,5,1,10,6,13,14,13,13,9,12,17,3,16,6,12,13,6,7,13,13,15,12,9,13,16,14,4,13,5,13,15,14,15,7,11,14,14,12,13,9,10,1,13,5,18,15,18,16,18,20,1,1,1,1,1,1,1,1,1,1,1,1,1,97,6,20,735340,6150,6150,4750,Northern_European,124,1,0,10439.0,Unknown,5123017,9111392.0,2.0,32,1412,33,2,1,7,137,5,0.5640381053188674,0.5026737967914437,0.5514705882352942,0.010071388084476,0.006578947368421,0.0,0.0007501875468867,0.0247561890472618,0.0505924720131114,0.1428571428571428,0.6744186046511627,0.8333333333333333,0,0,0,0,0,0,1,29,141,200000,-4687.5,5000000.0,1500000.0,350000.0,500000.0,7,750000,0.0,-0.2
30321,ÃÂScar,Trejo,2024,367,Argentina,Santiago del Estero,Argentina,26-04-88,Attacking Midfield,Midfield,Right,180.0,30-06-25,Eleven Talent Group,https://img.a.transfermarkt.technology/portrait/header/30321-1653039805.jpg?lm=1,ES1,Rayo Vallecano de Madrid S.A.D.,1000000.0,4000000.0,36,138,140,13,11,16,12,16,12,7,11,7,8,16,15,6,16,11,12,10,14,13,16,15,14,15,13,14,9,15,13,10,14,15,9,12,10,13,12,16,6,14,6,6,2,2,1,3,2,4,3,1,3,3,3,10,8,6,13,12,15,14,12,1,1,1,1,1,1,1,1,19,1,10,20,10,13,79,13,20,1181655,6900,6250,4900,Mediterranean_Hispanic,137,0,0,17507.0,Unknown,958318,1866666.667,3.0,4,1336,4,3,1,3,163,0,0.5772691188145012,0.5187165775401069,0.6470588235294117,0.0168963709206291,0.0,0.0,0.0047511877969492,0.0197549387346836,0.0103428798966637,0.2857142857142857,0.3953488372093026,0.75,604,77,55,130,3,4043,5,12,32,800000,17045.454545454544,4000000.0,1600000.0,,3400000.0,5,2150000,-0.2,-0.6
31599,Norman,Theuerkauf,2024,2036,East Germany (GDR),Nordhausen,Germany,24-01-87,Defensive Midfield,Midfield,Left,183.0,30-06-25,Unknown,https://img.a.transfermarkt.technology/portrait/header/31599-1657874835.jpg?lm=1,L1,1. FuÃŸballclub Heidenheim 1846,300000.0,1500000.0,37,122,128,12,10,8,7,9,13,11,7,8,14,11,8,14,8,14,13,15,13,14,12,12,14,5,13,11,15,17,15,10,9,14,11,12,11,14,12,14,3,14,8,15,1,3,4,3,3,2,3,1,2,3,3,12,11,3,14,10,13,12,11,1,18,20,1,12,1,15,10,12,1,1,1,1,1,80,20,10,152823,6156,6156,4225,Northern_European,120,0,0,6711.0,Unknown,35000372,9111392.0,2.0,29,1053,40,3,0,7,2,4,0.5648319661286054,0.4465240641711229,0.5220588235294117,0.0064715669167937,0.0,0.0,0.0012503125781445,0.0072518129532383,0.0505924720131114,0.1428571428571428,0.4651162790697669,0.7916666666666665,0,0,0,0,0,0,4,13,62,175000,3205.128205128205,1500000.0,300000.0,50000.0,,4,550000,-0.4166666666666667,-0.4166666666666667
31653,Tobias,Sippel,2024,18,Germany,Bad DÃ¼rkheim,Germany,22-03-88,Goalkeeper,Goalkeeper,Right,183.0,30-06-25,Dr. Michael Becker,https://img.a.transfermarkt.technology/portrait/header/31653-1662965792.jpg?lm=1,L1,Borussia Verein fÃ¼r LeibesÃ¼bungen 1900 MÃ¶nchengladbach,300000.0,3000000.0,36,124,127,4,1,2,2,9,7,8,3,1,2,8,3,3,9,13,13,12,12,13,8,12,12,5,13,1,14,13,10,11,12,13,13,17,10,12,12,12,7,13,4,11,11,11,14,12,13,12,16,16,14,12,9,6,10,10,18,12,15,12,9,20,1,1,1,1,1,1,1,1,1,1,1,1,1,80,9,20,800866,6195,6195,4200,Northern_European,123,0,0,15341.0,Unknown,35006814,9111392.0,2.0,38,118,40,2,1,7,42,5,0.5699920613919026,0.4438502673796791,0.5441176470588236,0.0148048439224532,0.0,0.0,0.0012503125781445,0.0147536884221055,0.0505924720131114,0.1428571428571428,0.4651162790697669,0.75,0,0,0,0,0,0,12,28,64,300000,7317.073170731707,3000000.0,1000000.0,150000.0,1000000.0,2,50000,0.0,0.0
32113,Armando,Izzo,2024,2919,Italy,Napoli,Italy,02-03-92,Centre-Back,Defender,Right,183.0,30-06-26,Unknown,https://img.a.transfermarkt.technology/portrait/header/32113-1724827391.jpg?lm=1,IT1,Associazione Calcio Monza,2500000.0,25000000.0,32,133,146,4,8,10,9,12,4,15,8,4,14,12,5,14,12,16,15,15,13,13,9,14,16,7,14,9,13,14,14,14,13,14,12,14,14,13,13,12,12,13,11,11,3,3,2,3,1,2,3,1,3,3,3,12,14,9,13,12,14,13,15,1,1,20,17,1,10,1,1,1,1,1,1,1,1,78,8,20,5365133,6650,6500,5250,Mediterranean_Hispanic,134,3,0,60480.0,Brianza,43093074,3547500.0,4.0,52,1016,54,1,1,3,28,2,0.6103466525535857,0.5561497326203209,0.625,0.0583918416928429,0.0197368421052631,0.0,0.0122530632658164,0.1247811952988247,0.0196811022528403,0.4285714285714285,0.4651162790697669,0.5833333333333333,413,18,5,85,4,4203,18,55,69,2500000,72058.82352941176,25000000.0,5000000.0,50000.0,200000.0,4,1725000,0.0,0.0
33571,Lorenzo,De Silvestri,2024,1025,Italy,Roma,Italy,23-05-88,Right-Back,Defender,Right,187.0,30-06-25,Sergio Berti,https://img.a.transfermarkt.technology/portrait/header/33571-1595929290.jpg?lm=1,IT1,Bologna Football Club 1909,400000.0,6000000.0,36,127,144,8,12,10,9,11,4,15,6,15,12,11,4,11,11,14,13,16,14,12,8,13,18,8,12,13,13,17,16,14,12,14,14,14,14,12,13,14,14,12,9,12,1,1,1,1,1,1,1,1,1,1,1,13,18,12,11,12,18,14,14,1,9,13,20,8,20,1,7,1,17,1,1,1,1,84,9,20,320735,6350,6250,6100,Northern_European,125,6,0,32115.0,Unknown,1401054,3783333.333,3.0,52,1244,54,1,1,7,40,11,0.5772691188145012,0.6470588235294117,0.5588235294117647,0.0310021079424916,0.0394736842105263,0.0,0.0017504376094023,0.0297574393598399,0.0209913238312175,0.2857142857142857,0.5581395348837206,0.75,526,36,31,63,1,6656,21,70,128,400000,7894.736842105263,6000000.0,1000000.0,,3200000.0,5,4650000,0.0,0.0
33706,Unknown,Nani,2024,2431,Portugal,Amadora,Portugal,17-11-86,Left Winger,Attack,Right,177.0,30-06-25,PPSM,https://img.a.transfermarkt.technology/portrait/header/33706-1695118404.png?lm=1,PO1,Club Football Estrela da Amadora,200000.0,36500000.0,38,123,165,13,14,16,13,14,14,6,14,5,5,15,11,4,16,9,9,9,13,9,14,12,14,17,12,14,6,9,9,12,14,12,8,15,10,10,10,10,9,11,14,14,2,2,2,1,3,1,1,1,1,3,2,17,14,10,13,15,17,8,8,1,1,1,1,1,1,1,14,1,14,20,18,18,14,67,15,20,347975206,6150,6150,6650,Mixed_Race,118,112,24,27650.0,Unknown,736009,13333333.33,3.0,76,57,79,0,1,4,55,7,0.5640381053188674,0.7058823529411764,0.5073529411764706,0.0266906268497605,0.7368421052631579,0.3157894736842105,0.0007501875468867,0.1822955738934734,0.0740483531764771,0.2857142857142857,0.3255813953488373,0.8333333333333333,616,128,139,86,4,16603,27,135,150,0,-7142.857142857143,36500000.0,9500000.0,300000.0,25000000.0,13,18075000,-1.0,-1.0
33829,José,Fonte,2024,3268,Portugal,Penafiel,Portugal,22-12-83,Centre-Back,Defender,Right,191.0,30-06-25,ROGON,https://img.a.transfermarkt.technology/portrait/header/33829-1666690457.jpg?lm=1,PO1,Casa Pia AtlÃ©tico Clube,100000.0,7000000.0,41,139,146,6,9,10,7,11,9,17,8,8,14,14,8,15,12,14,14,14,14,15,12,13,13,10,20,10,15,16,16,9,10,13,16,14,9,14,15,15,10,14,11,10,3,4,2,2,3,2,2,1,2,2,3,12,16,5,10,14,14,13,12,1,1,20,1,1,1,10,1,1,1,1,1,1,5,78,10,20,1020628,6950,6750,5300,Mediterranean_Hispanic,140,50,1,32218.0,Unknown,742448,5390000.0,3.0,76,1136,79,1,1,3,48,2,0.6434241862926701,0.5614973262032085,0.6691176470588234,0.0311015665208906,0.3289473684210526,0.0131578947368421,0.0002500625156289,0.0347586896724181,0.0299174977082696,0.2857142857142857,0.6511627906976742,0.9583333333333331,719,32,21,127,3,10381,3,33,85,100000,-11764.70588235294,7000000.0,2000000.0,,,7,3800000,0.0,-0.6666666666666666
33862,Sinan,Bolat,2024,968,TÃ¼rkiye,Kayseri,TÃ¼rkiye,03-09-88,Goalkeeper,Goalkeeper,Right,186.0,30-06-26,Bolat Management,https://img.a.transfermarkt.technology/portrait/header/33862-1713448592.png?lm=1,BE1,Koninklijke Voetbal Club Westerlo,500000.0,3500000.0,36,128,140,5,3,2,1,12,9,10,1,1,6,11,1,12,12,12,12,16,12,13,10,13,15,13,12,2,8,10,14,13,16,11,16,12,14,11,12,15,14,18,12,12,12,11,11,11,11,14,13,16,15,7,13,14,18,5,14,12,13,12,7,20,1,1,1,1,1,1,1,1,1,1,1,1,1,77,5,20,347975206,6261,6261,5503,North_African__Middle_Eastern,130,12,0,17500.0,Unknown,8157608,150000.0,1.0,100,717,100,2,1,6,123,5,0.5787245302990209,0.5832085561497325,0.5955882352941175,0.016889611599767,0.0789473684210526,0.0,0.0022505626406601,0.0172543135783946,0.0008055779327203,0.0,0.5348837209302322,0.75,0,0,0,0,0,0,5,89,205,300000,6250.0,3500000.0,1200000.0,500000.0,1500000.0,9,3600000,-0.4,-0.5714285714285714
33873,Asmir,Begovic,2024,29,Jugoslawien (SFR),Trebinje,Bosnia-Herzegovina,20-06-87,Goalkeeper,Goalkeeper,Right,199.0,30-06-25,Unknown,https://img.a.transfermarkt.technology/portrait/header/33873-1520608555.jpg?lm=1,GB1,Everton Football Club,300000.0,13000000.0,37,131,150,1,3,5,1,8,1,6,3,8,1,13,7,6,8,11,14,13,11,13,5,12,17,7,11,2,15,12,13,7,15,10,15,16,9,12,14,14,8,13,4,1,15,15,15,12,14,13,13,14,15,8,11,16,13,10,11,14,16,12,8,20,1,1,1,1,1,1,1,1,1,1,1,1,1,101,7,20,4290625,6550,6000,5500,Mediterranean_Hispanic,133,63,0,46397.0,Unknown,5123112,8750000.0,3.0,55,1517,10,2,1,3,65,5,0.5441915850754168,0.5828877005347594,0.6176470588235294,0.0447930537356352,0.4144736842105262,0.0,0.0012503125781445,0.0647661915478869,0.0485846829078585,0.2857142857142857,0.8372093023255816,0.7916666666666665,0,0,0,0,0,0,3,10,26,300000,5263.1578947368425,13000000.0,2000000.0,100000.0,200000.0,10,5200000,0.0,0.0
34130,Tom,Heaton,2024,985,England,Chester,England,15-04-86,Goalkeeper,Goalkeeper,Right,188.0,30-06-25,10Ten Football,https://img.a.transfermarkt.technology/portrait/header/34130-1688121718.jpg?lm=1,GB1,Manchester United Football Club,250000.0,6000000.0,38,135,150,3,3,2,2,8,8,8,3,1,1,12,2,3,8,7,13,14,10,17,11,13,13,1,18,1,14,18,6,7,11,10,14,13,10,10,13,14,10,16,6,15,14,15,16,6,13,10,13,16,11,5,11,12,10,2,17,11,17,15,15,20,1,1,1,1,1,1,1,1,1,1,1,1,1,84,8,20,1140975,6750,6750,5750,Northern_European,135,3,0,75395.0,Unknown,5112064,8800000.0,1.0,32,355,33,2,1,7,132,5,0.6434241862926701,0.6096256684491979,0.6323529411764706,0.0727940232153703,0.0197368421052631,0.0,0.0010002500625156,0.0297574393598399,0.0488624684019,0.0,0.581395348837209,0.8333333333333333,0,0,0,0,0,0,7,99,312,250000,4166.666666666667,6000000.0,1700000.0,,,6,3150000,0.0,0.0
34784,Lasse,Schöne,2024,467,Denmark,Taastrup,Denmark,27-05-86,Defensive Midfield,Midfield,Right,178.0,30-06-25,Forza Sports Group,https://img.a.transfermarkt.technology/portrait/header/34784-1704798405.jpg?lm=1,NL1,Nijmegen Eendracht Combinatie,175000.0,7000000.0,38,122,140,15,12,11,11,14,17,7,14,5,9,15,13,11,13,8,14,13,14,14,15,15,15,10,18,14,14,17,15,7,10,14,9,16,7,8,8,16,6,16,7,13,3,1,1,1,2,1,2,2,4,2,4,8,13,8,15,14,17,18,16,1,1,1,1,5,5,20,11,20,13,11,16,13,10,78,12,20,267185,6100,5750,5000,Northern_European,120,51,3,3999.0,Unknown,929798,930000.0,2.0,28,1462,30,3,1,7,138,4,0.5111140513363324,0.5294117647058822,0.5220588235294117,0.0038528128913767,0.3355263157894737,0.0394736842105263,0.0006251562890722,0.0347586896724181,0.0051390316397677,0.1428571428571428,0.3488372093023257,0.8333333333333333,645,119,93,54,1,10285,17,37,50,150000,1388.888888888889,7000000.0,1500000.0,,100000.0,5,2600000,-0.14285714285714285,-0.3333333333333333
35047,Axel,Witsel,2024,13,Belgium,LiÃ¨ge,Belgium,12-01-89,Centre-Back,Defender,Right,186.0,30-06-25,Nomi Sports,https://img.a.transfermarkt.technology/portrait/header/35047-1665067807.jpg?lm=1,ES1,Club AtlÃ©tico de Madrid S.A.D.,3500000.0,40000000.0,35,144,160,8,10,13,10,15,8,13,11,9,12,16,14,12,15,11,18,13,18,19,13,14,13,8,13,12,12,18,13,10,11,18,14,18,10,14,14,16,13,18,10,10,2,2,2,2,3,2,2,3,2,1,2,17,8,11,6,18,15,10,14,1,1,15,1,1,1,20,8,20,10,8,12,10,1,81,12,20,11817277,7750,7944,7244,Mixed_Race,144,124,12,119999.0,Unknown,8169215,22250000.0,4.0,7,849,8,1,1,4,52,2,0.8014024874305372,0.7694117647058822,0.6985294117647058,0.1158644157484451,0.8157894736842105,0.1578947368421052,0.0172543135783946,0.1997999499874969,0.1235867662990638,0.4285714285714285,0.5348837209302322,0.7083333333333333,0,0,0,0,0,0,9,53,155,2500000,42857.142857142855,40000000.0,8000000.0,1500000.0,7500000.0,5,17000000,-0.2857142857142857,-0.5
35247,Unknown,Vieirinha,2024,1091,Portugal,GuimarÃ£es,Portugal,24-01-86,Right-Back,Defender,Right,172.0,30-06-25,ROGON,https://img.a.transfermarkt.technology/portrait/header/35247-1727967261.png?lm=1,GR1,Panthessalonikios Athlitikos Omilos Konstantinoupoliton,300000.0,8000000.0,38,125,150,13,15,15,10,14,15,10,15,14,8,14,16,8,15,13,12,15,12,12,13,13,15,15,19,12,8,13,14,10,11,13,8,12,10,9,11,13,9,13,16,16,1,3,1,3,1,1,1,3,1,3,3,14,11,10,15,14,16,12,7,1,20,1,16,16,16,1,16,7,16,10,6,10,1,70,12,20,314720,6250,6400,3014,Mediterranean_Hispanic,110,25,1,6150.0,Unknown,744574,1766666.667,3.0,76,579,79,1,1,3,153,11,0.5971156390579518,0.3170053475935828,0.4485294117647059,0.0059298556305625,0.1644736842105263,0.0131578947368421,0.0012503125781445,0.0397599399849962,0.0097873089085807,0.2857142857142857,0.2093023255813952,0.8333333333333333,550,66,68,65,2,15861,27,198,343,250000,-14102.564102564103,8000000.0,2500000.0,,800000.0,4,3200000,-0.16666666666666666,-0.16666666666666666
36898,Sascha,Burchert,2024,35,East Germany (GDR),Berlin,Germany,30-10-89,Goalkeeper,Goalkeeper,Right,187.0,Unknown,SEG,https://img.a.transfermarkt.technology/portrait/header/36898-1723630766.jpeg?lm=1,L1,FuÃŸball-Club St. Pauli von 1910,200000.0,600000.0,35,123,123,3,1,2,2,5,8,2,1,1,1,12,4,2,7,9,12,13,10,12,12,9,12,5,8,1,12,11,11,13,14,13,13,12,13,13,13,8,5,8,8,11,14,12,13,14,13,12,12,15,14,13,12,10,10,6,16,8,12,15,7,20,1,1,1,1,1,1,1,1,1,1,1,1,1,80,7,20,839827,6000,6000,3750,Northern_European,120,0,0,3000.0,Unknown,35015008,9111392.0,2.0,29,178,40,2,1,7,101,5,0.5441915850754168,0.3957219251336898,0.5220588235294117,0.0028881612426335,0.0,0.0,0.0007501875468867,0.0027506876719179,0.0505924720131114,0.1428571428571428,0.5581395348837206,0.7083333333333333,0,0,0,0,0,0,9,86,135,200000,2777.777777777778,600000.0,150000.0,50000.0,250000.0,4,250000,0.0,0.0
37838,Dejan,Lovren,2024,1091,Jugoslawien (SFR),Zenica,Croatia,05-07-89,Centre-Back,Defender,Right,188.0,30-06-26,ROOF,https://img.a.transfermarkt.technology/portrait/header/37838-1727967070.png?lm=1,GR1,Panthessalonikios Athlitikos Omilos Konstantinoupoliton,1000000.0,20000000.0,35,136,153,7,7,9,8,12,7,15,7,10,14,14,8,14,13,14,16,15,13,11,10,12,15,9,14,9,15,13,12,12,11,14,15,12,13,13,14,11,14,13,10,5,1,2,3,3,2,2,1,3,1,1,3,15,14,12,14,12,14,10,13,1,10,20,10,1,1,1,1,1,1,1,1,1,1,84,10,20,3519976,6769,7450,6499,Northern_European,136,70,4,115992.0,Unknown,24000971,11660000.0,5.0,55,1705,25,1,1,7,153,2,0.7360412807621064,0.6897326203208556,0.6397058823529411,0.1119951873635462,0.4605263157894737,0.0526315789473684,0.0047511877969492,0.0997749437359339,0.0647517986610739,0.5714285714285714,0.581395348837209,0.7083333333333333,509,21,13,86,4,13007,27,160,137,800000,0.0,20000000.0,5000000.0,1100000.0,7000000.0,8,18100000,-0.3333333333333333,-0.6
38253,Robert,Lewandowski,2024,131,Poland,Warszawa,Poland,21-08-88,Centre-Forward,Attack,Right,185.0,30-06-26,Gol International,https://img.a.transfermarkt.technology/portrait/header/38253-1701118759.jpg?lm=1,ES1,Futbol Club Barcelona,15000000.0,90000000.0,36,186,190,3,8,13,19,18,15,17,12,3,7,13,20,7,16,15,19,16,17,17,13,17,20,14,15,19,7,12,12,14,13,19,15,20,14,18,16,18,8,15,2,8,2,2,3,2,3,2,3,3,2,1,1,15,20,15,10,16,18,10,11,1,1,1,1,1,1,1,1,1,1,10,12,8,20,81,13,20,347975206,9300,9400,9250,Northern_European,183,132,76,345204.0,Unknown,719601,12536250.0,4.0,75,1646,78,0,1,7,96,3,0.9940460439269648,0.9839572192513368,0.9852941176470588,0.3333262521400492,0.8684210526315789,1.0,0.0747686921730432,0.4498624656164041,0.0696199894441512,0.4285714285714285,0.5116279069767438,0.75,805,600,155,81,1,18905,22,39,29,15000000,317021.27659574465,90000000.0,14000000.0,,3000000.0,4,1800000,0.0,-0.25
39125,Borna,Barisic,2024,449,Croatia,Osijek,Croatia,10-11-92,Left-Back,Defender,Left,186.0,30-06-26,ARGENTUM SPORT,https://img.a.transfermarkt.technology/portrait/header/39125-1723800799.jpg?lm=1,TR1,Trabzonspor KulÃ¼bÃ¼,3000000.0,6500000.0,32,126,135,17,17,12,11,9,16,7,13,12,10,13,14,12,13,8,11,6,12,7,13,10,10,8,10,14,12,14,11,13,12,13,11,13,12,14,11,10,9,16,14,13,2,1,2,2,1,1,2,2,3,1,2,12,15,13,10,10,12,15,14,1,20,14,1,19,1,1,14,1,1,14,1,1,1,80,20,6,5678955,6300,6300,5500,Northern_European,107,26,1,17399.0,Unknown,24044137,2450000.0,1.0,24,1095,25,1,0,7,204,8,0.5838846255623181,0.5828877005347594,0.4264705882352941,0.0167920842559001,0.1710526315789473,0.0131578947368421,0.0147536884221055,0.032258064516129,0.0135837106586294,0.0,0.5348837209302322,0.5833333333333333,397,18,79,68,0,9486,9,55,213,1800000,61538.46153846154,6500000.0,1200000.0,,200000.0,4,750000,-0.4857142857142857,-0.6727272727272727
39333,Caner,Erkin,2024,7160,TÃ¼rkiye,Balikesir,TÃ¼rkiye,04-10-88,Left-Back,Defender,Left,181.0,30-06-25,FOOTALENT,https://img.a.transfermarkt.technology/portrait/header/39333-1665674187.png?lm=1,TR1,EyÃ¼p Spor KulÃ¼bÃ¼,175000.0,13000000.0,36,120,140,16,16,13,9,13,14,9,13,8,7,15,12,9,13,13,14,13,13,10,13,12,17,12,10,14,8,13,14,13,13,11,10,14,12,11,12,12,16,12,10,10,2,2,2,1,1,2,3,2,3,3,1,12,14,18,8,17,7,4,3,1,18,1,1,20,1,1,14,10,5,12,1,8,1,74,20,10,432591,6050,6050,5000,Mediterranean_Hispanic,120,63,2,16590.0,Unknown,8489926,2250000.0,3.0,100,131,100,1,0,3,66,8,0.5508070918232336,0.5294117647058822,0.5220588235294117,0.0160108998876987,0.4144736842105262,0.0263157894736842,0.0006251562890722,0.0647661915478869,0.0124725686824634,0.2857142857142857,0.418604651162791,0.75,601,45,125,159,6,13192,16,71,129,175000,-15566.037735849057,13000000.0,2100000.0,1400000.0,1500000.0,9,6275000,-0.2222222222222222,-0.46153846153846156
39728,Mats,Hummels,2024,12,Germany,Bergisch Gladbach,Germany,16-12-88,Centre-Back,Defender,Right,191.0,30-06-25,HMH Sportmanagement,https://img.a.transfermarkt.technology/portrait/header/39728-1709560545.jpg?lm=1,IT1,Associazione Sportiva Roma,5000000.0,60000000.0,36,151,177,5,11,11,10,14,8,17,9,8,15,16,11,16,15,11,17,14,17,15,16,17,16,13,15,13,16,16,9,8,7,16,16,13,8,10,16,17,8,17,15,7,1,1,1,2,2,1,1,1,3,2,1,6,13,10,16,14,17,18,16,1,1,20,10,1,6,12,1,1,1,1,1,1,1,94,14,20,19730268,7849,7849,7249,Northern_European,154,76,5,191781.0,Unknown,35007944,23233333.33,3.0,38,177,40,1,1,7,29,2,0.7888330246096851,0.7699465240641711,0.7720588235294117,0.1851783543371182,0.5,0.0657894736842105,0.0247561890472618,0.2998249562390597,0.1290498809966943,0.2857142857142857,0.6511627906976742,0.75,715,60,32,94,3,18623,71,159,137,3500000,78409.09090909091,60000000.0,15000000.0,250000.0,5500000.0,4,6850000,-0.3,-0.4166666666666667
40034,Jens,Grahl,2024,24,Germany,Stuttgart,Germany,22-09-88,Goalkeeper,Goalkeeper,Right,192.0,30-06-26,PESM,https://img.a.transfermarkt.technology/portrait/header/40034-1663064684.jpg?lm=1,L1,Eintracht Frankfurt FuÃŸball AG,200000.0,750000.0,36,120,120,4,2,3,1,7,5,5,2,2,2,8,4,1,7,10,12,13,12,12,7,12,13,5,13,2,9,17,11,12,14,13,15,12,10,11,16,12,5,10,5,11,15,11,11,6,12,10,13,14,12,11,12,6,10,6,15,13,15,14,13,20,1,1,1,1,1,1,1,1,1,1,1,1,1,88,7,20,887962,5989,5739,3989,Northern_European,119,0,0,4250.0,Unknown,35012145,250000.0,1.0,38,1432,40,2,1,7,63,5,0.5096586398518127,0.421283422459893,0.5147058823529411,0.004095182825145,0.0,0.0,0.0007501875468867,0.0035008752188047,0.0013611489208033,0.0,0.6744186046511627,0.75,0,0,0,0,0,0,11,45,189,200000,4838.709677419355,750000.0,300000.0,50000.0,100000.0,5,150000,0.0,0.0
40433,Alexis,Sánchez,2024,410,Chile,Tocopilla,Chile,19-12-88,Centre-Forward,Attack,Right,169.0,30-06-26,Vibra Futbol,https://img.a.transfermarkt.technology/portrait/header/40433-1660118147.jpg?lm=1,IT1,Udinese Calcio,2500000.0,70000000.0,36,140,175,12,13,15,13,17,14,14,13,3,3,15,13,4,17,13,13,15,12,12,15,14,14,16,12,16,5,12,15,15,16,12,10,15,15,11,8,14,8,15,14,12,3,2,3,1,1,3,3,2,1,2,4,18,17,6,8,15,13,13,13,1,1,1,1,1,1,1,8,1,8,12,13,12,20,70,10,20,3999591,7000,8420,6266,Mediterranean_Hispanic,141,148,48,35281.0,Unknown,75000261,26375000.0,4.0,19,1497,19,0,1,3,205,3,0.8643821116697539,0.6648128342245989,0.6764705882352942,0.0340592522066768,0.9736842105263156,0.631578947368421,0.0122530632658164,0.3498374593648412,0.1465040695574877,0.4285714285714285,0.13953488372093,0.75,728,208,147,84,1,17738,32,149,112,2000000,43333.333333333336,70000000.0,15000000.0,2750000.0,6500000.0,9,25100000,-0.2,-0.2
40633,Milan,Badelj,2024,252,Jugoslawien (SFR),Zagreb,Croatia,25-02-89,Defensive Midfield,Midfield,Right,186.0,30-06-25,World Soccer Agency,https://img.a.transfermarkt.technology/portrait/header/40633-1692277462.jpg?lm=1,IT1,Genoa Cricket and Football Club,800000.0,15000000.0,35,125,130,9,9,12,9,14,11,10,11,3,12,12,11,14,14,12,13,14,15,12,14,13,15,12,14,9,14,17,13,10,12,13,12,15,11,13,12,14,12,8,7,10,1,1,1,1,1,1,3,1,1,2,3,13,13,10,9,13,15,16,16,1,1,1,1,1,1,20,1,20,1,1,1,1,1,76,10,20,706866,6250,6750,5050,Northern_European,125,55,2,49807.0,Unknown,24000969,3316666.667,3.0,55,1697,25,3,1,7,104,4,0.6434241862926701,0.53475935828877,0.5588235294117647,0.0480858086127266,0.3618421052631578,0.0263157894736842,0.0037509377344336,0.0747686921730432,0.0183986592238673,0.2857142857142857,0.5348837209302322,0.7083333333333333,580,47,52,100,0,8786,28,69,42,800000,17073.170731707316,15000000.0,4000000.0,,3000000.0,5,8700000,0.0,0.0
40680,Sven,Ulreich,2024,27,Germany,Schorndorf,Germany,03-08-88,Goalkeeper,Goalkeeper,Right,192.0,30-06-25,Unknown,https://img.a.transfermarkt.technology/portrait/header/40680-1700659982.jpg?lm=1,L1,FC Bayern MÃ¼nchen,700000.0,6000000.0,36,128,137,5,1,2,2,7,8,5,2,1,1,8,3,3,7,10,13,13,12,13,6,12,10,7,11,1,12,14,10,11,14,14,15,13,10,13,15,12,3,12,6,12,11,12,14,8,15,10,15,15,11,13,12,5,7,6,12,11,17,14,16,20,1,1,1,1,1,1,1,1,1,1,1,1,1,87,8,20,1177042,6400,6400,3755,Northern_European,127,0,0,38355.0,Unknown,35008097,3500000.0,1.0,38,1352,40,2,1,7,68,5,0.5971156390579518,0.3962566844919786,0.5735294117647058,0.0370275596823891,0.0,0.0,0.0032508127031757,0.0297574393598399,0.0194172060335009,0.0,0.6744186046511627,0.75,0,0,0,0,0,0,12,57,64,500000,10975.609756097561,6000000.0,1500000.0,100000.0,500000.0,5,2450000,-0.2857142857142857,-0.2857142857142857
40687,Mathieu,Valbuena,2024,3062,France,Bruges,France,28-09-84,Attacking Midfield,Midfield,Right,167.0,30-06-25,Playeleven,https://img.a.transfermarkt.technology/portrait/header/40687-1727960492.jpg?lm=1,GR1,Athens Kallithea Football Club,125000.0,15000000.0,40,120,155,16,16,15,8,17,15,5,9,4,6,15,14,6,17,13,14,12,15,13,16,14,18,16,18,12,6,16,10,11,14,13,5,17,10,9,6,14,12,15,12,12,2,1,1,2,2,2,3,1,3,1,1,16,17,12,13,16,19,8,8,1,1,1,1,1,1,1,14,10,14,20,19,15,1,58,8,20,422433,6253,6500,5001,Northern_European,120,52,8,23653.0,Unknown,8430055,3825000.0,4.0,34,263,36,3,1,7,32,0,0.6103466525535857,0.52951871657754,0.5220588235294117,0.0228310546375217,0.3421052631578947,0.1052631578947368,0.0003750937734433,0.0747686921730432,0.0212228117447706,0.4285714285714285,0.0930232558139532,0.9166666666666664,785,108,165,79,1,15781,22,76,68,100000,-1086.9565217391305,15000000.0,3500000.0,,,6,4075000,-0.3333333333333333,-0.7142857142857143
40792,Manuel,Riemann,2024,80,Germany,MÃ¼hldorf am Inn,Germany,09-09-88,Goalkeeper,Goalkeeper,Right,186.0,30-06-25,ROOF,https://img.a.transfermarkt.technology/portrait/header/40792-1691250480.jpg?lm=1,L1,Verein fÃ¼r LeibesÃ¼bungen Bochum 1848 FuÃŸballgemeinschaft,300000.0,1200000.0,36,130,130,2,2,2,2,11,6,5,2,3,3,12,12,3,12,16,14,13,16,12,10,12,18,10,16,1,13,13,13,11,13,14,14,17,11,11,12,18,13,16,7,14,13,13,15,15,12,12,14,15,18,8,11,10,17,13,12,15,17,10,7,20,1,1,1,1,1,1,1,1,1,1,1,1,1,83,5,20,347975206,6500,6500,4500,Northern_European,130,0,0,16781.0,Unknown,35014447,100000.0,1.0,38,1004,40,2,1,7,212,5,0.6103466525535857,0.4759358288770053,0.5955882352941175,0.0161953327855064,0.0,0.0,0.0012503125781445,0.0057514378594648,0.0005277924386788,0.0,0.5348837209302322,0.75,0,0,0,0,0,0,13,30,89,300000,6097.5609756097565,1200000.0,300000.0,120000.0,500000.0,4,470000,-0.5,-0.625
41384,Marko,Arnautovic,2024,46,Austria,Wien,Austria,19-04-89,Centre-Forward,Attack,Right,190.0,30-06-25,Unknown,https://img.a.transfermarkt.technology/portrait/header/41384-1716316175.jpg?lm=1,IT1,Football Club Internazionale Milano S.p.A.,4000000.0,35000000.0,35,150,153,4,11,15,16,17,12,16,13,4,4,14,16,6,17,16,9,14,13,8,15,11,15,17,15,14,6,13,13,13,11,16,14,16,14,13,17,15,14,13,8,11,2,3,1,2,2,1,2,2,3,1,1,14,18,14,11,12,18,10,8,1,1,1,1,1,1,1,1,1,1,11,10,10,20,83,15,20,347975206,7500,7500,6300,Northern_European,149,102,33,74038.0,Unknown,37003555,12200000.0,6.0,6,1663,7,0,1,7,89,3,0.7426567875099233,0.6684491978609625,0.7352941176470587,0.0714836805853958,0.6710526315789473,0.4342105263157894,0.0197549387346836,0.1747936984246061,0.0677518819967221,0.7142857142857142,0.6279069767441858,0.7083333333333333,522,139,73,69,3,9250,40,103,102,3500000,72340.4255319149,35000000.0,12000000.0,500000.0,6500000.0,8,17050000,-0.125,-0.3
42205,Yann,Sommer,2024,46,Switzerland,Morges,Switzerland,17-12-88,Goalkeeper,Goalkeeper,Right,183.0,30-06-26,Unknown,https://img.a.transfermarkt.technology/portrait/header/42205-1669897427.jpg?lm=1,IT1,Football Club Internazionale Milano S.p.A.,5000000.0,13000000.0,36,153,155,3,3,2,1,11,6,6,2,2,2,12,3,3,12,13,14,14,16,15,11,15,16,10,16,1,16,12,12,11,14,14,13,18,11,12,11,16,7,18,4,16,12,13,14,14,14,13,16,18,18,8,12,14,15,6,15,12,17,12,14,20,1,1,5,1,5,1,1,1,3,1,1,3,1,79,8,20,20922652,7649,7699,6649,Northern_European,152,74,0,76711.0,Unknown,69000199,8300000.0,3.0,92,982,92,2,1,7,89,5,0.7689865043662345,0.7057754010695186,0.7573529411764706,0.0740647755374384,0.4868421052631578,0.0,0.0247561890472618,0.0647661915478869,0.046084613461485,0.2857142857142857,0.4651162790697669,0.75,0,0,0,0,0,0,11,30,26,4000000,89772.72727272728,13000000.0,2500000.0,,900000.0,7,500000,-0.2,-0.2
42412,Jonny,Evans,2024,985,Northern Ireland,Belfast,Northern Ireland,03-01-88,Centre-Back,Defender,Right,188.0,30-06-25,Unknown,https://img.a.transfermarkt.technology/portrait/header/42412-1699471667.jpg?lm=1,GB1,Manchester United Football Club,2000000.0,15000000.0,36,148,155,4,5,10,6,12,4,15,3,9,16,12,5,16,13,12,17,14,15,15,13,13,15,3,15,6,15,14,14,12,11,15,15,11,10,13,15,17,8,14,12,15,2,2,3,1,2,4,1,3,1,1,1,16,14,6,16,14,15,16,18,1,12,20,11,1,1,1,1,1,1,1,1,1,1,77,16,20,3656453,7400,7750,6000,Northern_European,148,98,5,115992.0,Unknown,5005078,6150000.0,2.0,70,165,72,1,1,7,132,2,0.7757343212490078,0.6363636363636364,0.7279411764705881,0.1119951873635462,0.6447368421052632,0.0657894736842105,0.0097524381095273,0.0747686921730432,0.0341398372177004,0.1428571428571428,0.581395348837209,0.75,540,24,15,67,5,11091,30,173,144,1500000,25641.02564102564,15000000.0,3000000.0,,1000000.0,3,3000000,-0.25,-0.25
42710,Toby,Alderweireld,2024,1096,Belgium,Wilrijk,Belgium,02-03-89,Centre-Back,Defender,Right,187.0,30-06-25,Stirr Associates,https://img.a.transfermarkt.technology/portrait/header/42710-1664349412.jpg?lm=1,BE1,Royal Antwerp Football Club,2800000.0,40000000.0,35,142,170,7,10,10,10,14,10,15,9,12,13,15,8,15,13,13,15,14,15,13,13,15,14,10,14,10,15,14,13,9,10,12,14,15,9,12,17,15,5,13,9,13,1,3,3,2,1,1,1,1,1,1,1,11,13,9,13,15,18,15,15,1,1,20,15,1,11,10,1,1,1,1,1,1,1,91,14,20,347975206,6500,6500,5850,Northern_European,142,121,5,55000.0,Unknown,8169242,10000000.0,4.0,7,1668,8,1,1,7,173,2,0.6103466525535857,0.6203208556149732,0.6838235294117647,0.0531002590751124,0.7960526315789473,0.0657894736842105,0.0137534383595899,0.1997999499874969,0.055529320258896,0.4285714285714285,0.5581395348837206,0.7083333333333333,629,42,28,69,0,16820,14,75,130,2200000,53750.0,40000000.0,6000000.0,,2500000.0,7,15200000,-0.21428571428571427,-0.26666666666666666
42735,Sven,Kums,2024,157,Belgium,Asse,Belgium,26-02-88,Central Midfield,Midfield,Right,176.0,30-06-25,Stirr Associates,https://img.a.transfermarkt.technology/portrait/header/42735-1704960098.jpg?lm=1,BE1,Koninklijke Atletiek Associatie Gent,400000.0,7500000.0,36,125,135,12,12,14,11,14,11,6,14,5,6,15,15,8,14,11,13,13,15,15,16,15,16,13,14,12,10,15,15,9,11,7,8,12,8,15,11,15,6,14,10,15,2,3,1,4,2,1,2,2,2,4,2,14,16,2,13,12,18,15,15,1,1,1,1,1,1,19,1,20,1,1,8,1,1,63,10,20,787695,6400,6250,5500,Northern_European,124,0,0,27999.0,Unknown,8156639,3860000.0,5.0,7,100,8,3,1,7,120,1,0.5772691188145012,0.5828877005347594,0.5514705882352942,0.0270276272755977,0.0,0.0,0.0017504376094023,0.0372593148287071,0.0214172615905997,0.5714285714285714,0.3023255813953489,0.75,728,65,87,112,3,20146,10,34,63,300000,5555.555555555556,7500000.0,1500000.0,100000.0,850000.0,7,2050000,-0.25,-0.4
42913,Lasse,Nielsen,2024,1467,Denmark,Aalborg,Denmark,08-01-88,Centre-Back,Defender,Right,185.0,30-06-25,Elite Consulting,https://img.a.transfermarkt.technology/portrait/header/42913-1727796206.png?lm=1,TR1,GÃ¶ztepe Sportif Yat?r?mlar A.?.,100000.0,2500000.0,36,123,125,6,9,8,6,11,6,14,6,13,14,10,9,14,10,15,14,14,11,14,10,14,14,7,14,12,13,15,15,10,7,11,14,12,13,14,14,14,14,14,11,9,1,3,2,3,2,2,2,3,3,3,1,13,9,8,15,14,15,12,6,1,5,20,10,1,1,1,1,1,1,1,1,1,1,82,9,20,347975206,6150,5512,5008,Northern_European,125,1,0,4659.0,Unknown,934948,500000.0,3.0,28,9,30,1,1,7,110,2,0.479624239216724,0.5302673796791444,0.5588235294117647,0.0044901202869428,0.006578947368421,0.0,0.0002500625156289,0.0122530632658164,0.0027500763910108,0.2857142857142857,0.5116279069767438,0.75,552,19,16,77,0,14555,3,8,34,75000,657.8947368421053,2500000.0,500000.0,,250000.0,4,1200000,0.0,-0.625
43250,Jan,Vertonghen,2024,58,Belgium,Sint-Niklaas,Belgium,24-04-87,Centre-Back,Defender,Left,189.0,30-06-25,YOU FIRST,https://img.a.transfermarkt.technology/portrait/header/43250-1668080180.jpg?lm=1,BE1,Royal Sporting Club Anderlecht,1500000.0,32000000.0,37,138,165,7,11,10,8,14,11,14,10,12,15,14,10,16,14,14,14,14,16,14,11,15,14,12,15,11,16,15,11,8,9,12,14,15,10,11,15,16,13,13,11,12,1,1,3,2,1,3,1,4,3,1,3,14,14,9,16,17,14,10,11,1,15,20,1,10,1,11,8,6,1,1,1,1,1,79,20,9,347975206,7000,7000,6500,Northern_European,139,139,9,64999.0,Unknown,8150316,12500000.0,1.0,7,1374,8,1,0,7,175,2,0.6765017200317545,0.6898395721925134,0.6617647058823528,0.0627554661179385,0.9144736842105262,0.1184210526315789,0.0072518129532383,0.1597899474868717,0.0694185949609711,0.0,0.6046511627906974,0.7916666666666665,720,53,22,108,2,17665,26,147,137,1000000,20454.545454545456,32000000.0,6000000.0,,1750000.0,5,9250000,-0.3333333333333333,-0.3333333333333333
43530,Adam,Lallana,2024,180,England,St Albans,England,10-05-88,Attacking Midfield,Midfield,Right,172.0,30-06-25,CAA Stellar,https://img.a.transfermarkt.technology/portrait/header/43530-1662663337.jpg?lm=1,GB1,Southampton Football Club,1000000.0,25000000.0,36,142,159,11,13,16,8,16,7,6,7,4,11,15,9,9,18,11,15,12,16,15,15,15,15,16,14,16,11,16,14,10,13,13,6,14,10,11,9,15,7,16,15,12,2,3,1,3,1,3,3,1,3,2,1,16,15,8,15,15,18,13,15,1,1,1,1,1,1,17,14,19,14,14,20,14,1,73,14,20,5797608,7099,7099,6249,Northern_European,134,34,3,77714.0,Unknown,5125012,31000000.0,1.0,32,1411,33,3,1,7,186,0,0.6896004233924319,0.6629946524064171,0.625,0.0750332896552456,0.2236842105263157,0.0394736842105263,0.0047511877969492,0.1247811952988247,0.1721992277563265,0.0,0.2093023255813952,0.75,570,86,72,42,1,9703,26,143,118,900000,24285.714285714286,25000000.0,5000000.0,,750000.0,3,16100000,-0.1,-0.1
44058,Wojciech,Szcz?Sny,2024,131,Poland,Warszawa,Poland,18-04-90,Goalkeeper,Goalkeeper,Right,196.0,30-06-25,CAA Stellar,https://img.a.transfermarkt.technology/portrait/header/44058-1595847517.jpg?lm=1,ES1,Futbol Club Barcelona,6000000.0,40000000.0,34,153,169,3,3,2,1,10,1,5,3,2,2,11,6,1,8,12,13,14,17,12,10,12,15,7,8,4,14,9,11,9,15,11,17,12,12,11,15,15,5,14,8,2,16,14,14,13,18,16,16,17,16,7,13,17,13,12,12,12,16,9,14,20,1,1,1,1,1,1,1,1,1,1,1,1,1,90,9,20,347975206,7650,8250,7500,Northern_European,151,64,0,231537.0,Unknown,28009478,9225000.0,2.0,75,1646,78,2,1,7,96,5,0.8418893887271766,0.7967914438502673,0.75,0.2235674343645804,0.4210526315789473,0.0,0.0297574393598399,0.1997999499874969,0.0512236451012528,0.1428571428571428,0.7674418604651163,0.6666666666666665,0,0,0,0,0,0,13,49,50,1000000,22500.0,40000000.0,10000000.0,,2000000.0,6,4450000,-0.8333333333333334,-0.875
44162,Miralem,Pjanic,2024,2410,Jugoslawien (SFR),Tuzla,Bosnia-Herzegovina,02-04-90,Central Midfield,Midfield,Right,180.0,30-06-25,LIAN Sports Group,https://img.a.transfermarkt.technology/portrait/header/44162-1727362852.png?lm=1,RU1,PFK CSKA Moskva,3000000.0,70000000.0,34,145,169,15,16,13,8,16,18,8,15,4,9,18,14,10,16,8,17,12,15,12,15,15,13,11,7,10,15,15,10,11,14,12,7,12,11,13,11,11,13,10,15,10,1,3,2,3,1,1,3,3,2,2,1,16,14,6,11,12,17,14,15,1,1,1,1,1,1,19,1,20,1,1,14,1,1,72,12,20,347975206,7250,7995,6995,Northern_European,143,107,17,55291.0,Unknown,8438112,27625000.0,4.0,55,1537,10,3,1,7,148,1,0.8081503043133105,0.7427807486631015,0.6911764705882353,0.0533812536995211,0.7039473684210525,0.2236842105263157,0.0147536884221055,0.3498374593648412,0.1534487069085252,0.4285714285714285,0.3953488372093026,0.6666666666666665,651,77,129,123,1,13354,26,51,40,2500000,37735.84905660377,70000000.0,13000000.0,6500000.0,11500000.0,7,14000000,-0.16666666666666666,-0.5
44996,Serdar,Aziz,2024,36,TÃ¼rkiye,Bursa,TÃ¼rkiye,23-10-90,Centre-Back,Defender,Right,183.0,30-06-25,Haluk Canatar,https://img.a.transfermarkt.technology/portrait/header/44996-1696446267.png?lm=1,TR1,FenerbahÃ§e Spor KulÃ¼bÃ¼,350000.0,5000000.0,34,125,135,3,3,5,3,8,3,16,4,4,15,10,3,16,9,16,12,18,9,12,7,11,14,5,12,4,12,14,13,14,13,15,13,12,14,12,15,14,18,15,16,7,2,1,2,3,3,2,2,3,2,2,3,10,14,10,14,14,14,7,12,1,5,20,10,1,1,1,1,1,1,1,1,1,1,86,10,20,2624763,6263,6263,4975,Mediterranean_Hispanic,122,18,2,11711.0,Unknown,70002622,4500000.0,1.0,100,280,100,1,1,3,84,2,0.5789891505689336,0.5267379679144385,0.536764705882353,0.0112996532468397,0.1184210526315789,0.0263157894736842,0.0015003750937734,0.0247561890472618,0.0249729159143309,0.0,0.4651162790697669,0.6666666666666665,357,27,15,106,5,9950,57,195,141,200000,1086.9565217391305,5000000.0,1000000.0,400000.0,2200000.0,3,1100000,-0.6666666666666666,-0.8333333333333334
45026,Rui,Patrício,2024,800,Portugal,Leiria,Portugal,15-02-88,Goalkeeper,Goalkeeper,Left,190.0,30-06-25,Gestifute,https://img.a.transfermarkt.technology/portrait/header/45026-1716296132.jpg?lm=1,IT1,Atalanta Bergamasca Calcio S.p.a.,1000000.0,20000000.0,36,147,157,1,3,5,2,9,2,8,1,12,1,11,4,3,8,12,13,12,14,15,5,13,18,11,14,11,15,13,14,11,14,16,16,16,10,12,14,16,7,15,8,14,16,9,16,6,16,11,17,17,5,12,14,17,18,5,8,15,18,18,17,20,1,1,1,1,1,1,1,1,1,1,1,1,1,84,20,6,347975206,7342,7242,6142,Northern_European,147,104,0,66537.0,Unknown,55000929,14900000.0,2.0,76,817,79,2,0,7,31,5,0.7085207726911882,0.6515508021390374,0.7205882352941175,0.0642405854730607,0.6842105263157894,0.0,0.0047511877969492,0.0997749437359339,0.0827522986749631,0.1428571428571428,0.6279069767441858,0.75,0,0,0,0,0,0,6,25,28,1000000,22500.0,20000000.0,4000000.0,100000.0,5000000.0,3,4000000,0.0,-0.7142857142857143
45320,Ángel,Di María,2024,294,Argentina,Rosario,Argentina,14-02-88,Right Winger,Attack,Left,178.0,30-06-25,DCGLOBALSL,https://img.a.transfermarkt.technology/portrait/header/45320-1700648952.jpg?lm=1,PO1,Sport Lisboa e Benfica,3000000.0,65000000.0,36,160,174,16,17,17,14,16,14,5,17,4,4,17,14,7,19,12,16,12,14,12,18,14,16,17,10,15,4,12,12,15,17,12,10,15,15,12,10,14,14,16,9,16,2,2,1,2,3,3,4,3,3,2,1,12,18,10,13,16,18,6,12,1,1,1,1,7,1,1,17,13,18,17,16,20,9,75,20,8,17897694,8000,8500,7800,Mediterranean_Hispanic,158,122,25,147885.0,Unknown,14000219,44750000.0,4.0,4,1248,4,0,0,3,188,10,0.8749669224662608,0.8288770053475936,0.8014705882352942,0.1427916188283779,0.8026315789473684,0.3289473684210526,0.0147536884221055,0.3248312078019504,0.2485902386177393,0.4285714285714285,0.3488372093023257,0.75,800,193,275,91,5,19076,50,138,53,3000000,-22727.272727272728,65000000.0,15000000.0,,7500000.0,5,36000000,0.0,-0.4
45333,James,Mccarthy,2024,371,Scotland,Glasgow,Ireland,12-11-90,Central Midfield,Midfield,Right,180.0,31-05-25,StormSportsX,https://img.a.transfermarkt.technology/portrait/header/45333-1464869334.jpg?lm=1,SC1,The Celtic Football Club,200000.0,17000000.0,34,127,139,9,11,13,10,14,11,10,8,6,13,12,8,13,14,13,15,16,12,14,12,14,16,4,14,11,14,16,17,11,10,11,9,10,10,14,12,12,9,13,16,12,1,1,1,2,1,4,1,1,2,1,2,7,13,2,17,11,17,13,14,1,1,1,1,1,1,18,7,20,8,1,9,1,1,69,10,20,570433,6350,6350,5500,Northern_European,123,32,4,63795.0,Unknown,5217388,9111392.0,2.0,82,545,52,3,1,7,200,1,0.590500132310135,0.5828877005347594,0.5441176470588236,0.0615928629296634,0.2105263157894736,0.0526315789473684,0.0007501875468867,0.0847711927981995,0.0505924720131114,0.1428571428571428,0.3953488372093026,0.6666666666666665,454,29,22,67,0,6836,10,167,351,100000,-17105.263157894737,17000000.0,4000000.0,1250000.0,5000000.0,4,6750000,-0.5,-0.6666666666666666
45403,André,Ayew,2024,738,France,Seclin,Ghana,17-12-89,Left Winger,Attack,Left,175.0,30-06-25,Wasserman,https://img.a.transfermarkt.technology/portrait/header/45403-1668429304.jpg?lm=1,FR1,Le Havre Athletic Club,800000.0,18000000.0,35,128,140,9,10,16,15,15,11,15,12,5,6,9,14,7,14,13,15,17,16,14,8,10,15,15,18,12,7,11,14,12,14,16,10,15,11,15,13,13,13,15,7,15,3,1,2,1,2,3,2,1,2,2,3,17,16,12,8,15,15,4,5,1,1,1,1,1,1,1,10,1,12,16,12,20,19,72,20,5,4784259,6250,7000,4350,African_Caribbean,123,107,23,48315.0,Unknown,8442448,23450000.0,2.0,34,1354,41,0,0,1,126,7,0.6765017200317545,0.4598930481283422,0.5441176470588236,0.0466451076518409,0.7039473684210525,0.3026315789473684,0.0037509377344336,0.0897724431107777,0.1302536181560599,0.1428571428571428,0.2790697674418605,0.7083333333333333,578,162,54,84,2,11372,9,66,92,700000,6382.978723404255,18000000.0,5000000.0,1000000.0,3000000.0,12,8000000,-0.3,-0.4166666666666667
45671,Cenk,Tosun,2024,36,Germany,Wetzlar,TÃ¼rkiye,07-06-91,Centre-Forward,Attack,Right,183.0,30-06-26,Unknown,https://img.a.transfermarkt.technology/portrait/header/45671-1728392200.JPG?lm=1,TR1,FenerbahÃ§e Spor KulÃ¼bÃ¼,1700000.0,23000000.0,33,120,135,7,8,10,15,11,10,15,13,7,8,12,16,4,12,16,13,14,14,14,10,13,17,12,13,11,8,13,14,8,10,13,12,12,10,11,12,12,14,10,15,10,1,1,1,4,3,2,2,2,3,3,2,12,14,5,15,10,15,4,10,1,1,1,1,1,1,1,1,1,1,10,1,1,20,78,18,20,1858437,6100,6100,4250,Northern_European,118,44,18,47858.0,Unknown,91001078,11525000.0,2.0,38,1659,100,0,1,7,84,3,0.5574225985710506,0.4491978609625668,0.5073529411764706,0.0462038205612746,0.2894736842105263,0.2368421052631578,0.0082520630157539,0.1147786946736684,0.0640017778271618,0.1428571428571428,0.4651162790697669,0.625,503,198,61,57,1,8215,18,130,239,1400000,30000.0,23000000.0,3000000.0,150000.0,2800000.0,7,17200000,-0.3,-0.48148148148148145
45672,Kevin,Trapp,2024,24,Germany,Merzig,Germany,08-07-90,Goalkeeper,Goalkeeper,Right,189.0,30-06-26,Sports360 GmbH,https://img.a.transfermarkt.technology/portrait/header/45672-1724772525.jpg?lm=1,L1,Eintracht Frankfurt FuÃŸball AG,4000000.0,12000000.0,34,144,148,6,3,1,3,10,8,7,2,2,1,9,3,3,10,8,15,14,16,13,7,14,12,6,9,1,16,17,10,13,14,14,13,15,10,10,16,16,5,15,5,14,13,12,10,10,14,11,17,17,15,12,11,11,15,4,13,12,17,15,17,20,1,1,1,1,1,1,1,1,1,1,1,1,1,88,7,20,347975206,7200,7200,6250,Northern_European,143,6,0,57692.0,Unknown,35018013,6000000.0,3.0,38,943,40,2,1,7,63,5,0.702963747023022,0.6631016042780749,0.6911764705882353,0.0556997007552092,0.0394736842105263,0.0,0.0197549387346836,0.0597649412353088,0.0333064807355759,0.2857142857142857,0.6046511627906974,0.6666666666666665,0,0,0,0,0,0,22,93,127,3000000,81944.44444444444,12000000.0,2000000.0,150000.0,3000000.0,3,5500000,-0.25,-0.5714285714285714
45683,Manuel,Gulde,2024,60,Germany,Mannheim,Germany,12-02-91,Centre-Back,Defender,Right,184.0,Unknown,Unique Sports Group,https://img.a.transfermarkt.technology/portrait/header/45683-1658411711.jpg?lm=1,L1,Sport-Club Freiburg,1500000.0,4000000.0,33,127,129,5,8,7,5,11,6,14,4,10,13,12,7,13,11,6,13,12,13,16,9,14,10,6,10,7,15,15,10,12,11,12,12,13,14,12,12,16,5,14,14,9,2,2,2,3,2,3,3,1,3,3,1,9,12,8,13,9,13,17,14,1,10,20,10,8,8,12,1,12,1,1,1,1,1,83,12,20,1823251,6250,6250,4500,Northern_European,126,0,0,9198.0,Unknown,35017406,1200000.0,1.0,38,906,40,1,1,7,189,2,0.5772691188145012,0.4759358288770053,0.5661764705882353,0.0088730570573586,0.0,0.0,0.0072518129532383,0.0197549387346836,0.0066390733075918,0.0,0.4883720930232553,0.625,342,17,1,42,1,5494,23,354,323,800000,21212.121212121212,4000000.0,1000000.0,100000.0,200000.0,3,900000,-0.4666666666666667,-0.4666666666666667
45717,Unknown,Nenê,2024,110302,Brazil,Sorocaba,Brazil,28-07-83,Centre-Forward,Attack,Left,183.0,30-06-25,Unknown,https://img.a.transfermarkt.technology/portrait/header/45717-1537365392.jpg?lm=1,PO1,Avs Futebol SAD,50000.0,6000000.0,41,125,157,13,12,14,13,14,14,11,14,6,5,14,18,5,16,10,12,11,14,14,16,15,15,15,13,14,7,12,13,9,10,11,10,15,10,11,11,12,9,13,7,14,3,3,3,1,3,3,3,2,2,3,3,15,16,14,10,14,13,8,8,1,1,1,1,1,1,1,17,15,15,18,20,15,16,70,20,7,79623,6238,6238,3493,Mediterranean_Hispanic,116,0,0,5830.0,Unknown,312059,2500000.0,2.0,10,1398,11,0,0,3,35,3,0.5756813971950252,0.368235294117647,0.4926470588235294,0.0056208581054396,0.0,0.0,0.0,0.0297574393598399,0.0138614961526709,0.1428571428571428,0.4651162790697669,0.9583333333333331,534,172,33,102,7,7044,7,49,98,50000,-20833.333333333332,6000000.0,1200000.0,,,9,5500000,0.0,0.0
46083,Domagoj,Vida,2024,2441,Jugoslawien (SFR),Nasice,Croatia,29-04-89,Centre-Back,Defender,Right,184.0,30-06-25,GPA Turkey,https://img.a.transfermarkt.technology/portrait/header/46083-1728415235.png?lm=1,GR1,Athlitiki Enosi Konstantinoupoleos,1000000.0,12000000.0,35,130,150,6,9,10,8,11,6,15,7,12,13,10,7,15,12,17,14,18,11,10,9,11,18,5,16,9,12,17,16,12,12,15,14,18,12,13,16,12,14,11,7,10,1,4,1,4,2,1,2,4,3,2,4,12,17,10,16,11,14,10,11,1,1,20,1,1,1,1,1,1,1,1,1,1,1,76,10,20,347975206,6750,7230,5983,Northern_European,129,98,4,37847.0,Unknown,24003525,2900000.0,3.0,55,1018,25,1,1,7,34,2,0.7069330510717121,0.6345454545454545,0.588235294117647,0.0365370261112564,0.6447368421052632,0.0526315789473684,0.0047511877969492,0.0597649412353088,0.0160837801050029,0.2857142857142857,0.4883720930232553,0.7083333333333333,586,52,23,108,4,15515,13,45,41,900000,8695.652173913044,12000000.0,2000000.0,850000.0,3000000.0,5,2850000,-0.25,-0.4
46413,Ante,Budimir,2024,331,Jugoslawien (SFR),Zenica,Croatia,22-07-91,Centre-Forward,Attack,Left,190.0,30-06-27,MG MEDIATOR TRANSFER,https://img.a.transfermarkt.technology/portrait/header/46413-1665055952.jpg?lm=1,ES1,Club AtlÃ©tico Osasuna,5000000.0,15000000.0,33,135,142,6,8,10,15,11,4,17,10,3,7,12,16,12,12,13,16,14,14,13,10,13,16,13,5,16,12,14,14,11,11,15,16,15,12,14,18,14,8,12,7,8,2,3,2,1,3,3,1,1,3,4,2,11,13,7,8,10,13,12,12,1,1,1,1,1,1,1,1,1,1,7,1,7,20,75,20,8,347975206,6600,6700,4500,Northern_European,134,14,1,11901.0,Unknown,24003746,2245714.286,7.0,55,1705,25,0,0,7,51,3,0.6368086795448531,0.4759358288770053,0.625,0.0114831205273815,0.0921052631578947,0.0131578947368421,0.0247561890472618,0.0747686921730432,0.0124487584988471,0.8571428571428572,0.6279069767441858,0.625,437,150,36,78,0,3410,9,40,88,5000000,133783.7837837838,15000000.0,7000000.0,,350000.0,8,8400000,0.0,0.0
46580,Andrej,Kramaric,2024,533,Jugoslawien (SFR),Zagreb,Croatia,19-06-91,Centre-Forward,Attack,Right,177.0,30-06-25,Unknown,https://img.a.transfermarkt.technology/portrait/header/46580-1657201316.jpg?lm=1,L1,TSG 1899 Hoffenheim FuÃŸball-Spielbetriebs GmbH,5000000.0,38000000.0,33,147,152,12,13,13,14,15,15,14,13,6,5,13,16,7,15,13,15,9,13,12,15,12,14,16,11,14,7,11,15,14,16,12,10,14,13,16,11,14,4,14,6,10,3,2,2,3,2,2,1,3,3,3,1,12,17,13,12,10,14,8,17,1,1,1,1,1,1,1,12,1,10,14,16,12,20,73,15,20,347975206,7350,7800,7000,Northern_European,147,71,19,76711.0,Unknown,24004434,7066666.667,3.0,55,1697,25,0,1,7,199,3,0.7823498279968246,0.7433155080213903,0.7205882352941175,0.0740647755374384,0.4671052631578947,0.25,0.0247561890472618,0.1897974493623406,0.0392325712769799,0.2857142857142857,0.3255813953488373,0.625,497,229,83,36,0,7664,20,57,85,4000000,86486.48648648648,38000000.0,7500000.0,1000000.0,250000.0,4,6750000,-0.2,-0.3333333333333333
48067,Artem,Dzyuba,2024,71985,UdSSR,Moskau,Russia,22-08-88,Centre-Forward,Attack,Right,197.0,30-06-25,Gestifute,https://img.a.transfermarkt.technology/portrait/header/48067-1726165311.png?lm=1,RU1,Akron Togliatti,2000000.0,16000000.0,36,120,140,7,7,9,15,13,8,15,9,9,7,12,14,7,13,14,14,18,14,15,12,14,13,11,14,12,12,14,9,8,9,13,17,16,9,11,15,15,13,17,5,11,3,3,3,1,1,2,3,3,1,1,1,13,15,15,12,13,10,10,11,1,1,1,1,1,1,1,1,3,1,1,8,3,20,91,14,20,1216783,6350,6720,4977,Northern_European,122,55,30,28766.0,Unknown,8085570,9111392.0,2.0,101,985,81,0,1,7,14,3,0.63945488224398,0.5269518716577539,0.536764705882353,0.0277682557186268,0.3618421052631578,0.3947368421052631,0.0097524381095273,0.0797699424856214,0.0505924720131114,0.1428571428571428,0.7906976744186047,0.75,613,220,120,47,1,17056,19,33,22,1800000,27906.976744186046,16000000.0,3000000.0,600000.0,500000.0,11,13250000,-0.1,-0.4
48119,Danijel,Aleksic,2024,2293,Jugoslawien (SFR),Pula,Serbia,30-04-91,Attacking Midfield,Midfield,Left,182.0,30-06-26,FutureBall,https://img.a.transfermarkt.technology/portrait/header/48119-1727457436.png?lm=1,TR1,Konyaspor,750000.0,3400000.0,33,125,130,13,13,13,14,13,17,9,17,5,4,15,14,3,15,7,14,8,14,8,13,14,12,14,5,14,5,12,13,13,13,8,9,13,12,11,13,7,3,14,6,8,1,3,4,3,3,3,1,1,1,2,3,13,12,8,12,10,13,12,7,1,1,1,1,1,1,1,1,15,1,14,20,14,12,79,20,10,347975206,6150,5616,4358,Mediterranean_Hispanic,123,2,0,19999.0,Unknown,5797637,2060000.0,3.0,55,1192,85,3,0,3,125,0,0.4933844932521831,0.4607486631016042,0.5441176470588236,0.0193026891475241,0.0131578947368421,0.0,0.0035008752188047,0.0167541885471367,0.0114169838051056,0.2857142857142857,0.4418604651162785,0.625,429,96,40,58,0,8579,17,50,52,700000,8510.63829787234,3400000.0,1500000.0,3000000.0,500000.0,9,4150000,-0.17647058823529413,-0.4166666666666667
48870,Jonas,Lössl,2024,865,Denmark,Kolding,Denmark,01-02-89,Goalkeeper,Goalkeeper,Right,195.0,30-06-29,Nine Group ,https://img.a.transfermarkt.technology/portrait/header/48870-1727290554.jpg?lm=1,DK1,Fodbold Club Midtjylland,400000.0,5000000.0,35,123,135,7,1,2,1,12,9,7,2,3,3,11,1,3,9,10,12,13,11,12,11,10,12,6,12,5,13,14,10,11,11,14,15,13,10,10,15,9,5,14,11,3,14,14,12,8,13,13,14,14,12,9,12,13,15,5,13,11,16,14,17,20,1,1,1,1,1,1,1,1,1,1,1,1,1,89,9,20,347975206,6150,6150,5150,Northern_European,124,1,0,5377.0,Unknown,1700114,1833333.333,3.0,28,741,30,2,1,7,86,5,0.5640381053188674,0.5454545454545454,0.5514705882352942,0.0051834334839374,0.006578947368421,0.0,0.0017504376094023,0.0247561890472618,0.0101576895635989,0.2857142857142857,0.7441860465116279,0.7083333333333333,0,0,0,0,0,0,6,18,39,200000,4054.054054054054,5000000.0,1500000.0,,250000.0,10,4050000,-0.5,-0.5555555555555556
49723,Timothy,Chandler,2024,24,Germany,Frankfurt am Main,United States,29-03-90,Right-Back,Defender,Right,186.0,30-06-25,Unknown,https://img.a.transfermarkt.technology/portrait/header/49723-1663064872.jpg?lm=1,L1,Eintracht Frankfurt FuÃŸball AG,500000.0,5000000.0,34,125,133,8,13,10,7,11,7,10,9,17,12,10,6,12,11,12,11,14,10,14,9,11,15,9,11,12,12,13,15,12,10,15,13,14,14,14,15,13,10,13,10,15,2,3,4,4,2,1,1,1,1,3,3,10,12,6,10,11,14,13,11,1,16,10,20,16,20,8,16,10,16,10,1,12,1,84,8,20,1302023,6248,6098,4748,Mixed_Race,115,29,1,14999.0,Unknown,91001071,1000000.0,1.0,38,507,102,1,1,4,63,11,0.5571579783011379,0.5024598930481283,0.4852941176470588,0.014474602817478,0.1907894736842105,0.0131578947368421,0.0022505626406601,0.0247561890472618,0.0055279313314258,0.0,0.5348837209302322,0.6666666666666665,386,29,28,64,2,5129,18,101,176,350000,7894.736842105263,5000000.0,1500000.0,50000.0,600000.0,3,125000,-0.3,-0.3
50219,Simon,Mignolet,2024,2282,Belgium,Sint-Truiden,Belgium,06-03-88,Goalkeeper,Goalkeeper,Right,193.0,30-06-26,SportPlus,https://img.a.transfermarkt.technology/portrait/header/50219-1705413908.jpg?lm=1,BE1,Club Brugge Koninklijke Voetbalvereniging,2000000.0,14000000.0,36,140,152,5,1,3,2,11,8,4,2,3,1,11,3,1,8,10,15,14,14,14,8,13,15,3,10,1,15,11,10,11,15,13,14,14,11,12,14,15,1,13,4,15,14,11,12,7,15,12,15,17,12,14,12,16,15,5,15,13,18,16,16,20,1,1,1,1,1,1,1,1,1,1,1,1,1,88,5,20,347975206,6800,7000,5750,Northern_European,140,35,0,85000.0,Unknown,8167246,6700000.0,3.0,7,1376,8,2,1,7,53,5,0.6765017200317545,0.6096256684491979,0.6691176470588234,0.0820687770553887,0.2302631578947368,0.0,0.0097524381095273,0.0697674418604651,0.037195477652157,0.2857142857142857,0.6976744186046511,0.75,0,0,0,0,0,0,6,29,64,1500000,37837.83783783784,14000000.0,3000000.0,,400000.0,3,8000000,-0.25,-0.4642857142857143
50355,Fedor,Smolov,2024,16704,UdSSR,Saratov,Russia,09-02-90,Centre-Forward,Attack,Right,187.0,30-06-25,prosm,https://img.a.transfermarkt.technology/portrait/header/50355-1721636139.png?lm=1,RU1,FK Krasnodar,2000000.0,16000000.0,34,128,145,10,9,11,14,14,12,8,13,10,7,11,12,6,14,12,12,12,13,12,12,13,15,14,10,14,9,10,9,15,13,12,14,14,14,13,13,12,13,8,6,12,2,3,3,2,1,2,2,3,2,1,4,15,18,7,13,9,12,10,10,1,1,1,1,1,1,1,7,1,1,10,8,8,20,83,11,20,3249267,6500,6500,5750,Northern_European,129,45,16,34520.0,Unknown,58008957,4560000.0,2.0,101,1344,81,0,1,7,78,3,0.6103466525535857,0.6096256684491979,0.588235294117647,0.0333244174672438,0.2960526315789473,0.2105263157894736,0.0097524381095273,0.0797699424856214,0.0253062585071807,0.1428571428571428,0.5581395348837206,0.6666666666666665,535,164,57,57,0,16706,19,85,90,1500000,34146.34146341463,16000000.0,2000000.0,1000000.0,1500000.0,12,9850000,-0.25,-0.4642857142857143
50655,Efecan,Karaca,2024,11282,TÃ¼rkiye,Istanbul,TÃ¼rkiye,16-11-89,Attacking Midfield,Midfield,Right,170.0,30-06-25,DW Sports Management,https://img.a.transfermarkt.technology/portrait/header/50655-1724671025.jpg?lm=1,TR1,Alanyaspor,350000.0,2000000.0,35,125,125,10,13,12,11,13,10,5,13,11,4,13,12,8,13,16,11,15,12,13,12,12,16,14,14,13,7,15,16,15,16,11,6,14,12,15,7,14,13,14,5,15,2,2,2,3,3,1,1,1,3,1,3,7,14,4,14,10,18,10,10,1,1,1,8,1,8,10,10,14,20,10,12,18,1,58,5,20,347975206,6200,6200,5400,Mediterranean_Hispanic,122,8,1,13825.0,Unknown,70013738,9111392.0,2.0,100,667,100,3,1,3,15,0,0.5706536120666843,0.5721925133689839,0.536764705882353,0.0133409681471832,0.0526315789473684,0.0131578947368421,0.0015003750937734,0.0097524381095273,0.0505924720131114,0.1428571428571428,0.1627906976744184,0.7083333333333333,545,51,68,93,2,4570,13,39,31,350000,7142.857142857143,2000000.0,400000.0,150000.0,350000.0,6,475000,-0.3,-0.4166666666666667
51471,Mateo,Kovacic,2024,281,Austria,Linz,Croatia,06-05-94,Central Midfield,Midfield,Right,177.0,30-06-27,Unknown,https://img.a.transfermarkt.technology/portrait/header/51471-1682668192.jpg?lm=1,GB1,Manchester City Football Club,30000000.0,45000000.0,30,164,172,10,10,17,8,17,12,10,10,7,12,15,12,15,17,14,16,14,18,11,15,16,17,16,11,13,12,15,17,15,15,16,9,12,14,15,15,13,12,13,8,15,3,2,2,1,2,1,2,4,3,2,2,14,14,9,12,14,16,14,17,1,1,1,1,1,1,18,10,20,10,7,15,5,1,78,11,20,233998516,8300,8050,7250,Northern_European,164,81,3,173988.0,Unknown,24016925,30775000.0,4.0,6,841,25,3,1,7,131,1,0.8154273617359089,0.7700534759358288,0.8455882352941175,0.1679971263230163,0.5328947368421052,0.0394736842105263,0.1497874468617154,0.2248062015503876,0.1709491930331398,0.4285714285714285,0.3255813953488373,0.5,566,32,47,74,2,13227,25,76,95,28000000,743243.2432432432,45000000.0,9000000.0,12000000.0,22000000.0,4,17000000,-0.06666666666666667,-0.2631578947368421
51894,Mert,Günok,2024,114,TÃ¼rkiye,KarabÃ¼k,TÃ¼rkiye,01-03-89,Goalkeeper,Goalkeeper,Right,196.0,30-06-25,FutureBall,https://img.a.transfermarkt.technology/portrait/header/51894-1727355668.png?lm=1,TR1,Be?ikta? Jimnastik KulÃ¼bÃ¼,1200000.0,5000000.0,35,120,140,4,1,1,3,9,8,5,3,2,1,13,1,2,10,9,13,12,12,12,10,12,8,5,8,7,14,13,8,8,12,11,14,14,8,10,12,10,5,10,6,14,13,14,12,10,13,14,13,14,12,7,13,12,9,3,15,5,13,15,15,20,1,1,1,1,1,1,1,1,1,1,1,1,1,76,10,20,1718698,6100,6100,5000,Mediterranean_Hispanic,120,22,0,14180.0,Unknown,70005951,1300000.0,1.0,100,709,100,2,1,3,37,5,0.5574225985710506,0.5294117647058822,0.5220588235294117,0.0136837622766165,0.1447368421052631,0.0,0.0057514378594648,0.0247561890472618,0.0071946442956748,0.0,0.7674418604651163,0.7083333333333333,0,0,0,0,0,0,19,82,201,1200000,19791.666666666668,5000000.0,1500000.0,50000.0,100000.0,4,950000,0.0,-0.14285714285714285
52281,Güray,Vural,2024,589,TÃ¼rkiye,Afyon,TÃ¼rkiye,11-06-88,Left-Back,Defender,Left,177.0,30-06-25,Soccer Republic,https://img.a.transfermarkt.technology/portrait/header/52281-1726736583.jpg?lm=1,TR1,Antalyaspor,150000.0,3750000.0,36,120,125,13,13,12,11,12,14,8,12,10,7,12,13,7,12,12,11,11,12,13,12,11,12,12,9,14,8,13,14,12,12,11,9,16,12,12,11,11,10,14,6,15,3,1,1,1,1,3,1,3,3,3,3,18,13,7,13,10,12,8,13,1,18,1,1,16,1,1,20,12,16,18,8,16,1,68,20,9,344302,5941,5741,4091,Mediterranean_Hispanic,111,1,0,3871.0,Unknown,70014232,542000.0,1.0,100,25,100,1,0,3,19,8,0.5099232601217253,0.4321925133689839,0.4558823529411764,0.0037292138813275,0.006578947368421,0.0,0.0005001250312578,0.0185046261565391,0.0029834162060057,0.0,0.3255813953488373,0.75,512,37,68,72,3,5265,30,179,275,150000,0.0,3750000.0,1500000.0,,500000.0,7,2825000,-0.3333333333333333,-0.6
52403,Dimitrios,Siovas,2024,3999,Greece,Drama,Greece,16-09-88,Centre-Back,Defender,Left,191.0,30-06-25,Unknown,https://img.a.transfermarkt.technology/portrait/header/52403-1728393929.png?lm=1,GR1,PAS Lamia 1964,350000.0,6000000.0,36,124,135,6,13,10,7,14,7,15,12,10,14,12,12,14,14,12,13,14,14,13,12,14,13,12,14,11,14,12,13,8,8,14,14,13,9,12,14,13,8,10,9,13,1,2,3,2,2,1,3,1,2,1,1,13,12,9,11,12,10,13,15,1,1,20,1,1,1,10,1,1,1,1,1,1,1,83,20,10,347975206,5999,5749,3505,Mediterranean_Hispanic,127,20,1,4999.0,Unknown,36002122,1433333.333,3.0,40,428,42,1,0,3,147,2,0.5109817412013761,0.36951871657754,0.5735294117647058,0.0048184301573859,0.131578947368421,0.0131578947368421,0.0015003750937734,0.0297574393598399,0.0079354056112669,0.2857142857142857,0.6511627906976742,0.75,415,14,8,68,1,8490,14,71,123,250000,2272.7272727272725,6000000.0,2000000.0,400000.0,400000.0,8,4500000,-0.2857142857142857,-0.375
52570,Fraser,Forster,2024,148,England,Hexham,England,17-03-88,Goalkeeper,Goalkeeper,Right,201.0,30-06-25,CAA Stellar,https://img.a.transfermarkt.technology/portrait/header/52570-1676412801.jpg?lm=1,GB1,Tottenham Hotspur Football Club,1200000.0,15000000.0,36,136,150,4,3,2,3,8,6,1,3,2,1,9,3,7,7,7,12,15,16,15,9,15,17,2,9,1,15,6,12,2,12,13,20,11,2,9,19,15,5,16,6,1,19,11,14,4,14,13,16,17,12,3,13,13,19,3,8,13,20,18,15,20,1,1,1,1,1,1,1,1,1,1,1,1,1,99,7,20,9003176,6791,6241,5341,Northern_European,135,6,0,81194.0,Unknown,5128263,7500000.0,2.0,32,624,33,2,1,7,202,5,0.5760783275998942,0.5658823529411764,0.6323529411764706,0.0783936377409577,0.0394736842105263,0.0,0.0057514378594648,0.0747686921730432,0.041640045556821,0.1428571428571428,0.8837209302325584,0.75,0,0,0,0,0,0,6,72,288,1200000,32142.85714285714,15000000.0,3000000.0,,,5,9000000,0.0,0.0
52769,Unknown,Willian,2024,683,Brazil,RibeirÃ£o Pires,Brazil,09-08-88,Left Winger,Attack,Right,175.0,30-06-25,Sports Invest UK ltd,https://img.a.transfermarkt.technology/portrait/header/52769-1728418132.png?lm=1,GR1,Olympiakos Syndesmos Filathlon Peiraios,2000000.0,50000000.0,36,134,162,10,13,16,11,15,14,9,14,8,5,13,13,8,16,9,14,9,13,11,13,13,10,14,8,14,7,14,13,13,14,12,9,12,14,12,11,12,8,14,13,12,1,1,1,1,1,1,1,1,1,1,1,14,10,8,14,11,16,13,12,1,1,1,1,1,1,1,15,13,15,18,18,20,12,78,8,20,6705620,7000,6700,6000,African_Caribbean,132,70,9,52196.0,Unknown,8832889,28166666.67,3.0,10,1226,11,0,1,1,141,7,0.6368086795448531,0.6363636363636364,0.6102941176470589,0.0503926682612226,0.4605263157894737,0.1184210526315789,0.0097524381095273,0.2498124531132783,0.1564580497791605,0.2857142857142857,0.2790697674418605,0.75,776,115,149,50,2,20639,16,39,40,1000000,-208333.33333333334,50000000.0,10000000.0,,10000000.0,6,18500000,-0.6666666666666666,-0.6666666666666666
53418,Kevin,Kampl,2024,23826,Germany,Solingen,Slovenia,09-10-90,Central Midfield,Midfield,Right,178.0,30-06-26,Unknown,https://img.a.transfermarkt.technology/portrait/header/53418-1696919483.jpg?lm=1,L1,RasenBallsport Leipzig,3500000.0,22000000.0,34,141,150,11,11,14,10,14,11,5,13,6,8,14,10,12,15,18,12,8,14,11,14,15,14,15,10,12,11,16,18,14,15,10,8,15,12,16,6,15,9,14,13,17,3,2,2,4,3,3,3,3,2,3,1,9,17,13,6,13,12,10,10,1,1,1,1,1,1,10,15,20,19,15,16,19,1,66,12,20,347975206,7250,6500,6000,Northern_European,135,28,2,40077.0,Unknown,91005023,9250000.0,5.0,38,1392,87,3,1,7,162,1,0.6103466525535857,0.6363636363636364,0.6323529411764706,0.038690352614457,0.1842105263157894,0.0263157894736842,0.0172543135783946,0.1097774443610902,0.0513625378482735,0.5714285714285714,0.3488372093023257,0.6666666666666665,601,61,108,91,2,13679,44,111,109,3000000,76282.05128205128,22000000.0,4500000.0,25000.0,200000.0,6,8250000,-0.14285714285714285,-0.14285714285714285
53622,?Lkay,Gündo?An,2024,281,Germany,Gelsenkirchen,Germany,24-10-90,Central Midfield,Midfield,Right,180.0,30-06-25,Unknown,https://img.a.transfermarkt.technology/portrait/header/53622-1689683568.jpg?lm=1,GB1,Manchester City Football Club,12000000.0,50000000.0,34,165,167,10,11,14,13,17,14,7,12,6,10,16,14,13,16,15,17,13,16,14,16,14,13,13,10,16,12,16,15,14,16,14,10,13,13,16,13,17,8,15,11,14,1,2,3,3,2,2,1,1,1,3,3,13,17,6,7,14,16,16,14,1,1,1,1,1,1,16,11,20,10,11,16,10,1,80,13,20,61209266,8250,8200,8100,North_African__Middle_Eastern,164,59,14,191386.0,Unknown,91003875,11116666.67,3.0,38,526,40,3,1,6,131,1,0.8352738819793597,0.8609625668449197,0.8455882352941175,0.1847969355170446,0.3881578947368421,0.1842105263157894,0.0597649412353088,0.2498124531132783,0.0617331963110086,0.2857142857142857,0.3953488372093026,0.6666666666666665,642,117,78,52,0,15989,34,264,429,10000000,236904.7619047619,50000000.0,10000000.0,700000.0,6500000.0,5,6100000,-0.3333333333333333,-0.4444444444444444
53696,Lars,Unnerstall,2024,317,Germany,IbbenbÃ¼ren,Germany,20-07-90,Goalkeeper,Goalkeeper,Right,198.0,30-06-27,ROOF,https://img.a.transfermarkt.technology/portrait/header/53696-1723459783.jpg?lm=1,NL1,Football Club Twente,3500000.0,3500000.0,34,134,136,5,1,1,2,7,8,5,3,2,3,8,3,2,8,7,12,12,14,13,7,12,10,1,13,1,15,14,13,9,14,16,18,13,9,12,17,13,5,13,3,14,17,15,14,6,14,10,14,13,12,8,13,18,11,6,11,12,10,10,10,20,1,1,1,1,1,1,1,1,1,1,1,1,1,103,5,20,347975206,6700,6100,5000,Northern_European,134,0,0,3999.0,Unknown,91018384,200000.0,1.0,38,649,40,2,1,7,91,5,0.5574225985710506,0.5294117647058822,0.625,0.0038528128913767,0.0,0.0,0.0172543135783946,0.0172543135783946,0.0010833634267618,0.0,0.8139534883720931,0.6666666666666665,0,0,0,0,0,0,10,38,100,3000000,76282.05128205128,3500000.0,800000.0,,150000.0,6,525000,-0.14285714285714285,-0.0625
54781,Nicolás,Otamendi,2024,294,Argentina,Buenos Aires,Argentina,12-02-88,Centre-Back,Defender,Right,183.0,30-06-25,Gestifute,https://img.a.transfermarkt.technology/portrait/header/54781-1669835534.jpg?lm=1,PO1,Sport Lisboa e Benfica,1000000.0,35000000.0,36,158,159,5,8,11,10,13,6,15,6,11,18,13,10,16,12,17,18,20,14,15,12,13,18,6,19,13,14,18,18,10,13,16,13,16,10,15,15,15,16,14,3,9,2,3,1,3,2,3,1,2,2,1,2,16,18,12,7,19,15,14,12,1,1,20,13,1,1,7,1,1,1,1,1,1,1,81,12,20,3420019,7750,7550,7000,Mediterranean_Hispanic,157,91,4,38174.0,Unknown,14004589,18875000.0,4.0,4,275,4,1,1,3,188,2,0.7492722942577401,0.7433155080213903,0.7941176470588234,0.0368527829572415,0.5986842105263157,0.0526315789473684,0.0047511877969492,0.1747936984246061,0.1048362454512625,0.4285714285714285,0.4651162790697669,0.75,657,39,18,162,2,20149,8,16,14,1000000,23750.0,35000000.0,7000000.0,,50000.0,5,11800000,0.0,-0.3333333333333333
54906,Matteo,Darmian,2024,46,Italy,Legnano,Italy,02-12-89,Right-Back,Defender,Right,183.0,30-06-25,TMP SOCCER srl ,https://img.a.transfermarkt.technology/portrait/header/54906-1695027410.jpg?lm=1,IT1,Football Club Internazionale Milano S.p.A.,4000000.0,15000000.0,35,142,146,4,12,10,10,13,3,11,8,10,13,12,4,15,12,12,13,14,13,15,10,12,17,5,10,13,14,16,15,13,14,15,11,17,13,14,13,15,9,14,5,17,4,2,3,2,3,1,2,3,3,2,3,10,16,8,14,15,18,18,18,1,16,15,20,17,20,1,15,1,18,1,1,1,1,70,11,20,5762053,7100,6750,5900,Northern_European,132,36,1,49230.0,Unknown,7990060,5482000.0,5.0,52,812,54,1,1,7,89,11,0.6434241862926701,0.6256684491978609,0.6102941176470589,0.0475286474502393,0.2368421052631578,0.0131578947368421,0.0197549387346836,0.0747686921730432,0.030428623017306,0.5714285714285714,0.4651162790697669,0.7083333333333333,576,24,27,68,1,10631,11,60,83,4000000,103947.36842105263,15000000.0,3000000.0,200000.0,1000000.0,6,6200000,0.0,0.0
55089,Oliver,Baumann,2024,533,Germany,Breisach am Rhein,Germany,02-06-90,Goalkeeper,Goalkeeper,Right,187.0,30-06-26,CN Sports,https://img.a.transfermarkt.technology/portrait/header/55089-1657200130.jpg?lm=1,L1,TSG 1899 Hoffenheim FuÃŸball-Spielbetriebs GmbH,3000000.0,10000000.0,34,137,142,5,3,1,3,9,6,6,3,1,3,8,3,3,9,8,16,11,13,16,7,12,13,4,11,3,8,17,10,12,14,12,14,16,10,12,14,17,5,14,4,14,13,10,14,8,16,11,16,16,16,8,15,8,14,6,14,12,18,16,10,20,1,1,1,1,1,1,1,1,1,1,1,1,1,82,7,20,5931272,6734,6734,5984,Northern_European,133,0,0,57692.0,Unknown,35017377,5500000.0,1.0,38,252,40,2,1,7,199,5,0.6413072241333686,0.6346524064171123,0.6176470588235294,0.0556997007552092,0.0,0.0,0.0147536884221055,0.0497624406101525,0.0305286257951609,0.0,0.5581395348837206,0.6666666666666665,0,0,0,0,0,0,10,26,52,3000000,84285.71428571429,10000000.0,2500000.0,50000.0,3000000.0,2,1100000,0.0,-0.25
55099,Nicolas,Höfler,2024,60,Germany,Ãœberlingen,Germany,09-03-90,Defensive Midfield,Midfield,Right,181.0,Unknown,Unknown,https://img.a.transfermarkt.technology/portrait/header/55099-1658412737.jpg?lm=1,L1,Sport-Club Freiburg,1000000.0,4500000.0,34,135,138,8,11,9,7,13,6,9,8,10,12,15,7,12,14,12,13,11,16,17,14,16,12,7,12,10,13,18,15,11,13,12,9,16,12,16,12,17,8,15,7,16,2,2,1,2,3,2,3,1,1,3,1,7,10,3,16,13,16,14,18,1,1,13,12,1,12,20,1,20,1,1,1,1,1,81,10,20,1848645,6500,6500,4750,Northern_European,133,0,0,11538.0,Unknown,35017386,9111392.0,2.0,38,1714,40,3,1,7,189,4,0.6103466525535857,0.5026737967914437,0.6176470588235294,0.0111326014598201,0.0,0.0,0.0047511877969492,0.0222555638909727,0.0505924720131114,0.1428571428571428,0.418604651162791,0.6666666666666665,544,37,32,132,2,9033,10,29,109,700000,18055.555555555555,4500000.0,1000000.0,50000.0,150000.0,4,400000,-0.65,-0.65
55336,Denis,Glushakov,2024,3719,UdSSR,"Millerovo, Rostov Oblast",Russia,27-01-87,Central Midfield,Midfield,Right,181.0,30-06-25,Unknown,https://img.a.transfermarkt.technology/portrait/header/55336-1603044411.png?lm=1,RU1,FK Khimki,150000.0,10000000.0,37,120,141,11,9,12,12,13,12,7,14,8,11,12,12,11,12,13,13,13,13,10,12,12,16,10,15,13,11,15,13,12,12,12,10,16,12,13,12,19,8,16,6,13,3,3,1,3,3,1,1,1,3,1,1,6,11,16,13,12,12,15,13,1,1,9,1,1,1,18,10,20,8,7,13,6,1,80,11,20,347975206,5899,5899,5249,Northern_European,120,57,5,1917.0,Unknown,8083059,8000000.0,1.0,101,953,81,3,1,7,76,1,0.5308282614448266,0.5560427807486631,0.5220588235294117,0.0018423977435455,0.375,0.0657894736842105,0.0005001250312578,0.0497624406101525,0.044417900497236,0.0,0.418604651162791,0.7916666666666665,523,79,34,89,1,8328,11,43,36,100000,609.7560975609756,10000000.0,2500000.0,,75000.0,8,2525000,-0.3333333333333333,-0.6666666666666666
55605,Hasan Ali,Kald?R?M,2024,3205,Germany,Neuwied,TÃ¼rkiye,09-12-89,Left-Back,Defender,Left,183.0,30-06-25,Gamechanger 24,https://img.a.transfermarkt.technology/portrait/header/55605-1696332450.png?lm=1,TR1,Kayserispor KulÃ¼bÃ¼,100000.0,6000000.0,35,120,125,11,12,9,7,12,10,11,10,13,13,12,8,13,12,10,12,13,13,13,8,12,13,7,10,11,13,15,16,12,12,11,11,17,12,15,12,14,13,12,12,7,1,2,1,1,2,2,2,2,3,1,3,14,12,5,16,12,18,10,12,1,20,1,1,18,1,1,10,5,1,1,1,1,1,76,20,8,735308,6000,6000,4016,Mediterranean_Hispanic,120,35,1,13825.0,Unknown,91002778,1925000.0,2.0,38,1034,100,1,0,3,118,8,0.5441915850754168,0.4241711229946523,0.5220588235294117,0.0133409681471832,0.2302631578947368,0.0131578947368421,0.0002500625156289,0.0297574393598399,0.0106669629711936,0.1428571428571428,0.4651162790697669,0.7083333333333333,526,18,46,79,2,11659,27,87,59,100000,625.0,6000000.0,1500000.0,75000.0,400000.0,5,2100000,0.0,-0.3333333333333333
55619,Nordin,Amrabat,2024,2441,Netherlands,Naarden,Morocco,31-03-87,Right Winger,Attack,Right,179.0,30-06-25,11MANGMT,https://img.a.transfermarkt.technology/portrait/header/55619-1728416194.png?lm=1,GR1,Athlitiki Enosi Konstantinoupoleos,300000.0,6000000.0,37,125,155,11,14,15,9,14,11,7,9,4,7,13,14,7,15,14,10,12,10,9,13,9,14,15,9,13,8,8,13,14,12,15,8,16,13,11,15,10,12,11,7,10,2,1,2,2,3,2,2,2,1,3,3,13,15,13,9,12,15,10,10,1,1,1,1,1,1,1,12,1,14,18,16,20,16,77,11,20,374001,6500,6955,4968,North_African__Middle_Eastern,119,58,5,21289.0,Unknown,37001123,4639285.714,7.0,67,1009,67,0,1,6,34,10,0.6705477639587193,0.5259893048128341,0.5147058823529411,0.0205483354206759,0.381578947368421,0.0657894736842105,0.0012503125781445,0.0297574393598399,0.0257467469318592,0.8571428571428572,0.3720930232558141,0.7916666666666665,607,97,104,112,3,9636,16,52,50,250000,-10256.410256410256,6000000.0,1500000.0,,2000000.0,11,7850000,-0.16666666666666666,-0.375
55735,Henrikh,Mkhitaryan,2024,46,UdSSR,Yerevan,Armenia,21-01-89,Central Midfield,Midfield,Right,177.0,30-06-26,Rafaela Pimenta,https://img.a.transfermarkt.technology/portrait/header/55735-1664973670.jpg?lm=1,IT1,Football Club Internazionale Milano S.p.A.,6000000.0,37000000.0,35,149,165,11,12,14,14,15,11,10,14,4,7,15,13,10,16,14,17,10,12,11,16,15,15,14,5,16,9,15,12,13,15,13,8,14,14,12,10,11,6,12,11,17,3,3,3,3,1,2,2,2,1,2,1,17,16,10,6,11,19,13,14,1,1,1,1,1,1,1,13,18,12,16,20,12,10,75,15,20,5875523,7450,8000,6900,North_African__Middle_Eastern,149,94,32,93653.0,Unknown,59006269,21940000.0,5.0,101,1685,5,3,1,6,89,1,0.808811854988092,0.7326203208556149,0.7352941176470587,0.0904242632581664,0.6184210526315789,0.4210526315789473,0.0297574393598399,0.1847961990497624,0.1218644962360065,0.5714285714285714,0.3255813953488373,0.7083333333333333,704,181,150,82,0,19186,22,102,50,5000000,118918.91891891892,37000000.0,5000000.0,,1200000.0,7,14800000,-0.16666666666666666,-0.16666666666666666
55769,Danilo,D'Ambrosio,2024,2919,Italy,Napoli,Italy,09-09-88,Centre-Back,Defender,Right,180.0,30-06-25,Unknown,https://img.a.transfermarkt.technology/portrait/header/55769-1595925735.jpg?lm=1,IT1,Associazione Calcio Monza,1000000.0,13000000.0,36,138,146,4,12,10,13,12,5,18,8,13,13,12,6,14,12,17,14,15,14,13,10,12,16,7,13,13,13,14,15,12,12,13,14,14,12,13,13,17,13,14,10,16,2,1,4,3,3,1,3,2,2,1,3,13,16,8,17,16,20,12,14,1,12,18,20,10,18,1,10,1,12,1,1,1,1,75,10,20,1245342,6900,6600,5750,Mediterranean_Hispanic,128,6,0,71154.0,Unknown,1414241,3790000.0,1.0,52,1016,54,1,1,3,28,2,0.6235776660492194,0.6096256684491979,0.5808823529411764,0.0686988403902252,0.0394736842105263,0.0,0.0047511877969492,0.0647661915478869,0.0210283618989416,0.0,0.3953488372093026,0.75,541,43,28,96,3,9929,21,75,50,800000,15151.515151515152,13000000.0,3000000.0,,,2,700000,-0.2,-0.2
56100,Leon,Balogun,2024,124,Germany,Berlin,Nigeria,28-06-88,Centre-Back,Defender,Right,190.0,31-05-25,Avid Sports Group,https://img.a.transfermarkt.technology/portrait/header/56100-1689170546.jpg?lm=1,SC1,Rangers Football Club,150000.0,2000000.0,36,121,128,5,8,8,6,11,5,14,7,16,12,13,6,13,9,14,10,15,9,8,8,11,15,7,13,10,12,15,12,14,12,12,16,12,16,15,15,12,13,12,10,12,2,1,2,4,3,4,2,1,2,2,2,8,14,4,8,12,17,13,13,1,1,20,15,1,14,10,1,9,1,1,1,1,1,81,10,20,552988,6050,6050,4750,Mixed_Race,122,46,1,9279.0,Unknown,92002651,9111392.0,2.0,38,178,70,1,1,4,161,2,0.5508070918232336,0.5026737967914437,0.536764705882353,0.0089512720559053,0.3026315789473684,0.0131578947368421,0.0005001250312578,0.0097524381095273,0.0505924720131114,0.1428571428571428,0.6279069767441858,0.75,377,20,6,65,3,8096,33,138,148,150000,1515.1515151515152,2000000.0,500000.0,,100000.0,9,1575000,0.0,-0.25
56416,Dries,Mertens,2024,141,Belgium,Leuven,Belgium,06-05-87,Second Striker,Attack,Right,169.0,30-06-25,Stirr Associates,https://img.a.transfermarkt.technology/portrait/header/56416-1671109411.png?lm=1,TR1,Galatasaray Spor KulÃ¼bÃ¼,1800000.0,32000000.0,37,135,166,12,14,13,17,16,13,7,13,3,4,14,16,8,17,14,14,11,15,12,14,14,17,17,15,15,8,13,13,12,15,8,6,15,10,12,7,14,10,15,11,13,3,2,1,3,3,1,1,4,2,2,3,17,16,10,18,15,18,6,12,1,1,1,1,1,1,1,1,1,1,16,20,13,18,61,12,20,766051,7300,7250,6400,Northern_European,133,105,21,128205.0,Unknown,8169425,4281500.0,4.0,7,826,8,0,1,7,102,12,0.7095792537708389,0.6791443850267379,0.6176470588235294,0.1237882710333166,0.6907894736842105,0.2763157894736842,0.0087521880470117,0.1597899474868717,0.0237589933053695,0.4285714285714285,0.13953488372093,0.7916666666666665,804,270,222,95,1,12800,14,46,66,1800000,33333.333333333336,32000000.0,5000000.0,,350000.0,4,7850000,0.0,-0.1
56831,Juan,Neira,2024,653,Argentina,Azul,Argentina,21-02-89,Attacking Midfield,Midfield,Right,179.0,30-06-25,Primotempo,https://img.a.transfermarkt.technology/portrait/header/56831-1727962381.jpg?lm=1,GR1,Omilos Filathlon Irakliou FC,150000.0,1650000.0,35,120,120,12,12,15,12,14,12,11,10,8,7,14,12,8,15,13,12,10,13,10,15,12,13,15,11,13,9,13,13,10,13,12,9,12,10,12,11,13,16,14,15,11,2,3,2,3,2,1,1,1,1,3,1,15,8,7,13,11,12,7,5,1,1,1,1,1,1,6,7,16,6,10,20,7,16,69,12,20,347975206,6000,5280,3017,Mediterranean_Hispanic,120,0,0,2110.0,Unknown,14006698,9111392.0,2.0,4,115,4,3,1,3,145,0,0.4489282879068537,0.3173262032085561,0.5220588235294117,0.0020287618758853,0.0,0.0,0.0005001250312578,0.008002000500125,0.0505924720131114,0.1428571428571428,0.3720930232558141,0.7083333333333333,409,60,31,113,4,14654,6,25,50,125000,-12931.034482758621,1650000.0,700000.0,500000.0,700000.0,5,800000,-0.16666666666666666,-0.375
57071,Péter,Gulácsi,2024,23826,Hungary,Budapest,Hungary,06-05-90,Goalkeeper,Goalkeeper,Right,190.0,30-06-26,Unknown,https://img.a.transfermarkt.technology/portrait/header/57071-1719214600.jpg?lm=1,L1,RasenBallsport Leipzig,3000000.0,13000000.0,34,138,146,4,2,1,2,9,7,3,3,2,3,10,2,1,9,8,16,13,13,17,7,11,12,3,12,2,8,14,10,12,13,14,14,13,10,12,15,17,4,15,4,13,14,13,10,8,16,13,15,16,15,11,10,14,16,5,15,13,17,14,18,20,1,1,1,1,1,1,1,1,1,1,1,1,1,86,6,20,347975206,7160,7161,6211,Northern_European,133,49,0,67077.0,Unknown,28018193,1625000.0,2.0,45,273,47,2,1,7,162,5,0.6978036517597248,0.6589304812834224,0.6176470588235294,0.0647620187967057,0.3223684210526316,0.0,0.0147536884221055,0.0647661915478869,0.0090002500069446,0.1428571428571428,0.6279069767441858,0.6666666666666665,0,0,0,0,0,0,11,77,345,2500000,66666.66666666667,13000000.0,3000000.0,,,2,1250000,-0.16666666666666666,-0.2857142857142857
57500,César,Azpilicueta,2024,13,Spain,Pamplona,Spain,28-08-89,Centre-Back,Defender,Right,178.0,30-06-25,Unknown,https://img.a.transfermarkt.technology/portrait/header/57500-1668169250.jpg?lm=1,ES1,Club AtlÃ©tico de Madrid S.A.D.,2000000.0,40000000.0,35,148,165,8,15,12,6,11,7,10,9,11,14,13,8,16,15,15,15,16,14,16,10,15,18,8,18,12,15,18,18,10,12,12,10,17,11,14,12,18,12,15,5,16,3,3,3,3,2,4,3,1,2,2,1,12,14,6,18,16,20,15,12,1,19,18,20,16,15,1,1,1,1,1,1,1,1,76,15,20,21003166,7400,7750,6500,Mediterranean_Hispanic,142,40,1,173988.0,Unknown,67033300,7400000.0,2.0,89,1115,89,1,1,3,52,2,0.7757343212490078,0.6898395721925134,0.6838235294117647,0.1679971263230163,0.2631578947368421,0.0131578947368421,0.0097524381095273,0.1997999499874969,0.041084474568738,0.1428571428571428,0.3488372093023257,0.7083333333333333,736,19,62,92,2,17462,9,79,170,1800000,33333.333333333336,40000000.0,6000000.0,2000000.0,7000000.0,3,3000000,-0.1,-0.55
57723,Iván,Marcano,2024,720,Spain,Santander,Spain,23-06-87,Centre-Back,Defender,Left,189.0,30-06-25,IDUB GLOBAL,https://img.a.transfermarkt.technology/portrait/header/57723-1582712906.png?lm=1,PO1,Futebol Clube do Porto,250000.0,8000000.0,37,135,144,8,11,10,9,12,6,16,7,14,15,14,7,14,13,12,14,15,14,14,11,14,15,6,16,12,15,16,14,9,9,13,14,10,10,12,13,18,13,12,16,12,2,1,2,3,1,3,1,1,1,2,1,12,15,5,15,14,18,13,14,1,15,20,1,1,1,10,1,1,1,1,1,1,1,77,20,10,735930,6750,6750,5250,Mediterranean_Hispanic,135,0,0,38626.0,Unknown,67009719,4182500.0,4.0,89,1331,89,1,0,3,100,2,0.6434241862926701,0.5561497326203209,0.6323529411764706,0.0372892419614776,0.0,0.0,0.0010002500625156,0.0397599399849962,0.0232089780271674,0.4285714285714285,0.6046511627906974,0.7916666666666665,535,44,15,106,4,17142,10,199,525,200000,0.0,8000000.0,2000000.0,,300000.0,9,9250000,-0.2,-0.3333333333333333
58088,Fernando,Muslera,2024,141,Argentina,Buenos Aires,Uruguay,16-06-86,Goalkeeper,Goalkeeper,Right,190.0,30-06-25,SBI Football,https://img.a.transfermarkt.technology/portrait/header/58088-1671035581.png?lm=1,TR1,Galatasaray Spor KulÃ¼bÃ¼,1100000.0,18000000.0,38,135,160,4,2,9,2,11,9,8,1,1,3,11,7,2,10,10,15,13,12,10,10,11,17,8,16,7,17,13,12,11,15,12,15,16,10,11,12,12,2,12,6,12,12,10,14,7,16,11,15,15,14,4,14,15,13,4,18,18,18,15,18,20,1,1,1,1,1,1,1,1,1,1,1,1,1,84,8,20,347975206,7050,7545,5555,Northern_European,134,133,0,80126.0,Unknown,78001113,4875000.0,2.0,4,275,103,2,1,7,102,5,0.7486107435829584,0.5887700534759358,0.625,0.0773623585008598,0.875,0.0,0.005251312828207,0.0897724431107777,0.0270563071196422,0.1428571428571428,0.6279069767441858,0.8333333333333333,0,0,0,0,0,0,14,72,168,1000000,-10869.565217391304,18000000.0,3000000.0,,,1,0,-0.2857142857142857,-0.3333333333333333
58358,Thomas,Müller,2024,27,Germany,Weilheim in Oberbayern,Germany,13-09-89,Second Striker,Attack,Right,185.0,30-06-25,KÃ¶gl & Partner GmbH,https://img.a.transfermarkt.technology/portrait/header/58358-1683890647.jpg?lm=1,L1,FC Bayern MÃ¼nchen,8000000.0,75000000.0,35,171,174,11,17,11,13,13,7,14,10,8,9,16,13,11,13,17,20,13,16,16,18,16,18,13,17,20,11,20,17,12,12,13,13,20,14,19,11,16,9,17,2,18,2,3,2,2,1,1,1,1,3,1,1,10,17,10,20,19,16,10,10,1,1,1,1,1,1,10,10,14,15,11,20,18,15,76,13,20,347975206,8545,8545,8495,Northern_European,165,115,42,335615.0,Unknown,35011448,9111392.0,2.0,38,1650,40,0,1,7,68,12,0.8809208785392961,0.9032085561497324,0.8529411764705881,0.3240669481762869,0.756578947368421,0.5526315789473684,0.0397599399849962,0.3748437109277319,0.0505924720131114,0.1428571428571428,0.5116279069767438,0.7083333333333333,824,289,277,44,1,17122,21,48,36,6000000,131111.11111111112,75000000.0,15000000.0,100000.0,23000000.0,0,0,-0.25,-0.4
58995,Anthony,Jung,2024,86,Spain,Villajoyosa,Germany,03-11-91,Centre-Back,Defender,Left,186.0,30-06-25,CAA Stellar,https://img.a.transfermarkt.technology/portrait/header/58995-1660208184.jpg?lm=1,L1,Sportverein Werder Bremen von 1899,1000000.0,1500000.0,33,125,135,13,13,10,7,11,12,10,13,14,12,14,9,12,10,13,13,13,15,13,11,13,12,11,10,13,12,13,15,11,10,14,13,14,13,15,13,14,13,12,6,13,2,2,1,1,1,3,2,2,1,3,3,10,14,12,6,11,10,8,8,1,20,19,12,18,12,10,12,1,10,1,1,1,1,87,20,7,1725682,6246,6246,4496,Mediterranean_Hispanic,121,0,0,13310.0,Unknown,92021650,800000.0,1.0,89,1600,40,1,0,3,194,2,0.5767398782746759,0.4755080213903743,0.5294117647058822,0.0128436752551885,0.0,0.0,0.0047511877969492,0.0072518129532383,0.0044167893552598,0.0,0.5348837209302322,0.625,504,28,31,62,1,10923,5,14,67,1000000,29687.5,1500000.0,500000.0,75000.0,150000.0,5,400000,0.0,0.0
59016,David,Alaba,2024,418,Austria,Wien,Austria,24-06-92,Centre-Back,Defender,Left,180.0,30-06-26,Unknown,https://img.a.transfermarkt.technology/portrait/header/59016-1684921582.jpeg?lm=1,ES1,Real Madrid Club de FÃºtbol,20000000.0,65000000.0,32,164,174,12,11,12,10,15,15,13,14,13,14,16,14,13,15,13,15,12,16,15,13,15,16,12,15,14,16,15,14,15,12,14,12,18,15,15,13,14,8,15,7,19,2,3,1,2,1,1,4,3,3,2,3,12,17,10,14,15,15,12,10,1,20,19,1,17,1,14,12,17,1,12,10,1,1,78,20,10,184320073,8200,8200,7450,South_East_Asian,158,94,14,419579.0,Unknown,16010162,150000.0,1.0,6,1663,7,1,0,9,167,2,0.8352738819793597,0.7914438502673796,0.8014705882352942,0.4051440362994842,0.6184210526315789,0.1842105263157894,0.0997749437359339,0.3248312078019504,0.0008055779327203,0.0,0.3953488372093026,0.5833333333333333,647,53,75,37,1,18252,45,214,381,10000000,239024.39024390245,65000000.0,13000000.0,3000000.0,22000000.0,4,4100000,-0.5,-0.6666666666666666
59145,Gernot,Trauner,2024,234,Austria,Linz,Austria,25-03-92,Centre-Back,Defender,Right,183.0,30-06-26,ROOF,https://img.a.transfermarkt.technology/portrait/header/59145-1676465806.jpg?lm=1,NL1,Feyenoord Rotterdam,3500000.0,5000000.0,32,136,136,8,10,9,7,11,9,15,10,9,14,12,8,13,11,16,12,13,14,14,13,12,14,6,16,9,15,15,15,12,11,13,15,13,11,13,16,16,11,14,8,11,3,2,2,2,3,2,1,2,3,3,1,10,13,5,8,12,13,15,16,1,1,20,16,1,14,14,1,14,14,1,10,12,1,82,10,20,12321996,6788,6588,5238,Northern_European,135,8,1,14999.0,Unknown,16023929,1500000.0,1.0,6,841,7,1,1,7,85,2,0.6219899444297433,0.5548663101604278,0.6323529411764706,0.014474602817478,0.0526315789473684,0.0131578947368421,0.0172543135783946,0.0247561890472618,0.0083057862718408,0.0,0.4651162790697669,0.5833333333333333,441,31,23,69,4,12094,34,221,406,3000000,79729.72972972973,5000000.0,1000000.0,200000.0,300000.0,4,750000,-0.14285714285714285,-0.3333333333333333
59322,Oleksandr,Karavaev,2024,338,Ukraine,Kherson,Ukraine,02-06-92,Right-Back,Defender,Right,175.0,30-06-25,ProStar,https://img.a.transfermarkt.technology/portrait/header/59322-1726134817.png?lm=1,UKR1,Futbolniy Klub Dynamo Kyiv,1800000.0,5000000.0,32,129,140,14,14,12,10,9,10,10,10,11,9,12,11,11,12,9,11,12,10,11,12,9,14,10,12,13,12,15,15,14,14,13,8,13,13,13,11,15,5,12,7,18,2,2,2,1,1,3,1,3,4,2,1,7,14,5,7,12,14,16,19,1,15,1,19,14,18,4,11,10,18,13,10,20,9,73,10,20,8819962,6511,6511,4759,Northern_European,120,45,2,6918.0,Unknown,71023439,2500000.0,1.0,103,723,101,1,1,7,97,11,0.6118020640381053,0.5036363636363635,0.5220588235294117,0.0066714496908576,0.2960526315789473,0.0263157894736842,0.0087521880470117,0.0247561890472618,0.0138614961526709,0.0,0.2790697674418605,0.5833333333333333,413,52,61,24,2,11851,4,8,29,1500000,48076.92307692308,5000000.0,1000000.0,,400000.0,7,3900000,-0.16666666666666666,-0.25
59323,Cristhian,Stuani,2024,12321,Uruguay,Tala,Uruguay,12-10-86,Centre-Forward,Attack,Right,184.0,30-06-26,Unknown,https://img.a.transfermarkt.technology/portrait/header/59323-1726736068.jpg?lm=1,ES1,Girona FÃºtbol Club S. A. D.,1800000.0,10000000.0,38,133,150,7,11,12,16,11,8,15,12,6,7,12,15,8,12,12,14,15,15,14,11,14,14,10,12,15,8,13,13,11,10,14,13,13,12,12,14,13,7,14,11,12,2,2,2,3,3,1,1,3,2,3,3,14,13,7,11,12,15,14,13,1,1,1,1,1,1,1,8,1,12,13,10,15,20,74,13,20,347975206,6750,6850,5500,Mediterranean_Hispanic,133,50,8,32000.0,Unknown,78000806,2395000.0,4.0,106,1468,103,0,1,3,107,3,0.6566551997883038,0.5828877005347594,0.6176470588235294,0.0308910619569006,0.3289473684210526,0.1052631578947368,0.0087521880470117,0.0497624406101525,0.0132781466151837,0.4285714285714285,0.4883720930232553,0.8333333333333333,615,251,27,133,3,6467,21,44,31,1200000,16666.666666666668,10000000.0,3000000.0,,,7,4150000,-0.3333333333333333,-0.4
59377,David,De Gea,2024,430,Spain,Madrid,Spain,07-11-90,Goalkeeper,Goalkeeper,Right,192.0,30-06-25,Unknown,https://img.a.transfermarkt.technology/portrait/header/59377-1667548362.jpg?lm=1,IT1,Associazione Calcio Fiorentina,5000000.0,70000000.0,34,145,178,5,2,3,2,13,7,1,2,2,2,8,2,3,8,5,14,11,9,12,5,13,16,5,13,10,15,9,12,13,17,12,15,17,13,12,13,14,5,15,3,16,16,8,10,6,16,14,14,19,3,10,8,17,18,5,14,13,17,18,19,20,1,1,1,1,1,1,1,1,1,1,1,1,1,76,9,20,48310558,7500,7500,6750,Mediterranean_Hispanic,139,45,0,434969.0,Unknown,67030171,25000000.0,1.0,89,892,89,2,1,3,26,5,0.7426567875099233,0.7165775401069518,0.6617647058823528,0.420004886023366,0.2960526315789473,0.0,0.0247561890472618,0.3498374593648412,0.1388649684713464,0.0,0.6744186046511627,0.6666666666666665,0,0,0,0,0,0,6,6,23,5000000,116666.66666666667,70000000.0,10000000.0,500000.0,18000000.0,3,11000000,0.0,-0.375
59561,Dani,Parejo,2024,1050,Spain,Coslada,Spain,16-04-89,Central Midfield,Midfield,Right,182.0,30-06-26,AC Talent,https://img.a.transfermarkt.technology/portrait/header/59561-1688725780.jpg?lm=1,ES1,Villarreal Club de FÃºtbol S.A.D.,2500000.0,35000000.0,35,155,159,12,14,13,13,16,17,8,16,8,9,18,18,13,15,11,16,12,16,12,17,15,15,13,15,13,14,15,16,10,11,12,10,15,11,13,12,14,13,14,10,10,4,2,1,3,1,1,1,2,3,1,1,10,12,14,12,16,16,13,13,1,1,1,1,1,1,18,10,20,8,1,16,1,1,74,14,20,347975206,7750,7750,6000,Mediterranean_Hispanic,154,4,0,53118.0,Unknown,67030707,9111392.0,2.0,89,388,89,3,1,3,216,1,0.7757343212490078,0.6363636363636364,0.7720588235294117,0.0512829673804831,0.0263157894736842,0.0,0.0122530632658164,0.1747936984246061,0.0505924720131114,0.1428571428571428,0.4418604651162785,0.7083333333333333,738,101,110,157,2,13869,6,25,25,2000000,41304.34782608696,35000000.0,10000000.0,100000.0,5000000.0,5,11575000,-0.2,-0.5
59641,Denis,Odoi,2024,1096,Belgium,Leuven,Ghana,27-05-88,Right-Back,Defender,Right,178.0,30-06-26,Unknown,https://img.a.transfermarkt.technology/portrait/header/59641-1643672368.jpg?lm=1,BE1,Royal Antwerp Football Club,300000.0,2500000.0,36,127,132,10,12,13,8,13,10,11,9,11,13,13,9,12,13,16,11,14,11,12,11,12,15,13,12,12,14,13,13,13,13,10,14,15,13,12,10,14,15,11,8,11,2,1,3,1,4,1,1,1,3,1,3,14,14,8,10,10,13,10,6,1,12,20,20,7,10,15,1,12,1,1,1,1,1,76,10,20,733969,6143,5993,3993,African_Caribbean,122,3,0,14999.0,Unknown,8156635,1066666.667,3.0,7,826,41,1,1,1,173,11,0.5432654141307224,0.421711229946524,0.536764705882353,0.014474602817478,0.0197368421052631,0.0,0.0012503125781445,0.0122530632658164,0.0058983119919997,0.2857142857142857,0.3488372093023257,0.75,608,19,30,135,6,16189,7,21,32,300000,5555.555555555556,2500000.0,600000.0,,200000.0,6,1250000,0.0,-0.25
59970,Taras,Stepanenko,2024,660,UdSSR,"Velyka Novosilka, Donetsk Oblast",Ukraine,08-08-89,Defensive Midfield,Midfield,Left,181.0,30-06-25,ProStar,https://img.a.transfermarkt.technology/portrait/header/59970-1723486706.png?lm=1,UKR1,FC Shakhtar Donetsk,2500000.0,10000000.0,35,125,147,3,11,8,11,12,7,13,11,5,15,11,13,14,10,14,13,18,14,15,11,12,17,9,15,11,13,17,19,10,11,12,13,15,11,11,13,17,14,15,2,13,1,1,1,1,1,1,1,1,1,1,1,15,15,4,20,15,20,17,11,1,1,13,1,1,1,20,1,17,1,1,1,1,1,79,20,12,347975206,6500,6500,5000,Northern_European,124,70,4,23100.0,Unknown,71003050,9111392.0,2.0,101,1571,101,3,0,7,72,4,0.6103466525535857,0.5294117647058822,0.5514705882352942,0.0222970682894186,0.4605263157894737,0.0526315789473684,0.0122530632658164,0.0497624406101525,0.0505924720131114,0.1428571428571428,0.418604651162791,0.7083333333333333,523,30,27,131,0,14844,17,40,38,1500000,20588.235294117647,10000000.0,2000000.0,800000.0,1600000.0,1,900000,-0.4,-0.5
60561,Anthony,Lopes,2024,1041,France,Givors,Portugal,01-10-90,Goalkeeper,Goalkeeper,Left,184.0,30-06-25,Unknown,https://img.a.transfermarkt.technology/portrait/header/60561-1640775949.jpg?lm=1,FR1,Olympique Lyonnais,2000000.0,25000000.0,34,142,154,2,2,2,3,10,4,6,1,1,3,9,1,3,10,13,14,18,11,12,8,11,15,9,17,5,13,10,10,13,16,14,13,15,13,15,14,14,12,15,6,1,11,14,13,12,14,10,16,16,14,11,13,13,14,8,18,12,17,12,8,20,1,1,1,1,1,1,1,1,1,1,1,1,1,81,20,6,347975206,7100,7100,6250,Mediterranean_Hispanic,140,14,0,72876.0,Unknown,85003956,9111392.0,2.0,34,542,79,2,0,3,143,5,0.6897327335273882,0.6631016042780749,0.6691176470588234,0.0703616333222931,0.0921052631578947,0.0,0.0097524381095273,0.1247811952988247,0.0505924720131114,0.1428571428571428,0.4883720930232553,0.6666666666666665,0,0,0,0,0,0,5,22,38,1500000,41428.57142857143,25000000.0,4500000.0,50000.0,150000.0,1,100000,-0.625,-0.7
61651,Jordan,Henderson,2024,610,England,Sunderland,England,17-06-90,Central Midfield,Midfield,Right,182.0,30-06-26,PLG,https://img.a.transfermarkt.technology/portrait/header/61651-1662621084.jpg?lm=1,NL1,AFC Ajax Amsterdam,4000000.0,35000000.0,34,154,159,11,13,11,8,15,10,10,9,9,15,13,10,14,14,14,15,16,15,15,14,14,19,11,19,14,16,18,18,13,13,14,13,15,14,18,15,15,8,17,9,13,1,1,1,1,2,2,4,2,2,1,3,15,18,4,18,19,20,15,19,1,1,14,13,1,12,20,1,19,14,1,8,1,1,80,8,20,347975206,7700,7700,7250,Northern_European,155,69,2,220384.0,Unknown,28005568,16000000.0,2.0,32,1436,33,3,1,7,6,1,0.7691188145011907,0.7700534759358288,0.7794117647058822,0.2127979049967797,0.4539473684210526,0.0263157894736842,0.0197549387346836,0.1747936984246061,0.0888635795438762,0.1428571428571428,0.4418604651162785,0.6666666666666665,649,39,83,72,1,13974,25,144,130,3500000,90789.47368421052,35000000.0,7000000.0,50000.0,8500000.0,3,8000000,-0.125,-0.5333333333333333
61697,Wes,Foderingham,2024,379,England,London,England,14-01-91,Goalkeeper,Goalkeeper,Left,185.0,30-06-26,CAA Stellar,https://img.a.transfermarkt.technology/portrait/header/61697-1596446743.jpg?lm=1,GB1,West Ham United Football Club,900000.0,900000.0,33,127,128,3,1,3,1,10,1,5,1,1,2,12,1,3,12,10,12,9,11,15,14,13,12,3,12,1,16,8,10,10,14,9,12,12,10,13,12,14,2,12,4,1,12,11,14,4,14,15,11,15,9,14,15,10,13,5,19,11,17,10,14,20,1,1,1,1,1,1,1,1,1,1,1,1,1,75,20,6,3763274,6350,6350,4010,Mixed_Race,128,0,0,11599.0,Unknown,28010402,110000.0,1.0,32,858,33,2,0,4,220,5,0.590500132310135,0.4235294117647058,0.5808823529411764,0.0111915041130467,0.0,0.0,0.0042510627656914,0.0042510627656914,0.0005833495374871,0.0,0.5116279069767438,0.625,0,0,0,0,0,0,1,3,18,900000,36956.52173913043,900000.0,100000.0,75000.0,,5,150000,0.0,0.0
61841,Adam,Smith,2024,989,England,London,England,29-04-91,Right-Back,Defender,Right,174.0,30-06-26,CAA Stellar,https://img.a.transfermarkt.technology/portrait/header/61841-1547728546.jpg?lm=1,GB1,Association Football Club Bournemouth,1000000.0,9000000.0,33,128,136,6,12,12,7,13,6,7,9,3,12,13,4,13,13,10,13,13,13,11,9,12,14,9,11,13,13,13,15,14,13,11,7,15,14,15,11,15,10,14,5,13,3,1,2,2,2,2,4,3,2,3,4,12,14,2,8,11,15,13,11,1,19,14,20,16,18,1,1,1,8,1,1,5,1,79,8,20,4567028,6300,6300,4250,Northern_European,117,0,0,28998.0,Unknown,28011401,9111392.0,2.0,32,858,33,1,1,7,22,11,0.5838846255623181,0.4491978609625668,0.4999999999999999,0.0279922789243409,0.0,0.0,0.0047511877969492,0.0447611902975743,0.0505924720131114,0.1428571428571428,0.2558139534883721,0.625,485,9,41,99,3,6441,15,90,91,1000000,28000.0,9000000.0,2000000.0,300000.0,,2,300000,0.0,0.0
61842,Andros,Townsend,2024,589,England,London,England,16-07-91,Right Winger,Attack,Left,181.0,30-06-26,Unique Sports Group,https://img.a.transfermarkt.technology/portrait/header/61842-1726737135.jpg?lm=1,TR1,Antalyaspor,1400000.0,15000000.0,33,132,144,12,15,15,9,13,11,7,14,5,5,11,6,6,13,12,8,10,10,12,12,11,13,12,10,11,9,12,16,14,13,13,8,14,14,15,11,12,4,10,9,9,2,2,1,1,3,1,2,3,1,3,2,12,10,6,14,12,13,10,15,1,1,1,1,1,1,1,14,1,19,15,10,20,8,75,20,16,7835229,6600,6600,5500,Mixed_Race,131,13,3,52196.0,Unknown,28005834,15650000.0,2.0,32,858,33,0,0,4,19,10,0.6235776660492194,0.5828877005347594,0.6029411764705883,0.0503926682612226,0.0855263157894736,0.0394736842105263,0.0067516879219804,0.0747686921730432,0.0869190810855857,0.1428571428571428,0.418604651162791,0.625,496,58,71,31,1,12868,7,83,414,1200000,21212.121212121212,15000000.0,3000000.0,,500000.0,6,3700000,-0.3333333333333333,-0.3333333333333333
61887,Federico,Macheda,2024,6676,Italy,Roma,Italy,22-08-91,Centre-Forward,Attack,Right,185.0,30-06-25,Team Raiola,https://img.a.transfermarkt.technology/portrait/header/61887-1727786978.jpg?lm=1,GR1,A.G.S Asteras Tripolis,275000.0,3500000.0,33,120,130,6,7,12,12,14,7,13,10,4,6,11,16,6,13,10,12,10,12,10,12,10,12,12,6,13,8,9,12,13,12,13,13,12,13,12,13,11,13,11,14,6,1,3,2,2,2,3,1,1,2,1,3,15,13,12,10,13,12,9,6,1,1,1,1,1,1,1,1,1,1,7,7,6,20,77,15,20,1611589,5950,5500,3972,Mediterranean_Hispanic,120,0,0,17260.0,Unknown,5006431,9111392.0,2.0,52,1244,54,0,1,3,5,3,0.4780365175972479,0.4194652406417112,0.5220588235294117,0.0166578634559248,0.0,0.0,0.00112528132033,0.0172543135783946,0.0505924720131114,0.1428571428571428,0.5116279069767438,0.625,407,100,27,55,1,10243,6,22,64,250000,-8064.5161290322585,3500000.0,1000000.0,,2500000.0,11,4625000,-0.09090909090909091,-0.2857142857142857
62094,James,Tavernier,2024,124,England,Bradford,England,31-10-91,Right-Back,Defender,Right,182.0,31-05-26,StormSportsX,https://img.a.transfermarkt.technology/portrait/header/62094-1663162918.jpg?lm=1,SC1,Rangers Football Club,6000000.0,10000000.0,33,133,136,13,14,13,14,14,15,14,14,7,9,11,18,10,13,11,10,10,12,6,14,12,10,8,13,14,8,12,13,15,13,13,11,15,14,16,12,16,9,13,1,14,1,1,1,3,3,1,1,3,1,2,2,16,11,3,17,4,15,14,16,1,13,10,19,11,20,8,11,5,13,11,1,13,1,75,11,20,9126392,6650,6650,5600,North_African__Middle_Eastern,131,0,0,34798.0,Unknown,28016194,175000.0,2.0,32,236,33,1,1,6,161,11,0.6301931727970362,0.5935828877005347,0.6029411764705883,0.0335928590671944,0.0,0.0,0.0297574393598399,0.0497624406101525,0.0009444706797411,0.1428571428571428,0.4418604651162785,0.625,644,138,152,68,0,21576,3,12,33,3000000,121875.0,10000000.0,3000000.0,,0.0,4,475000,-0.5384615384615384,-0.5714285714285714
63463,Daniel,Wass,2024,206,Denmark,Gladsaxe,Denmark,31-05-89,Central Midfield,Midfield,Right,178.0,30-06-25,CAA Stellar,https://img.a.transfermarkt.technology/portrait/header/63463-1668184126.jpg?lm=1,DK1,BrÃ¸ndby IdrÃ¦tsforening,1000000.0,15000000.0,35,140,150,13,15,13,11,14,15,10,14,14,11,14,9,12,13,12,13,12,12,13,13,14,13,11,8,13,13,14,14,12,12,13,12,13,12,13,12,12,10,14,4,19,2,1,3,3,1,1,3,1,1,1,2,17,16,7,13,17,15,13,11,1,11,1,20,11,18,15,14,20,18,12,14,14,1,70,8,20,347975206,7150,7150,6250,Northern_European,128,43,1,26887.0,Unknown,936891,2930000.0,5.0,28,544,30,3,1,7,45,1,0.696348240275205,0.6631016042780749,0.5808823529411764,0.0259538608757955,0.2828947368421052,0.0131578947368421,0.0047511877969492,0.0747686921730432,0.0162504514014278,0.5714285714285714,0.3488372093023257,0.7083333333333333,624,68,69,78,2,11103,9,27,54,800000,14583.333333333334,15000000.0,5000000.0,100000.0,500000.0,8,3500000,-0.2,-0.3333333333333333
63489,Vasilios,Lampropoulos,2024,653,Greece,Pyrgos,Greece,31-03-90,Centre-Back,Defender,Right,185.0,30-06-25,Unknown,https://img.a.transfermarkt.technology/portrait/header/63489-1727961921.jpg?lm=1,GR1,Omilos Filathlon Irakliou FC,300000.0,1000000.0,34,120,125,4,8,7,7,8,5,14,5,12,13,9,7,13,8,14,12,14,12,12,9,12,16,6,10,9,13,13,13,12,12,14,14,13,12,13,14,14,14,12,8,13,1,3,2,2,3,2,3,3,3,3,2,13,15,6,12,14,16,12,11,1,10,20,16,1,7,16,1,1,1,1,1,1,1,86,12,20,333984,5749,5749,4015,Mediterranean_Hispanic,119,5,0,4794.0,Unknown,36015868,9111392.0,2.0,40,1195,42,1,1,3,145,2,0.5109817412013761,0.4240641711229946,0.5147058823529411,0.004620478617854,0.0328947368421052,0.0,0.0012503125781445,0.0047511877969492,0.0505924720131114,0.1428571428571428,0.5116279069767438,0.6666666666666665,365,16,3,58,1,10412,6,79,180,250000,0.0,1000000.0,200000.0,350000.0,250000.0,9,750000,-0.2857142857142857,-0.375
64399,Vicente,Guaita,2024,940,Spain,Torrent,Spain,10-01-87,Goalkeeper,Goalkeeper,Right,190.0,30-06-25,JCRsport,https://img.a.transfermarkt.technology/portrait/header/64399-1447229636.jpg?lm=1,ES1,Real Club Celta de Vigo S. A. D.,800000.0,10000000.0,37,138,150,2,2,2,1,10,1,8,1,3,1,12,5,1,10,9,13,13,13,14,11,12,15,3,11,2,16,11,11,10,12,14,16,13,11,14,13,13,4,12,6,1,14,14,11,8,16,12,13,15,12,17,14,17,14,5,16,13,16,10,12,20,1,1,1,1,1,1,1,1,1,1,1,1,1,81,9,20,4757875,6900,6900,5750,Mediterranean_Hispanic,137,0,0,81194.0,Unknown,1510602,9111392.0,2.0,89,1509,89,2,1,3,165,5,0.6632707065361206,0.6096256684491979,0.6470588235294117,0.0783936377409577,0.0,0.0,0.0037509377344336,0.0497624406101525,0.0505924720131114,0.1428571428571428,0.6279069767441858,0.7916666666666665,0,0,0,0,0,0,7,34,74,800000,16279.06976744186,10000000.0,6000000.0,,100000.0,6,600000,0.0,-0.2
64793,Leonardo,Pavoletti,2024,1390,Italy,Livorno,Italy,26-11-88,Centre-Forward,Attack,Right,188.0,30-06-26,Unknown,https://img.a.transfermarkt.technology/portrait/header/64793-1725530760.jpg?lm=1,IT1,Cagliari Calcio,800000.0,13000000.0,36,127,140,4,5,10,14,11,4,18,8,4,4,12,14,4,12,11,14,15,14,13,10,14,16,9,12,14,6,14,16,11,10,15,16,16,12,12,16,14,11,10,14,7,2,2,1,4,2,3,2,2,2,1,1,10,15,7,14,12,17,16,11,1,1,1,1,1,1,1,1,1,1,1,1,1,20,78,10,20,1262108,6350,6350,5250,Mediterranean_Hispanic,124,1,1,24902.0,Unknown,43008385,10266666.67,3.0,52,847,54,0,1,3,46,3,0.590500132310135,0.5561497326203209,0.5514705882352942,0.0240371106027672,0.006578947368421,0.0131578947368421,0.0037509377344336,0.0647661915478869,0.0570108429123031,0.2857142857142857,0.581395348837209,0.75,469,148,27,81,1,6871,20,108,340,700000,16176.470588235294,13000000.0,4000000.0,,,7,6100000,-0.125,-0.3
65278,Unknown,Pedro,2024,398,Spain,Santa Cruz de Tenerife,Spain,28-07-87,Right Winger,Attack,Right,167.0,30-06-25,BahÃ­a Internacional,https://img.a.transfermarkt.technology/portrait/header/65278-1695027154.jpg?lm=1,IT1,SocietÃ  Sportiva Lazio S.p.A.,1000000.0,30000000.0,37,149,165,12,12,16,15,17,10,6,16,3,4,12,13,5,16,14,15,12,13,13,13,15,20,18,8,17,5,14,17,14,17,15,6,20,14,10,7,13,7,16,10,17,2,2,3,1,2,2,1,2,2,1,4,17,20,5,14,15,20,12,17,1,1,1,1,1,1,1,10,1,10,20,17,20,12,66,17,20,2315029,7450,7500,7000,Mediterranean_Hispanic,149,65,17,61731.0,Unknown,1510305,27000000.0,1.0,89,1324,89,0,1,3,185,10,0.7426567875099233,0.7433155080213903,0.7352941176470587,0.0595998288926204,0.4276315789473684,0.2236842105263157,0.0047511877969492,0.1497874468617154,0.1499763882330064,0.0,0.0930232558139532,0.7916666666666665,744,187,110,68,1,16681,32,82,57,1000000,20454.545454545456,30000000.0,8000000.0,,300000.0,3,8000000,0.0,-0.3333333333333333
66100,Oriol,Romeu,2024,12321,Spain,Ulldecona,Spain,24-09-91,Defensive Midfield,Midfield,Right,183.0,30-06-25,MagicPlayers,https://img.a.transfermarkt.technology/portrait/header/66100-1701118491.jpg?lm=1,ES1,Girona FÃºtbol Club S. A. D.,2000000.0,12000000.0,33,142,145,7,8,9,9,14,6,12,9,10,14,14,8,17,14,15,16,17,16,15,14,16,12,6,13,7,16,18,17,7,10,13,12,18,7,18,16,16,8,12,11,12,1,3,3,3,3,3,3,2,1,3,1,13,16,8,10,13,14,10,12,1,1,14,8,1,8,20,1,20,1,1,1,1,1,79,9,20,12052989,7100,6400,5650,Mediterranean_Hispanic,142,0,0,52196.0,Unknown,67043255,5125000.0,4.0,89,1547,89,3,1,3,107,4,0.5971156390579518,0.5989304812834224,0.6838235294117647,0.0503926682612226,0.0,0.0,0.0097524381095273,0.0597649412353088,0.0284452345898497,0.4285714285714285,0.4651162790697669,0.625,479,12,8,120,0,10338,11,112,145,1800000,-5714.285714285715,12000000.0,2500000.0,2000000.0,8000000.0,8,11200000,-0.1,-0.4
67063,Danny,Welbeck,2024,1237,England,Manchester,England,26-11-90,Centre-Forward,Attack,Right,185.0,30-06-26,Prodigy Sports Group,https://img.a.transfermarkt.technology/portrait/header/67063-1700673547.jpg?lm=1,GB1,Brighton and Hove Albion Football Club,5000000.0,18000000.0,34,134,160,5,8,13,14,13,4,13,9,3,6,11,10,6,14,11,12,13,12,13,12,13,14,14,4,15,8,15,16,15,13,13,14,15,15,14,14,12,5,12,16,12,2,1,3,2,2,4,4,3,1,1,1,9,15,4,16,13,15,11,15,1,1,1,1,1,1,1,1,1,1,19,11,17,20,73,9,20,13316132,6698,6698,5998,African_Caribbean,132,42,16,57996.0,Unknown,28010491,20000000.0,1.0,32,905,33,0,1,1,44,3,0.6365440592749405,0.6361497326203208,0.6102941176470589,0.055993248404076,0.2763157894736842,0.2105263157894736,0.0247561890472618,0.0897724431107777,0.1110864190671963,0.0,0.5116279069767438,0.6666666666666665,481,105,45,24,0,11264,21,252,239,5000000,134722.22222222222,18000000.0,3000000.0,1800000.0,6000000.0,6,8700000,0.0,-0.16666666666666666
68033,Steven,Zuber,2024,2441,Switzerland,Winterthur,Switzerland,17-08-91,Centre-Forward,Attack,Right,182.0,30-06-25,Unknown,https://img.a.transfermarkt.technology/portrait/header/68033-1728416346.png?lm=1,GR1,Athlitiki Enosi Konstantinoupoleos,1800000.0,10000000.0,33,130,140,14,13,14,12,13,13,8,13,8,8,13,12,9,14,9,12,10,12,10,13,10,10,15,6,12,9,12,13,13,13,14,10,12,14,14,13,9,5,12,7,15,3,3,1,1,1,1,3,1,2,3,1,12,13,6,9,10,13,12,12,1,6,1,1,10,1,1,19,10,10,20,10,14,1,81,12,20,7592622,6750,6750,5000,Northern_European,129,51,10,20105.0,Unknown,69004250,3025000.0,4.0,92,1670,92,0,1,7,34,3,0.6434241862926701,0.5294117647058822,0.588235294117647,0.019405044577721,0.3355263157894737,0.131578947368421,0.0087521880470117,0.0497624406101525,0.0167782438401066,0.4285714285714285,0.4418604651162785,0.625,500,90,54,40,0,12428,16,98,77,1200000,28750.0,10000000.0,3000000.0,650000.0,1250000.0,7,7425000,-0.4,-0.4
68390,Séamus,Coleman,2024,29,Ireland,Donegal,Ireland,11-10-88,Right-Back,Defender,Right,177.0,30-06-25,Unknown,https://img.a.transfermarkt.technology/portrait/header/68390-1627488566.jpg?lm=1,GB1,Everton Football Club,500000.0,19000000.0,36,127,153,5,12,11,12,12,8,14,13,12,12,12,7,14,12,15,13,15,13,13,9,14,18,11,15,13,13,15,14,12,11,14,10,9,13,13,12,13,11,12,11,10,2,3,3,2,2,2,3,3,3,2,2,10,13,7,18,12,15,15,14,1,10,14,20,1,17,1,1,1,17,1,1,5,1,67,9,20,2013039,6341,6741,5491,Northern_European,126,65,1,81194.0,Unknown,56001681,70000.0,1.0,49,421,52,1,1,7,65,11,0.642233395078063,0.5819251336898396,0.5661764705882353,0.0783936377409577,0.4276315789473684,0.0131578947368421,0.0022505626406601,0.0947736934233558,0.0003611211422539,0.0,0.3255813953488373,0.75,512,31,36,51,0,8563,23,186,293,500000,10540.54054054054,19000000.0,3000000.0,,150000.0,1,25000,0.0,-0.4444444444444444
68645,Martín,Montoya,2024,605,Spain,GavÃ ,Spain,14-04-91,Right-Back,Defender,Right,175.0,30-06-25,Unknown,https://img.a.transfermarkt.technology/portrait/header/68645-1691487947.jpg?lm=1,GR1,Aris Thessalonikis,700000.0,15000000.0,33,125,153,8,13,12,8,12,6,11,9,11,12,12,8,13,14,13,14,13,12,11,11,11,12,10,11,12,12,15,14,13,12,11,9,11,12,16,12,12,10,13,12,10,1,1,3,3,1,2,4,2,1,3,1,12,11,10,12,11,13,13,13,1,16,1,20,11,19,1,1,1,11,1,1,1,1,73,8,20,2011228,6550,6550,5750,Mediterranean_Hispanic,119,0,0,55000.0,Unknown,67053464,7000000.0,1.0,89,524,89,1,1,3,20,11,0.6169621593014025,0.6096256684491979,0.5147058823529411,0.0531002590751124,0.0,0.0,0.0032508127031757,0.0747686921730432,0.038862190616406,0.0,0.2790697674418605,0.625,360,5,32,64,1,7454,11,58,241,600000,-10256.410256410256,15000000.0,5000000.0,,4000000.0,8,15800000,-0.25,-0.3333333333333333
68863,Mauro,Icardi,2024,141,Argentina,Rosario,Argentina,19-02-93,Centre-Forward,Attack,Right,181.0,30-06-26,Unknown,https://img.a.transfermarkt.technology/portrait/header/68863-1671105169.png?lm=1,TR1,Galatasaray Spor KulÃ¼bÃ¼,15000000.0,100000000.0,31,150,174,4,7,12,18,15,4,17,12,2,5,12,17,5,14,8,15,12,17,13,10,13,14,14,12,15,6,11,12,14,15,16,13,14,14,14,13,12,8,17,9,7,2,1,1,2,2,3,1,1,2,4,1,14,17,14,14,17,8,12,8,1,1,1,1,1,1,1,1,1,1,1,1,1,20,75,10,20,40613652,7700,7500,7000,Mediterranean_Hispanic,148,8,1,229999.0,Galatasaray A.Åž.,67046662,18325000.0,4.0,4,1248,4,0,1,3,102,3,0.7426567875099233,0.7433155080213903,0.7279411764705881,0.2220823150094582,0.0526315789473684,0.0131578947368421,0.0747686921730432,0.4998749687421855,0.101780605016806,0.4285714285714285,0.418604651162791,0.5416666666666665,470,264,65,27,0,7693,24,107,208,13000000,320000.0,100000000.0,15000000.0,200000.0,12000000.0,4,9500000,-0.23529411764705882,-0.35
69015,Andriy,Yarmolenko,2024,338,UdSSR,Leningrad,Ukraine,23-10-89,Right Winger,Attack,Left,189.0,30-06-25,ProStar,https://img.a.transfermarkt.technology/portrait/header/69015-1726135604.png?lm=1,UKR1,Futbolniy Klub Dynamo Kyiv,2000000.0,25000000.0,35,130,160,13,14,14,14,15,12,12,13,8,6,12,15,7,16,11,13,15,13,13,14,13,14,16,13,14,8,12,11,12,13,15,13,14,14,13,13,12,8,10,14,13,1,1,2,3,3,4,1,3,1,3,3,8,10,12,16,14,16,8,11,1,1,1,1,6,1,1,15,1,20,15,10,20,14,81,20,6,5006779,6500,7230,5983,Northern_European,131,109,45,35340.0,Unknown,71003202,15083333.33,3.0,101,820,101,0,0,7,97,10,0.7069330510717121,0.6345454545454545,0.6029411764705883,0.0341162236253714,0.7171052631578947,0.5921052631578947,0.0097524381095273,0.1247811952988247,0.0837708454679296,0.2857142857142857,0.6046511627906974,0.7083333333333333,574,196,117,74,2,17881,18,118,223,1500000,31707.317073170732,25000000.0,5000000.0,500000.0,4000000.0,5,10300000,-0.25,-0.25
69633,Christian,Eriksen,2024,985,Denmark,Middelfart,Denmark,14-02-92,Central Midfield,Midfield,Right,182.0,30-06-25,Unknown,https://img.a.transfermarkt.technology/portrait/header/69633-1718628122.jpg?lm=1,GB1,Manchester United Football Club,8000000.0,100000000.0,32,161,170,16,16,12,14,18,17,4,14,3,5,17,16,6,17,7,15,8,15,15,17,17,16,14,8,15,12,17,16,12,12,12,8,17,11,15,7,14,3,17,4,13,3,3,3,3,3,1,3,1,2,4,1,8,16,2,15,15,18,18,19,1,1,1,1,1,1,17,12,20,12,14,19,13,1,76,15,20,192148791,8050,8458,7400,Northern_European,153,115,38,197186.0,Unknown,27010680,14216666.67,3.0,28,951,30,3,1,7,132,1,0.8694098967980948,0.7860962566844919,0.7647058823529411,0.190397515659898,0.756578947368421,0.5,0.0397599399849962,0.4998749687421855,0.0789558969415817,0.2857142857142857,0.4418604651162785,0.5833333333333333,642,122,177,36,0,14874,10,80,232,6000000,138095.2380952381,100000000.0,25000000.0,3500000.0,16000000.0,4,12000000,-0.25,-0.5384615384615384
69642,Nicolai,Boilesen,2024,190,Denmark,Ballerup,Denmark,16-02-92,Centre-Back,Defender,Left,186.0,30-06-25,Unknown,https://img.a.transfermarkt.technology/portrait/header/69642-1664349675.jpg?lm=1,DK1,Football Club KÃ¸benhavn,300000.0,2250000.0,32,130,145,11,13,13,5,14,10,10,8,6,13,14,8,12,15,13,14,14,15,14,14,13,15,12,15,14,14,14,12,12,12,13,14,14,12,14,12,12,5,15,13,13,3,1,2,2,1,3,3,3,2,2,1,18,18,6,15,15,16,16,14,1,18,20,1,15,1,1,1,1,1,1,1,1,1,75,20,8,3503679,6500,6500,5000,Northern_European,129,22,1,13107.0,Unknown,27013502,500000.0,1.0,28,132,30,1,0,7,90,2,0.6103466525535857,0.5294117647058822,0.588235294117647,0.0126476549501886,0.1447368421052631,0.0131578947368421,0.0012503125781445,0.0110027506876719,0.0027500763910108,0.0,0.5348837209302322,0.5833333333333333,289,6,22,24,2,11713,22,317,369,200000,3448.2758620689656,2250000.0,750000.0,100000.0,1000000.0,2,200000,-0.3333333333333333,-0.42857142857142855
70114,Anton,Zabolotnyi,2024,3719,UdSSR,Aizpute,Russia,13-06-91,Centre-Forward,Attack,Right,191.0,30-06-26,Field Management,https://img.a.transfermarkt.technology/portrait/header/70114-1629035251.png?lm=1,RU1,FK Khimki,900000.0,2500000.0,33,120,125,10,12,7,9,12,11,15,12,11,9,10,9,8,12,10,12,16,12,14,10,12,18,12,13,13,10,15,12,12,14,16,16,14,13,15,16,11,10,13,11,5,3,1,2,1,2,1,2,2,3,2,2,15,18,3,7,15,16,17,15,1,1,1,1,1,1,1,1,1,1,9,7,7,20,90,7,20,3189084,5999,5999,3999,Northern_European,121,19,2,29489.0,Unknown,58030743,1500000.0,1.0,101,28,81,0,1,7,76,3,0.5440592749404605,0.4223529411764705,0.5294117647058822,0.0284663970019515,0.125,0.0263157894736842,0.0042510627656914,0.0122530632658164,0.0083057862718408,0.0,0.6511627906976742,0.625,454,111,45,58,1,7571,8,45,63,750000,21875.0,2500000.0,600000.0,250000.0,350000.0,10,400000,-0.16666666666666666,-0.25
70359,David,Simão,2024,8024,France,Versailles,Portugal,15-05-90,Central Midfield,Midfield,Left,183.0,30-06-25,Proeleven S.A.,https://img.a.transfermarkt.technology/portrait/header/70359-1655553351.png?lm=1,PO1,Futebol Clube de Arouca,200000.0,2500000.0,34,121,125,14,15,12,8,14,14,8,10,6,12,16,14,12,15,14,13,12,13,11,16,15,13,10,13,9,13,16,12,9,10,13,11,13,9,9,13,13,14,12,7,7,1,1,3,1,2,3,1,1,3,1,2,8,13,12,12,11,11,8,9,1,1,1,1,1,1,19,6,20,3,7,16,6,1,75,20,7,407669,6050,6050,5050,Mediterranean_Hispanic,119,0,0,2038.0,Unknown,55004196,400000.0,1.0,34,1578,79,3,0,3,98,1,0.5508070918232336,0.53475935828877,0.5147058823529411,0.0019592374327326,0.0,0.0,0.0007501875468867,0.0122530632658164,0.0021945054029278,0.0,0.4651162790697669,0.6666666666666665,433,31,38,135,4,7783,3,10,42,200000,0.0,2500000.0,550000.0,,900000.0,12,2625000,0.0,-0.2
70411,Darko,Lazovi?,2024,276,Jugoslawien (SFR),?a?ak,Serbia,15-09-90,Left Midfield,Midfield,Right,181.0,30-06-25,Seven Stars,https://img.a.transfermarkt.technology/portrait/header/70411-1663671610.jpg?lm=1,IT1,Verona Hellas Football Club,1500000.0,5000000.0,34,137,144,9,14,15,10,13,6,7,12,5,9,12,6,9,13,11,12,9,11,12,12,12,14,15,9,16,10,11,14,16,13,13,10,13,17,15,11,14,7,8,7,17,3,1,2,2,1,3,2,2,3,3,1,13,13,7,12,11,17,11,9,1,14,1,11,20,16,1,18,10,15,14,11,12,1,66,10,20,347975206,6850,6800,5200,Northern_European,130,23,0,21346.0,Unknown,5747078,472000.0,1.0,55,3,85,3,1,7,214,6,0.6500396930404869,0.5508021390374331,0.5955882352941175,0.0206033756048385,0.1513157894736842,0.0,0.0072518129532383,0.0247561890472618,0.0025945165143476,0.0,0.418604651162791,0.6666666666666665,493,60,76,29,1,5896,13,90,197,1500000,37500.0,5000000.0,1500000.0,800000.0,1250000.0,3,1650000,0.0,-0.25
71271,Unknown,Adrián,2024,150,Spain,Sevilla,Spain,03-01-87,Goalkeeper,Goalkeeper,Right,190.0,30-06-26,BahÃ­a Internacional,https://img.a.transfermarkt.technology/portrait/header/71271-1687166366.jpg?lm=1,ES1,Real Betis BalompiÃ© S.A.D.,600000.0,9000000.0,37,132,140,5,1,3,3,13,10,3,3,3,1,12,3,2,10,13,13,14,11,12,7,13,15,2,11,2,13,10,10,11,14,13,13,14,11,11,13,12,7,13,7,16,13,13,16,15,13,12,13,14,12,15,13,18,14,12,13,15,16,8,12,20,1,1,1,1,1,1,1,1,1,1,1,1,1,80,7,20,1734633,6594,6594,5244,Mediterranean_Hispanic,131,0,0,69595.0,Unknown,67006173,9111392.0,2.0,89,1364,89,2,1,3,164,5,0.6227838052394814,0.5555080213903743,0.6029411764705883,0.0671934430725168,0.0,0.0,0.0027506876719179,0.0447611902975743,0.0505924720131114,0.1428571428571428,0.6279069767441858,0.7916666666666665,0,0,0,0,0,0,2,11,31,500000,12903.225806451614,9000000.0,3000000.0,,,3,1600000,-0.16666666666666666,-0.16666666666666666
71292,Jonjo,Shelvey,2024,7160,England,Romford,England,27-02-92,Central Midfield,Midfield,Right,184.0,30-06-25,CAA Stellar,https://img.a.transfermarkt.technology/portrait/header/71292-1694956266.png?lm=1,TR1,EyÃ¼p Spor KulÃ¼bÃ¼,2000000.0,18000000.0,32,133,145,12,13,12,11,13,14,8,14,6,9,16,13,12,15,15,13,15,15,13,18,14,11,13,14,13,12,11,13,10,9,12,11,13,12,15,14,12,15,15,13,7,1,3,3,3,2,3,4,2,1,1,1,11,14,15,12,12,12,8,10,1,1,1,1,1,1,20,1,15,1,1,11,1,1,80,12,20,18310299,6650,6650,5750,Northern_European,133,6,0,81194.0,Unknown,28011776,7575000.0,4.0,32,1245,33,3,1,7,66,1,0.6301931727970362,0.6096256684491979,0.6176470588235294,0.0783936377409577,0.0394736842105263,0.0,0.0097524381095273,0.0897724431107777,0.0420567237978832,0.4285714285714285,0.4883720930232553,0.5833333333333333,490,58,66,81,3,10116,19,75,77,1300000,30487.80487804878,18000000.0,3500000.0,2000000.0,5500000.0,6,4450000,-0.5,-0.6060606060606061
72047,Iago,Aspas,2024,940,Spain,MoaÃ±a,Spain,01-08-87,Centre-Forward,Attack,Left,176.0,30-06-25,Unknown,https://img.a.transfermarkt.technology/portrait/header/72047-1653042948.jpg?lm=1,ES1,Real Club Celta de Vigo S. A. D.,3000000.0,25000000.0,37,154,160,12,12,14,16,14,15,13,15,6,5,13,16,6,16,12,16,13,16,13,14,15,15,17,18,17,8,14,15,15,15,15,11,16,13,12,7,13,16,18,5,14,2,2,1,2,2,1,2,3,2,1,1,8,14,15,16,13,11,8,6,1,1,1,1,1,1,1,1,1,1,5,17,18,20,67,20,14,347975206,7600,7600,6000,Mediterranean_Hispanic,154,18,6,49863.0,Unknown,67010455,7366666.667,3.0,89,959,89,0,0,3,165,3,0.755887801005557,0.6363636363636364,0.7720588235294117,0.0481398831796231,0.1184210526315789,0.0789473684210526,0.0147536884221055,0.1247811952988247,0.0408992842412289,0.2857142857142857,0.3023255813953489,0.7916666666666665,616,232,86,119,3,5115,9,43,48,2500000,50000.0,25000000.0,6000000.0,,,3,5000000,-0.16666666666666666,-0.375
72441,Rafael,Tolói,2024,800,Brazil,GlÃ³ria D'Oeste,Italy,10-10-90,Centre-Back,Defender,Right,185.0,30-06-25,Madeira Sports,https://img.a.transfermarkt.technology/portrait/header/72441-1663583172.jpg?lm=1,IT1,Atalanta Bergamasca Calcio S.p.a.,2500000.0,16000000.0,34,146,151,7,8,11,7,13,7,14,7,11,16,13,7,16,13,17,16,14,13,13,12,14,15,9,12,11,13,14,16,13,12,14,13,15,14,15,15,14,15,14,8,11,1,4,1,2,2,1,2,2,2,3,1,13,13,14,14,15,16,8,9,1,1,20,15,1,1,1,1,1,1,1,1,1,1,75,9,20,347975206,7300,7400,6150,Mediterranean_Hispanic,146,8,0,35577.0,Unknown,19052922,9111392.0,2.0,10,546,54,1,1,3,31,2,0.7294257740142895,0.6524064171122994,0.713235294117647,0.0343450749174155,0.0526315789473684,0.0,0.0122530632658164,0.0797699424856214,0.0505924720131114,0.1428571428571428,0.5116279069767438,0.6666666666666665,557,29,23,139,5,14540,30,117,92,1500000,40909.09090909091,16000000.0,5000000.0,1600000.0,,4,1500000,-0.4,-0.625
72476,Bernd,Leno,2024,931,Germany,Bietigheim-Bissingen,Germany,04-03-92,Goalkeeper,Goalkeeper,Right,190.0,30-06-27,fair-sport GmbH,https://img.a.transfermarkt.technology/portrait/header/72476-1642711733.jpg?lm=1,GB1,Fulham Football Club,13000000.0,35000000.0,32,138,163,3,3,2,1,10,5,6,1,1,3,10,2,1,9,8,14,14,11,12,7,10,12,4,9,6,13,16,10,13,16,14,14,14,10,12,12,13,4,14,8,2,13,14,12,13,15,15,16,16,16,13,12,12,12,8,14,12,15,14,15,20,1,1,1,1,1,1,1,1,1,1,1,1,1,83,8,20,27129015,6900,6900,6500,Northern_European,138,9,0,98593.0,Unknown,92012109,12133333.33,3.0,38,188,40,2,1,7,95,5,0.6632707065361206,0.6898395721925134,0.6544117647058822,0.0951944125522519,0.0592105263157894,0.0,0.0647661915478869,0.1747936984246061,0.067381501319481,0.2857142857142857,0.6279069767441858,0.5833333333333333,0,0,0,0,0,0,6,29,68,11000000,248863.63636363635,35000000.0,7000000.0,500000.0,9000000.0,4,3750000,-0.15384615384615385,-0.15384615384615385
72522,Luuk,De Jong,2024,383,Switzerland,Aigle,Netherlands,27-08-90,Centre-Forward,Attack,Right,188.0,30-06-25,V4S,https://img.a.transfermarkt.technology/portrait/header/72522-1682332002.jpg?lm=1,NL1,Eindhovense Voetbalvereniging Philips Sport Vereniging,3500000.0,13000000.0,34,139,144,4,8,10,15,14,12,17,12,4,5,11,12,4,12,12,16,16,14,13,14,14,14,11,14,15,5,14,16,11,12,15,16,15,11,15,14,12,8,15,5,8,3,3,1,1,3,1,3,2,2,3,1,12,16,6,12,11,15,13,17,1,1,1,1,1,1,1,1,1,1,7,14,7,20,87,12,20,347975206,7000,7000,6250,Northern_European,139,38,8,29999.0,Unknown,37008621,6780000.0,5.0,92,26,68,0,1,7,62,3,0.6765017200317545,0.6631016042780749,0.6617647058823528,0.0289588618076162,0.25,0.1052631578947368,0.0172543135783946,0.0647661915478869,0.0376399344426234,0.5714285714285714,0.581395348837209,0.6666666666666665,643,278,143,58,1,16326,16,68,54,3000000,77027.02702702703,13000000.0,3500000.0,650000.0,5500000.0,6,4700000,-0.14285714285714285,-0.14285714285714285
72768,Nélson,Oliveira,2024,2420,Portugal,Barcelos,Portugal,08-08-91,Centre-Forward,Attack,Right,186.0,30-06-25,MadeinFootball,https://img.a.transfermarkt.technology/portrait/header/72768-1696346309.png?lm=1,PO1,VitÃ³ria Sport Clube,500000.0,6000000.0,33,120,135,5,9,12,13,13,11,14,13,3,6,12,14,5,14,13,14,12,13,12,11,12,14,14,10,13,9,10,12,11,11,15,12,12,11,11,14,12,10,13,13,6,3,2,2,2,1,2,4,1,1,2,4,13,14,13,8,13,13,12,10,1,1,1,1,1,1,1,1,1,1,1,1,1,20,83,12,20,2750920,6497,6247,4748,Mediterranean_Hispanic,119,17,2,26020.0,Unknown,55011049,3425000.0,2.0,76,142,79,0,1,3,217,3,0.5768721884096322,0.5024598930481283,0.5147058823529411,0.0251166707061655,0.1118421052631578,0.0263157894736842,0.0022505626406601,0.0297574393598399,0.0190005277924386,0.1428571428571428,0.5348837209302322,0.625,443,101,37,61,2,11190,14,75,205,500000,0.0,6000000.0,2000000.0,500000.0,6000000.0,13,7150000,0.0,-0.375
73794,Duván,Zapata,2024,416,Colombia,Santiago de Cali,Colombia,01-04-91,Centre-Forward,Attack,Right,188.0,30-06-26,Unknown,https://img.a.transfermarkt.technology/portrait/header/73794-1661508410.jpg?lm=1,IT1,Torino Calcio,8000000.0,45000000.0,33,151,159,4,9,12,18,13,4,15,11,4,4,13,14,7,13,13,16,14,15,12,12,14,15,12,7,15,3,18,13,13,10,15,15,16,17,14,19,14,11,14,10,5,4,1,3,1,1,3,2,2,2,2,2,14,15,5,13,12,19,18,13,1,1,1,1,1,1,1,1,1,1,1,1,1,20,88,10,20,347975206,7550,7500,6600,African_Caribbean,148,34,4,64038.0,Unknown,76014012,9332000.0,5.0,20,1334,20,0,1,1,201,3,0.7426567875099233,0.7005347593582887,0.7279411764705881,0.0618275079253037,0.2236842105263157,0.0526315789473684,0.0397599399849962,0.2248062015503876,0.0518181060585016,0.5714285714285714,0.581395348837209,0.625,466,172,68,42,0,8412,17,112,209,4000000,113235.29411764706,45000000.0,10000000.0,150000.0,,6,11850000,-0.5,-0.5
73926,Davide,Faraoni,2024,276,Italy,Bracciano,Italy,25-10-91,Right-Back,Defender,Right,180.0,30-06-25,Unknown,https://img.a.transfermarkt.technology/portrait/header/73926-1663671695.jpg?lm=1,IT1,Verona Hellas Football Club,1500000.0,7000000.0,33,137,142,10,14,11,12,12,7,13,9,11,11,12,7,11,13,10,13,14,13,14,12,13,14,9,10,16,13,14,16,14,13,13,11,14,15,14,11,16,13,13,7,15,2,1,2,2,2,3,1,1,2,3,2,12,14,8,11,13,15,15,10,1,10,15,19,10,20,1,1,10,17,1,1,1,1,71,9,20,5988914,6850,6750,5250,Mediterranean_Hispanic,134,0,0,17885.0,Unknown,43008971,4150000.0,2.0,52,235,54,1,1,3,214,11,0.6434241862926701,0.5561497326203209,0.625,0.0172613742471806,0.0,0.0,0.0072518129532383,0.0347586896724181,0.0230284174560404,0.1428571428571428,0.3953488372093026,0.625,439,32,41,92,4,7152,18,68,158,1000000,27142.85714285714,7000000.0,2000000.0,100000.0,4000000.0,11,3200000,-0.3333333333333333,-0.5
74229,Unknown,Koke,2024,13,Spain,Madrid,Spain,08-01-92,Central Midfield,Midfield,Right,176.0,30-06-25,Gesport Espizua SL,https://img.a.transfermarkt.technology/portrait/header/74229-1664970397.jpg?lm=1,ES1,Club AtlÃ©tico de Madrid S.A.D.,12000000.0,70000000.0,32,157,162,15,15,13,12,14,14,9,14,6,12,16,10,14,14,14,15,15,15,16,15,15,16,10,14,15,15,17,16,13,12,15,9,14,13,15,12,16,10,13,6,18,3,3,2,3,2,1,1,2,1,1,3,10,15,6,17,12,16,11,12,1,1,1,1,1,1,20,15,20,15,10,14,8,1,73,14,20,134021250,7850,7850,7300,Mediterranean_Hispanic,158,66,0,306644.0,Unknown,67047092,9111392.0,2.0,89,892,89,3,1,3,52,1,0.7889653347446415,0.7754010695187166,0.8014705882352942,0.2960920503627341,0.4342105263157894,0.0,0.0597649412353088,0.3498374593648412,0.0505924720131114,0.1428571428571428,0.3023255813953489,0.5833333333333333,738,55,119,126,0,13048,15,55,39,10000000,241025.64102564103,70000000.0,20000000.0,,5000000.0,0,0,-0.16666666666666666,-0.2857142857142857
74230,Pablo,Sarabia,2024,543,Spain,Madrid,Spain,11-05-92,Right Winger,Attack,Left,174.0,30-06-25,Pablo Barquero,https://img.a.transfermarkt.technology/portrait/header/74230-1602692460.jpg?lm=1,GB1,Wolverhampton Wanderers Football Club,8000000.0,40000000.0,32,154,156,15,15,15,15,17,15,7,13,5,7,15,13,6,17,10,13,11,13,13,16,14,9,15,8,15,8,15,14,15,16,15,6,12,14,13,10,14,9,15,10,15,2,1,1,1,2,1,2,2,3,4,1,7,12,10,10,12,14,14,10,1,1,1,1,10,1,1,15,13,15,17,20,19,1,70,20,10,36552285,7700,7450,6750,Mediterranean_Hispanic,151,22,9,103561.0,Unknown,67045428,6750000.0,4.0,89,892,89,0,0,3,222,10,0.7360412807621064,0.7165775401069518,0.75,0.0999915991297857,0.1447368421052631,0.1184210526315789,0.0397599399849962,0.1997999499874969,0.0374732631461985,0.4285714285714285,0.2558139534883721,0.5833333333333333,554,122,95,100,0,11495,9,23,24,7000000,162162.16216216216,40000000.0,7000000.0,,2000000.0,5,12000000,-0.3,-0.4166666666666667
74294,Nemanja,Gudelj,2024,368,Jugoslawien (SFR),Belgrad,Serbia,16-11-91,Centre-Back,Defender,Right,187.0,30-06-26,Unknown,https://img.a.transfermarkt.technology/portrait/header/74294-1718893660.jpg?lm=1,ES1,Sevilla FÃºtbol Club S.A.D.,3500000.0,7000000.0,33,136,144,14,12,13,10,15,13,11,13,12,9,14,12,9,13,16,13,13,14,13,13,12,16,14,11,13,10,15,17,12,13,13,12,14,11,15,14,15,13,13,9,12,2,1,3,2,3,1,4,3,4,2,1,14,16,10,3,17,14,11,7,1,1,15,1,1,1,20,1,19,1,1,12,1,1,77,11,20,7634150,6797,6947,5247,Mediterranean_Hispanic,129,48,1,101700.0,Unknown,62013805,4700000.0,4.0,55,166,85,1,1,3,181,2,0.6694892828790685,0.5558288770053476,0.588235294117647,0.0981945853977425,0.3157894736842105,0.0131578947368421,0.0172543135783946,0.0347586896724181,0.0260840578904969,0.4285714285714285,0.5581395348837206,0.625,531,46,38,104,2,11771,7,38,127,3500000,115000.0,7000000.0,2000000.0,100000.0,,6,4000000,0.0,-0.125
74683,Nemanja,Matic,2024,1041,Jugoslawien (SFR),Å abac,Serbia,01-08-88,Defensive Midfield,Midfield,Left,194.0,30-06-26,Universal Twenty Two,https://img.a.transfermarkt.technology/portrait/header/74683-1655212906.jpg?lm=1,FR1,Olympique Lyonnais,3000000.0,40000000.0,36,143,165,10,11,12,8,15,10,16,14,5,13,15,12,16,15,10,15,14,16,14,13,14,13,4,14,10,16,16,13,8,10,19,16,10,10,12,17,11,11,13,7,10,4,1,3,2,3,3,1,3,2,3,1,13,13,5,16,16,18,11,11,1,1,7,1,1,1,20,1,20,1,1,1,1,1,85,20,11,2990937,7150,6750,6500,Northern_European,145,48,2,86345.0,Unknown,62000307,13591666.67,6.0,55,1725,85,3,0,7,143,4,0.6434241862926701,0.6898395721925134,0.7058823529411764,0.0833675322781711,0.3157894736842105,0.0263157894736842,0.0147536884221055,0.1997999499874969,0.0754835782660629,0.7142857142857142,0.7209302325581395,0.75,652,29,41,119,2,12906,19,37,60,2500000,59722.22222222222,40000000.0,6000000.0,,1500000.0,8,10750000,-0.16666666666666666,-0.2857142857142857
74810,Ben,Mee,2024,1148,England,Sale,England,21-09-89,Centre-Back,Defender,Left,180.0,30-06-25,Unknown,https://img.a.transfermarkt.technology/portrait/header/74810-1700647998.jpg?lm=1,GB1,Brentford Football Club,1000000.0,10000000.0,35,136,143,6,8,8,6,10,4,16,4,15,15,10,5,16,9,17,14,16,11,14,8,13,14,7,15,8,14,18,14,13,12,10,14,12,12,15,15,15,9,11,8,10,4,1,2,2,2,1,3,2,1,3,2,12,12,3,15,11,16,16,15,1,18,20,1,1,1,1,1,1,1,1,1,1,1,74,20,7,347975206,6800,6800,5500,Northern_European,136,0,0,57996.0,Unknown,4002177,9111392.0,2.0,32,1284,33,1,0,7,43,2,0.6500396930404869,0.5828877005347594,0.6397058823529411,0.055993248404076,0.0,0.0,0.0047511877969492,0.0497624406101525,0.0505924720131114,0.1428571428571428,0.3953488372093026,0.7083333333333333,478,20,15,76,1,5138,8,79,126,900000,28333.333333333332,10000000.0,2000000.0,,50000.0,3,850000,-0.1,-0.1
74842,Mario,Götze,2024,24,Germany,Memmingen,Germany,03-06-92,Attacking Midfield,Midfield,Right,176.0,30-06-26,Sports360 GmbH,https://img.a.transfermarkt.technology/portrait/header/74842-1663065102.jpg?lm=1,L1,Eintracht Frankfurt FuÃŸball AG,5500000.0,55000000.0,32,147,171,12,13,16,12,16,11,8,10,5,7,16,10,9,17,8,16,8,16,15,16,16,12,14,12,15,7,18,18,12,14,17,7,7,11,11,8,15,5,15,16,15,1,3,1,3,1,2,1,2,3,1,2,9,14,13,10,7,13,14,18,1,1,1,1,1,1,6,12,16,12,13,20,13,16,75,10,20,26726078,7350,7350,6500,Northern_European,143,63,17,62500.0,Unknown,35017438,20666666.67,3.0,38,941,40,3,1,7,63,0,0.7228102672664726,0.6898395721925134,0.6911764705882353,0.0603423885701815,0.4144736842105262,0.2236842105263157,0.0272568142035508,0.274818704676169,0.1147902256729353,0.2857142857142857,0.3023255813953489,0.5833333333333333,569,132,131,40,1,15771,51,183,130,5000000,102222.22222222222,55000000.0,7000000.0,12500000.0,42000000.0,5,20500000,-0.09090909090909091,-0.2857142857142857
74857,Marc-André,Ter Stegen,2024,131,Germany,MÃ¶nchengladbach,Germany,30-04-92,Goalkeeper,Goalkeeper,Right,187.0,30-06-28,ROOF,https://img.a.transfermarkt.technology/portrait/header/74857-1674465246.jpg?lm=1,ES1,Futbol Club Barcelona,28000000.0,90000000.0,32,174,183,6,3,3,3,13,9,7,1,3,3,17,4,2,14,11,17,15,18,15,9,13,18,5,14,1,12,14,10,14,14,16,16,15,11,13,15,15,6,15,8,14,13,15,15,12,14,19,14,18,18,10,17,16,18,5,14,17,18,14,8,20,1,1,1,1,1,1,1,1,1,1,1,1,1,85,16,20,170775003,8700,8250,7950,Northern_European,172,28,0,164999.0,Unknown,35017428,12000000.0,1.0,38,1002,40,2,1,7,96,5,0.8418893887271766,0.8449197860962566,0.9044117647058822,0.1593171927188595,0.1842105263157894,0.0,0.1397849462365591,0.4498624656164041,0.0666407400205561,0.0,0.5581395348837206,0.5833333333333333,0,0,0,0,0,0,21,148,281,15000000,331111.1111111111,90000000.0,18000000.0,400000.0,10000000.0,3,250000,-0.4642857142857143,-0.5714285714285714
74960,Martin,Dúbravka,2024,762,CSSR,Å½ilina,Slovakia,15-01-89,Goalkeeper,Goalkeeper,Right,191.0,30-06-25,1863,https://img.a.transfermarkt.technology/portrait/header/74960-1700237195.jpg?lm=1,GB1,Newcastle United Football Club,1000000.0,7500000.0,35,139,150,1,1,1,1,11,2,3,2,5,5,12,3,3,10,9,15,14,12,10,12,11,15,14,13,3,15,12,10,13,12,13,15,14,9,10,12,15,10,14,8,1,15,14,13,5,14,14,16,17,14,11,11,16,14,4,12,12,15,16,12,20,1,1,1,1,1,1,1,1,1,1,1,1,1,83,10,20,12724386,6550,7000,5750,Northern_European,138,29,0,52196.0,Manchester UFC,63002306,2050000.0,2.0,14,1729,86,2,1,7,137,5,0.6765017200317545,0.6096256684491979,0.6544117647058822,0.0503926682612226,0.1907894736842105,0.0,0.0047511877969492,0.0372593148287071,0.0113614267062973,0.1428571428571428,0.6511627906976742,0.7083333333333333,0,0,0,0,0,0,9,44,119,1000000,22222.222222222223,7500000.0,1500000.0,,,6,3900000,0.0,0.0
75458,Robin,Olsen,2024,405,Sweden,MalmÃ¶,Sweden,08-01-90,Goalkeeper,Goalkeeper,Right,196.0,30-06-25,Unknown,https://img.a.transfermarkt.technology/portrait/header/75458-1697721104.jpg?lm=1,GB1,Aston Villa Football Club,1500000.0,10000000.0,34,134,141,2,3,2,3,11,1,3,1,1,3,10,4,3,10,13,12,14,13,14,8,13,10,2,10,1,14,12,10,11,12,13,17,13,10,10,13,11,8,13,4,13,17,13,11,6,14,12,13,15,11,9,13,13,11,4,8,13,16,16,16,20,1,1,1,1,1,1,1,1,1,1,1,1,1,89,8,20,8001917,6692,6992,5742,Northern_European,133,60,0,40597.0,Unknown,68007215,3887500.0,4.0,91,902,91,2,1,7,30,5,0.6754432389521038,0.6087700534759358,0.6176470588235294,0.0391924735927818,0.3947368421052631,0.0,0.0072518129532383,0.0497624406101525,0.0215700436123225,0.4285714285714285,0.7674418604651163,0.6666666666666665,0,0,0,0,0,0,3,16,78,1500000,48333.333333333336,10000000.0,2500000.0,,,8,8250000,0.0,0.0
75489,Niclas,Füllkrug,2024,379,Germany,Hannover,Germany,09-02-93,Centre-Forward,Attack,Right,189.0,30-06-28,ROOF,https://img.a.transfermarkt.technology/portrait/header/75489-1709560033.jpg?lm=1,GB1,West Ham United Football Club,15000000.0,15000000.0,31,129,143,7,9,13,13,12,14,15,13,6,7,10,14,6,11,14,13,16,13,12,10,11,11,12,12,12,7,12,14,13,11,14,16,11,13,12,15,11,8,13,16,11,4,2,2,2,1,1,4,2,3,2,2,7,15,9,13,13,12,14,14,1,1,1,1,1,1,1,15,1,12,15,10,12,20,81,12,20,3936650,6448,6448,5098,Northern_European,128,0,0,37499.0,Unknown,92018043,10650000.0,5.0,38,596,40,0,1,7,220,3,0.603466525535856,0.5398930481283422,0.5808823529411764,0.0362009913026852,0.0,0.0,0.0747686921730432,0.0747686921730432,0.0591405316814355,0.5714285714285714,0.6046511627906974,0.5416666666666665,428,161,56,27,0,5548,24,169,260,15000000,347093.0232558139,15000000.0,7000000.0,200000.0,1000000.0,8,3400000,0.0,0.15384615384615385
75921,Christopher,Trimmel,2024,89,Austria,Oberpullendorf,Austria,24-02-87,Right-Back,Defender,Right,189.0,30-06-25,ROOF,https://img.a.transfermarkt.technology/portrait/header/75921-1692707564.jpg?lm=1,L1,1. FC Union Berlin,600000.0,1200000.0,37,136,137,18,16,11,10,12,13,13,11,14,13,13,10,13,12,13,15,15,15,16,12,14,16,9,15,10,12,16,16,11,10,15,14,17,10,12,13,17,10,11,6,14,3,1,1,1,1,1,3,3,1,2,1,10,14,6,16,13,17,15,12,1,1,10,20,1,20,1,1,1,14,1,1,14,1,78,12,20,406593,6600,5930,5317,Northern_European,136,23,1,19177.0,Unknown,16008969,9111392.0,2.0,6,1068,7,1,1,7,0,11,0.5349298756284732,0.5633155080213903,0.6397058823529411,0.0185089517548645,0.1513157894736842,0.0131578947368421,0.0027506876719179,0.0057514378594648,0.0505924720131114,0.1428571428571428,0.6046511627906974,0.7916666666666665,594,47,91,104,2,9009,17,37,72,600000,14583.333333333334,1200000.0,200000.0,,,2,125000,0.0,-0.25
76028,Unknown,Taison,2024,1091,Brazil,Pelotas,Brazil,13-01-88,Left Winger,Attack,Right,172.0,30-06-25,Dornelles A. E.,https://img.a.transfermarkt.technology/portrait/header/76028-1727967515.png?lm=1,GR1,Panthessalonikios Athlitikos Omilos Konstantinoupoliton,500000.0,15000000.0,36,134,160,3,12,16,12,15,11,7,14,4,7,13,12,8,16,12,12,12,11,11,15,14,16,16,14,15,4,12,12,15,13,14,5,13,14,12,9,14,9,12,9,14,2,3,1,2,3,2,3,1,3,3,2,15,12,15,7,11,13,12,7,1,1,1,1,1,1,1,13,13,1,20,18,10,10,75,10,20,670379,6723,6723,4781,Mixed_Race,132,8,1,26836.0,Unknown,19010481,10770000.0,2.0,10,1135,11,0,1,4,153,7,0.6398518126488489,0.5059893048128342,0.6102941176470589,0.025904614395229,0.0526315789473684,0.0131578947368421,0.0022505626406601,0.0747686921730432,0.0598072168671351,0.1428571428571428,0.2093023255813952,0.75,683,134,135,101,5,25270,14,26,23,450000,9523.809523809523,15000000.0,2500000.0,,1800000.0,4,5100000,-0.1,-0.25
76158,Alexander,Meyer,2024,16,Germany,Bad Oldesloe,Germany,13-04-91,Goalkeeper,Goalkeeper,Right,195.0,30-06-26,AKA Global GmbH,https://img.a.transfermarkt.technology/portrait/header/76158-1716381651.jpg?lm=1,L1,Borussia Dortmund,800000.0,1000000.0,33,120,122,2,2,1,3,10,5,1,3,3,3,13,2,3,9,10,13,16,12,8,11,10,12,1,12,3,10,13,14,9,11,13,18,14,8,9,15,13,5,12,8,13,16,10,11,5,15,12,12,14,8,6,11,7,12,7,14,14,14,14,14,20,1,1,1,1,1,1,1,1,1,1,1,1,1,90,6,20,166154,5470,5470,3470,Northern_European,114,0,0,4499.0,Unknown,91018450,400000.0,1.0,38,122,40,2,1,7,41,5,0.4740672135485578,0.3657754010695186,0.4779411764705882,0.0043356215243813,0.0,0.0,0.0037509377344336,0.0047511877969492,0.0021945054029278,0.0,0.7441860465116279,0.625,0,0,0,0,0,0,11,98,239,800000,20270.27027027027,1000000.0,200000.0,50000.0,75000.0,5,700000,0.0,0.0
76274,Christian,Gytkjaer,2024,607,Denmark,Roskilde,Denmark,06-05-90,Centre-Forward,Attack,Right,185.0,30-06-25,Unknown,https://img.a.transfermarkt.technology/portrait/header/76274-1661763625.jpg?lm=1,IT1,Venezia Football Club,700000.0,3000000.0,34,123,129,7,8,11,14,13,10,15,12,7,5,10,14,5,11,10,16,16,14,14,8,10,13,11,6,14,6,10,8,13,11,14,12,15,10,13,13,15,5,13,7,6,2,3,3,4,2,3,1,3,1,3,3,12,16,13,6,10,14,11,12,1,1,1,1,1,1,1,1,1,1,1,1,1,20,77,14,20,544354,6150,6250,5450,Northern_European,123,9,5,21537.0,Unknown,27000596,9111392.0,2.0,28,1250,30,0,1,7,210,3,0.5772691188145012,0.5775401069518716,0.5441176470588236,0.0207878085026462,0.0592105263157894,0.0657894736842105,0.0032508127031757,0.0147536884221055,0.0505924720131114,0.1428571428571428,0.5116279069767438,0.6666666666666665,509,203,35,26,0,8021,2,16,52,700000,19354.83870967742,3000000.0,1300000.0,100000.0,300000.0,9,2250000,0.0,0.0
76326,Tjaronn,Chery,2024,1096,Netherlands,Den Haag,Suriname,04-06-88,Attacking Midfield,Midfield,Left,171.0,30-06-26,A.B SOCCER LTD,https://img.a.transfermarkt.technology/portrait/header/76326-1663189247.jpg?lm=1,BE1,Royal Antwerp Football Club,350000.0,4500000.0,36,133,140,12,13,15,13,16,14,8,15,6,5,15,17,4,15,6,12,10,15,12,15,12,15,16,7,13,5,11,13,12,13,13,6,16,13,14,9,13,5,16,8,15,4,3,4,3,2,4,3,3,1,1,2,13,15,7,11,12,15,14,12,1,1,1,1,1,1,1,12,12,16,15,19,20,12,68,20,14,470785,6626,6273,6011,African_Caribbean,134,4,0,10256.0,Unknown,37000496,1491250.0,4.0,67,407,90,3,0,1,173,0,0.580312251918497,0.6375401069518716,0.625,0.0098946801247963,0.0263157894736842,0.0,0.0015003750937734,0.0222555638909727,0.0082571738103836,0.4285714285714285,0.1860465116279068,0.75,627,153,132,58,1,11655,5,5,22,500000,13636.363636363636,4500000.0,1500000.0,,50000.0,10,2050000,0.42857142857142855,0.25
76467,Kiko,Femenía,2024,1050,Spain,Sanet y Negrals,Spain,02-02-91,Right-Back,Defender,Right,174.0,30-06-25,Goal Management,https://img.a.transfermarkt.technology/portrait/header/76467-1726231817.jpg?lm=1,ES1,Villarreal Club de FÃºtbol S.A.D.,1400000.0,6000000.0,33,134,141,10,14,13,9,12,9,8,9,14,10,14,11,13,14,9,9,13,10,12,12,12,11,13,9,12,12,10,11,16,11,12,8,14,16,13,9,13,6,11,6,16,3,2,2,2,1,3,2,3,2,3,1,12,12,11,13,8,14,16,7,1,14,1,18,14,20,1,12,1,16,11,1,11,1,71,13,20,6273716,6700,6700,5250,Mediterranean_Hispanic,126,0,0,16393.0,Unknown,67063051,1490000.0,2.0,89,1312,89,1,1,3,216,11,0.6368086795448531,0.5561497326203209,0.5661764705882353,0.0158206732862948,0.0,0.0,0.0067516879219804,0.0297574393598399,0.0082502291730325,0.1428571428571428,0.2558139534883721,0.625,467,17,28,53,0,3715,8,34,74,1200000,26829.268292682926,6000000.0,1200000.0,500000.0,2500000.0,7,2400000,-0.14285714285714285,-0.2
78570,Anthony,Moris,2024,3948,Belgium,Arlon,Luxembourg,29-04-90,Goalkeeper,Goalkeeper,Left,186.0,30-06-26,Vulpes-vna,https://img.a.transfermarkt.technology/portrait/header/78570-1714467075.png?lm=1,BE1,Royale Union Saint-Gilloise,2000000.0,2000000.0,34,120,120,6,2,2,3,14,7,11,2,1,2,14,12,1,11,6,10,12,9,12,8,11,14,2,6,8,10,12,12,14,14,14,12,14,13,14,10,15,10,7,10,12,11,11,10,10,13,14,13,15,12,12,11,7,9,8,11,11,10,8,11,20,1,1,1,1,1,1,1,1,1,1,1,1,1,80,20,7,347975206,5980,5980,3012,Northern_European,118,50,0,4499.0,Unknown,8189704,9111392.0,2.0,7,87,60,2,0,7,177,5,0.54154538237629,0.3167914438502673,0.5073529411764706,0.0043356215243813,0.3289473684210526,0.0,0.0097524381095273,0.0097524381095273,0.0505924720131114,0.1428571428571428,0.5348837209302322,0.6666666666666665,0,0,0,0,0,0,6,62,178,1800000,64814.81481481482,2000000.0,200000.0,50000.0,,3,100000,-0.1,0.2
79045,Jeroen,Zoet,2024,1090,Netherlands,Veendam,Netherlands,06-01-91,Goalkeeper,Goalkeeper,Right,189.0,30-06-27,Key United,https://img.a.transfermarkt.technology/portrait/header/79045-1602505437.jpg?lm=1,NL1,Alkmaar Zaanstreek,400000.0,12500000.0,33,123,137,1,2,3,2,8,4,3,3,3,1,11,5,3,11,7,13,11,13,12,14,11,18,4,13,3,14,14,17,9,12,12,14,15,10,15,12,13,7,15,5,12,13,13,14,6,13,12,14,15,13,10,13,17,17,6,17,16,18,15,10,20,1,1,1,1,1,1,1,1,1,1,1,1,1,89,5,20,1554614,6150,6700,5750,Northern_European,123,11,0,24615.0,Unknown,29022550,1500000.0,1.0,67,1566,68,2,1,7,16,5,0.6368086795448531,0.6096256684491979,0.5441176470588236,0.0237599784474226,0.0723684210526315,0.0,0.0017504376094023,0.0622655663915979,0.0083057862718408,0.0,0.6046511627906974,0.625,0,0,0,0,0,0,7,61,117,400000,9459.45945945946,12500000.0,4000000.0,100000.0,500000.0,6,3800000,0.0,0.0
79612,Stefan,Schwab,2024,1091,Austria,Saalfelden am Steinernen Meer,Austria,27-09-90,Central Midfield,Midfield,Left,183.0,30-06-25,Unknown,https://img.a.transfermarkt.technology/portrait/header/79612-1727967422.png?lm=1,GR1,Panthessalonikios Athlitikos Omilos Konstantinoupoliton,900000.0,2500000.0,34,120,125,9,9,13,9,13,12,10,9,8,10,14,15,11,13,14,13,13,12,12,14,13,12,12,16,13,13,15,15,11,10,14,13,14,10,13,15,12,10,13,9,8,3,2,2,4,3,1,3,3,3,2,2,12,13,9,13,11,14,15,12,1,1,6,1,1,1,19,6,20,1,1,16,1,1,77,20,7,347975206,6000,6000,3014,Northern_European,120,1,0,8246.0,Unknown,16015696,300000.0,2.0,6,1265,7,3,0,7,153,1,0.5441915850754168,0.3170053475935828,0.5220588235294117,0.0079537894201178,0.006578947368421,0.0,0.0042510627656914,0.0122530632658164,0.0016389344148448,0.1428571428571428,0.4651162790697669,0.6666666666666665,670,121,98,123,2,16348,9,68,127,800000,18125.0,2500000.0,500000.0,175000.0,450000.0,4,625000,-0.1111111111111111,-0.2
79967,Simon,Zoller,2024,35,Germany,Friedrichshafen,Germany,26-06-91,Centre-Forward,Attack,Right,179.0,Unknown,GoalSky,https://img.a.transfermarkt.technology/portrait/header/79967-1723632686.jpeg?lm=1,L1,FuÃŸball-Club St. Pauli von 1910,350000.0,3000000.0,33,121,128,6,9,13,13,12,7,14,10,5,6,10,11,6,12,12,13,10,11,12,11,10,11,13,7,14,8,12,14,15,14,10,10,12,13,12,9,11,6,11,16,13,2,1,2,3,1,3,4,2,2,3,3,10,15,7,7,9,12,12,10,1,1,1,1,1,1,1,15,1,15,15,12,15,20,70,10,20,1309231,6050,6050,4400,Northern_European,114,0,0,11506.0,Unknown,91007707,1476666.667,3.0,38,514,40,0,1,7,101,3,0.5508070918232336,0.4652406417112299,0.4779411764705882,0.0111017017073078,0.0,0.0,0.0015003750937734,0.0147536884221055,0.00817615304314,0.2857142857142857,0.3720930232558141,0.625,386,120,46,43,1,7733,24,121,215,300000,4878.048780487805,3000000.0,700000.0,50000.0,150000.0,6,1300000,-0.14285714285714285,-0.5714285714285714
80059,Serdar,Dursun,2024,11282,Germany,Hamburg,TÃ¼rkiye,19-10-91,Centre-Forward,Attack,Right,190.0,30-06-26,Unknown,https://img.a.transfermarkt.technology/portrait/header/80059-1724671095.jpg?lm=1,TR1,Alanyaspor,600000.0,3500000.0,33,125,128,5,8,9,13,13,6,16,13,4,6,12,15,7,12,14,13,14,11,14,11,13,15,14,8,14,8,14,14,10,13,16,17,14,10,15,14,16,5,14,6,7,1,1,4,2,3,1,3,2,3,2,1,9,10,5,10,12,16,10,15,1,1,1,1,1,1,1,1,1,1,1,12,1,20,80,12,20,2259962,6250,6250,5000,Mediterranean_Hispanic,125,8,7,17725.0,Unknown,92025557,350000.0,1.0,38,594,100,0,1,3,15,3,0.5772691188145012,0.5294117647058822,0.5588235294117647,0.0171068754846191,0.0526315789473684,0.0921052631578947,0.0027506876719179,0.0172543135783946,0.0019167199088863,0.0,0.6279069767441858,0.625,437,138,55,45,0,5857,6,19,38,400000,8125.0,3500000.0,700000.0,75000.0,150000.0,10,1575000,-0.4666666666666667,-0.6
80293,Aïssa,Mandi,2024,1082,France,ChÃ¢lons-en-Champagne,Algeria,22-10-91,Centre-Back,Defender,Right,186.0,30-06-26,Wasserman,https://img.a.transfermarkt.technology/portrait/header/80293-1704566125.jpg?lm=1,FR1,Lille Olympique Sporting Club Lille MÃ©tropole,1800000.0,20000000.0,33,139,148,6,15,11,5,12,6,14,5,12,15,14,6,15,12,15,15,16,12,13,13,12,16,7,12,12,14,14,14,13,13,14,13,15,14,13,14,13,13,14,8,15,1,2,1,1,1,3,3,2,2,3,3,16,13,7,16,13,15,14,14,1,15,20,16,10,13,1,1,1,1,1,1,1,1,78,9,20,11709349,6950,7200,6000,North_African__Middle_Eastern,139,76,3,22256.0,Unknown,85079680,2800000.0,1.0,34,359,1,1,1,6,128,2,0.702963747023022,0.6363636363636364,0.6617647058823528,0.0214820873169068,0.5,0.0394736842105263,0.0087521880470117,0.0997749437359339,0.0155282091169199,0.0,0.5348837209302322,0.625,446,25,16,73,5,5677,6,25,44,1500000,36111.11111111111,20000000.0,4000000.0,,1000000.0,3,2300000,-0.16666666666666666,-0.25
80894,Lukasz,Skorupski,2024,1025,Poland,Zabrze,Poland,05-05-91,Goalkeeper,Goalkeeper,Right,188.0,30-06-25,Unknown,https://img.a.transfermarkt.technology/portrait/header/80894-1724827036.jpg?lm=1,IT1,Bologna Football Club 1909,3500000.0,7000000.0,33,130,137,7,3,1,1,5,8,6,2,3,3,5,3,2,5,13,13,14,12,12,5,13,13,10,11,9,14,17,16,12,16,15,14,14,13,15,15,14,8,12,4,11,13,11,11,1,12,9,17,16,3,16,9,12,13,5,14,10,17,17,14,20,1,1,1,1,1,1,1,1,1,1,1,1,1,84,5,20,2492869,6492,6492,5592,Northern_European,129,7,0,32115.0,Unknown,54009099,4945000.0,2.0,75,1694,78,2,1,7,40,5,0.6092881714739349,0.5927272727272727,0.588235294117647,0.0310021079424916,0.0460526315789473,0.0,0.0172543135783946,0.0347586896724181,0.0274452068113003,0.1428571428571428,0.581395348837209,0.625,0,0,0,0,0,0,10,35,119,2500000,79032.25806451614,7000000.0,1500000.0,50000.0,750000.0,6,1200000,-0.2857142857142857,-0.2857142857142857
81512,Christian,Kabasele,2024,410,Zaire,Lubumbashi,Belgium,24-02-91,Centre-Back,Defender,Right,187.0,30-06-25,Unknown,https://img.a.transfermarkt.technology/portrait/header/81512-1692277533.jpg?lm=1,IT1,Udinese Calcio,1000000.0,9000000.0,33,126,145,6,8,9,10,12,8,14,12,10,11,10,10,12,11,12,14,14,12,10,9,11,13,8,10,12,13,12,14,14,12,15,15,12,15,12,15,12,8,12,9,14,3,2,3,3,3,2,2,1,2,4,3,11,15,14,10,8,14,12,14,1,1,20,1,1,8,10,1,6,1,1,6,1,8,86,10,20,3711202,6300,6250,5650,African_Caribbean,126,2,0,19139.0,Unknown,18023431,9111392.0,2.0,111,869,8,1,1,1,205,2,0.5772691188145012,0.5989304812834224,0.5661764705882353,0.0184722582987561,0.0131578947368421,0.0,0.0047511877969492,0.0447611902975743,0.0505924720131114,0.1428571428571428,0.5581395348837206,0.625,363,29,10,48,2,6963,5,19,39,1000000,25675.675675675677,9000000.0,1500000.0,25000.0,200000.0,6,1250000,0.0,-0.3333333333333333
82009,Kevin,Volland,2024,89,Germany,Marktoberdorf,Germany,30-07-92,Centre-Forward,Attack,Left,179.0,30-06-26,Unique Sports Group,https://img.a.transfermarkt.technology/portrait/header/82009-1726351449.jpg?lm=1,L1,1. FC Union Berlin,4000000.0,35000000.0,32,145,151,8,10,14,12,12,12,11,13,8,7,14,13,10,12,18,14,15,13,12,14,12,17,15,11,17,7,16,18,13,12,18,9,17,13,18,14,13,8,13,3,15,2,3,3,1,2,2,1,1,4,3,1,9,13,6,14,12,17,12,10,1,1,1,1,1,1,1,12,1,15,12,17,16,20,85,20,11,44696821,7248,7248,5998,Northern_European,136,14,1,92055.0,Unknown,91014650,8925000.0,4.0,38,917,40,0,0,7,0,3,0.7093146335009262,0.6361497326203208,0.6397058823529411,0.0888812068670837,0.0921052631578947,0.0131578947368421,0.0197549387346836,0.1747936984246061,0.0495569321370038,0.4285714285714285,0.3720930232558141,0.5833333333333333,562,173,116,81,3,7791,26,61,99,2500000,61538.46153846154,35000000.0,8000000.0,1250000.0,9000000.0,4,6500000,-0.375,-0.5
82048,Nicola,Sansone,2024,1005,Germany,MÃ¼nchen,Italy,10-09-91,Left Winger,Attack,Right,174.0,30-06-25,TMP SOCCER srl ,https://img.a.transfermarkt.technology/portrait/header/82048-1663656944.jpg?lm=1,IT1,Unione Sportiva Lecce,1000000.0,16000000.0,33,128,150,12,13,14,11,11,13,7,13,5,6,12,13,9,15,10,13,11,13,12,11,12,12,13,10,14,8,12,13,14,14,12,7,14,13,13,9,12,9,12,9,14,2,1,3,3,1,2,3,2,1,1,1,12,12,7,11,12,12,12,12,1,1,1,1,1,1,1,10,1,7,20,15,12,20,63,11,20,1890991,6400,6400,5850,Mediterranean_Hispanic,126,3,0,39422.0,Unknown,92016695,9750000.0,3.0,38,1006,54,0,1,3,206,7,0.5971156390579518,0.6203208556149732,0.5661764705882353,0.0380578733052209,0.0197368421052631,0.0,0.0047511877969492,0.0797699424856214,0.0541403927886885,0.2857142857142857,0.2558139534883721,0.625,484,98,57,69,3,7396,20,99,99,800000,22058.823529411766,16000000.0,4500000.0,100000.0,1000000.0,6,7025000,-0.2,-0.3333333333333333
82350,Stefan,Bell,2024,39,Germany,Andernach,Germany,24-08-91,Centre-Back,Defender,Right,192.0,30-06-25,Unknown,https://img.a.transfermarkt.technology/portrait/header/82350-1657706740.jpg?lm=1,L1,1. FuÃŸball- und Sportverein Mainz 05,800000.0,6000000.0,33,130,132,3,6,7,7,10,3,16,6,6,15,11,6,14,10,16,14,17,13,15,10,13,13,7,14,8,15,16,12,9,8,15,18,16,11,13,14,15,10,17,9,10,1,3,2,4,2,3,2,3,3,2,2,6,12,6,18,14,18,12,15,1,1,20,12,1,1,1,1,1,1,1,1,1,1,88,8,20,2444155,6495,6495,4995,Northern_European,130,0,0,28766.0,Unknown,91004660,9111392.0,2.0,38,67,40,1,1,7,1,2,0.6096851018788039,0.5288770053475935,0.5955882352941175,0.0277682557186268,0.0,0.0,0.0037509377344336,0.0297574393598399,0.0505924720131114,0.1428571428571428,0.6744186046511627,0.625,436,25,17,92,0,5046,22,78,239,800000,19117.647058823528,6000000.0,2500000.0,1000000.0,800000.0,3,1000000,0.0,-0.2
82503,Aridane,Hernández,2024,367,Spain,Tuineje,Spain,23-03-89,Centre-Back,Defender,Right,188.0,30-06-25,JV SPORTS ,https://img.a.transfermarkt.technology/portrait/header/82503-1484149571.jpg?lm=1,ES1,Rayo Vallecano de Madrid S.A.D.,800000.0,4000000.0,35,133,136,6,7,8,8,7,6,16,7,9,14,9,7,13,11,13,15,15,13,14,9,12,14,11,13,7,16,14,14,11,10,14,16,13,12,14,15,14,9,14,10,8,3,2,2,3,3,3,3,3,3,2,3,19,13,9,13,10,11,12,13,1,1,20,5,1,1,8,1,1,1,1,1,1,1,77,8,20,1762406,6800,6800,3800,Mediterranean_Hispanic,131,0,0,15875.0,Unknown,67006487,2000000.0,1.0,89,1533,89,1,1,3,163,2,0.6500396930404869,0.4010695187165775,0.6029411764705883,0.0153204835425021,0.0,0.0,0.0037509377344336,0.0197549387346836,0.0110836412122558,0.0,0.581395348837209,0.7083333333333333,361,10,3,82,3,4500,9,30,63,400000,12000.0,4000000.0,1200000.0,,,4,900000,-0.5,-0.5555555555555556
82873,Pascal,GroãÅ¸,2024,16,Germany,Mannheim,Germany,15-06-91,Central Midfield,Midfield,Right,181.0,30-06-26,Excellence Sport,https://img.a.transfermarkt.technology/portrait/header/82873-1719671915.jpg?lm=1,L1,Borussia Dortmund,8000000.0,12000000.0,33,136,150,17,17,11,13,14,14,11,14,6,10,15,14,10,15,13,13,12,15,14,15,14,15,13,12,16,13,14,16,8,12,11,10,15,9,15,11,16,6,15,5,13,2,3,2,2,1,2,2,1,1,2,3,17,13,5,13,12,17,15,14,1,1,1,1,1,12,14,14,18,14,15,20,15,1,78,11,20,23823150,6800,6800,5500,Northern_European,132,0,0,76555.0,Unknown,92017376,5000000.0,2.0,38,906,40,3,1,7,41,1,0.6500396930404869,0.5828877005347594,0.6102941176470589,0.073914139243941,0.0,0.0,0.0397599399849962,0.0597649412353088,0.0277507708547459,0.1428571428571428,0.418604651162791,0.625,599,96,114,78,1,7421,5,28,83,7000000,188888.88888888888,12000000.0,2500000.0,200000.0,300000.0,5,3225000,-0.125,-0.125
84301,Benjamin,André,2024,1082,France,Nice,France,03-08-90,Defensive Midfield,Midfield,Right,180.0,30-06-26,Unknown,https://img.a.transfermarkt.technology/portrait/header/84301-1666690769.jpg?lm=1,FR1,Lille Olympique Sporting Club Lille MÃ©tropole,8000000.0,15000000.0,34,136,136,10,12,11,8,14,9,13,13,8,10,13,8,14,14,13,14,15,13,15,13,13,15,10,13,11,12,15,14,14,15,14,11,14,13,15,13,15,13,14,5,16,2,3,3,1,2,2,4,1,4,3,2,9,15,8,16,13,16,12,13,1,1,1,13,1,13,18,1,20,12,1,12,12,1,76,8,20,4999447,6800,6550,4500,Northern_European,135,0,0,29918.0,Unknown,85028361,7000000.0,1.0,34,1041,36,3,1,7,128,4,0.6169621593014025,0.4759358288770053,0.6323529411764706,0.0288806468090694,0.0,0.0,0.0397599399849962,0.0747686921730432,0.038862190616406,0.0,0.3953488372093026,0.6666666666666665,625,32,36,140,1,8666,1,1,7,6000000,161764.70588235295,15000000.0,3000000.0,500000.0,1500000.0,2,250000,-0.25,-0.25
84435,Kevin,Vogt,2024,89,Germany,Witten,Germany,23-09-91,Centre-Back,Defender,Right,194.0,Unknown,ROOF,https://img.a.transfermarkt.technology/portrait/header/84435-1726350948.jpg?lm=1,L1,1. FC Union Berlin,2000000.0,17000000.0,33,136,141,6,9,8,5,10,7,12,7,15,12,14,5,13,11,13,12,14,14,13,10,15,15,7,15,9,13,16,12,12,8,13,16,13,16,14,16,15,11,13,9,15,2,1,2,3,2,2,3,3,1,3,1,9,15,12,12,11,13,10,8,1,1,20,12,1,1,17,1,15,1,1,8,1,1,85,12,20,6877657,6750,6750,5250,Northern_European,134,0,0,44109.0,Unknown,91004433,1800000.0,3.0,38,1672,40,1,1,7,0,2,0.6434241862926701,0.5561497326203209,0.625,0.0425837214310061,0.0,0.0,0.0097524381095273,0.0847711927981995,0.0099724992360898,0.2857142857142857,0.7209302325581395,0.625,513,18,17,108,3,8616,40,113,67,2000000,55882.35294117647,17000000.0,5000000.0,,1000000.0,7,6400000,0.0,-0.2
84483,Aleksandr,Erokhin,2024,964,UdSSR,Barnaul,Russia,13-10-89,Attacking Midfield,Midfield,Right,195.0,30-06-25,D-Sports,https://img.a.transfermarkt.technology/portrait/header/84483-1721723636.png?lm=1,RU1,AO FK Zenit Sankt-Peterburg,400000.0,7500000.0,35,123,133,10,10,10,13,12,9,14,12,9,10,12,10,10,12,13,15,13,15,15,12,15,12,9,11,15,14,15,12,10,10,10,15,12,12,12,12,13,13,8,7,14,1,3,2,2,2,3,3,3,1,1,3,8,14,5,6,10,10,9,14,1,1,1,1,1,1,12,13,19,14,14,20,13,14,79,11,20,1703857,6382,6382,5239,Northern_European,120,32,4,34599.0,Unknown,59010237,9111392.0,2.0,101,143,81,3,1,7,7,0,0.5947340566287378,0.5549732620320855,0.5220588235294117,0.0334007012312585,0.2105263157894736,0.0526315789473684,0.0017504376094023,0.0372593148287071,0.0505924720131114,0.1428571428571428,0.7441860465116279,0.7083333333333333,439,76,36,56,1,14230,7,24,103,300000,-19444.444444444445,7500000.0,2000000.0,,1000000.0,5,1850000,-0.25,-0.4
84938,Timo,Horn,2024,80,Germany,KÃ¶ln,Germany,12-05-93,Goalkeeper,Goalkeeper,Left,192.0,30-06-26,Sports360 GmbH,https://img.a.transfermarkt.technology/portrait/header/84938-1657109580.jpg?lm=1,L1,Verein fÃ¼r LeibesÃ¼bungen Bochum 1848 FuÃŸballgemeinschaft,800000.0,12000000.0,31,132,141,1,3,1,3,9,2,7,3,2,2,9,3,1,9,10,14,14,13,13,8,12,14,1,11,2,15,13,12,11,13,14,15,17,9,11,16,15,5,15,6,2,13,11,10,10,14,13,15,15,11,12,15,12,15,5,14,13,17,15,18,20,1,1,1,1,1,1,1,1,1,1,1,1,1,90,20,8,3198187,6592,6592,5242,Northern_European,132,0,0,61328.0,Unknown,91014821,9111392.0,2.0,38,777,40,2,0,7,212,5,0.6225191849695687,0.5552941176470588,0.6102941176470589,0.0592106851344187,0.0,0.0,0.0037509377344336,0.0597649412353088,0.0505924720131114,0.1428571428571428,0.6744186046511627,0.5416666666666665,0,0,0,0,0,0,12,33,103,500000,12121.212121212122,12000000.0,5000000.0,500000.0,2500000.0,4,950000,-0.375,-0.5833333333333334
84992,James,Forrest,2024,371,Scotland,Prestwick,Scotland,07-07-91,Right Winger,Attack,Right,175.0,31-05-25,Avid Sports Group,https://img.a.transfermarkt.technology/portrait/header/84992-1701211739.jpg?lm=1,SC1,The Celtic Football Club,1000000.0,8000000.0,33,126,145,9,12,14,13,12,8,7,10,5,9,13,12,12,14,13,14,5,13,12,13,12,12,11,8,14,12,13,13,14,14,12,7,12,13,12,12,7,5,13,13,10,2,1,2,1,3,3,2,3,1,4,4,12,14,5,20,14,13,13,8,1,1,1,1,1,1,1,15,1,18,15,10,20,1,67,10,20,4813790,6299,6299,4949,Northern_European,125,38,5,22038.0,Unknown,29040974,9111392.0,2.0,82,1184,83,0,1,7,200,10,0.5837523154273617,0.5239572192513369,0.5588235294117647,0.0212715827529168,0.25,0.0657894736842105,0.0047511877969492,0.0397599399849962,0.0505924720131114,0.1428571428571428,0.2790697674418605,0.625,518,109,109,16,2,17155,14,145,349,500000,13793.103448275862,8000000.0,2000000.0,100000.0,2000000.0,1,650000,-0.5,-0.6666666666666666
85177,Nathaniel,Clyne,2024,873,England,London,England,05-04-91,Right-Back,Defender,Right,175.0,30-06-25,ROOF,https://img.a.transfermarkt.technology/portrait/header/85177-1700648209.jpg?lm=1,GB1,Crystal Palace Football Club,1500000.0,21000000.0,33,129,150,5,11,10,5,13,6,9,4,11,14,12,5,15,13,13,14,14,13,15,10,12,12,8,9,12,14,15,16,13,13,13,9,12,14,15,12,14,9,14,14,11,3,1,3,2,1,1,3,2,2,3,4,14,12,8,14,13,14,12,13,1,15,1,20,11,17,1,1,1,1,1,1,1,1,67,9,20,4316222,6449,6449,5199,African_Caribbean,128,14,0,81194.0,Unknown,28019851,10450000.0,2.0,32,858,33,1,1,1,58,11,0.6035988356708124,0.5506951871657754,0.5808823529411764,0.0783936377409577,0.0921052631578947,0.0,0.0072518129532383,0.1047761940485121,0.0580293897052695,0.1428571428571428,0.2790697674418605,0.625,461,8,23,46,0,5469,7,114,343,1500000,36363.63636363636,21000000.0,5000000.0,,1500000.0,3,10000000,0.0,0.0
85288,Unknown,Isco,2024,150,Spain,BenalmÃ¡dena,Spain,21-04-92,Attacking Midfield,Midfield,Right,176.0,30-06-27,Gestifute,https://img.a.transfermarkt.technology/portrait/header/85288-1699613327.jpg?lm=1,ES1,Real Betis BalompiÃ© S.A.D.,8000000.0,90000000.0,32,142,180,15,15,16,13,18,14,9,15,8,5,17,15,8,19,10,12,8,12,12,19,13,13,18,12,12,11,8,7,9,11,17,8,9,10,10,13,12,10,11,5,15,3,1,2,2,3,2,1,2,2,2,3,10,14,14,8,15,8,13,11,1,1,1,1,1,1,1,17,18,16,17,20,17,10,79,14,20,13868925,7200,7200,6500,Mediterranean_Hispanic,135,38,12,32145.0,Unknown,67103537,18000000.0,2.0,89,171,89,3,1,3,164,0,0.702963747023022,0.6898395721925134,0.6323529411764706,0.0310310764604719,0.25,0.1578947368421052,0.0397599399849962,0.4498624656164041,0.0999749993055362,0.1428571428571428,0.3023255813953489,0.5833333333333333,535,86,80,59,2,11629,23,82,112,6000000,100000.0,90000000.0,15000000.0,,20000000.0,4,13500000,-0.25,-0.25
85295,Iván,Balliu,2024,367,Spain,Caldes de Malavella,Albania,01-01-92,Right-Back,Defender,Right,172.0,30-06-25,FabiÃ¡n Bustos,https://img.a.transfermarkt.technology/portrait/header/85295-1688119678.jpg?lm=1,ES1,Rayo Vallecano de Madrid S.A.D.,2000000.0,4000000.0,32,133,136,8,14,12,7,13,8,9,12,14,11,13,7,14,13,12,13,14,13,13,12,12,12,6,7,13,13,15,15,14,14,10,6,14,14,15,10,14,6,12,5,15,2,1,3,3,2,1,1,3,1,3,2,15,14,4,10,12,14,15,13,1,13,1,20,9,17,1,1,1,12,1,1,1,1,63,12,20,3647641,6650,6650,4650,Mediterranean_Hispanic,130,6,0,12637.0,Unknown,67053461,9111392.0,2.0,89,301,0,1,1,3,163,11,0.6301931727970362,0.4919786096256684,0.5955882352941175,0.0121938148351643,0.0394736842105263,0.0,0.0097524381095273,0.0197549387346836,0.0505924720131114,0.1428571428571428,0.2093023255813952,0.5833333333333333,436,4,22,88,2,4265,2,3,24,1500000,45161.290322580644,4000000.0,1000000.0,,500000.0,4,1400000,-0.25,-0.5714285714285714
85370,Sergi,Roberto,2024,1047,Spain,Reus,Spain,07-02-92,Central Midfield,Midfield,Right,178.0,30-06-26,Unknown,https://img.a.transfermarkt.technology/portrait/header/85370-1662585931.jpg?lm=1,IT1,Calcio Como,2500000.0,60000000.0,32,145,155,10,13,13,10,14,8,8,11,10,10,14,12,12,14,11,13,12,14,14,14,14,14,13,13,14,13,16,16,14,12,12,9,15,14,16,11,14,9,13,8,18,3,3,1,2,2,2,3,2,3,2,1,10,13,5,16,12,15,14,14,1,1,1,15,1,15,18,1,20,15,1,8,10,1,68,11,20,11344947,7249,7249,6749,Mediterranean_Hispanic,141,11,1,86300.0,Unknown,67063007,9111392.0,2.0,89,1219,89,3,1,3,47,1,0.7094469436358826,0.7164705882352941,0.6764705882352942,0.0833240795012007,0.0723684210526315,0.0131578947368421,0.0122530632658164,0.2998249562390597,0.0505924720131114,0.1428571428571428,0.3488372093023257,0.5833333333333333,489,26,47,66,2,12473,35,190,157,2000000,12820.51282051282,60000000.0,20000000.0,1500000.0,5000000.0,2,1000000,-0.2,-0.3333333333333333
85372,Enric,Saborit,2024,2832,Spain,MatarÃ³,Spain,27-04-92,Centre-Back,Defender,Left,187.0,30-06-25,Unknown,https://img.a.transfermarkt.technology/portrait/header/85372-1725479696.jpg?lm=1,TR1,Gaziantep Futbol KulÃ¼bÃ¼ A.?.,500000.0,1200000.0,32,130,131,9,12,12,9,10,7,10,10,7,14,11,13,14,13,12,12,13,11,12,11,12,13,12,10,13,14,14,14,14,13,12,12,9,14,13,12,16,9,13,7,11,1,3,4,2,3,2,1,2,3,2,2,15,14,5,12,12,14,14,10,1,20,16,1,18,1,1,15,1,1,15,1,1,1,72,20,10,1363228,6500,6100,5700,Mediterranean_Hispanic,125,0,0,12821.0,Unknown,67050445,9111392.0,2.0,89,928,89,1,0,3,103,2,0.5574225985710506,0.6042780748663101,0.5588235294117647,0.0123714884121099,0.0,0.0,0.0022505626406601,0.0057514378594648,0.0505924720131114,0.1428571428571428,0.5581395348837206,0.5833333333333333,427,22,27,85,4,12460,14,56,93,400000,0.0,1200000.0,600000.0,,,6,100000,-0.2,-0.2
85791,Stefan,Lainer,2024,18,Austria,Salzburg,Austria,27-08-92,Right-Back,Defender,Right,175.0,30-06-26,ROOF,https://img.a.transfermarkt.technology/portrait/header/85791-1627997478.jpg?lm=1,L1,Borussia Verein fÃ¼r LeibesÃ¼bungen 1900 MÃ¶nchengladbach,2500000.0,18000000.0,32,128,137,4,11,11,7,11,7,11,7,14,13,11,11,13,11,16,12,16,11,12,11,12,16,10,12,12,13,16,17,13,11,12,8,16,14,17,11,11,12,13,9,8,1,1,1,2,3,3,3,3,2,2,1,11,12,10,14,12,16,12,10,1,12,8,20,10,18,1,1,1,12,1,1,1,1,73,11,20,2859052,6400,6800,5400,Northern_European,125,37,2,47944.0,Unknown,16014123,6350000.0,2.0,6,1291,7,1,1,7,42,11,0.6500396930404869,0.5721925133689839,0.5588235294117647,0.0462868636461514,0.2434210526315789,0.0263157894736842,0.0122530632658164,0.0897724431107777,0.0352509791938664,0.1428571428571428,0.2790697674418605,0.5833333333333333,519,27,59,76,1,8782,18,69,117,1800000,44871.794871794875,18000000.0,3500000.0,75000.0,125000.0,5,6075000,-0.28,-0.4
85906,Danny,Da Costa,2024,39,Germany,Neuss,Germany,13-07-93,Right-Back,Defender,Right,187.0,30-06-25,Sports360 GmbH,https://img.a.transfermarkt.technology/portrait/header/85906-1657707067.jpg?lm=1,L1,1. FuÃŸball- und Sportverein Mainz 05,800000.0,15000000.0,31,128,132,3,12,13,8,11,3,13,8,16,12,11,7,13,11,13,12,16,11,10,11,10,15,11,7,15,12,16,18,14,11,13,13,14,15,15,15,12,8,13,10,14,1,3,3,4,1,2,3,2,1,2,1,10,12,2,12,12,16,17,15,1,12,12,18,12,20,1,1,1,10,1,1,8,1,87,10,20,3335562,6400,6400,4900,African_Caribbean,126,0,0,16300.0,Unknown,92028423,750000.0,2.0,38,1031,40,1,1,1,1,11,0.5971156390579518,0.5187165775401069,0.5661764705882353,0.015730870880556,0.0,0.0,0.0037509377344336,0.0747686921730432,0.0041390038612183,0.1428571428571428,0.5581395348837206,0.5416666666666665,391,13,39,19,0,5985,19,88,243,800000,18421.052631578947,15000000.0,5000000.0,1000000.0,1000000.0,9,5200000,-0.3333333333333333,-0.4666666666666667
85941,Stefan,Ortega,2024,281,Germany,Hofgeismar,Germany,06-11-92,Goalkeeper,Goalkeeper,Right,185.0,30-06-26,Unknown,https://img.a.transfermarkt.technology/portrait/header/85941-1668065114.jpg?lm=1,GB1,Manchester City Football Club,9000000.0,9000000.0,32,129,134,3,1,2,3,11,6,7,1,1,2,12,2,1,11,10,12,12,12,12,11,12,14,5,13,5,11,12,13,11,12,13,14,14,9,12,13,16,4,15,5,2,12,13,13,10,15,14,13,15,13,11,14,12,13,8,15,13,14,14,12,20,1,1,1,1,1,1,1,1,1,1,1,1,1,88,8,20,1383669,6440,6090,4340,Northern_European,128,0,0,23198.0,Unknown,91100272,9111392.0,2.0,38,631,40,2,1,7,131,5,0.5560994972214872,0.4588235294117647,0.5808823529411764,0.0223916987814875,0.0,0.0,0.0447611902975743,0.0447611902975743,0.0505924720131114,0.1428571428571428,0.5116279069767438,0.5833333333333333,0,0,0,0,0,0,6,20,54,9000000,241891.8918918919,9000000.0,200000.0,75000.0,250000.0,4,525000,0.0,0.0
86202,Antonio,Rüdiger,2024,418,Germany,Berlin,Germany,03-03-93,Centre-Back,Defender,Right,190.0,30-06-26,Unknown,https://img.a.transfermarkt.technology/portrait/header/86202-1684484602.jpg?lm=1,ES1,Real Madrid Club de FÃºtbol,25000000.0,50000000.0,31,166,166,5,10,10,7,10,9,15,8,14,15,12,7,17,11,18,15,18,13,14,10,17,17,9,18,8,14,13,15,17,9,17,15,15,16,16,18,16,14,12,14,13,3,3,1,2,1,4,1,3,3,3,1,15,17,15,9,13,15,9,11,1,10,20,12,1,1,1,1,1,1,1,1,1,1,85,10,20,123524990,8300,7700,7000,African_Caribbean,165,53,2,244754.0,Unknown,92023410,22000000.0,2.0,38,178,40,1,1,1,167,2,0.7691188145011907,0.7433155080213903,0.8529411764705881,0.2363299977694241,0.3486842105263157,0.0263157894736842,0.1247811952988247,0.2498124531132783,0.1221978388288563,0.1428571428571428,0.6279069767441858,0.5416666666666665,562,30,14,84,4,15459,21,112,138,24000000,597500.0,50000000.0,10000000.0,200000.0,6000000.0,4,6500000,-0.04,-0.04
86784,Ricardo,Rodríguez,2024,150,Switzerland,ZÃ¼rich,Switzerland,25-08-92,Left-Back,Defender,Right,182.0,30-06-26,Elite FA,https://img.a.transfermarkt.technology/portrait/header/86784-1718216908.jpg?lm=1,ES1,Real Betis BalompiÃ© S.A.D.,3500000.0,28000000.0,32,137,144,11,12,13,12,15,11,8,11,13,10,14,13,11,15,8,13,12,15,14,15,15,14,13,10,14,11,14,14,12,15,16,9,13,12,14,7,13,7,15,5,12,2,2,3,2,2,2,3,1,3,3,1,16,15,7,13,14,15,12,13,1,1,1,1,1,1,1,1,20,1,1,16,1,1,66,10,20,5414655,6785,6785,4766,Mediterranean_Hispanic,138,32,0,21398.0,Unknown,51055617,8483333.333,3.0,92,1711,92,1,1,3,164,8,0.6480550410161419,0.5043850267379678,0.6544117647058822,0.0206535877026709,0.2105263157894736,0.0,0.0172543135783946,0.1397849462365591,0.0471031602711186,0.2857142857142857,0.4418604651162785,0.5833333333333333,498,34,47,42,0,9411,26,88,58,2500000,59756.09756097561,28000000.0,5000000.0,750000.0,10000000.0,6,7500000,-0.2857142857142857,-0.2857142857142857
87854,Unknown,Fredy,2024,44006,Angola,Luanda,Angola,27-03-90,Attacking Midfield,Midfield,Right,170.0,30-06-26,Proeleven S.A.,https://img.a.transfermarkt.technology/portrait/header/87854-1665560587.png?lm=1,TR1,Bodrumspor Spor Faaliyetleri Anonim ?irketi,450000.0,1500000.0,34,120,128,13,12,13,10,13,11,8,12,6,9,12,13,10,13,14,12,13,12,10,11,12,12,13,11,13,9,12,14,14,14,11,9,14,13,12,11,12,7,12,7,15,2,2,3,1,1,2,3,3,3,3,1,13,16,5,12,14,15,13,13,1,1,1,1,1,1,1,14,20,14,16,18,16,1,70,9,20,347975206,6050,6350,5000,African_Caribbean,115,37,2,10000.0,Unknown,55017367,250000.0,2.0,3,868,3,3,1,1,39,0,0.590500132310135,0.5294117647058822,0.4852941176470588,0.009647482104698,0.2434210526315789,0.0263157894736842,0.0020005001250312,0.0072518129532383,0.0013611489208033,0.1428571428571428,0.1627906976744184,0.6666666666666665,432,57,52,66,3,5905,12,39,95,400000,5882.35294117647,1500000.0,700000.0,,600000.0,8,2500000,-0.2,-0.42857142857142855
87884,Unknown,Mário Rui,2024,6195,Portugal,Sines,Portugal,27-05-91,Left-Back,Defender,Left,168.0,30-06-26,Unknown,https://img.a.transfermarkt.technology/portrait/header/87884-1661351255.jpg?lm=1,IT1,SocietÃ  Sportiva Calcio Napoli,3500000.0,15000000.0,33,147,148,13,15,11,7,13,12,8,11,12,14,14,7,15,13,13,14,15,12,14,12,14,15,12,9,13,13,15,15,16,16,14,6,16,15,15,11,14,10,12,8,11,2,3,2,3,2,2,3,2,3,4,2,14,14,8,12,13,15,14,13,1,20,1,1,18,1,1,16,1,1,1,1,1,1,67,20,7,347975206,7339,7239,5789,Mediterranean_Hispanic,144,11,0,74808.0,Unknown,55027761,9111392.0,2.0,76,1373,79,1,0,3,184,8,0.7081238422863191,0.6137967914438502,0.6985294117647058,0.0722272058802229,0.0723684210526315,0.0,0.0172543135783946,0.0747686921730432,0.0505924720131114,0.1428571428571428,0.1162790697674416,0.625,425,6,32,98,5,5298,18,60,120,1000000,23611.11111111111,15000000.0,4000000.0,,1000000.0,5,3400000,-0.7142857142857143,-0.8
88103,James,Rodríguez,2024,367,Colombia,CÃºcuta,Colombia,12-07-91,Attacking Midfield,Midfield,Left,180.0,30-06-25,Gestifute,https://img.a.transfermarkt.technology/portrait/header/88103-1720681352.jpg?lm=1,ES1,Rayo Vallecano de Madrid S.A.D.,5000000.0,80000000.0,33,150,175,17,17,15,16,18,16,12,17,8,6,17,14,6,18,10,16,12,18,11,19,17,13,18,13,16,8,14,9,11,13,14,11,12,10,12,11,15,10,16,15,15,3,2,2,2,3,1,2,3,1,1,4,14,15,16,6,15,12,9,11,1,1,1,1,1,1,1,14,14,14,16,20,17,9,75,20,7,14778545,7500,8250,6750,Mediterranean_Hispanic,149,88,25,59137.0,Unknown,76002390,27126000.0,5.0,20,401,20,3,0,3,163,0,0.8418893887271766,0.7165775401069518,0.7352941176470587,0.0570950177045925,0.5789473684210527,0.3289473684210526,0.0247561890472618,0.3998499624906226,0.150676407677991,0.5714285714285714,0.3953488372093026,0.625,488,123,155,50,1,12663,39,148,57,2500000,53571.42857142857,80000000.0,20000000.0,2500000.0,18000000.0,11,67500000,-0.5,-0.5
88262,Dedryck,Boyata,2024,2282,Belgium,Brussel,Belgium,28-11-90,Centre-Back,Defender,Right,188.0,30-06-25,Stirr Associates,https://img.a.transfermarkt.technology/portrait/header/88262-1707939940.jpg?lm=1,BE1,Club Brugge Koninklijke Voetbalvereniging,500000.0,10000000.0,34,132,133,5,7,9,8,11,6,16,6,11,14,12,7,16,11,16,14,17,10,14,10,10,16,7,13,10,14,15,13,12,11,14,16,14,12,14,16,15,13,13,14,8,2,4,1,2,3,4,3,3,1,3,2,17,13,9,11,14,13,15,17,1,1,20,12,1,1,1,1,1,1,1,1,1,1,84,8,20,347975206,6700,6800,5500,African_Caribbean,133,31,0,55000.0,Unknown,28019224,1700000.0,2.0,7,265,8,1,1,1,53,2,0.6500396930404869,0.5828877005347594,0.6176470588235294,0.0531002590751124,0.2039473684210526,0.0,0.0022505626406601,0.0497624406101525,0.0094169282480068,0.1428571428571428,0.581395348837209,0.6666666666666665,330,26,12,42,6,10600,25,139,155,300000,-6250.0,10000000.0,3000000.0,,2500000.0,6,4500000,-0.4,-0.625
88348,Alexandros,Paschalakis,2024,683,Greece,Athens,Greece,28-07-89,Goalkeeper,Goalkeeper,Right,197.0,30-06-26,SPORTS ACTION,https://img.a.transfermarkt.technology/portrait/header/88348-1728417085.png?lm=1,GR1,Olympiakos Syndesmos Filathlon Peiraios,700000.0,2500000.0,35,120,120,2,3,1,2,9,3,1,1,1,1,8,3,3,9,13,10,14,10,9,8,9,16,6,10,5,13,12,10,12,14,13,16,17,12,12,16,12,5,11,8,1,15,9,12,10,13,13,13,16,16,16,12,11,15,9,10,13,16,11,15,20,1,1,1,1,1,1,1,1,1,1,1,1,1,90,7,20,627666,6000,6000,3500,Mediterranean_Hispanic,118,3,0,13010.0,Unknown,36023442,9111392.0,2.0,40,104,42,2,1,3,141,5,0.5441915850754168,0.3689839572192513,0.5073529411764706,0.0125539900753857,0.0197368421052631,0.0,0.0032508127031757,0.0122530632658164,0.0505924720131114,0.1428571428571428,0.7906976744186047,0.7083333333333333,0,0,0,0,0,0,1,3,12,600000,14516.129032258064,2500000.0,500000.0,,100000.0,4,450000,-0.25,-0.25
88680,Luca,Caldirola,2024,2919,Italy,Desio,Italy,01-02-91,Centre-Back,Defender,Left,186.0,30-06-25,Reset Group Srl,https://img.a.transfermarkt.technology/portrait/header/88680-1712508051.jpg?lm=1,IT1,Associazione Calcio Monza,1300000.0,4000000.0,33,129,137,4,13,10,10,12,4,17,4,10,13,10,7,13,10,8,13,10,12,15,10,14,14,4,13,8,14,17,10,11,11,11,15,13,12,13,12,17,8,16,6,10,1,1,1,1,1,1,1,1,1,1,1,12,14,4,14,12,16,15,17,1,16,20,1,1,1,1,1,1,1,1,1,1,1,75,20,10,1888381,6450,6450,5250,Northern_European,127,0,0,24231.0,Unknown,43008773,2012500.0,4.0,52,411,54,1,0,7,28,2,0.6037311458057687,0.5561497326203209,0.5735294117647058,0.023389181417275,0.0,0.0,0.0062515628907226,0.0197549387346836,0.0111530875857662,0.4285714285714285,0.5348837209302322,0.625,402,15,4,71,2,6624,15,69,113,1000000,25757.575757575756,4000000.0,1250000.0,150000.0,2000000.0,10,5750000,-0.23076923076923078,-0.3333333333333333
88682,Mattia,De Sciglio,2024,749,Italy,Milano,Italy,20-10-92,Right-Back,Defender,Right,183.0,30-06-25,Unknown,https://img.a.transfermarkt.technology/portrait/header/88682-1663577192.jpg?lm=1,IT1,Empoli Football Club S.r.l.,1000000.0,14000000.0,32,136,146,11,13,11,7,13,5,12,12,10,13,13,7,13,13,7,14,10,11,11,11,12,12,7,6,11,14,18,15,13,14,13,11,10,14,13,13,14,8,10,17,15,1,2,2,1,3,4,1,2,1,1,1,13,13,1,14,11,20,19,18,1,19,10,20,18,19,1,11,1,11,1,1,1,1,78,12,20,6088906,6800,6800,5750,Mediterranean_Hispanic,130,39,0,53462.0,Unknown,43037008,12000000.0,1.0,52,952,54,1,1,3,64,11,0.6500396930404869,0.6096256684491979,0.5955882352941175,0.0516151397199903,0.256578947368421,0.0,0.0047511877969492,0.0697674418604651,0.0666407400205561,0.0,0.4651162790697669,0.5833333333333333,349,5,13,40,5,9333,37,224,292,1000000,27941.176470588234,14000000.0,2500000.0,150000.0,12000000.0,5,3350000,0.0,-0.5
88755,Kevin,De Bruyne,2024,281,Belgium,Drongen,Belgium,28-06-91,Attacking Midfield,Midfield,Right,181.0,30-06-25,Roc Nation Sports,https://img.a.transfermarkt.technology/portrait/header/88755-1713391485.jpg?lm=1,GB1,Manchester City Football Club,45000000.0,150000000.0,33,189,189,14,19,15,16,16,17,6,17,7,9,18,16,9,18,12,14,13,15,15,20,18,17,16,13,14,11,14,15,15,13,14,10,16,14,17,13,15,6,15,7,14,1,3,1,3,3,3,3,3,3,2,1,13,17,13,14,11,18,16,13,1,1,1,1,1,1,12,15,20,15,14,20,14,12,68,16,20,347975206,9450,9400,9400,Northern_European,181,91,24,394372.0,Unknown,18004457,35333333.33,3.0,7,431,8,3,1,7,131,0,0.9940460439269648,1.0,0.9705882352941176,0.38080372187519,0.5986842105263157,0.3157894736842105,0.2248062015503876,0.7499374843710929,0.1962739705547376,0.2857142857142857,0.418604651162791,0.625,637,152,257,58,0,16214,27,163,128,35000000,811627.9069767442,150000000.0,30000000.0,1200000.0,9000000.0,4,23000000,-0.3,-0.4166666666666667
89200,Rasmus,Falk,2024,190,Denmark,Middelfart,Denmark,15-01-92,Central Midfield,Midfield,Right,177.0,30-06-27,CMA Group,https://img.a.transfermarkt.technology/portrait/header/89200-1695237961.jpg?lm=1,DK1,Football Club KÃ¸benhavn,850000.0,3000000.0,32,135,145,5,11,15,8,16,5,5,6,3,6,15,8,9,15,15,15,13,14,14,14,14,13,15,12,14,12,15,15,14,15,17,6,16,13,14,13,11,3,16,14,13,1,2,3,1,1,2,1,3,2,3,3,14,16,6,16,14,15,18,14,1,1,1,1,1,1,15,1,20,1,12,18,12,1,65,9,20,6287164,6750,6500,5000,Northern_European,134,2,0,23525.0,Unknown,27010681,9111392.0,2.0,28,951,30,3,1,7,90,1,0.6103466525535857,0.5294117647058822,0.625,0.0227074556274725,0.0131578947368421,0.0,0.0040010002500625,0.0147536884221055,0.0505924720131114,0.1428571428571428,0.3255813953488373,0.5833333333333333,506,61,81,55,1,16592,10,59,86,650000,18333.333333333332,3000000.0,1000000.0,100000.0,650000.0,1,500000,-0.23529411764705882,-0.35
90681,Eliaquim,Mangala,2024,1465,France,Colombes,France,13-02-91,Centre-Back,Defender,Left,187.0,30-06-25,Team Spirit Football,https://img.a.transfermarkt.technology/portrait/header/90681-1724845234.jpg?lm=1,PO1,Grupo Desportivo Estoril Praia,400000.0,35000000.0,33,121,145,7,7,8,9,12,8,15,8,12,13,12,10,13,12,17,12,13,10,12,8,11,16,8,10,11,12,12,12,12,12,14,15,10,12,12,13,11,12,12,17,10,3,2,1,1,4,3,1,1,3,3,3,15,14,5,12,11,17,13,13,1,12,20,5,5,1,12,1,1,1,1,1,1,1,84,20,12,-1,6050,6050,5250,African_Caribbean,121,8,0,32655.0,Unknown,18031822,25875000.0,2.0,34,375,36,1,0,1,109,2,0.5508070918232336,0.5561497326203209,0.5294117647058822,0.0315235412661366,0.0526315789473684,0.0,0.0017504376094023,0.1747936984246061,0.1437262146170727,0.1428571428571428,0.5581395348837206,0.625,381,21,13,95,2,13212,13,83,263,350000,7317.073170731707,35000000.0,8000000.0,3000000.0,5000000.0,11,24000000,-0.125,-0.3
91059,Joshua,King,2024,415,Norway,Oslo,Norway,15-01-92,Left Winger,Attack,Right,180.0,30-06-25,ROGON,https://img.a.transfermarkt.technology/portrait/header/91059-1696447644.png?lm=1,FR1,Toulouse Football Club,2000000.0,20000000.0,32,130,144,7,9,14,14,13,7,7,10,4,4,11,12,4,13,5,10,9,10,12,7,9,13,16,5,15,6,13,12,17,14,12,11,16,17,13,14,14,4,12,12,12,2,1,3,3,3,2,1,1,1,3,4,12,13,7,8,10,7,6,14,1,1,1,1,1,1,1,14,1,14,19,14,15,20,74,7,20,8342426,6550,6900,5100,Mixed_Race,116,62,20,56089.0,Unknown,53020695,1230000.0,1.0,71,1096,73,0,1,4,203,7,0.6632707065361206,0.5401069518716577,0.4926470588235294,0.0541518162777965,0.4078947368421052,0.2631578947368421,0.0097524381095273,0.0997749437359339,0.0068057446040167,0.0,0.3953488372093026,0.5833333333333333,440,93,52,29,0,9029,27,87,68,2000000,55882.35294117647,20000000.0,4000000.0,250000.0,1250000.0,8,4200000,-0.13043478260869565,-0.42857142857142855
91469,Kian,Hansen,2024,2778,Denmark,Grindsted,Denmark,03-03-89,Centre-Back,Defender,Right,184.0,30-06-26,Elite Consulting,https://img.a.transfermarkt.technology/portrait/header/91469-1519042814.jpg?lm=1,DK1,Fodbold Club NordsjÃ¦lland,300000.0,2000000.0,35,125,126,7,11,9,5,12,8,10,7,17,15,13,6,15,12,16,15,15,14,14,12,13,13,6,12,8,14,16,14,9,9,13,13,13,10,11,13,12,9,14,14,15,1,3,1,2,1,3,3,1,2,3,3,7,14,4,15,13,13,13,12,1,8,20,13,1,1,17,1,11,1,1,1,1,1,73,11,20,347975206,6500,5750,4500,Northern_European,125,2,0,6722.0,Unknown,1707103,1225000.0,2.0,28,564,30,1,1,7,87,2,0.5111140513363324,0.4759358288770053,0.5588235294117647,0.0064821887067198,0.0131578947368421,0.0,0.0012503125781445,0.0097524381095273,0.0067779660546126,0.1428571428571428,0.4883720930232553,0.7083333333333333,485,10,26,52,3,13788,1,7,42,200000,4285.714285714285,2000000.0,500000.0,,200000.0,3,550000,-0.3333333333333333,-0.42857142857142855
91845,Heung-Min,Son,2024,148,"Korea, South","Chuncheon, Gangwon","Korea, South",08-07-92,Left Winger,Attack,Right,184.0,30-06-25,CAA Base Ltd,https://img.a.transfermarkt.technology/portrait/header/91845-1669336455.jpg?lm=1,GB1,Tottenham Hotspur Football Club,45000000.0,90000000.0,32,173,173,14,14,16,18,13,13,8,16,6,5,13,9,6,17,8,15,6,17,11,12,14,14,13,13,18,7,14,17,16,14,12,10,16,16,16,10,16,5,14,5,14,2,1,1,3,3,3,1,1,2,2,2,14,17,8,7,14,18,11,15,1,1,1,1,1,1,1,15,1,13,20,11,14,19,77,19,20,347975206,8650,8950,8250,10,168,102,33,222704.0,Unknown,92020288,21250000.0,2.0,57,358,58,0,1,0,202,7,0.9345064831966128,0.8770053475935828,0.875,0.215038137053921,0.6710526315789473,0.4342105263157894,0.2248062015503876,0.4498624656164041,0.1180310564182338,0.1428571428571428,0.4883720930232553,0.5833333333333333,640,237,106,29,4,11911,15,70,78,38000000,970512.8205128205,90000000.0,16000000.0,3000000.0,14000000.0,2,9000000,-0.15555555555555556,-0.24
91849,Thomas,Delaney,2024,190,Denmark,Frederiksberg,Denmark,03-09-91,Central Midfield,Midfield,Left,182.0,30-06-26,Unknown,https://img.a.transfermarkt.technology/portrait/header/91849-1668183672.jpg?lm=1,DK1,Football Club KÃ¸benhavn,2500000.0,27000000.0,33,145,146,8,10,9,11,12,13,16,12,8,14,13,9,17,11,15,15,19,14,17,11,14,18,7,13,13,15,17,18,11,10,14,15,16,12,17,14,16,14,15,5,14,2,2,1,1,1,1,3,3,1,2,2,17,15,4,14,16,17,15,12,1,8,10,1,1,1,20,11,20,1,11,1,1,1,79,20,8,31490411,6999,7499,6749,Northern_European,144,69,7,76711.0,Unknown,27002693,9333333.333,3.0,28,509,30,3,0,7,90,1,0.742524477374967,0.7164705882352941,0.6985294117647058,0.0740647755374384,0.4539473684210526,0.0921052631578947,0.0122530632658164,0.134783695923981,0.0518255136698241,0.2857142857142857,0.4418604651162785,0.625,487,42,41,101,0,13318,23,105,85,2000000,55882.35294117647,27000000.0,6000000.0,500000.0,800000.0,7,19150000,-0.2,-0.2
91970,Juan,Cuadrado,2024,800,Colombia,NecoclÃ­,Colombia,26-05-88,Right Midfield,Midfield,Right,176.0,30-06-25,Andrei MartÃ­nez,https://img.a.transfermarkt.technology/portrait/header/91970-1663576912.jpg?lm=1,IT1,Atalanta Bergamasca Calcio S.p.a.,1000000.0,32000000.0,36,152,163,12,15,16,10,15,10,7,13,6,13,15,9,13,17,16,12,13,12,12,15,11,19,16,12,15,13,11,15,16,16,12,8,19,15,13,9,15,15,12,10,15,1,1,2,1,3,1,2,2,2,1,2,15,14,6,13,16,19,8,14,1,12,1,19,12,20,1,10,1,20,10,1,16,1,72,9,20,5383992,7600,7850,7600,African_Caribbean,142,113,10,178076.0,Unknown,76010707,23666666.67,3.0,20,1024,20,3,1,1,31,9,0.7889653347446415,0.8074866310160427,0.6838235294117647,0.171944569706462,0.7434210526315789,0.131578947368421,0.0047511877969492,0.1597899474868717,0.1314573553154254,0.2857142857142857,0.3023255813953489,0.75,527,55,93,119,5,10355,19,107,120,1000000,27142.85714285714,32000000.0,7000000.0,,,8,11400000,0.0,-0.5
92164,Mats,Rits,2024,58,Belgium,Antwerpen,Belgium,18-07-93,Defensive Midfield,Midfield,Right,178.0,30-06-26,Quadrans,https://img.a.transfermarkt.technology/portrait/header/92164-1705056841.jpg?lm=1,BE1,Royal Sporting Club Anderlecht,3500000.0,6000000.0,31,127,132,10,10,13,11,14,10,8,11,4,10,14,14,9,14,15,13,13,11,14,14,14,9,14,12,15,7,15,14,11,11,12,10,9,12,16,11,16,12,12,14,13,2,3,3,2,3,2,2,4,1,1,3,10,18,5,16,10,15,12,12,1,1,1,1,1,1,19,1,20,1,1,12,1,1,73,11,20,5140686,6450,6300,4750,Northern_European,126,0,0,18000.0,Unknown,18027240,1750000.0,2.0,7,74,8,3,1,7,175,4,0.5838846255623181,0.5026737967914437,0.5661764705882353,0.0173724202327716,0.0,0.0,0.0172543135783946,0.0297574393598399,0.0096947137420483,0.1428571428571428,0.3488372093023257,0.5416666666666665,489,44,48,55,0,12821,3,39,246,3000000,65714.28571428571,6000000.0,1000000.0,500000.0,700000.0,4,2200000,-0.14285714285714285,-0.25
92248,Nicolai,Larsen,2024,1177,Denmark,Herlev,Denmark,09-03-91,Goalkeeper,Goalkeeper,Right,187.0,30-06-26,Unknown,https://img.a.transfermarkt.technology/portrait/header/92248-1583755582.jpg?lm=1,DK1,Silkeborg IdrÃ¦tsforening,400000.0,1250000.0,33,120,126,3,3,2,1,11,7,1,1,1,2,12,12,2,11,10,12,13,15,13,9,12,14,4,14,9,13,14,9,8,12,11,14,16,7,11,12,12,6,15,4,11,11,11,14,4,15,11,13,13,13,11,13,7,12,2,15,12,14,16,15,20,1,1,1,1,1,1,1,1,1,1,1,1,1,83,8,20,867322,6050,5850,3750,Northern_European,118,0,0,2689.0,Unknown,27010429,9111392.0,2.0,28,618,30,2,1,7,182,5,0.5243450648319662,0.3957219251336898,0.5073529411764706,0.0025878542729046,0.0,0.0,0.0017504376094023,0.0060015003750937,0.0505924720131114,0.1428571428571428,0.5581395348837206,0.625,0,0,0,0,0,0,1,1,8,300000,6060.606060606061,1250000.0,300000.0,,450000.0,3,50000,-0.25,-0.3333333333333333
92571,Aaron,Cresswell,2024,379,England,Liverpool,England,15-12-89,Left-Back,Defender,Left,170.0,30-06-25,Unique Sports Group,https://img.a.transfermarkt.technology/portrait/header/92571-1700670925.jpg?lm=1,GB1,West Ham United Football Club,900000.0,12000000.0,35,142,145,16,16,13,8,13,16,11,14,11,13,12,13,13,13,8,14,13,15,14,12,15,13,12,12,13,14,16,16,14,13,13,8,15,14,15,10,18,9,14,11,13,1,2,1,1,1,4,1,4,3,2,3,12,16,4,14,11,14,14,16,1,20,18,1,16,1,1,8,1,1,4,1,1,1,66,20,7,13483494,7096,7096,5496,Northern_European,143,3,0,57996.0,Unknown,28005949,2512500.0,2.0,32,845,33,1,0,7,220,8,0.6892034929875629,0.5824598930481283,0.6911764705882353,0.055993248404076,0.0197368421052631,0.0,0.0042510627656914,0.0597649412353088,0.0139309425261812,0.1428571428571428,0.1627906976744184,0.7083333333333333,579,24,69,54,3,7414,15,34,85,700000,20967.74193548387,12000000.0,2000000.0,,50000.0,2,2650000,-0.2222222222222222,-0.2222222222222222
92572,Joel,Ward,2024,873,England,Emsworth,England,29-10-89,Right-Back,Defender,Right,186.0,30-06-25,Avid Sports Group,https://img.a.transfermarkt.technology/portrait/header/92572-1547722707.jpg?lm=1,GB1,Crystal Palace Football Club,1000000.0,5000000.0,35,130,136,8,9,10,5,10,6,14,8,10,14,11,5,15,11,15,15,16,11,16,9,13,18,3,14,11,13,16,15,10,12,12,15,14,11,12,14,13,5,10,6,12,3,2,1,2,2,3,4,3,1,1,1,14,12,1,16,9,15,10,13,1,15,16,20,1,10,11,1,7,1,1,1,1,1,82,11,20,2826614,6500,6500,5400,Northern_European,123,0,0,46397.0,Unknown,28004100,650000.0,1.0,32,463,33,1,1,7,58,11,0.6103466525535857,0.5721925133689839,0.5441176470588236,0.0447930537356352,0.0,0.0,0.0047511877969492,0.0247561890472618,0.0035834328731353,0.0,0.5348837209302322,0.7083333333333333,489,13,15,59,0,4890,6,29,55,900000,26562.5,5000000.0,1000000.0,,400000.0,1,250000,-0.1,-0.1
92947,Sergi,Gómez,2024,714,Spain,Arenys de Mar,Spain,28-03-92,Centre-Back,Defender,Right,185.0,30-06-25,Unique Sports Group,https://img.a.transfermarkt.technology/portrait/header/92947-1447159892.jpg?lm=1,ES1,Reial Club Deportiu Espanyol de Barcelona S.A.D.,1000000.0,10000000.0,32,138,149,6,9,10,8,12,7,14,9,12,14,14,9,15,14,10,14,13,13,13,14,13,13,7,14,8,16,15,14,12,10,11,13,13,15,13,14,14,9,12,10,6,1,3,2,3,1,3,3,3,3,1,3,13,12,2,13,11,11,12,15,1,1,20,13,1,1,9,1,1,1,1,1,1,1,75,9,20,10182524,6900,6900,5400,Mediterranean_Hispanic,138,0,0,18533.0,Unknown,67071183,2200000.0,3.0,89,83,89,1,1,3,170,2,0.6632707065361206,0.5721925133689839,0.6544117647058822,0.0178870942355546,0.0,0.0,0.0047511877969492,0.0497624406101525,0.0121947831884219,0.2857142857142857,0.5116279069767438,0.5833333333333333,430,8,5,46,6,8784,4,10,23,900000,10810.81081081081,10000000.0,3000000.0,500000.0,800000.0,3,5500000,-0.1,-0.4
93081,Nick,Viergever,2024,200,Netherlands,Capelle aan den IJssel,Netherlands,03-08-89,Centre-Back,Defender,Left,183.0,30-06-25,Soccer Vision ,https://img.a.transfermarkt.technology/portrait/header/93081-1723460789.jpg?lm=1,NL1,Football Club Utrecht,450000.0,4000000.0,35,125,135,7,9,9,7,12,9,14,9,13,15,12,8,13,11,11,13,13,11,12,13,12,13,9,16,13,14,16,15,11,10,14,12,14,11,11,11,15,12,14,6,15,2,1,2,3,2,1,1,2,3,3,1,11,16,6,8,12,15,14,12,1,19,20,12,17,10,15,8,10,1,1,1,1,1,78,20,8,347975206,6250,6250,5500,Northern_European,121,3,0,5999.0,Unknown,37001736,1183333.333,3.0,67,314,68,1,0,7,92,2,0.5772691188145012,0.5828877005347594,0.5294117647058822,0.0057840474233951,0.0197368421052631,0.0,0.0020005001250312,0.0197549387346836,0.0065464781410594,0.2857142857142857,0.4651162790697669,0.7083333333333333,527,29,20,65,8,11944,12,62,110,400000,10000.0,4000000.0,1000000.0,,300000.0,6,2650000,-0.1111111111111111,-0.2
93315,Henrik,Dalsgaard,2024,678,Denmark,Roum,Denmark,27-07-89,Right-Back,Defender,Right,192.0,30-06-25,People In Sport,https://img.a.transfermarkt.technology/portrait/header/93315-1538465685.jpg?lm=1,DK1,Aarhus Gymnastik Forening,400000.0,2500000.0,35,122,129,7,13,11,8,11,8,13,9,12,10,12,8,13,10,15,9,13,12,12,13,12,13,13,9,9,12,13,15,13,11,14,16,14,13,13,13,12,7,12,10,16,3,3,3,2,1,1,2,2,3,3,2,12,11,5,14,12,14,14,14,1,1,17,20,1,19,1,1,9,17,1,9,15,10,81,8,20,347975206,6000,6000,5000,Northern_European,116,26,1,11426.0,Unknown,27031289,1100000.0,1.0,28,1257,30,1,1,7,11,11,0.5441915850754168,0.5294117647058822,0.4926470588235294,0.0110244523260271,0.1710526315789473,0.0131578947368421,0.0017504376094023,0.0122530632658164,0.0060835023195088,0.0,0.6744186046511627,0.7083333333333333,523,36,43,63,2,13919,4,40,140,300000,6250.0,2500000.0,500000.0,,350000.0,4,900000,-0.25,-0.4
93604,Lukas,Kübler,2024,60,Germany,Bonn,Germany,30-08-92,Right-Back,Defender,Right,182.0,Unknown,ROOF,https://img.a.transfermarkt.technology/portrait/header/93604-1658412582.jpg?lm=1,L1,Sport-Club Freiburg,2000000.0,3000000.0,32,124,127,6,12,8,6,10,6,11,7,13,15,11,11,16,11,11,13,16,10,15,8,10,13,6,10,7,14,16,14,12,11,16,13,15,12,16,12,13,12,11,10,14,3,1,1,1,2,1,2,3,2,2,2,6,14,9,13,11,15,12,13,1,1,14,20,1,16,10,1,10,1,1,1,1,1,75,10,20,1557725,6149,6149,4549,Northern_European,123,0,0,4999.0,Unknown,91101321,9111392.0,2.0,38,224,40,1,1,7,189,11,0.5639057951839112,0.4811764705882352,0.5441176470588236,0.0048184301573859,0.0,0.0,0.0097524381095273,0.0147536884221055,0.0505924720131114,0.1428571428571428,0.4418604651162785,0.5833333333333333,345,15,12,50,0,4199,18,114,418,2000000,60937.5,3000000.0,500000.0,50000.0,150000.0,3,375000,0.0,-0.2
93637,Mario,Engels,2024,1304,Germany,Troisdorf,Germany,22-10-93,Right Winger,Attack,Right,184.0,30-06-25,SEG,https://img.a.transfermarkt.technology/portrait/header/93637-1724752830.jpg?lm=1,NL1,Heracles Almelo,450000.0,700000.0,31,120,120,12,11,13,10,13,11,8,11,4,4,12,11,5,12,12,10,9,11,9,11,9,12,13,7,11,6,11,15,14,15,11,11,12,14,12,10,11,10,11,6,12,1,3,2,3,3,4,3,3,3,4,3,14,12,7,8,12,14,8,10,1,1,1,1,1,1,1,14,12,14,17,17,18,20,75,9,20,2094399,5900,5900,4400,Northern_European,102,0,0,2000.0,Unknown,92016239,100000.0,1.0,38,1526,40,0,1,7,113,10,0.530960571579783,0.4652406417112299,0.3897058823529412,0.0019225439766243,0.0,0.0,0.0020005001250312,0.0032508127031757,0.0005277924386788,0.0,0.4883720930232553,0.5416666666666665,390,62,51,48,1,6337,8,27,94,600000,23000.0,700000.0,150000.0,25000.0,100000.0,7,750000,0.3333333333333333,0.3333333333333333
93707,Christian,Günter,2024,60,Germany,Villingen-Schwenningen,Germany,28-02-93,Left-Back,Defender,Left,184.0,Unknown,Unique Sports Group,https://img.a.transfermarkt.technology/portrait/header/93707-1658411784.jpg?lm=1,L1,Sport-Club Freiburg,5000000.0,12000000.0,31,137,139,13,15,14,9,11,13,9,12,16,12,12,8,12,11,14,10,14,9,12,8,9,13,11,14,12,11,13,16,14,11,14,12,18,17,15,13,13,10,12,3,14,2,2,3,1,2,2,3,1,2,2,4,4,14,4,17,11,17,14,14,1,20,10,12,20,12,1,16,1,1,15,1,1,1,87,20,10,5851022,6636,6636,5986,Northern_European,123,6,0,16781.0,Unknown,91105585,9111392.0,2.0,38,1609,40,1,0,7,189,8,0.6283408309076476,0.6348663101604277,0.5441176470588236,0.0161953327855064,0.0394736842105263,0.0,0.0247561890472618,0.0597649412353088,0.0505924720131114,0.1428571428571428,0.4883720930232553,0.5416666666666665,516,19,56,47,1,7086,5,36,189,4000000,132758.62068965516,12000000.0,2500000.0,,1500000.0,0,0,-0.2,-0.3333333333333333
93720,Alexandre,Lacazette,2024,1041,France,Lyon,France,28-05-91,Centre-Forward,Attack,Right,175.0,30-06-25,score agencies,https://img.a.transfermarkt.technology/portrait/header/93720-1672830448.jpg?lm=1,FR1,Olympique Lyonnais,9000000.0,70000000.0,33,140,161,5,11,14,14,15,11,13,13,3,5,12,14,5,15,10,15,14,14,14,12,14,12,14,15,16,7,15,15,13,14,15,10,14,13,13,12,11,8,13,8,10,2,3,3,1,2,1,3,2,1,1,3,14,13,7,15,12,14,14,14,1,1,1,1,1,1,1,1,1,1,12,1,14,20,73,11,20,347975206,7198,6998,6848,African_Caribbean,140,16,3,104393.0,Unknown,34011687,53000000.0,1.0,34,884,36,0,1,1,143,3,0.6762370997618418,0.7270588235294118,0.6691176470588234,0.1007949926951053,0.1052631578947368,0.0394736842105263,0.0447611902975743,0.3498374593648412,0.294424845134587,0.0,0.2790697674418605,0.625,583,263,88,64,2,9578,34,78,49,8000000,188095.2380952381,70000000.0,12000000.0,150000.0,6000000.0,2,13000000,-0.1111111111111111,-0.2
93740,Willi,Orbán,2024,23826,Germany,Kaiserslautern,Hungary,03-11-92,Centre-Back,Defender,Right,186.0,30-06-27,ROGON,https://img.a.transfermarkt.technology/portrait/header/93740-1724337179.jpg?lm=1,L1,RasenBallsport Leipzig,10000000.0,20000000.0,32,142,143,5,7,7,8,11,5,16,8,10,15,13,8,16,10,12,13,16,12,14,11,13,16,7,14,6,14,15,16,11,11,15,14,16,12,14,16,17,10,14,10,10,3,2,3,3,1,3,1,2,3,1,1,10,14,5,13,16,17,13,15,1,1,20,1,1,1,12,1,12,1,1,1,1,1,87,13,20,18869764,7100,6650,5800,Northern_European,141,33,5,67122.0,Unknown,91011532,2000000.0,1.0,38,700,47,1,1,7,162,2,0.6301931727970362,0.6149732620320855,0.6764705882352942,0.0648054715736761,0.2171052631578947,0.0657894736842105,0.0497624406101525,0.0997749437359339,0.0110836412122558,0.0,0.5348837209302322,0.5833333333333333,529,61,16,63,4,9784,12,69,193,10000000,300000.0,20000000.0,4000000.0,150000.0,900000.0,1,700000,0.0,0.0
93763,Alexander,Schwolow,2024,89,Germany,Wiesbaden,Germany,02-06-92,Goalkeeper,Goalkeeper,Right,190.0,Unknown,feel soccer GmbH,https://img.a.transfermarkt.technology/portrait/header/93763-1726351593.jpg?lm=1,L1,1. FC Union Berlin,700000.0,9000000.0,32,126,136,5,1,2,1,11,7,5,1,3,1,11,2,1,11,11,12,12,13,12,11,12,11,6,12,1,13,12,10,11,14,12,15,12,12,12,12,8,9,11,8,14,13,12,13,12,12,14,14,13,11,14,12,5,12,7,14,9,15,14,17,20,1,1,1,1,1,1,1,1,1,1,1,1,1,84,11,20,2228380,6295,6295,5295,Northern_European,126,0,0,47944.0,FC Schalke 04,91105570,7000000.0,1.0,38,1665,40,2,1,7,0,5,0.5832230748875364,0.5609625668449197,0.5661764705882353,0.0462868636461514,0.0,0.0,0.0032508127031757,0.0447611902975743,0.038862190616406,0.0,0.6279069767441858,0.5833333333333333,0,0,0,0,0,0,7,47,88,700000,17567.567567567567,9000000.0,2000000.0,150000.0,250000.0,6,2725000,0.0,-0.2222222222222222
93844,Leonardo,Bittencourt,2024,86,Germany,Leipzig,Germany,19-12-93,Central Midfield,Midfield,Right,171.0,Unknown,feel soccer GmbH,https://img.a.transfermarkt.technology/portrait/header/93844-1660206490.jpg?lm=1,L1,Sportverein Werder Bremen von 1899,2500000.0,7000000.0,31,130,135,14,14,15,11,13,11,8,11,5,6,12,10,8,13,16,11,14,9,10,12,10,15,15,13,13,7,12,15,15,15,11,6,14,14,11,7,11,9,12,14,17,1,2,1,2,3,1,2,1,1,4,3,9,16,10,12,11,13,11,8,1,1,1,1,1,1,1,20,12,15,20,18,15,10,62,12,20,3546515,6399,6549,5249,Mixed_Race,121,0,0,42281.0,Unknown,92014331,4200000.0,5.0,38,816,40,3,1,4,194,1,0.6168298491664461,0.5560427807486631,0.5294117647058822,0.0408185730687413,0.0,0.0,0.0122530632658164,0.0347586896724181,0.0233062029500819,0.5714285714285714,0.1860465116279068,0.5416666666666665,440,79,50,101,2,5666,34,128,89,2000000,56617.64705882353,7000000.0,2500000.0,2500000.0,6500000.0,6,3000000,-0.2,-0.2
93936,Kike,García,2024,1108,Spain,Motilla de Palancar,Spain,25-11-89,Centre-Forward,Attack,Right,186.0,30-06-25,Joseba Diaz,https://img.a.transfermarkt.technology/portrait/header/93936-1490620015.jpg?lm=1,ES1,Deportivo AlavÃ©s S.A.D.,1000000.0,3000000.0,35,130,136,5,9,12,15,12,7,14,10,7,4,12,10,8,14,10,11,15,14,14,10,9,11,12,11,14,9,16,16,12,11,14,14,15,13,14,16,14,12,12,9,11,3,1,3,1,3,4,1,3,3,1,3,10,11,2,14,12,20,8,6,1,1,1,1,1,1,1,1,1,1,16,1,1,20,79,12,20,1481806,6400,6400,5500,Mediterranean_Hispanic,130,0,0,8662.0,Unknown,67065538,2125000.0,2.0,89,987,89,0,1,3,59,3,0.5971156390579518,0.5828877005347594,0.5955882352941175,0.0083554862027776,0.0,0.0,0.0047511877969492,0.0147536884221055,0.0117781049473596,0.1428571428571428,0.5348837209302322,0.7083333333333333,565,137,26,57,0,5151,10,71,135,900000,20588.235294117647,3000000.0,1000000.0,,0.0,4,2900000,-0.1,-0.4
94005,Sead,Kolasinac,2024,800,Germany,Karlsruhe,Bosnia-Herzegovina,20-06-93,Centre-Back,Defender,Left,183.0,30-06-25,Unknown,https://img.a.transfermarkt.technology/portrait/header/94005-1666815100.jpg?lm=1,IT1,Atalanta Bergamasca Calcio S.p.a.,10000000.0,20000000.0,31,132,144,6,10,11,7,12,6,13,8,13,13,11,8,15,11,17,12,18,10,11,9,11,17,9,9,12,12,15,17,14,13,15,12,18,16,14,17,12,14,14,7,14,2,1,4,1,2,4,1,2,4,1,2,12,16,13,10,15,12,10,10,1,19,16,1,20,1,12,12,10,1,1,1,1,1,82,20,8,6313376,6598,6998,6398,Mediterranean_Hispanic,129,49,0,21155.0,Unknown,92029805,9111392.0,2.0,38,710,10,1,0,3,31,2,0.6762370997618418,0.6789304812834224,0.588235294117647,0.0204189427070307,0.3223684210526316,0.0,0.0497624406101525,0.0997749437359339,0.0505924720131114,0.1428571428571428,0.4651162790697669,0.5416666666666665,484,34,43,84,0,10767,29,171,200,10000000,306250.0,20000000.0,6000000.0,,5000000.0,5,7500000,0.0,0.25
94293,Erik,Marxen,2024,2778,Denmark,Middelfart,Denmark,02-12-90,Centre-Back,Defender,Left,185.0,31-12-25,CMA Group,https://img.a.transfermarkt.technology/portrait/header/default.jpg?lm=1,DK1,Fodbold Club NordsjÃ¦lland,200000.0,500000.0,34,120,121,13,13,5,7,12,10,14,10,12,14,13,8,13,10,16,13,15,13,13,12,13,13,8,16,8,12,8,12,10,10,11,15,14,10,11,13,12,15,12,8,10,2,4,3,2,3,2,3,1,3,2,3,10,4,13,7,7,9,10,10,1,17,20,11,15,10,12,10,10,8,8,1,6,1,80,20,6,347975206,5500,5750,3000,Northern_European,119,0,0,4033.0,Unknown,27014407,150000.0,1.0,28,951,30,1,0,7,87,2,0.5111140513363324,0.3155080213903743,0.5147058823529411,0.003885643878421,0.0,0.0,0.0007501875468867,0.0022505626406601,0.0008055779327203,0.0,0.5116279069767438,0.6666666666666665,430,26,33,60,0,10042,5,26,94,100000,1666.6666666666667,500000.0,100000.0,50000.0,200000.0,5,100000,-0.5,-0.6
94308,Marko,Dmitrovic,2024,1244,Jugoslawien (SFR),Subotica,Serbia,24-01-92,Goalkeeper,Goalkeeper,Left,189.0,30-06-25,IDUB GLOBAL,https://img.a.transfermarkt.technology/portrait/header/94308-1669364494.jpg?lm=1,ES1,Club Deportivo LeganÃ©s S.A.D.,900000.0,12000000.0,32,138,145,3,10,8,5,8,7,9,10,10,8,3,10,8,7,9,13,14,13,15,8,14,12,6,10,9,14,11,12,10,13,12,14,11,11,12,11,15,10,10,7,9,15,14,14,8,14,16,13,15,9,10,15,11,12,8,13,11,12,11,11,20,1,1,1,1,1,1,1,1,1,1,1,1,1,81,20,11,7346698,6900,6800,5400,Northern_European,139,19,0,21487.0,Unknown,62038612,1000000.0,1.0,55,1433,85,2,0,7,54,5,0.6500396930404869,0.5721925133689839,0.6617647058823528,0.0207395276393458,0.125,0.0,0.0042510627656914,0.0597649412353088,0.0055279313314258,0.0,0.6046511627906974,0.5833333333333333,0,0,0,0,0,0,5,29,65,800000,16176.470588235294,12000000.0,2500000.0,250000.0,300000.0,6,3700000,-0.1111111111111111,-0.6
94529,Stephan,El Shaarawy,2024,12,Italy,Savona,Italy,27-10-92,Left Winger,Attack,Right,178.0,30-06-25,Manuel El Shaarawy,https://img.a.transfermarkt.technology/portrait/header/94529-1609843947.jpg?lm=1,IT1,Associazione Sportiva Roma,5000000.0,30000000.0,32,140,152,12,11,14,14,16,11,8,14,4,6,14,12,7,17,9,15,11,12,14,13,14,13,15,5,16,9,11,12,15,15,12,8,10,15,12,10,12,6,11,15,14,2,1,2,3,3,1,4,3,1,2,2,10,15,8,12,9,11,15,15,1,1,1,1,14,10,1,19,1,10,20,15,12,14,72,9,20,6886942,6997,6697,5747,Mediterranean_Hispanic,139,29,6,106922.0,Unknown,43036636,16433333.33,3.0,52,1348,54,0,1,3,29,7,0.6364117491399841,0.6093048128342246,0.6617647058823528,0.1032370387608426,0.1907894736842105,0.0789473684210526,0.0247561890472618,0.1497874468617154,0.0912710538070501,0.2857142857142857,0.3488372093023257,0.5833333333333333,534,127,64,28,0,12221,24,154,112,5000000,119512.19512195123,30000000.0,9000000.0,7000000.0,27000000.0,5,7400000,0.0,0.0
95424,Kyle,Walker,2024,281,England,Sheffield,England,28-05-90,Right-Back,Defender,Right,178.0,30-06-26,CAA Base Ltd,https://img.a.transfermarkt.technology/portrait/header/95424-1668090663.jpg?lm=1,GB1,Manchester City Football Club,13000000.0,50000000.0,34,164,164,8,11,14,7,13,11,13,8,12,14,13,6,13,13,13,16,13,13,13,12,13,16,10,11,13,14,15,16,19,13,13,11,19,18,17,13,18,5,13,7,14,2,2,4,1,3,3,1,1,2,2,1,10,15,7,14,7,13,14,15,5,10,14,20,1,18,1,1,1,5,1,1,5,1,83,10,20,347975206,8200,8500,7500,Mixed_Race,154,68,0,202986.0,Unknown,28009441,29300000.0,2.0,32,1366,33,1,1,4,131,11,0.8749669224662608,0.7967914438502673,0.7720588235294117,0.1959980958027514,0.4473684210526315,0.0,0.0647661915478869,0.2498124531132783,0.1627545209589155,0.1428571428571428,0.3488372093023257,0.6666666666666665,636,12,52,81,1,14468,14,86,109,10000000,284285.71428571426,50000000.0,10000000.0,,2000000.0,2,6000000,-0.23076923076923078,-0.23076923076923078
95641,Darko,Brasanac,2024,1244,Jugoslawien (SFR),?ajetina,Serbia,12-02-92,Central Midfield,Midfield,Right,178.0,30-06-25,Unknown,https://img.a.transfermarkt.technology/portrait/header/95641-1541146477.jpg?lm=1,ES1,Club Deportivo LeganÃ©s S.A.D.,1400000.0,4000000.0,32,135,139,10,11,9,12,13,10,13,11,7,11,13,11,13,13,14,15,16,11,16,13,12,12,11,10,14,14,17,16,13,13,12,12,12,12,15,11,14,8,13,7,14,2,1,1,2,1,2,3,2,2,2,3,11,13,8,9,13,9,10,13,1,1,1,1,1,1,14,1,20,1,12,16,1,1,73,12,20,1848916,6494,5958,4531,Northern_European,134,3,0,9921.0,Unknown,62039552,900000.0,3.0,55,4,85,3,1,7,54,1,0.5386345594072506,0.4792513368983956,0.625,0.0095711983406832,0.0197368421052631,0.0,0.0067516879219804,0.0197549387346836,0.0049723603433428,0.2857142857142857,0.3488372093023257,0.5833333333333333,383,23,29,80,0,7286,13,111,175,1200000,37096.77419354839,4000000.0,2000000.0,250000.0,600000.0,7,2650000,-0.14285714285714285,-0.2
95736,Leandro,Chichizola,2024,130,Argentina,San Justo,Argentina,27-03-90,Goalkeeper,Goalkeeper,Right,185.0,30-06-25,AREA SPORT TEAM,https://img.a.transfermarkt.technology/portrait/header/95736-1712347475.jpg?lm=1,IT1,Parma Calcio 1913,400000.0,1500000.0,34,121,135,6,3,2,1,10,9,4,2,1,3,9,3,3,8,7,12,13,11,12,9,10,13,5,9,3,12,10,11,10,13,11,11,14,10,13,11,12,3,15,8,12,13,14,14,5,15,12,13,16,7,8,12,11,15,5,15,11,16,12,13,20,1,1,1,1,1,1,1,1,1,1,1,1,1,80,6,20,347975206,6044,6044,4744,Mediterranean_Hispanic,119,0,0,11452.0,Unknown,14000746,940000.0,1.0,4,1301,4,2,1,3,155,5,0.5500132310134956,0.5020320855614973,0.5147058823529411,0.0110495583749433,0.0,0.0,0.0017504376094023,0.0072518129532383,0.005194588738576,0.0,0.5116279069767438,0.6666666666666665,0,0,0,0,0,0,3,6,30,400000,10606.060606060606,1500000.0,300000.0,50000.0,50000.0,7,350000,0.0,0.0
95810,Kieran,Trippier,2024,762,England,Bury,England,19-09-90,Right-Back,Defender,Right,173.0,30-06-26,CAA Base Ltd,https://img.a.transfermarkt.technology/portrait/header/95810-1696454076.jpg?lm=1,GB1,Newcastle United Football Club,10000000.0,35000000.0,34,152,153,14,16,12,9,14,16,11,10,11,13,13,5,15,14,12,14,13,15,13,14,14,15,8,16,15,14,16,17,13,13,14,9,16,14,16,12,15,8,11,7,13,3,4,1,1,2,2,1,3,3,3,2,13,12,4,12,13,15,14,14,1,15,1,20,14,19,1,1,1,13,1,1,1,1,72,8,20,347975206,7595,7745,6595,Northern_European,146,37,1,115992.0,Unknown,28018613,13633333.33,3.0,32,281,33,1,1,7,137,11,0.775072770574226,0.7,0.713235294117647,0.1119951873635462,0.2434210526315789,0.0131578947368421,0.0497624406101525,0.1747936984246061,0.0757150661407261,0.2857142857142857,0.2325581395348837,0.6666666666666665,556,14,98,42,1,13384,10,64,78,8000000,233823.5294117647,35000000.0,8000000.0,,250000.0,5,6200000,-0.2,-0.2727272727272727
95976,Alex,Mccarthy,2024,180,England,Guildford,England,03-12-89,Goalkeeper,Goalkeeper,Right,193.0,30-06-26,SBM,https://img.a.transfermarkt.technology/portrait/header/95976-1520416774.jpg?lm=1,GB1,Southampton Football Club,500000.0,6500000.0,35,126,140,3,3,1,2,10,8,5,2,2,3,11,4,2,14,7,13,12,10,10,9,12,15,3,7,2,15,12,11,9,14,12,17,13,9,13,15,11,1,10,9,12,14,13,11,5,14,14,15,14,11,18,11,15,15,5,12,11,16,15,18,20,1,1,1,1,1,1,1,1,1,1,1,1,1,79,9,20,6166941,6300,6300,5250,Northern_European,126,1,0,57996.0,Unknown,8601160,4466666.667,3.0,32,578,33,2,1,7,186,5,0.5838846255623181,0.5561497326203209,0.5661764705882353,0.055993248404076,0.006578947368421,0.0,0.0022505626406601,0.032258064516129,0.0247877255868218,0.2857142857142857,0.6976744186046511,0.7083333333333333,0,0,0,0,0,0,7,107,292,500000,13235.29411764706,6500000.0,1500000.0,,175000.0,6,3450000,0.0,0.0
96254,Pietro,Terracciano,2024,430,Italy,San Felice a Cancello,Italy,08-03-90,Goalkeeper,Goalkeeper,Right,193.0,30-06-26,Unknown,https://img.a.transfermarkt.technology/portrait/header/96254-1595853091.jpg?lm=1,IT1,Associazione Calcio Fiorentina,2500000.0,2500000.0,34,139,145,5,3,2,2,9,9,10,3,2,2,10,5,1,9,4,14,14,14,14,11,10,13,8,12,7,15,14,10,10,12,15,17,13,9,13,14,14,5,12,6,15,14,16,15,8,14,15,15,15,12,14,16,12,12,5,13,12,16,16,13,20,1,1,1,1,1,1,1,1,1,1,1,1,1,78,6,20,347975206,6950,6950,4750,Mediterranean_Hispanic,141,0,0,10769.0,Unknown,43017977,350000.0,2.0,52,1296,54,2,1,3,26,5,0.6698862132839376,0.5026737967914437,0.6764705882352942,0.0103900417822591,0.0,0.0,0.0122530632658164,0.0122530632658164,0.0019167199088863,0.1428571428571428,0.6976744186046511,0.6666666666666665,0,0,0,0,0,0,9,48,76,1500000,45967.74193548387,2500000.0,1000000.0,,,5,250000,-0.4,-0.4
96341,Romelu,Lukaku,2024,6195,Belgium,Antwerpen,Belgium,13-05-93,Centre-Forward,Attack,Left,191.0,30-06-27,TEAM LUKAKU,https://img.a.transfermarkt.technology/portrait/header/96341-1661780981.jpg?lm=1,IT1,SocietÃ  Sportiva Calcio Napoli,30000000.0,100000000.0,31,162,176,4,10,13,18,13,11,15,14,3,5,13,20,10,14,16,14,16,16,13,11,14,18,13,16,15,5,19,12,14,8,20,16,13,17,14,20,17,10,12,7,6,3,3,3,1,4,1,1,1,2,2,4,19,18,8,9,17,17,15,12,1,1,1,1,1,1,1,1,1,1,1,1,1,20,93,20,12,142679281,8150,8982,7984,African_Caribbean,161,102,68,405971.0,FC Internazionale Milano,18007344,58676666.67,6.0,7,74,8,0,0,1,184,3,0.9387404075152156,0.8485561497326203,0.8235294117647058,0.3920039165436309,0.6710526315789473,0.894736842105263,0.1497874468617154,0.4998749687421855,0.3259627582432845,0.7142857142857142,0.6511627906976742,0.5416666666666665,672,318,95,52,1,12437,19,73,58,25000000,585714.2857142857,100000000.0,17000000.0,15000000.0,25000000.0,10,46000000,-0.16666666666666666,-0.2857142857142857
96718,ÃÂScar,De Marcos,2024,621,Spain,Laguardia,Spain,14-04-89,Right-Back,Defender,Right,182.0,30-06-25,Unknown,https://img.a.transfermarkt.technology/portrait/header/96718-1709675357.png?lm=1,ES1,Athletic Club Bilbao,1500000.0,10000000.0,35,128,150,10,12,11,11,10,10,11,12,4,11,12,7,12,12,12,12,15,12,14,11,11,13,12,9,14,14,14,15,12,12,11,10,14,13,14,13,13,5,11,10,20,4,1,1,2,1,1,3,2,1,3,1,11,15,7,12,12,14,11,8,1,11,1,20,11,19,1,12,14,15,12,13,15,10,78,11,20,884024,6400,6400,4900,Mediterranean_Hispanic,120,0,0,9770.0,Unknown,67065930,350000.0,1.0,89,790,89,1,1,3,33,11,0.5971156390579518,0.5187165775401069,0.5220588235294117,0.0094253901335158,0.0,0.0,0.0072518129532383,0.0497624406101525,0.0019167199088863,0.0,0.4418604651162785,0.7083333333333333,581,42,65,95,2,12346,25,91,183,1500000,34210.52631578947,10000000.0,3000000.0,,2000000.0,1,500000,0.0,-0.16666666666666666
97503,Jeppe,Grønning,2024,1063,Unknown,Unknown,Denmark,24-05-91,Defensive Midfield,Midfield,Right,180.0,30-06-26,Nordic Sky,https://img.a.transfermarkt.technology/portrait/header/default.jpg?lm=1,DK1,Viborg Fodsports Forening,350000.0,400000.0,33,120,120,6,6,8,8,10,5,9,9,7,13,13,7,14,8,14,13,15,13,14,12,13,15,9,16,12,14,17,16,11,10,12,11,13,11,14,13,14,9,13,6,11,3,3,2,1,1,2,3,1,2,3,3,8,13,3,15,9,7,12,12,1,1,12,1,1,1,20,1,17,1,1,1,1,1,79,13,20,347975206,5999,5749,1991,Northern_European,120,0,0,2016.0,Unknown,27031794,9111392.0,2.0,105,1549,30,3,1,7,215,4,0.5109817412013761,0.2075935828877005,0.5220588235294117,0.0019379938528804,0.0,0.0,0.0015003750937734,0.0017504376094023,0.0505924720131114,0.1428571428571428,0.3953488372093026,0.625,433,25,19,71,0,6702,0,0,0,250000,7500.0,400000.0,100000.0,25000.0,75000.0,3,75000,-0.2857142857142857,-0.375
98512,Serdar,Gürler,2024,6890,France,Haguenau,TÃ¼rkiye,14-09-91,Left Winger,Attack,Right,175.0,30-06-25,MEK Football,https://img.a.transfermarkt.technology/portrait/header/98512-1695642532.png?lm=1,TR1,?stanbul Ba?ak?ehir Futbol KulÃ¼bÃ¼,600000.0,3500000.0,33,125,130,12,13,14,12,13,13,7,13,5,3,12,11,3,15,7,12,12,12,14,12,10,12,15,10,15,8,12,14,14,15,10,7,14,15,13,8,12,7,12,10,10,2,2,1,3,2,2,3,3,4,2,3,20,12,5,8,7,9,15,10,1,1,1,1,1,1,1,12,1,12,18,1,20,10,65,8,20,2958195,6150,6150,5000,Mediterranean_Hispanic,124,7,0,8019.0,Unknown,34007438,1039600.0,5.0,34,588,100,0,1,3,4,7,0.5640381053188674,0.5294117647058822,0.5514705882352942,0.0077345943007337,0.0460526315789473,0.0,0.0027506876719179,0.0172543135783946,0.0057479374427067,0.5714285714285714,0.2790697674418605,0.625,378,76,63,43,0,8019,30,68,198,500000,8974.358974358975,3500000.0,1000000.0,150000.0,150000.0,12,4950000,-0.375,-0.6666666666666666
99331,Jannik,Vestergaard,2024,1003,Denmark,Hvidovre,Denmark,03-08-92,Centre-Back,Defender,Right,199.0,30-06-27,Unique Sports Group,https://img.a.transfermarkt.technology/portrait/header/99331-1701083132.jpg?lm=1,GB1,Leicester City Football Club,3000000.0,20000000.0,32,134,150,5,6,12,7,9,12,17,11,14,15,14,7,15,13,10,13,15,15,14,13,13,14,6,14,5,12,16,14,7,7,13,19,13,7,12,18,15,6,13,7,6,3,1,2,3,2,2,1,2,3,1,1,13,15,4,11,14,16,15,11,1,1,20,1,1,1,10,1,10,1,1,1,1,5,96,13,20,10792565,6700,6750,5500,Northern_European,134,35,2,86994.0,Unknown,27013431,14900000.0,4.0,28,644,30,1,1,7,127,2,0.6434241862926701,0.5828877005347594,0.625,0.0839942178838111,0.2302631578947368,0.0263157894736842,0.0147536884221055,0.0997749437359339,0.0827522986749631,0.4285714285714285,0.8372093023255816,0.5833333333333333,411,28,5,60,1,6156,17,51,54,3000000,75641.02564102564,20000000.0,4000000.0,250000.0,3500000.0,5,13000000,0.0,-0.14285714285714285
99343,Ander,Herrera,2024,621,Spain,Bilbao,Spain,14-08-89,Central Midfield,Midfield,Right,182.0,30-06-25,AC Talent,https://img.a.transfermarkt.technology/portrait/header/99343-1709675915.png?lm=1,ES1,Athletic Club Bilbao,2000000.0,30000000.0,35,145,156,7,15,9,10,15,7,5,9,3,15,15,14,14,15,17,17,14,13,14,14,13,18,8,15,12,14,16,18,13,15,12,8,16,13,16,11,16,17,17,6,13,3,3,1,2,1,3,1,1,4,2,1,16,17,8,15,13,18,8,14,1,1,1,1,1,1,17,9,20,9,10,14,10,1,71,10,20,7979705,7250,7250,6250,Mediterranean_Hispanic,145,2,0,149589.0,A. Bilbao,67009261,21750000.0,2.0,89,191,89,3,1,3,33,1,0.7095792537708389,0.6631016042780749,0.7058823529411764,0.1444370306496576,0.0131578947368421,0.0,0.0097524381095273,0.1497874468617154,0.1208089113586488,0.1428571428571428,0.4418604651162785,0.7083333333333333,561,43,59,127,5,11757,28,125,59,1500000,12820.51282051282,30000000.0,5000000.0,,6000000.0,4,14000000,-0.25,-0.4
99352,Rubén,Pardo,2024,605,Spain,LogroÃ±o,Spain,22-10-92,Central Midfield,Midfield,Right,182.0,30-06-25,YOU FIRST,https://img.a.transfermarkt.technology/portrait/header/99352-1447314345.jpg?lm=1,GR1,Aris Thessalonikis,900000.0,10000000.0,32,129,136,14,14,13,9,14,16,4,14,2,7,14,12,8,16,8,13,13,14,13,16,12,13,14,10,13,9,14,14,11,12,12,10,12,11,12,10,12,5,12,8,5,3,3,3,2,3,3,1,1,3,3,3,8,14,4,14,12,13,15,16,1,1,1,1,1,1,10,1,20,1,1,10,1,1,69,16,20,2734302,6450,6450,4000,Mediterranean_Hispanic,128,0,0,10582.0,Unknown,67071948,9111392.0,2.0,89,855,89,3,1,3,20,1,0.6037311458057687,0.4224598930481283,0.5808823529411764,0.0102094713535153,0.0,0.0,0.0042510627656914,0.0497624406101525,0.0505924720131114,0.1428571428571428,0.4418604651162785,0.5833333333333333,379,17,50,47,2,3929,14,64,140,700000,-9677.41935483871,10000000.0,5000000.0,,4000000.0,5,5200000,-0.2222222222222222,-0.4166666666666667
99353,Unknown,Portu,2024,12321,Spain,Beniel,Spain,21-05-92,Right Winger,Attack,Right,167.0,30-06-27,Wasserman,https://img.a.transfermarkt.technology/portrait/header/99353-1669365520.jpg?lm=1,ES1,Girona FÃºtbol Club S. A. D.,3500000.0,20000000.0,32,141,154,10,11,13,12,12,12,8,11,8,9,13,8,11,13,16,12,15,12,13,14,11,17,12,13,14,8,15,16,15,12,13,10,14,15,12,14,12,9,13,6,17,3,2,3,3,1,2,2,3,3,2,3,14,10,6,10,11,16,9,13,1,1,1,14,1,13,12,12,18,18,13,14,20,14,71,12,20,13468949,7050,7050,5950,Mediterranean_Hispanic,134,0,0,24633.0,Getafe,67115581,5000000.0,3.0,89,172,89,0,1,3,107,10,0.6831172267795713,0.6310160427807486,0.625,0.0237773595582107,0.0,0.0,0.0172543135783946,0.0997749437359339,0.0277507708547459,0.2857142857142857,0.0930232558139532,0.5833333333333333,537,71,51,107,0,3222,3,14,53,2500000,73333.33333333333,20000000.0,5000000.0,,,4,8000000,-0.2857142857142857,-0.2857142857142857
99922,Marc,Bartra,2024,150,Spain,Sant Jaume dels Domenys,Spain,15-01-91,Centre-Back,Defender,Right,184.0,30-06-25,InterStarDeporte,https://img.a.transfermarkt.technology/portrait/header/99922-1724053472.jpg?lm=1,ES1,Real Betis BalompiÃ© S.A.D.,1000000.0,22000000.0,33,142,152,7,10,12,9,14,7,15,8,12,14,13,9,16,14,15,17,14,17,15,12,13,14,10,12,9,12,11,14,13,13,13,13,12,14,14,11,12,8,13,13,8,3,3,1,2,1,1,2,2,2,2,1,10,12,7,16,13,17,14,12,1,8,20,12,1,8,14,1,1,1,1,1,1,1,73,10,20,347975206,7150,7150,5550,Mediterranean_Hispanic,141,14,1,48075.0,Unknown,67063004,6583333.333,3.0,89,1317,89,1,1,3,164,2,0.696348240275205,0.588235294117647,0.6764705882352942,0.0464133595079986,0.0921052631578947,0.0131578947368421,0.0047511877969492,0.1097774443610902,0.0365473114975415,0.2857142857142857,0.4883720930232553,0.625,442,28,14,74,1,10856,16,78,150,1000000,-12820.51282051282,22000000.0,4500000.0,,2500000.0,5,6700000,0.0,-0.5
100131,William,Carvalho,2024,150,Angola,Luanda,Portugal,07-04-92,Defensive Midfield,Midfield,Right,187.0,30-06-26,PCR Sports,https://img.a.transfermarkt.technology/portrait/header/100131-1662113601.jpg?lm=1,ES1,Real Betis BalompiÃ© S.A.D.,3000000.0,30000000.0,32,152,156,8,9,13,9,15,10,11,9,11,12,15,9,16,14,13,13,14,17,18,15,15,12,9,15,10,17,17,11,10,10,18,14,13,10,16,18,12,8,14,6,6,3,3,1,1,2,1,3,1,2,3,2,14,10,10,8,15,19,16,15,1,1,10,1,1,1,18,1,20,1,1,1,1,1,83,13,20,23154542,7400,7650,6500,African_Caribbean,148,73,5,36638.0,Unknown,55012106,18500000.0,1.0,3,868,79,3,1,1,164,4,0.7625033077533738,0.6898395721925134,0.7279411764705881,0.0353695948366513,0.4802631578947368,0.0657894736842105,0.0147536884221055,0.1497874468617154,0.1027528542459512,0.0,0.5581395348837206,0.5833333333333333,458,25,32,87,2,12069,17,119,231,2000000,45833.333333333336,30000000.0,5000000.0,,700000.0,2,5100000,-0.3333333333333333,-0.6666666666666666
100986,Thomas,Meunier,2024,1082,Belgium,Bastogne,Belgium,12-09-91,Right-Back,Defender,Right,191.0,30-06-26,Thomas Meunier,https://img.a.transfermarkt.technology/portrait/header/100986-1662361426.jpg?lm=1,FR1,Lille Olympique Sporting Club Lille MÃ©tropole,2500000.0,35000000.0,33,134,145,8,15,13,10,11,10,13,12,8,11,11,3,14,13,14,13,15,12,13,13,10,16,12,8,15,10,16,16,13,11,15,14,15,15,15,16,13,8,14,12,14,1,3,2,1,3,1,1,2,1,3,1,11,16,8,15,11,17,14,16,1,1,10,20,1,18,10,8,12,15,8,6,10,10,90,8,20,8776634,6900,7300,6250,Northern_European,128,56,8,191781.0,Unknown,18043393,3100000.0,2.0,7,154,8,1,1,7,128,11,0.7161947605186557,0.6631016042780749,0.5808823529411764,0.1851783543371182,0.3684210526315789,0.1052631578947368,0.0122530632658164,0.1747936984246061,0.0171949220811689,0.1428571428571428,0.6511627906976742,0.625,469,38,60,68,0,15384,31,141,89,2000000,45945.94594594595,35000000.0,6000000.0,,1500000.0,5,6900000,-0.2,-0.2
101118,Unknown,Joel Robles,2024,1465,Spain,Getafe,Spain,17-06-90,Goalkeeper,Goalkeeper,Right,194.0,30-06-26,InterStarDeporte,https://img.a.transfermarkt.technology/portrait/header/101118-1698420821.JPG?lm=1,PO1,Grupo Desportivo Estoril Praia,700000.0,7500000.0,34,124,135,4,3,2,3,9,9,9,1,1,2,10,3,3,10,5,9,10,9,10,12,9,12,2,10,10,11,10,7,10,13,15,14,10,8,10,14,12,2,12,2,12,16,16,12,8,15,15,15,15,12,11,14,12,11,9,13,11,14,15,15,20,1,1,1,1,1,1,1,1,1,1,1,1,1,95,10,20,3844209,6550,6550,5000,Mediterranean_Hispanic,123,0,0,45622.0,Unknown,67037306,2050000.0,2.0,89,536,89,2,1,3,109,5,0.6169621593014025,0.5294117647058822,0.5441176470588236,0.0440447003544781,0.0,0.0,0.0032508127031757,0.0372593148287071,0.0113614267062973,0.1428571428571428,0.7209302325581395,0.6666666666666665,0,0,0,0,0,0,0,0,0,600000,5714.285714285715,7500000.0,2000000.0,,1000000.0,7,1500000,-0.14285714285714285,-0.3333333333333333
102017,Unknown,Jorginho,2024,11,Brazil,Imbituba,Italy,20-12-91,Defensive Midfield,Midfield,Right,178.0,30-06-25,Brezilya Agency,https://img.a.transfermarkt.technology/portrait/header/102017-1682590896.jpg?lm=1,GB1,Arsenal Football Club,12000000.0,65000000.0,33,164,165,11,12,12,8,18,9,7,9,2,10,18,18,14,16,10,16,14,19,15,18,18,15,13,15,15,14,17,17,11,14,14,9,14,12,17,9,15,10,15,8,6,1,3,2,1,1,2,2,3,1,2,2,11,15,7,12,13,17,13,12,1,1,1,1,1,1,20,1,20,1,1,10,1,1,65,9,20,193594995,8199,7749,7249,Mediterranean_Hispanic,158,44,5,127591.0,Unknown,43036641,25933333.33,3.0,10,654,54,3,1,3,21,4,0.7756020111140514,0.7699465240641711,0.8014705882352942,0.123195382031987,0.2894736842105263,0.0657894736842105,0.0597649412353088,0.3248312078019504,0.1440502976749354,0.2857142857142857,0.3488372093023257,0.625,577,49,33,90,0,11211,3,5,8,10000000,275000.0,65000000.0,13000000.0,,1400000.0,3,22000000,-0.16666666666666666,-0.3333333333333333
102226,Thorgan,Hazard,2024,58,Belgium,La LouviÃ¨re,Belgium,29-03-93,Left Winger,Attack,Right,175.0,30-06-26,Unknown,https://img.a.transfermarkt.technology/portrait/header/102226-1699906886.jpg?lm=1,BE1,Royal Sporting Club Anderlecht,5000000.0,45000000.0,31,144,153,15,13,14,12,14,13,7,13,7,8,13,13,8,15,14,11,10,10,13,13,12,13,13,10,13,8,15,15,14,13,10,8,11,14,13,9,13,6,12,16,18,2,2,3,1,3,3,3,2,4,3,1,11,16,8,10,14,16,14,14,1,8,1,5,10,8,8,20,12,18,20,15,18,15,71,14,20,35814998,7400,7600,7000,Northern_European,131,45,9,95825.0,Unknown,85023676,9500000.0,4.0,7,782,8,0,1,7,175,7,0.755887801005557,0.7433155080213903,0.6029411764705883,0.0925215839599384,0.2960526315789473,0.1184210526315789,0.0247561890472618,0.2248062015503876,0.052751465318481,0.4285714285714285,0.2790697674418605,0.5416666666666665,462,92,103,46,0,11538,20,113,255,4000000,106944.44444444444,45000000.0,8000000.0,400000.0,10000000.0,5,5500000,-0.2,-0.3333333333333333
102423,Leandro,Cabrera,2024,714,Uruguay,Montevideo,Uruguay,17-06-91,Centre-Back,Defender,Left,190.0,30-06-26,Unknown,https://img.a.transfermarkt.technology/portrait/header/102423-1500024381.jpg?lm=1,ES1,Reial Club Deportiu Espanyol de Barcelona S.A.D.,1200000.0,10000000.0,33,136,145,4,8,6,4,8,7,13,8,18,15,8,5,15,8,16,12,18,11,16,9,12,18,6,14,8,15,18,18,10,10,9,16,9,14,14,16,17,14,8,11,15,1,1,3,3,3,1,2,1,2,3,1,16,14,4,7,13,17,7,6,1,15,20,1,14,1,1,1,1,1,1,1,1,1,82,20,10,347975206,6700,6250,5300,Mediterranean_Hispanic,134,0,0,14410.0,Unknown,78027200,3700000.0,3.0,106,975,103,1,0,3,170,2,0.5772691188145012,0.5614973262032085,0.625,0.0139058542477986,0.0,0.0,0.0057514378594648,0.0497624406101525,0.0205283480096669,0.2857142857142857,0.6279069767441858,0.625,513,16,13,102,4,5640,10,25,36,1000000,0.0,10000000.0,3000000.0,1000000.0,600000.0,11,5000000,-0.16666666666666666,-0.5
102581,Sergey,Petrov,2024,16704,UdSSR,St. Petersburg,Russia,02-01-91,Right-Back,Defender,Right,175.0,30-06-25,Pavel Andreev,https://img.a.transfermarkt.technology/portrait/header/102581-1721724365.png?lm=1,RU1,FK Krasnodar,500000.0,6000000.0,33,121,132,10,10,10,7,11,7,13,9,11,13,12,3,12,11,11,13,13,12,18,10,13,12,6,10,9,12,18,14,12,13,13,8,15,12,12,9,15,7,3,13,14,1,1,3,2,1,2,1,2,2,3,3,12,10,7,10,13,14,12,19,1,14,1,20,1,1,10,1,8,8,1,1,5,1,74,9,20,2408978,6000,6000,5000,Northern_European,117,5,1,28962.0,Unknown,58039316,760000.0,1.0,101,1413,81,1,1,7,78,11,0.5441915850754168,0.5294117647058822,0.4999999999999999,0.0279575167027646,0.0328947368421052,0.0131578947368421,0.0022505626406601,0.0297574393598399,0.0041945609600266,0.0,0.2790697674418605,0.625,420,19,22,44,2,10180,11,113,332,500000,14062.5,6000000.0,1200000.0,50000.0,100000.0,2,1150000,0.0,-0.16666666666666666
103565,Wahbi,Khazri,2024,969,France,Ajaccio,Tunisia,08-02-91,Left Winger,Attack,Right,176.0,30-06-25,Unknown,https://img.a.transfermarkt.technology/portrait/header/103565-1702663230.JPG?lm=1,FR1,Montpellier HÃ©rault Sport Club,1800000.0,16000000.0,33,133,145,16,14,14,13,14,15,7,13,5,4,13,13,5,15,11,12,12,14,12,14,12,13,14,12,14,7,12,12,13,13,14,9,12,14,13,12,12,11,15,5,12,2,2,4,2,3,1,2,1,2,2,1,6,15,7,16,11,13,16,14,1,1,1,1,1,1,1,1,13,1,18,20,1,15,76,12,20,3649987,6650,6650,5250,North_African__Middle_Eastern,132,69,24,66739.0,Unknown,34011589,6933333.333,3.0,34,29,99,0,1,6,133,7,0.6301931727970362,0.5561497326203209,0.6102941176470589,0.0644356401607945,0.4539473684210526,0.3157894736842105,0.0087521880470117,0.0797699424856214,0.038491809955832,0.2857142857142857,0.3023255813953489,0.625,512,108,62,120,5,6460,21,47,36,1500000,28947.36842105263,16000000.0,4000000.0,600000.0,1000000.0,6,9100000,-0.16666666666666666,-0.4
104124,Michail,Antonio,2024,379,England,London,Jamaica,28-03-90,Centre-Forward,Attack,Right,180.0,30-06-25,Unique Sports Group,https://img.a.transfermarkt.technology/portrait/header/104124-1709884222.jpg?lm=1,GB1,West Ham United Football Club,4000000.0,18000000.0,34,142,148,8,11,14,12,13,6,15,9,15,9,11,10,8,13,13,15,13,13,11,11,12,14,14,9,14,9,15,14,15,14,15,12,13,15,13,16,14,5,13,11,14,3,2,2,3,3,1,4,1,2,2,3,14,14,6,12,13,15,16,16,1,1,1,9,1,14,1,11,1,15,13,1,17,20,82,10,20,26667291,7100,7100,5750,African_Caribbean,139,6,3,81194.0,Unknown,28036815,9111392.0,2.0,32,858,55,0,1,1,220,3,0.6897327335273882,0.6096256684491979,0.6617647058823528,0.0783936377409577,0.0394736842105263,0.0394736842105263,0.0197549387346836,0.0897724431107777,0.0505924720131114,0.1428571428571428,0.3953488372093026,0.6666666666666665,560,131,78,60,0,8107,18,127,133,3000000,98333.33333333333,18000000.0,3000000.0,,200000.0,4,6050000,-0.25,-0.5
104223,Jordy,Clasie,2024,1090,Netherlands,Haarlem,Netherlands,27-06-91,Defensive Midfield,Midfield,Right,169.0,30-06-25,Prime11,https://img.a.transfermarkt.technology/portrait/header/104223-1721657656.jpg?lm=1,NL1,Alkmaar Zaanstreek,2500000.0,11000000.0,33,131,140,9,9,13,6,14,11,7,10,8,12,15,11,13,14,17,14,16,14,15,16,15,16,14,14,13,14,15,15,10,13,14,8,14,10,11,8,17,12,14,9,11,3,3,2,1,3,2,3,1,1,3,2,9,14,6,16,16,14,14,13,1,1,18,1,1,1,20,10,18,10,1,8,1,1,68,10,20,347975206,6399,6399,5249,Northern_European,129,17,0,8151.0,Unknown,37001809,15000000.0,1.0,67,585,68,3,1,7,16,4,0.5969833289229955,0.5560427807486631,0.588235294117647,0.0078620557798469,0.1118421052631578,0.0,0.0122530632658164,0.0547636909227306,0.0833078696630462,0.0,0.13953488372093,0.625,519,25,52,85,2,11457,19,100,123,2000000,55714.28571428572,11000000.0,2500000.0,,3000000.0,5,6150000,-0.2,-0.3333333333333333
104597,Bram,Nuytinck,2024,467,Netherlands,Malden,Netherlands,04-05-90,Centre-Back,Defender,Left,191.0,30-06-26,Wasserman,https://img.a.transfermarkt.technology/portrait/header/104597-1723716327.jpg?lm=1,NL1,Nijmegen Eendracht Combinatie,600000.0,5000000.0,34,128,135,6,7,7,5,14,7,14,5,5,15,12,5,14,11,13,13,14,12,14,11,12,15,11,14,13,14,14,12,12,11,13,15,14,12,14,15,14,12,14,11,8,2,3,1,2,2,3,1,2,4,3,1,15,14,13,12,13,13,14,12,1,10,20,1,1,1,1,1,1,1,1,1,1,1,80,20,6,1153145,6400,6000,5100,Northern_European,128,0,0,21346.0,Unknown,37006661,2375000.0,2.0,67,899,68,1,0,7,138,2,0.5441915850754168,0.5401069518716577,0.5808823529411764,0.0206033756048385,0.0,0.0,0.0027506876719179,0.0247561890472618,0.0131670324175671,0.1428571428571428,0.6511627906976742,0.6666666666666665,451,16,8,55,6,9699,23,81,128,450000,10810.81081081081,5000000.0,2000000.0,,550000.0,4,2700000,-0.25,-0.35714285714285715
104918,Christian,Sørensen,2024,865,Denmark,Odense,Denmark,06-08-92,Left-Back,Defender,Left,179.0,30-06-27,Elite Consulting,https://img.a.transfermarkt.technology/portrait/header/104918-1695238429.jpg?lm=1,DK1,Fodbold Club Midtjylland,500000.0,500000.0,32,122,123,14,15,12,9,12,14,8,14,15,11,13,12,11,13,9,13,10,13,12,12,13,13,12,8,14,11,13,14,13,11,10,10,9,12,13,9,12,10,15,7,13,1,3,3,2,1,3,1,3,1,3,3,10,13,10,10,10,13,13,10,1,20,1,1,17,1,1,12,10,7,14,1,10,1,67,20,13,1203282,6100,5900,1800,Northern_European,119,0,0,7393.0,Unknown,27025520,750000.0,2.0,28,1070,30,1,0,7,86,8,0.530960571579783,0.1871657754010695,0.5147058823529411,0.007130117892212,0.0,0.0,0.0022505626406601,0.0022505626406601,0.0041390038612183,0.1428571428571428,0.3720930232558141,0.5833333333333333,351,43,58,45,0,10492,4,33,77,400000,12500.0,500000.0,100000.0,,200000.0,6,400000,-0.2,-0.2
105470,Unknown,Alisson,2024,31,Brazil,Novo Hamburgo,Brazil,02-10-92,Goalkeeper,Goalkeeper,Right,193.0,30-06-27,Unknown,https://img.a.transfermarkt.technology/portrait/header/105470-1668522221.jpg?lm=1,GB1,Liverpool Football Club,28000000.0,90000000.0,32,177,180,3,3,10,3,15,2,7,3,3,2,14,5,2,14,12,17,14,17,15,11,16,19,13,11,11,18,11,17,13,16,16,13,17,13,12,15,17,5,16,8,1,15,13,14,12,16,15,18,17,16,14,14,16,17,6,14,17,18,15,17,20,1,1,1,1,1,1,1,1,1,1,1,1,1,91,9,20,298419213,8850,8650,8250,Northern_European,176,55,0,220384.0,Unknown,19058734,9111392.0,2.0,10,1059,11,2,1,7,129,5,0.8948134427097116,0.8770053475935828,0.9338235294117648,0.2127979049967797,0.3618421052631578,0.0,0.1397849462365591,0.4498624656164041,0.0505924720131114,0.1428571428571428,0.6976744186046511,0.5833333333333333,0,0,0,0,0,0,15,77,81,25000000,828333.3333333334,90000000.0,18000000.0,,150000.0,3,5150000,-0.10714285714285714,-0.21875
105521,Ciro,Immobile,2024,114,Italy,Torre Annunziata,Italy,20-02-90,Centre-Forward,Attack,Right,185.0,30-06-26,Gea World,https://img.a.transfermarkt.technology/portrait/header/105521-1727355739.png?lm=1,TR1,Be?ikta? Jimnastik KulÃ¼bÃ¼,3800000.0,50000000.0,34,160,165,3,3,12,18,13,3,16,13,3,4,12,17,7,12,14,19,15,14,13,11,14,20,12,15,19,3,16,16,15,14,16,11,20,16,15,13,17,8,11,3,7,2,3,3,3,4,1,3,4,2,2,2,6,19,8,17,12,20,14,12,1,1,1,1,1,1,1,1,1,1,6,10,6,20,85,14,20,347975206,8000,8000,7750,Mediterranean_Hispanic,158,55,15,142499.0,Unknown,43010773,7660000.0,8.0,52,1507,54,0,1,3,37,3,0.808811854988092,0.8235294117647058,0.8014705882352942,0.1375908042336523,0.3618421052631578,0.1973684210526315,0.018754688672168,0.2498124531132783,0.0425289591377538,1.0,0.5116279069767438,0.6666666666666665,622,343,76,93,3,12006,40,104,50,3300000,73255.81395348837,50000000.0,10000000.0,,300000.0,11,7950000,-0.175,-0.67
106405,Jeffrey,Gouweleeuw,2024,167,Netherlands,Heemskerk,Netherlands,10-07-91,Centre-Back,Defender,Right,188.0,30-06-25,SEG,https://img.a.transfermarkt.technology/portrait/header/106405-1723534156.jpg?lm=1,L1,FC Augsburg 1907,2000000.0,12000000.0,33,126,135,7,10,12,8,12,8,12,10,10,13,13,12,14,13,14,14,10,15,11,13,13,12,10,12,8,12,10,13,12,11,15,14,15,14,13,12,13,10,13,5,9,1,1,1,1,1,3,4,2,3,3,1,11,14,10,12,13,11,16,14,1,1,20,10,1,8,12,1,12,1,1,1,1,1,78,10,20,2838964,6400,6150,4750,Northern_European,125,0,0,23077.0,Unknown,37004721,2250000.0,2.0,67,602,68,1,1,7,67,2,0.5640381053188674,0.5026737967914437,0.5588235294117647,0.0222748590923004,0.0,0.0,0.0097524381095273,0.0597649412353088,0.0124725686824634,0.1428571428571428,0.581395348837209,0.625,465,21,21,94,2,7956,11,59,105,1500000,48333.333333333336,12000000.0,2500000.0,,3000000.0,3,200000,-0.25,-0.5
106872,Kevin,Stöger,2024,18,Austria,Steyr,Austria,27-08-93,Attacking Midfield,Midfield,Left,175.0,30-06-27,Unknown,https://img.a.transfermarkt.technology/portrait/header/106872-1722945684.jpg?lm=1,L1,Borussia Verein fÃ¼r LeibesÃ¼bungen 1900 MÃ¶nchengladbach,5000000.0,6000000.0,31,125,136,14,13,12,10,13,14,4,11,3,11,16,9,12,15,16,12,13,15,11,15,13,11,13,4,11,12,12,13,11,12,13,6,13,10,15,9,12,11,13,7,12,1,1,3,1,3,1,2,3,3,3,2,11,12,10,9,12,12,9,10,1,1,1,1,1,1,15,10,20,10,10,16,10,8,74,20,11,2596726,6248,6098,4498,Northern_European,123,0,0,12499.0,Unknown,92012093,1000000.0,1.0,6,1424,7,3,0,7,42,0,0.5571579783011379,0.4757219251336897,0.5441176470588236,0.012060559652455,0.0,0.0,0.0247561890472618,0.0297574393598399,0.0055279313314258,0.0,0.2790697674418605,0.5416666666666665,395,47,78,75,0,5038,8,101,299,4500000,120270.27027027027,6000000.0,2000000.0,400000.0,250000.0,11,5300000,-0.1,0.5
106987,Marcel,Sabitzer,2024,16,Austria,Wels,Austria,17-03-94,Central Midfield,Midfield,Right,178.0,30-06-27,ROGON,https://img.a.transfermarkt.technology/portrait/header/106987-1711745992.jpg?lm=1,L1,Borussia Dortmund,20000000.0,42000000.0,30,148,156,11,12,12,12,13,15,11,16,4,12,14,16,14,13,16,14,15,13,13,14,13,17,13,13,16,14,16,17,12,12,12,9,16,14,16,12,15,12,14,8,19,3,3,2,3,1,3,1,2,2,1,3,13,16,13,7,16,16,8,10,1,10,1,10,10,10,15,10,20,10,12,15,15,10,76,12,20,21613401,7399,7399,6899,Northern_European,146,64,12,191781.0,Unknown,16045721,9087500.0,4.0,6,1653,7,3,1,7,41,1,0.7292934638793331,0.7325133689839571,0.713235294117647,0.1851783543371182,0.4210526315789473,0.1578947368421052,0.0997749437359339,0.2098024506126531,0.0504597349926386,0.4285714285714285,0.3488372093023257,0.5,587,140,91,84,3,14198,36,86,96,15000000,363414.6341463415,42000000.0,10000000.0,1200000.0,2750000.0,6,10500000,-0.25,-0.25
107010,Stefan,Savic,2024,449,Jugoslawien (SFR),Mojkovac,Montenegro,08-01-91,Centre-Back,Defender,Right,187.0,30-06-27,Zarko Pelicic,https://img.a.transfermarkt.technology/portrait/header/107010-1723802375.jpg?lm=1,TR1,Trabzonspor KulÃ¼bÃ¼,2000000.0,40000000.0,33,151,155,7,9,9,9,11,6,14,8,10,16,12,9,14,11,14,17,14,15,15,11,15,15,8,13,8,15,15,15,13,13,10,13,10,14,15,15,14,11,13,13,13,2,3,3,2,3,2,3,2,2,1,1,14,14,7,14,15,14,12,11,1,7,20,13,1,1,1,1,1,1,1,1,1,1,80,10,20,347975206,7550,7550,7050,Mediterranean_Hispanic,151,62,5,86312.0,Unknown,62012567,8100000.0,3.0,55,963,66,1,1,3,204,2,0.7492722942577401,0.748663101604278,0.75,0.0833356669083928,0.4078947368421052,0.0657894736842105,0.0097524381095273,0.1997999499874969,0.044973471485319,0.2857142857142857,0.5581395348837206,0.625,490,10,7,99,4,12426,27,131,113,1300000,28571.428571428572,40000000.0,6500000.0,100000.0,6000000.0,5,9050000,-0.48,-0.74
107612,Daniel,Sundgren,2024,60949,Sweden,Solna,Sweden,22-11-90,Right-Back,Defender,Right,178.0,30-06-25,Jonathan Chalkias,https://img.a.transfermarkt.technology/portrait/header/107612-1548405934.jpg?lm=1,GR1,Volou Neos Podosferikos Syllogos,300000.0,1200000.0,34,120,120,6,13,8,7,11,7,8,8,11,14,12,13,14,10,16,11,13,11,14,9,12,16,7,10,10,13,14,16,13,11,12,8,13,13,15,12,14,12,12,8,15,3,3,1,2,2,4,4,3,1,3,1,10,13,12,16,13,12,9,8,1,10,16,20,10,16,10,1,1,10,1,1,1,1,69,10,20,347975206,6219,6069,4024,Northern_European,118,1,0,8973.0,Unknown,68005637,120000.0,1.0,91,1393,91,1,1,7,218,11,0.5533209843874041,0.4250267379679144,0.5073529411764706,0.0086557931725065,0.006578947368421,0.0,0.0012503125781445,0.0057514378594648,0.0006389066362954,0.0,0.3488372093023257,0.6666666666666665,451,26,39,99,2,10260,6,32,133,250000,6666.666666666667,1200000.0,400000.0,50000.0,,5,650000,-0.16666666666666666,-0.4444444444444444
107775,Frederik,Rönnow,2024,89,Denmark,Horsens,Denmark,04-08-92,Goalkeeper,Goalkeeper,Right,188.0,Unknown,Boutique Transfers,https://img.a.transfermarkt.technology/portrait/header/107775-1692707378.jpg?lm=1,L1,1. FC Union Berlin,4500000.0,5500000.0,32,134,142,4,3,2,3,12,8,1,3,1,2,11,4,2,11,6,14,12,13,15,5,13,12,5,11,2,9,16,10,13,14,12,14,14,10,10,13,13,5,15,8,13,14,11,13,4,13,14,14,15,14,13,14,11,16,3,18,12,12,15,15,20,1,1,1,1,1,1,1,1,1,1,1,1,1,81,7,20,5310741,6695,6245,4995,Northern_European,132,8,0,19230.0,Unknown,27014576,1383333.333,3.0,28,636,30,2,1,7,0,5,0.5766075681397195,0.5288770053475935,0.6102941176470589,0.018560129469963,0.0526315789473684,0.0,0.0222555638909727,0.0272568142035508,0.0076576201172254,0.2857142857142857,0.581395348837209,0.5833333333333333,0,0,0,0,0,0,19,92,372,4000000,136206.89655172414,5500000.0,1000000.0,50000.0,750000.0,4,2200000,-0.1111111111111111,-0.2727272727272727
108354,Jordan,Ayew,2024,1003,France,Marseille,Ghana,11-09-91,Centre-Forward,Attack,Right,182.0,30-06-26,Wasserman,https://img.a.transfermarkt.technology/portrait/header/108354-1668429913.jpg?lm=1,GB1,Leicester City Football Club,4000000.0,10000000.0,33,130,140,5,10,14,10,14,9,11,10,5,11,11,12,14,12,14,13,14,10,12,11,11,17,11,6,14,11,14,18,14,13,13,11,15,13,17,13,12,8,13,7,14,2,3,1,1,1,2,2,3,3,3,1,15,14,8,10,11,14,7,14,1,1,1,1,1,1,1,8,1,15,16,12,20,13,78,8,20,6658690,6500,6500,5750,African_Caribbean,129,81,19,46397.0,Unknown,34010721,6100000.0,5.0,34,919,41,0,1,1,127,3,0.6103466525535857,0.6096256684491979,0.588235294117647,0.0447930537356352,0.5328947368421052,0.25,0.0197549387346836,0.0497624406101525,0.0338620517236589,0.5714285714285714,0.4418604651162785,0.625,553,90,60,80,3,6274,2,2,11,3500000,84210.52631578948,10000000.0,2000000.0,800000.0,4000000.0,8,5000000,-0.125,-0.125
108390,Thibaut,Courtois,2024,418,Belgium,Bree,Belgium,11-05-92,Goalkeeper,Goalkeeper,Left,200.0,30-06-26,Christophe Henrotay,https://img.a.transfermarkt.technology/portrait/header/108390-1717280733.jpg?lm=1,ES1,Real Madrid Club de FÃºtbol,28000000.0,75000000.0,32,181,181,6,1,10,2,10,9,10,1,2,3,13,5,3,12,8,15,15,12,16,9,16,16,14,13,3,16,14,11,12,13,14,18,12,11,8,14,16,5,18,5,15,20,16,14,5,16,16,18,19,12,6,15,14,14,10,15,16,15,14,14,20,1,1,1,1,1,1,1,1,1,1,1,1,1,96,20,9,255605643,9050,8750,8500,Northern_European,178,94,0,296047.0,Unknown,18026122,21975000.0,2.0,7,250,8,2,0,7,167,5,0.9080444562053454,0.9037433155080212,0.9485294117647058,0.2858594041948345,0.6184210526315789,0.0,0.1397849462365591,0.3748437109277319,0.1220589460818356,0.1428571428571428,0.86046511627907,0.5833333333333333,0,0,0,0,0,0,22,111,235,25000000,580232.5581395349,75000000.0,15000000.0,2000000.0,15000000.0,3,2000000,-0.10714285714285714,-0.2857142857142857
108725,Chris,Wood,2024,703,New Zealand,Auckland,New Zealand,07-12-91,Centre-Forward,Attack,Right,191.0,Unknown,CAA Base Ltd,https://img.a.transfermarkt.technology/portrait/header/108725-1674209978.jpg?lm=1,GB1,Nottingham Forest Football Club,7000000.0,18000000.0,33,133,138,3,9,11,14,11,10,15,11,3,7,12,15,9,12,14,14,16,13,13,9,14,15,10,14,12,10,15,15,12,11,16,16,14,13,15,15,14,7,13,9,5,1,2,2,2,3,3,1,2,3,2,3,15,11,5,15,15,16,13,13,1,1,1,1,1,1,1,1,1,1,1,1,1,20,90,11,20,20728888,6650,6900,5500,Pacific_Islander,132,70,33,92793.0,Unknown,5108293,13646000.0,5.0,68,107,69,0,1,8,140,3,0.6632707065361206,0.5828877005347594,0.6102941176470589,0.0895938324093985,0.4605263157894737,0.4342105263157894,0.0347586896724181,0.0897724431107777,0.0757854384844023,0.5714285714285714,0.6511627906976742,0.625,577,200,46,14,0,7631,12,46,96,7000000,214062.5,18000000.0,4000000.0,750000.0,1000000.0,7,14250000,0.0,0.0
109217,Edin,Visca,2024,449,Jugoslawien (SFR),Olovo,Bosnia-Herzegovina,17-02-90,Right Winger,Attack,Right,172.0,30-06-25,SC SPORT,https://img.a.transfermarkt.technology/portrait/header/109217-1723801041.jpg?lm=1,TR1,Trabzonspor KulÃ¼bÃ¼,2200000.0,13000000.0,34,135,140,12,14,13,14,13,11,5,14,7,7,13,12,7,13,14,12,7,13,13,14,13,14,16,12,16,7,12,14,15,15,11,7,17,13,13,7,17,10,14,5,15,1,1,1,2,2,1,4,1,1,3,2,14,14,2,16,12,15,13,16,1,1,1,1,1,1,1,15,10,18,15,12,20,14,63,16,20,347975206,6800,7406,5087,Northern_European,137,55,10,48076.0,Unknown,62027632,2350000.0,2.0,55,1082,10,0,1,7,204,10,0.7302196348240275,0.5387165775401069,0.6470588235294117,0.0464143251252647,0.3618421052631578,0.131578947368421,0.010752688172043,0.0647661915478869,0.0130281396705464,0.1428571428571428,0.2093023255813952,0.6666666666666665,552,143,157,33,1,8223,23,95,76,1800000,46052.63157894737,13000000.0,2500000.0,,300000.0,2,2000000,-0.28,-0.3333333333333333
110695,ÃÂMer Ali,?Ahiner,2024,6890,TÃ¼rkiye,Konya,TÃ¼rkiye,02-01-92,Right-Back,Defender,Right,175.0,30-06-25,GPA Turkey,https://img.a.transfermarkt.technology/portrait/header/110695-1695644115.png?lm=1,TR1,?stanbul Ba?ak?ehir Futbol KulÃ¼bÃ¼,450000.0,5250000.0,32,120,130,10,10,13,10,11,10,7,10,7,9,11,12,11,11,14,11,14,10,13,11,10,13,12,10,12,9,14,14,14,12,12,7,17,14,14,11,14,10,14,12,20,3,2,4,2,3,2,1,2,1,3,3,12,10,10,16,11,14,10,9,1,5,1,20,1,16,4,15,12,16,15,12,15,12,70,12,20,1355205,5999,5749,4011,Mediterranean_Hispanic,109,1,0,5529.0,Unknown,29040332,1000000.0,1.0,100,744,100,1,1,3,4,11,0.5109817412013761,0.4236363636363636,0.4411764705882353,0.0053302073083708,0.006578947368421,0.0,0.0020005001250312,0.0260065016254063,0.0055279313314258,0.0,0.2790697674418605,0.5833333333333333,495,60,39,69,0,8304,32,97,43,400000,2631.5789473684213,5250000.0,1750000.0,,300000.0,2,300000,-0.1111111111111111,-0.42857142857142855
110864,Sam,Johnstone,2024,543,England,Preston,England,25-03-93,Goalkeeper,Goalkeeper,Right,193.0,30-06-28,Unique Sports Group,https://img.a.transfermarkt.technology/portrait/header/110864-1672915792.jpg?lm=1,GB1,Wolverhampton Wanderers Football Club,10000000.0,12000000.0,31,136,140,2,3,2,3,10,1,3,1,1,2,9,2,2,9,9,12,14,9,13,8,12,15,4,10,8,15,12,11,10,15,10,17,12,8,10,11,15,9,11,6,2,14,13,11,9,17,12,14,16,12,15,13,8,14,2,10,8,14,12,12,20,1,1,1,1,1,1,1,1,1,1,1,1,1,85,7,20,20274604,6789,6789,5489,Northern_European,131,3,0,52196.0,Unknown,28037204,9625000.0,2.0,32,1183,33,2,1,7,222,5,0.6485842815559671,0.581711229946524,0.6029411764705883,0.0503926682612226,0.0197368421052631,0.0,0.0497624406101525,0.0597649412353088,0.0534459290535848,0.1428571428571428,0.6976744186046511,0.5416666666666665,0,0,0,0,0,0,4,53,113,8000000,310000.0,12000000.0,4000000.0,,250000.0,8,12750000,-0.2,-0.3333333333333333
110923,Mattia,Perin,2024,506,Italy,Latina,Italy,10-11-92,Goalkeeper,Goalkeeper,Right,188.0,30-06-25,World Soccer Agency,https://img.a.transfermarkt.technology/portrait/header/110923-1695107834.jpg?lm=1,IT1,Juventus Football Club,3000000.0,18000000.0,32,140,150,5,5,5,5,7,5,5,5,5,5,7,5,1,7,10,12,17,11,13,6,12,15,3,12,2,14,10,11,12,15,13,15,8,11,10,11,15,5,9,15,1,13,13,14,17,15,11,15,17,15,9,14,14,14,13,15,13,13,11,14,20,1,1,1,1,1,1,1,1,1,1,1,1,1,74,7,20,6858591,7000,6750,5500,Mediterranean_Hispanic,137,2,0,53462.0,Unknown,43044345,8300000.0,2.0,52,804,54,2,1,3,116,5,0.6434241862926701,0.5828877005347594,0.6470588235294117,0.0516151397199903,0.0131578947368421,0.0,0.0147536884221055,0.0897724431107777,0.046084613461485,0.1428571428571428,0.581395348837209,0.5833333333333333,0,0,0,0,0,0,14,96,217,3000000,72500.0,18000000.0,3000000.0,800000.0,6500000.0,6,11200000,0.0,0.0
111038,Dennis,Appiah,2024,618,France,Toulouse,France,09-06-92,Right-Back,Defender,Right,179.0,30-06-25,TTMA,https://img.a.transfermarkt.technology/portrait/header/111038-1727723257.jpg?lm=1,FR1,Association sportive de Saint-Ã‰tienne Loire,1000000.0,3000000.0,32,121,130,4,13,9,6,12,9,11,7,8,12,13,8,14,12,15,14,13,14,13,10,12,14,10,9,9,10,13,13,14,11,13,11,8,13,14,14,12,11,13,10,14,3,1,2,2,1,2,1,3,2,2,2,13,14,6,14,11,16,15,15,1,13,13,20,13,16,10,1,1,1,1,1,1,1,68,10,20,1298911,6044,6044,4494,African_Caribbean,120,0,0,18397.0,Unknown,85010865,1875000.0,2.0,34,1512,36,1,1,1,25,11,0.5500132310134956,0.4752941176470587,0.5220588235294117,0.0177557702873773,0.0,0.0,0.0047511877969492,0.0147536884221055,0.0103891774771521,0.1428571428571428,0.3720930232558141,0.5833333333333333,407,1,20,41,1,8429,12,131,131,900000,24193.548387096773,3000000.0,1000000.0,150000.0,500000.0,4,1050000,-0.1,-0.1
111051,Nampalys,Mendy,2024,826,France,La Seyne-sur-Mer,Senegal,23-06-92,Defensive Midfield,Midfield,Right,168.0,30-06-25,Unknown,https://img.a.transfermarkt.technology/portrait/header/111051-1547722265.jpg?lm=1,FR1,Racing Club de Lens,2500000.0,12000000.0,32,136,140,8,11,12,8,14,7,8,7,6,13,14,11,15,13,13,15,14,15,13,12,15,13,8,7,8,14,16,16,13,14,14,5,15,12,17,12,14,11,14,9,12,2,3,3,3,2,3,2,2,1,3,3,18,14,6,14,12,14,14,14,1,1,1,1,1,1,20,1,18,1,1,1,1,1,73,8,20,17684528,6799,6799,5249,African_Caribbean,136,17,0,57996.0,Unknown,85010871,15500000.0,1.0,34,786,84,3,1,1,158,4,0.6499073829055305,0.5560427807486631,0.6397058823529411,0.055993248404076,0.1118421052631578,0.0,0.0122530632658164,0.0597649412353088,0.0860857246034612,0.0,0.1162790697674416,0.5833333333333333,369,2,8,51,2,6149,14,81,162,2000000,52857.142857142855,12000000.0,3000000.0,1500000.0,4000000.0,5,11500000,-0.3333333333333333,-0.3333333333333333
111195,Joël,Veltman,2024,1237,Netherlands,Velsen,Netherlands,15-01-92,Right-Back,Defender,Right,184.0,30-06-25,Unknown,https://img.a.transfermarkt.technology/portrait/header/111195-1700650522.jpg?lm=1,GB1,Brighton and Hove Albion Football Club,8000000.0,10000000.0,32,139,142,7,11,10,8,13,4,14,5,9,14,13,7,16,13,17,14,14,14,16,11,14,16,9,15,11,16,14,14,12,12,11,13,16,12,14,12,16,12,13,12,11,2,2,3,3,2,3,2,2,2,2,3,8,9,4,18,15,18,14,16,1,1,20,19,1,14,10,1,1,10,1,1,1,1,73,8,20,24479847,6950,7000,6250,Northern_European,139,28,2,57996.0,Unknown,37024733,1000000.0,1.0,67,1569,68,1,1,7,44,11,0.6765017200317545,0.6631016042780749,0.6617647058823528,0.055993248404076,0.1842105263157894,0.0263157894736842,0.0397599399849962,0.0497624406101525,0.0055279313314258,0.0,0.4883720930232553,0.5833333333333333,452,16,21,74,2,10132,21,160,288,7000000,224193.5483870968,10000000.0,3000000.0,,300000.0,2,3250000,-0.3,-0.3
111196,Stefan,De Vrij,2024,46,Netherlands,Ouderkerk aan den IJssel,Netherlands,05-02-92,Centre-Back,Defender,Right,189.0,30-06-25,Unknown,https://img.a.transfermarkt.technology/portrait/header/111196-1663572651.jpg?lm=1,IT1,Football Club Internazionale Milano S.p.A.,7000000.0,60000000.0,32,151,161,4,8,10,9,13,6,16,8,7,17,14,8,15,14,13,17,15,14,13,12,13,14,12,13,8,14,16,15,12,12,14,15,16,12,15,15,12,10,13,9,9,3,3,3,3,1,1,2,3,2,3,3,16,16,2,12,14,16,14,16,1,1,20,8,1,1,1,1,1,1,1,1,1,1,78,10,20,14895474,7550,7500,6750,Northern_European,149,57,3,135384.0,Unknown,37001814,7000000.0,1.0,67,1101,68,1,1,7,89,2,0.7426567875099233,0.7165775401069518,0.7352941176470587,0.1307204373859968,0.375,0.0394736842105263,0.0347586896724181,0.2998249562390597,0.038862190616406,0.0,0.6046511627906974,0.5833333333333333,538,28,16,53,0,9414,32,188,298,7000000,182894.73684210525,60000000.0,12000000.0,1000000.0,5000000.0,2,9000000,0.0,-0.125
111266,Anthony,Losilla,2024,80,France,Firminy,France,10-03-86,Defensive Midfield,Midfield,Right,185.0,30-06-25,Soccertalk GmbH,https://img.a.transfermarkt.technology/portrait/header/111266-1657283817.jpg?lm=1,L1,Verein fÃ¼r LeibesÃ¼bungen Bochum 1848 FuÃŸballgemeinschaft,500000.0,900000.0,38,123,125,4,8,11,6,11,7,15,8,5,13,12,8,13,12,16,13,15,12,15,12,12,17,9,17,9,14,16,13,11,11,14,13,18,12,16,14,15,12,14,2,9,3,2,2,2,3,2,2,3,2,3,1,16,13,6,15,13,18,16,16,1,1,14,1,1,1,20,1,20,1,1,1,1,1,80,12,20,168657,6143,5943,4843,Northern_European,122,0,0,6904.0,Unknown,8434242,9111392.0,2.0,34,493,36,3,1,7,212,4,0.5366499073829055,0.5126203208556149,0.536764705882353,0.0066579310491335,0.0,0.0,0.0022505626406601,0.0042510627656914,0.0505924720131114,0.1428571428571428,0.5116279069767438,0.8333333333333333,650,38,27,129,4,3550,5,7,30,500000,9677.41935483871,900000.0,250000.0,,,2,300000,0.0,0.0
111275,Philipp,Max,2024,265,Germany,Viersen,Germany,30-09-93,Left-Back,Defender,Left,177.0,30-06-27,Sports360 GmbH,https://img.a.transfermarkt.technology/portrait/header/111275-1696508798.jpg?lm=1,GR1,Panathinaikos Athlitikos Omilos,1800000.0,20000000.0,31,140,147,13,16,12,9,13,14,8,9,14,10,13,15,12,12,13,10,14,12,11,13,12,15,12,10,11,10,15,15,15,12,14,9,15,15,15,11,12,10,15,5,15,3,2,1,3,3,3,3,1,1,2,2,10,18,6,10,11,17,13,13,1,20,1,12,20,12,8,15,8,10,15,1,10,1,77,20,10,17040376,7000,7000,5750,Northern_European,128,3,0,22998.0,Unknown,91100531,3510000.0,5.0,38,1586,40,1,0,7,150,8,0.6765017200317545,0.6096256684491979,0.5808823529411764,0.0221985753282857,0.0197368421052631,0.0,0.0087521880470117,0.0997749437359339,0.0194727631323092,0.5714285714285714,0.3255813953488373,0.5416666666666665,480,47,80,44,1,7241,17,35,42,1500000,38815.78947368421,20000000.0,4000000.0,25000.0,200000.0,5,4850000,-0.25,-0.25
111455,Granit,Xhaka,2024,15,Switzerland,Basel,Switzerland,27-09-92,Defensive Midfield,Midfield,Left,186.0,30-06-28,Signature - ISCM AG,https://img.a.transfermarkt.technology/portrait/header/111455-1689711080.jpg?lm=1,L1,Bayer 04 Leverkusen FuÃŸball,20000000.0,50000000.0,32,142,160,11,13,12,9,16,15,12,17,6,10,18,10,11,17,17,13,15,10,9,17,13,13,13,13,13,10,15,14,10,9,13,13,14,12,15,16,11,17,10,7,10,2,3,1,2,2,1,1,3,1,2,3,13,14,15,12,10,11,10,5,1,13,10,1,1,1,18,1,20,1,1,8,1,1,82,20,10,87489801,7245,7749,6396,Mediterranean_Hispanic,140,104,12,127591.0,Unknown,98003821,22833333.33,3.0,92,152,92,3,0,3,36,4,0.7756020111140514,0.678716577540107,0.6691176470588234,0.123195382031987,0.6842105263157894,0.1578947368421052,0.0997749437359339,0.2498124531132783,0.1268275970443623,0.2857142857142857,0.5348837209302322,0.5833333333333333,635,55,52,146,7,14047,19,68,70,17000000,446052.63157894736,50000000.0,10000000.0,1500000.0,7500000.0,3,500000,-0.15,-0.15
111508,Allan,Nyom,2024,3709,France,Neuilly-sur-Seine,Cameroon,10-05-88,Right-Back,Defender,Right,189.0,30-06-25,JV SPORTS ,https://img.a.transfermarkt.technology/portrait/header/111508-1541162382.jpg?lm=1,ES1,Getafe Club de FÃºtbol S.A.D. Team Dubai,500000.0,5000000.0,36,130,140,5,11,11,6,11,5,12,6,12,13,11,7,15,12,15,14,16,13,13,10,12,16,10,9,14,13,16,15,13,11,10,14,15,13,15,16,13,13,15,5,15,4,3,2,1,3,2,1,4,3,2,1,14,14,12,15,14,16,12,13,1,14,14,20,11,19,1,1,1,18,1,1,12,1,80,7,20,488861,6500,6000,5750,African_Caribbean,126,18,0,11299.0,Unknown,34009070,3850000.0,2.0,34,1029,15,1,1,1,105,11,0.5441915850754168,0.6096256684491979,0.5661764705882353,0.0109018189332439,0.1184210526315789,0.0,0.0022505626406601,0.0247561890472618,0.0213617044917914,0.1428571428571428,0.6046511627906974,0.75,568,9,18,154,4,4874,0,0,0,400000,8974.358974358975,5000000.0,1000000.0,,,7,3600000,-0.2,-0.5
111630,Erik,Lamela,2024,2441,Argentina,Carapachay,Argentina,04-03-92,Right Winger,Attack,Left,184.0,30-06-27,Interplayers,https://img.a.transfermarkt.technology/portrait/header/111630-1728416030.png?lm=1,GR1,Athlitiki Enosi Konstantinoupoleos,1800000.0,30000000.0,32,148,155,13,14,15,11,14,14,9,14,4,9,15,14,13,16,16,14,12,17,12,16,12,17,17,5,14,9,16,19,13,16,13,9,10,13,14,12,9,15,12,16,15,3,1,1,3,1,1,2,2,1,2,3,4,12,7,11,11,14,8,9,1,1,1,1,1,1,1,13,1,12,18,19,20,13,80,20,9,50625001,7250,7000,6250,Mediterranean_Hispanic,148,25,3,59999.0,Unknown,14005628,23500000.0,2.0,4,316,4,0,0,3,34,10,0.6765017200317545,0.6631016042780749,0.7279411764705881,0.0579273797878925,0.1644736842105263,0.0394736842105263,0.0087521880470117,0.1497874468617154,0.1305314036501014,0.1428571428571428,0.4883720930232553,0.5833333333333333,475,82,74,92,2,12616,20,212,389,1500000,33333.333333333336,30000000.0,6000000.0,4000000.0,22000000.0,4,18700000,-0.25,-0.7
111819,Unknown,Neto,2024,11,Brazil,AraxÃ¡,Brazil,19-07-89,Goalkeeper,Goalkeeper,Right,190.0,30-06-25,Bertolucci Sports,https://img.a.transfermarkt.technology/portrait/header/111819-1725051877.jpg?lm=1,GB1,Arsenal Football Club,2500000.0,18000000.0,35,150,156,5,3,3,3,10,8,6,1,2,2,11,5,1,9,7,16,12,16,15,11,13,15,6,12,3,16,12,13,12,16,15,15,14,13,14,15,12,7,14,6,13,13,14,14,8,13,10,15,17,14,13,12,14,14,8,11,16,14,13,13,20,1,1,1,1,1,1,1,1,1,1,1,1,1,84,7,20,26792223,7500,7250,6750,Northern_European,149,1,0,115992.0,Unknown,19030933,12166666.67,3.0,10,81,11,2,1,7,21,5,0.7095792537708389,0.7165775401069518,0.7352941176470587,0.1119951873635462,0.006578947368421,0.0,0.0122530632658164,0.0897724431107777,0.0675666916858801,0.2857142857142857,0.6279069767441858,0.7083333333333333,0,0,0,0,0,0,10,37,59,2000000,50000.0,18000000.0,4500000.0,,750000.0,6,7200000,-0.2,-0.2
111873,Emiliano,Martínez,2024,405,Argentina,Mar del Plata,Argentina,02-09-92,Goalkeeper,Goalkeeper,Right,195.0,30-06-29,Universal Twenty Two,https://img.a.transfermarkt.technology/portrait/header/111873-1668180824.jpg?lm=1,GB1,Aston Villa Football Club,28000000.0,35000000.0,32,149,155,1,1,3,3,11,1,5,1,1,2,12,4,2,11,7,13,12,12,14,7,13,14,8,13,11,13,12,13,10,16,13,15,13,10,12,12,14,7,14,6,2,15,14,12,10,16,14,14,18,14,10,11,14,13,5,15,15,15,9,14,20,1,1,1,1,1,1,1,1,1,1,1,1,1,85,10,20,39770086,7539,7739,6489,Mediterranean_Hispanic,146,17,0,115992.0,Unknown,14020367,9450000.0,2.0,4,908,4,2,1,3,30,5,0.774278909764488,0.688663101604278,0.713235294117647,0.1119951873635462,0.1118421052631578,0.0,0.1397849462365591,0.1747936984246061,0.0524736798244395,0.1428571428571428,0.7441860465116279,0.5833333333333333,0,0,0,0,0,0,2,2,10,25000000,882142.8571428572,35000000.0,4000000.0,,,6,4900000,-0.10714285714285714,-0.10714285714285714
111961,Unknown,Suso,2024,368,Spain,CÃ¡diz,Spain,19-11-93,Right Winger,Attack,Left,177.0,30-06-25,Promoesport,https://img.a.transfermarkt.technology/portrait/header/111961-1455551677.jpg?lm=1,ES1,Sevilla FÃºtbol Club S.A.D.,4000000.0,50000000.0,31,145,155,14,15,16,13,16,15,6,16,9,7,15,14,7,17,12,16,11,12,9,15,11,14,15,11,16,10,13,12,15,15,12,8,13,14,12,8,10,8,14,8,6,1,1,1,1,1,1,1,2,1,2,1,17,14,7,13,12,11,13,11,1,1,1,1,1,1,1,9,12,16,14,16,20,12,70,20,10,25400963,7250,7250,6000,Mediterranean_Hispanic,144,5,0,34215.0,Unknown,67085965,7686666.667,3.0,89,399,89,0,0,3,181,10,0.7095792537708389,0.6363636363636364,0.6985294117647058,0.033029904201111,0.0328947368421052,0.0,0.0197549387346836,0.2498124531132783,0.0426771114030945,0.2857142857142857,0.3255813953488373,0.5416666666666665,435,54,77,46,6,7718,14,93,131,2500000,26315.78947368421,50000000.0,8000000.0,1500000.0,6000000.0,6,12400000,-0.375,-0.5
112052,Bruno,Martins Indi,2024,1090,Portugal,Barreiro,Netherlands,08-02-92,Centre-Back,Defender,Left,185.0,30-06-25,Juzzt Football,https://img.a.transfermarkt.technology/portrait/header/112052-1629443870.jpg?lm=1,NL1,Alkmaar Zaanstreek,1000000.0,11500000.0,32,127,142,8,10,10,6,13,8,12,6,10,12,13,8,13,12,13,12,15,15,13,13,13,14,7,15,8,13,14,14,10,9,15,14,13,12,15,16,14,11,12,6,12,1,1,1,1,3,3,2,1,1,2,1,15,12,5,12,9,13,15,12,1,17,20,1,1,1,1,1,1,1,1,1,1,1,80,20,11,5994200,6250,6250,5500,African_Caribbean,126,36,2,8151.0,Unknown,37001836,7700000.0,2.0,76,150,68,1,0,1,16,2,0.5772691188145012,0.5828877005347594,0.5661764705882353,0.0078620557798469,0.2368421052631578,0.0263157894736842,0.0047511877969492,0.0572643160790197,0.042751187532987,0.1428571428571428,0.5116279069767438,0.5833333333333333,453,15,11,57,4,9794,19,115,357,800000,19117.647058823528,11500000.0,2000000.0,250000.0,4500000.0,3,2000000,-0.2,-0.6
112302,Roberto,Pereyra,2024,2441,Argentina,San Miguel de TucumÃ¡n,Argentina,07-01-91,Central Midfield,Midfield,Right,182.0,30-06-26,All In Sports,https://img.a.transfermarkt.technology/portrait/header/112302-1728415731.png?lm=1,GR1,Athlitiki Enosi Konstantinoupoleos,1800000.0,17000000.0,33,142,150,13,14,14,12,14,13,6,12,3,8,15,14,9,15,11,14,10,14,10,15,14,15,14,8,14,8,15,15,12,14,13,8,13,12,12,12,13,10,15,13,16,2,3,3,1,3,3,4,3,3,3,1,15,15,7,9,14,12,13,11,1,1,1,12,3,19,1,12,20,17,13,19,13,1,77,12,20,5489584,7100,6750,5500,Mediterranean_Hispanic,132,19,2,24615.0,Unknown,14021900,10166666.67,3.0,4,1304,4,3,1,3,34,1,0.6434241862926701,0.5828877005347594,0.6102941176470589,0.0237599784474226,0.125,0.0263157894736842,0.0087521880470117,0.0847711927981995,0.0564552719242201,0.2857142857142857,0.4418604651162785,0.625,481,51,54,69,3,6541,17,100,169,1500000,39864.86486486487,17000000.0,3000000.0,25000.0,1700000.0,5,5200000,-0.25,-0.5
112465,Sérgio,Oliveira,2024,683,Portugal,PaÃ§os de BrandÃ£o,Portugal,02-06-92,Central Midfield,Midfield,Right,181.0,30-06-26,Unknown,https://img.a.transfermarkt.technology/portrait/header/112465-1728417851.png?lm=1,GR1,Olympiakos Syndesmos Filathlon Peiraios,2500000.0,19000000.0,32,140,150,16,14,13,12,14,17,8,17,7,11,15,16,14,14,13,14,15,16,15,15,15,15,11,15,13,13,16,14,9,11,12,11,15,9,13,12,15,14,16,7,12,1,3,3,2,1,1,1,1,1,2,1,14,14,9,16,13,14,11,11,1,1,1,1,1,1,18,1,20,6,1,10,1,1,74,12,20,8586985,7250,6900,6050,Mediterranean_Hispanic,142,13,0,88141.0,Unknown,55012099,2000000.0,2.0,76,1130,79,3,1,3,141,1,0.6632707065361206,0.641711229946524,0.6838235294117647,0.0851017808879237,0.0855263157894736,0.0,0.0122530632658164,0.0947736934233558,0.0110836412122558,0.1428571428571428,0.418604651162791,0.5833333333333333,424,69,38,92,0,12543,12,51,67,2000000,47222.22222222222,19000000.0,5500000.0,300000.0,600000.0,11,16400000,-0.2,-0.6
112515,Marcos,Alonso,2024,940,Spain,Madrid,Spain,28-12-90,Left-Back,Defender,Left,188.0,30-06-25,LIAN Sports Group,https://img.a.transfermarkt.technology/portrait/header/112515-1694505734.jpg?lm=1,ES1,Real Club Celta de Vigo S. A. D.,2000000.0,45000000.0,33,144,151,14,13,12,14,14,15,16,14,12,13,14,12,14,14,12,14,12,14,12,13,14,13,12,9,15,13,14,15,12,10,15,13,14,12,16,15,14,9,13,7,13,2,2,2,1,1,2,3,4,3,3,3,13,14,10,12,13,14,13,12,1,18,12,1,20,1,1,19,1,1,1,1,1,1,87,20,9,7352534,7200,7250,6500,Mediterranean_Hispanic,143,9,0,115992.0,Unknown,67080310,12700000.0,2.0,89,892,89,1,0,3,165,8,0.7095792537708389,0.6898395721925134,0.6911764705882353,0.1119951873635462,0.0592105263157894,0.0,0.0097524381095273,0.2248062015503876,0.0705297369371371,0.1428571428571428,0.581395348837209,0.625,478,46,30,89,1,13346,12,87,112,1800000,7317.073170731707,45000000.0,8000000.0,,2000000.0,6,8700000,-0.1,-0.4
112541,Andrey,Lunev,2024,121,UdSSR,Moskau,Russia,13-11-91,Goalkeeper,Goalkeeper,Right,190.0,30-06-26,Unknown,https://img.a.transfermarkt.technology/portrait/header/112541-1721727463.png?lm=1,RU1,FK Dinamo Moskva,1500000.0,10500000.0,33,130,134,5,1,3,2,5,6,2,2,2,1,12,2,1,8,10,15,13,14,14,12,13,16,3,10,2,12,12,12,9,12,13,15,12,11,11,12,12,8,13,9,12,12,14,11,10,13,14,13,16,13,13,12,14,9,6,9,12,8,16,12,20,1,1,1,1,1,1,1,1,1,1,1,1,1,82,7,20,1588364,6250,6500,4750,Northern_European,127,7,0,19177.0,Unknown,58051185,3500000.0,1.0,101,985,81,2,1,7,74,5,0.6103466525535857,0.5026737967914437,0.5735294117647058,0.0185089517548645,0.0460526315789473,0.0,0.0072518129532383,0.0522630657664416,0.0194172060335009,0.0,0.6279069767441858,0.625,0,0,0,0,0,0,16,95,118,1500000,52678.57142857143,10500000.0,2000000.0,25000.0,25000.0,5,3200000,0.5,0.5
112930,Benito,Raman,2024,354,Belgium,Gent,Belgium,07-11-94,Centre-Forward,Attack,Right,172.0,30-06-26,Quadrans,https://img.a.transfermarkt.technology/portrait/header/112930-1693899816.jpg?lm=1,BE1,Yellow-Red Koninklijke Voetbalclub Mechelen,1300000.0,12000000.0,30,124,135,8,9,14,11,11,10,8,13,5,7,11,11,7,12,15,10,14,11,11,10,8,15,14,8,17,7,10,16,16,12,8,8,14,16,14,8,10,6,13,10,15,4,3,2,3,2,3,1,2,1,3,1,9,15,19,10,10,6,13,8,1,1,1,10,1,12,1,14,10,14,17,10,17,20,67,8,20,1517129,5791,6041,5125,Northern_European,107,1,0,14999.0,Unknown,18044169,3825000.0,4.0,7,532,8,0,1,7,223,3,0.5496163006086267,0.5427807486631016,0.4264705882352941,0.014474602817478,0.006578947368421,0.0,0.0062515628907226,0.0597649412353088,0.0212228117447706,0.4285714285714285,0.2093023255813952,0.5,393,97,35,49,1,8452,16,27,28,1300000,31818.18181818182,12000000.0,2000000.0,1000000.0,3000000.0,11,5800000,0.0,-0.13333333333333333
112948,Jakub,Brabec,2024,605,CSSR,Praha,Czech Republic,06-08-92,Centre-Back,Defender,Right,186.0,30-06-26,CHOVANECSPORT,https://img.a.transfermarkt.technology/portrait/header/112948-1487769697.jpg?lm=1,GR1,Aris Thessalonikis,1500000.0,3000000.0,32,125,130,5,8,11,8,13,9,14,7,6,14,13,12,13,10,10,12,11,10,13,9,13,12,9,12,11,14,14,11,12,10,14,14,15,13,12,15,14,6,12,3,6,2,2,2,3,1,3,2,1,1,1,2,13,14,6,13,10,14,15,16,1,1,20,1,1,1,1,1,1,1,1,1,1,1,77,8,20,3675373,6250,6250,4500,Northern_European,125,30,2,7829.0,Unknown,5652198,2500000.0,1.0,14,1180,28,1,1,7,20,2,0.5772691188145012,0.4759358288770053,0.5588235294117647,0.007551127020192,0.1973684210526315,0.0263157894736842,0.0072518129532383,0.0147536884221055,0.0138614961526709,0.0,0.5348837209302322,0.5833333333333333,462,23,5,65,0,14214,3,16,44,1200000,30303.030303030304,3000000.0,600000.0,,700000.0,4,400000,-0.3333333333333333,-0.4
113045,Rubén,Pérez,2024,265,Spain,Ã‰cija,Spain,26-04-89,Defensive Midfield,Midfield,Right,178.0,30-06-25,Promoesport,https://img.a.transfermarkt.technology/portrait/header/113045-1660812687.jpg?lm=1,GR1,Panathinaikos Athlitikos Omilos,500000.0,7500000.0,35,130,140,8,12,10,8,14,7,8,12,7,14,14,10,13,12,17,12,14,14,13,13,15,16,9,15,9,13,17,16,10,12,13,11,14,11,14,14,15,15,13,6,6,3,2,1,3,3,2,3,4,2,1,3,15,14,7,13,14,15,6,9,1,1,1,1,1,1,20,1,16,1,1,1,1,1,73,9,20,1161685,6250,6500,3020,Mediterranean_Hispanic,130,0,0,11827.0,Unknown,67037324,9111392.0,2.0,89,1721,89,3,1,3,150,4,0.6103466525535857,0.3176470588235294,0.5955882352941175,0.0114116648496968,0.0,0.0,0.0022505626406601,0.0372593148287071,0.0505924720131114,0.1428571428571428,0.3488372093023257,0.7083333333333333,500,4,9,174,5,6887,4,14,53,350000,-21794.871794871793,7500000.0,2500000.0,,,9,2500000,-0.4166666666666667,-0.5625
113707,Rémy,Cabella,2024,1082,France,Ajaccio,France,08-03-90,Attacking Midfield,Midfield,Right,172.0,30-06-25,TTMA,https://img.a.transfermarkt.technology/portrait/header/113707-1666690101.jpg?lm=1,FR1,Lille Olympique Sporting Club Lille MÃ©tropole,3500000.0,14000000.0,34,136,145,14,13,15,15,15,12,9,12,5,7,15,14,10,15,10,13,12,14,12,15,14,14,15,12,14,7,9,12,14,15,12,6,15,14,13,7,16,10,13,6,12,1,2,3,3,1,1,1,2,3,3,2,7,15,5,15,12,14,12,15,1,1,1,1,1,1,1,11,16,12,15,20,17,10,66,10,20,4571484,6800,6550,5500,Mediterranean_Hispanic,137,4,0,26270.0,Unknown,34008670,9000000.0,4.0,34,29,36,3,1,3,128,0,0.6169621593014025,0.5828877005347594,0.6470588235294117,0.0253580750226678,0.0263157894736842,0.0,0.0172543135783946,0.0697674418604651,0.049973610378066,0.4285714285714285,0.2093023255813952,0.6666666666666665,488,91,71,55,1,8115,10,96,214,3000000,77631.57894736843,14000000.0,3000000.0,,300000.0,8,7150000,-0.14285714285714285,-0.25
115333,Unknown,Juanpe,2024,12321,Spain,Las Palmas de Gran Canaria,Spain,30-04-91,Centre-Back,Defender,Right,190.0,30-06-25,DRL,https://img.a.transfermarkt.technology/portrait/header/115333-1510233713.jpg?lm=1,ES1,Girona FÃºtbol Club S. A. D.,1000000.0,7500000.0,33,130,135,6,6,8,4,12,6,15,7,8,15,13,5,15,12,11,14,13,13,14,11,14,12,9,11,8,14,14,14,11,8,7,15,14,13,13,14,13,7,11,8,10,4,3,3,4,3,1,2,1,3,2,3,12,10,9,12,8,14,15,15,1,1,20,4,1,1,15,1,1,1,1,1,1,1,80,10,20,1784183,6400,6400,3510,Mediterranean_Hispanic,130,0,0,4245.0,Unknown,67072242,9111392.0,2.0,89,803,89,1,1,3,107,2,0.5971156390579518,0.3700534759358288,0.5955882352941175,0.004090354738815,0.0,0.0,0.0047511877969492,0.0372593148287071,0.0505924720131114,0.1428571428571428,0.6279069767441858,0.625,410,22,10,105,0,6366,5,35,107,900000,23529.41176470588,7500000.0,2500000.0,,400000.0,4,600000,-0.1,-0.25
115763,Koray,Günter,2024,1467,Germany,HÃ¶xter,Germany,16-08-94,Centre-Back,Defender,Right,185.0,30-06-25,EMG Mundial,https://img.a.transfermarkt.technology/portrait/header/115763-1727796170.png?lm=1,TR1,GÃ¶ztepe Sportif Yat?r?mlar A.?.,850000.0,5000000.0,30,129,136,4,7,8,6,11,4,14,5,7,15,11,5,16,10,14,12,16,11,12,9,12,13,7,14,5,14,15,13,12,12,13,13,14,11,14,15,13,14,12,7,8,1,3,3,3,2,3,3,1,3,3,1,11,14,5,15,7,15,14,15,1,1,20,11,1,1,1,1,1,1,1,1,1,1,79,11,20,3170192,6450,6300,5100,Mediterranean_Hispanic,127,0,0,28817.0,Unknown,92023404,2450000.0,2.0,38,646,40,1,1,3,110,2,0.5838846255623181,0.5401069518716577,0.5735294117647058,0.0278175021991933,0.0,0.0,0.0040010002500625,0.0247561890472618,0.0135837106586294,0.1428571428571428,0.5116279069767438,0.5,304,7,4,41,2,8761,20,132,251,700000,12500.0,5000000.0,1300000.0,500000.0,2600000.0,7,4700000,-0.17647058823529413,-0.4166666666666667
116088,Marius,Bülter,2024,533,Germany,IbbenbÃ¼ren,Germany,29-03-93,Left Winger,Attack,Right,188.0,30-06-26,TPWE GmbH,https://img.a.transfermarkt.technology/portrait/header/116088-1691269482.jpg?lm=1,L1,TSG 1899 Hoffenheim FuÃŸball-Spielbetriebs GmbH,2500000.0,3000000.0,31,128,130,5,8,13,13,11,5,12,11,4,7,12,13,7,12,14,13,13,12,11,13,11,16,12,8,15,7,12,14,12,11,12,13,13,15,12,12,12,7,14,10,14,1,2,3,2,3,1,1,2,4,3,3,8,11,5,12,13,10,15,13,1,1,1,10,10,12,1,15,1,12,18,17,15,20,85,14,20,2048677,6397,6397,4897,Northern_European,121,0,0,25889.0,Unknown,91143947,1766666.667,3.0,38,649,40,0,1,7,199,7,0.5967187086530829,0.5183957219251336,0.5294117647058822,0.0249901748443183,0.0,0.0,0.0122530632658164,0.0147536884221055,0.0097873089085807,0.2857142857142857,0.581395348837209,0.5416666666666665,398,97,62,37,0,3697,7,19,59,2500000,90740.74074074074,3000000.0,800000.0,,,4,700000,0.0,-0.16666666666666666
116471,Hobie,Verhulst,2024,1090,Netherlands,Amsterdam,Netherlands,02-04-93,Goalkeeper,Goalkeeper,Left,192.0,30-06-25,SEG,https://img.a.transfermarkt.technology/portrait/header/116471-1629443631.jpg?lm=1,NL1,Alkmaar Zaanstreek,400000.0,650000.0,31,128,128,4,3,3,3,6,6,4,1,2,1,13,4,3,10,6,12,12,13,15,11,13,13,5,14,2,13,12,15,14,12,9,13,6,16,10,16,12,6,12,8,13,11,12,15,12,12,15,12,14,13,8,12,17,10,8,8,13,9,10,19,20,1,1,1,1,1,1,1,1,1,1,1,1,1,94,20,5,3348150,6150,6150,3750,Northern_European,133,0,0,1726.0,Unknown,37017522,9111392.0,2.0,67,64,68,2,0,7,16,5,0.5640381053188674,0.3957219251336898,0.6176470588235294,0.0016579648457378,0.0,0.0,0.0017504376094023,0.0030007501875468,0.0505924720131114,0.1428571428571428,0.6744186046511627,0.5416666666666665,0,0,0,0,0,0,2,9,66,300000,8928.57142857143,650000.0,100000.0,,150000.0,4,225000,-0.25,-0.4
116598,Viktor,Claesson,2024,190,Sweden,VÃ¤rnamo,Sweden,02-01-92,Central Midfield,Midfield,Right,183.0,30-06-26,MD Management,https://img.a.transfermarkt.technology/portrait/header/116598-1701290255.jpg?lm=1,DK1,Football Club KÃ¸benhavn,4500000.0,18000000.0,32,134,140,13,12,13,13,14,11,9,11,10,8,15,11,10,15,14,15,13,15,15,15,15,15,15,5,16,12,16,15,10,11,12,11,14,12,13,11,11,10,13,7,15,3,2,2,1,3,1,1,3,1,2,3,15,13,1,14,14,16,15,18,1,1,1,1,1,1,1,15,15,1,20,19,13,12,80,11,20,6073049,6700,6650,4000,Northern_European,130,62,11,16132.0,Unknown,93014195,2000000.0,1.0,91,1637,91,3,1,7,90,1,0.6301931727970362,0.4224598930481283,0.5955882352941175,0.0155686471798664,0.4078947368421052,0.1447368421052631,0.0222555638909727,0.0897724431107777,0.0110836412122558,0.0,0.4651162790697669,0.5833333333333333,481,131,97,58,0,12539,8,73,283,4000000,135714.2857142857,18000000.0,3500000.0,,1000000.0,3,4300000,-0.1111111111111111,-0.2
117432,Kevin,Behrens,2024,82,Germany,Bremen,Germany,03-02-91,Centre-Forward,Attack,Right,185.0,30-06-25,B O K S,https://img.a.transfermarkt.technology/portrait/header/117432-1692707679.jpg?lm=1,L1,Verein fÃ¼r LeibesÃ¼bungen Wolfsburg,2000000.0,4000000.0,33,125,129,7,6,9,12,12,5,13,9,5,7,11,10,6,11,13,12,16,11,11,13,12,14,11,12,14,7,15,15,13,12,15,15,12,13,15,16,13,10,10,6,14,2,3,1,2,1,2,1,3,2,1,2,6,12,10,10,12,11,12,10,1,1,1,1,1,1,1,13,1,13,13,13,16,20,78,10,20,1317496,6150,6150,4750,Northern_European,121,0,0,6999.0,Unknown,91103807,2000000.0,1.0,38,253,40,0,1,7,213,3,0.5640381053188674,0.5026737967914437,0.5294117647058822,0.0067496646894043,0.0,0.0,0.0097524381095273,0.0197549387346836,0.0110836412122558,0.0,0.5116279069767438,0.625,466,145,78,76,6,4955,7,18,86,1500000,36250.0,4000000.0,1000000.0,,75000.0,7,1300000,-0.25,-0.625
117478,Marnon,Busch,2024,2036,Germany,Stade,Germany,08-12-94,Right-Back,Defender,Right,182.0,30-06-27,Unknown,https://img.a.transfermarkt.technology/portrait/header/117478-1657874858.jpg?lm=1,L1,1. FuÃŸballclub Heidenheim 1846,1200000.0,1500000.0,30,128,129,9,15,10,7,10,5,7,10,14,13,10,6,12,11,14,11,16,12,13,11,13,14,10,12,13,10,13,17,13,12,15,10,14,15,14,13,16,10,12,14,12,3,2,3,2,2,2,2,2,1,1,2,8,12,6,10,8,13,13,15,1,1,1,20,1,18,1,1,1,15,1,1,15,1,80,10,20,1922556,6301,6301,4224,Northern_European,123,0,0,6711.0,Unknown,91123051,100000.0,1.0,38,1415,40,1,1,7,2,11,0.5840169356972744,0.4464171122994652,0.5441176470588236,0.0064715669167937,0.0,0.0,0.0057514378594648,0.0072518129532383,0.0005277924386788,0.0,0.4418604651162785,0.5,372,7,36,28,1,8458,14,66,183,1200000,37096.77419354839,1500000.0,300000.0,100000.0,350000.0,3,525000,0.0,-0.2
117674,Maximilian,Arnold,2024,82,Germany,Riesa,Germany,27-05-94,Central Midfield,Midfield,Left,184.0,30-06-26,Unknown,https://img.a.transfermarkt.technology/portrait/header/117674-1660652294.JPG?lm=1,L1,Verein fÃ¼r LeibesÃ¼bungen Wolfsburg,7000000.0,19000000.0,30,143,148,17,13,11,11,13,17,10,17,4,12,14,13,12,14,16,12,13,14,13,14,13,14,10,14,13,13,15,17,12,11,13,11,17,12,17,11,13,16,16,4,16,2,1,1,1,3,3,3,2,1,4,1,11,16,12,19,16,16,7,8,1,8,1,1,8,1,18,10,20,10,10,16,10,1,74,20,12,18197746,7150,7150,6150,Northern_European,141,3,0,76711.0,Unknown,91100466,9111392.0,2.0,38,1229,40,3,0,7,213,1,0.696348240275205,0.6524064171122994,0.6764705882352942,0.0740647755374384,0.0197368421052631,0.0,0.0347586896724181,0.0947736934233558,0.0505924720131114,0.1428571428571428,0.4883720930232553,0.5,545,83,76,119,3,7963,14,31,53,7000000,207575.75757575757,19000000.0,4000000.0,500000.0,10000000.0,1,50000,0.0,-0.3
118161,Marius,Müller,2024,82,Germany,Heppenheim,Germany,12-07-93,Goalkeeper,Goalkeeper,Right,192.0,Unknown,Unique Sports Group,https://img.a.transfermarkt.technology/portrait/header/118161-1724771088.jpg?lm=1,L1,Verein fÃ¼r LeibesÃ¼bungen Wolfsburg,1500000.0,2000000.0,31,125,132,4,1,1,2,8,6,7,1,1,2,8,2,1,10,8,14,13,10,12,9,11,14,1,14,1,12,13,10,13,12,13,16,15,10,12,15,15,5,13,8,13,14,11,11,9,13,9,16,16,15,11,10,7,14,14,13,14,16,12,14,20,1,1,1,1,1,1,1,1,1,1,1,1,1,92,10,20,1842751,6131,6120,4037,Northern_European,123,0,0,7928.0,Unknown,92018446,1183333.333,3.0,38,613,40,2,1,7,213,5,0.5600688012701773,0.4264171122994652,0.5441176470588236,0.0076467231295269,0.0,0.0,0.0072518129532383,0.0097524381095273,0.0065464781410594,0.2857142857142857,0.6744186046511627,0.5416666666666665,0,0,0,0,0,0,8,43,120,1500000,42647.05882352941,2000000.0,500000.0,100000.0,400000.0,7,2300000,0.5,0.5
118284,Jordan,Ferri,2024,969,France,Cavaillon,France,12-03-92,Central Midfield,Midfield,Right,173.0,30-06-26,Unknown,https://img.a.transfermarkt.technology/portrait/header/118284-1702663473.JPG?lm=1,FR1,Montpellier HÃ©rault Sport Club,4500000.0,7500000.0,32,134,138,12,13,12,8,13,11,7,10,7,11,15,9,14,14,15,14,18,13,12,13,13,15,12,15,13,14,17,16,13,13,15,7,12,12,15,12,15,14,13,4,9,1,1,1,3,4,4,2,3,2,1,2,18,14,8,14,13,14,12,12,1,1,1,1,1,1,18,1,20,1,1,1,1,1,73,8,20,6270684,6700,6700,3917,Northern_European,134,0,0,29897.0,Unknown,85003943,2000000.0,1.0,34,336,36,3,1,7,133,1,0.6368086795448531,0.4135828877005347,0.625,0.0288603688464832,0.0,0.0,0.0222555638909727,0.0372593148287071,0.0110836412122558,0.0,0.2325581395348837,0.5833333333333333,0,0,0,0,0,0,3,21,83,3500000,103333.33333333333,7500000.0,2000000.0,,600000.0,2,500000,-0.2222222222222222,-0.3
118287,Rachid,Ghezzal,2024,126,France,DÃ©cines-Charpieu,Algeria,09-05-92,Right Winger,Attack,Left,182.0,30-06-25,World in Motion,https://img.a.transfermarkt.technology/portrait/header/118287-1696076620.png?lm=1,TR1,Ã‡aykur Rizespor KulÃ¼bÃ¼,1500000.0,12000000.0,32,140,140,15,16,14,12,16,12,7,14,4,4,16,15,8,17,12,14,11,14,14,17,16,12,16,8,13,6,14,12,12,15,13,10,14,12,14,9,14,13,13,8,13,1,3,2,3,4,3,3,1,2,3,3,11,14,12,14,12,9,8,8,1,1,1,1,1,1,1,14,15,15,14,16,20,1,65,20,8,7282796,6850,6350,5750,North_African__Middle_Eastern,140,22,2,70513.0,Unknown,85031826,8500000.0,2.0,34,441,1,0,0,6,225,10,0.590500132310135,0.6096256684491979,0.6691176470588234,0.0680798797227133,0.1447368421052631,0.0263157894736842,0.0072518129532383,0.0597649412353088,0.047195755437651,0.1428571428571428,0.4418604651162785,0.5833333333333333,341,42,59,44,3,8321,32,118,159,1200000,21621.62162162162,12000000.0,2000000.0,,1000000.0,5,9000000,-0.4,-0.6
118534,Michael,Keane,2024,29,England,Stockport,England,11-01-93,Centre-Back,Defender,Right,188.0,30-06-25,Unknown,https://img.a.transfermarkt.technology/portrait/header/118534-1687967021.jpg?lm=1,GB1,Everton Football Club,6000000.0,30000000.0,31,127,146,5,8,8,9,12,5,16,5,12,14,12,5,16,12,11,15,13,11,13,9,11,17,5,11,10,14,15,13,10,9,13,14,14,12,13,15,12,8,12,11,10,1,3,4,1,1,3,1,3,1,1,2,10,15,5,14,14,16,16,14,1,1,20,13,1,1,1,1,7,10,1,1,1,1,83,11,20,10643607,6500,6500,5650,Northern_European,127,12,1,81194.0,Unknown,28047558,15530000.0,2.0,32,1427,33,1,1,7,65,2,0.6103466525535857,0.5989304812834224,0.5735294117647058,0.0783936377409577,0.0789473684210526,0.0131578947368421,0.0297574393598399,0.1497874468617154,0.0862523958998861,0.1428571428571428,0.581395348837209,0.5416666666666665,435,35,18,37,0,9435,4,10,29,6000000,190322.5806451613,30000000.0,5000000.0,,500000.0,3,3700000,0.0,-0.14285714285714285
118689,Leonardo,Spinazzola,2024,6195,Italy,Foligno,Italy,25-03-93,Left-Back,Defender,Right,186.0,30-06-26,Reset Group Srl,https://img.a.transfermarkt.technology/portrait/header/118689-1663580982.jpg?lm=1,IT1,SocietÃ  Sportiva Calcio Napoli,4000000.0,26000000.0,31,147,153,6,14,16,8,16,5,11,9,8,11,14,7,10,15,8,12,8,12,14,14,12,13,16,6,16,10,11,11,16,14,13,11,9,17,12,11,14,8,13,15,16,1,1,2,2,3,2,1,3,1,4,3,12,12,8,11,15,13,16,17,1,19,10,12,20,12,1,20,1,12,10,1,10,1,75,14,20,40261135,7348,7348,7148,Mediterranean_Hispanic,137,20,0,106922.0,Unknown,43036586,14950000.0,2.0,52,498,54,1,1,3,184,8,0.72254564699656,0.7591443850267379,0.6470588235294117,0.1032370387608426,0.131578947368421,0.0,0.0197549387346836,0.1297824456114028,0.0830300841690046,0.1428571428571428,0.5348837209302322,0.5416666666666665,383,22,39,29,0,8736,27,170,279,2500000,72058.82352941176,26000000.0,6000000.0,100000.0,250000.0,11,6500000,-0.375,-0.6666666666666666
118847,Dominik,Kohr,2024,39,Germany,Trier,Germany,31-01-94,Defensive Midfield,Midfield,Right,183.0,30-06-26,Sports360 GmbH,https://img.a.transfermarkt.technology/portrait/header/118847-1722886760.jpg?lm=1,L1,1. FuÃŸball- und Sportverein Mainz 05,3000000.0,8500000.0,30,131,135,4,7,10,7,12,4,13,8,4,14,12,7,16,11,17,14,17,12,14,11,12,16,8,12,10,13,17,16,13,11,14,12,16,16,15,14,13,14,14,7,17,3,4,2,1,3,2,2,3,1,4,1,8,13,6,12,12,14,12,17,1,1,14,14,1,14,20,10,20,14,1,10,1,1,77,11,20,5212548,6545,6545,5045,Northern_European,130,0,0,32603.0,Unknown,91108278,9111392.0,2.0,38,1522,40,3,1,7,1,4,0.6163006086266208,0.5342245989304812,0.5955882352941175,0.0314733291683041,0.0,0.0,0.0147536884221055,0.0422605651412853,0.0505924720131114,0.1428571428571428,0.4651162790697669,0.5,0,0,0,0,0,0,7,24,43,2500000,82142.85714285714,8500000.0,1700000.0,500000.0,1500000.0,5,7600000,-0.16666666666666666,-0.2857142857142857
118850,Ivan,Ordets,2024,80,Ukraine,"Blyzhnye, Donetsk Oblast",Ukraine,08-07-92,Centre-Back,Defender,Right,195.0,30-06-26,Murza Eduard,https://img.a.transfermarkt.technology/portrait/header/118850-1721851592.jpg?lm=1,L1,Verein fÃ¼r LeibesÃ¼bungen Bochum 1848 FuÃŸballgemeinschaft,2500000.0,5000000.0,32,126,130,5,7,7,8,11,9,16,8,9,13,10,7,14,11,9,15,16,12,13,13,11,16,3,9,10,14,15,14,11,9,14,15,16,11,12,15,15,11,12,8,2,3,2,2,1,3,3,2,2,1,2,3,13,11,7,13,14,16,13,15,1,1,20,1,1,1,5,1,1,1,1,1,1,1,93,10,20,4451829,6000,4814,4334,Northern_European,125,12,1,19229.0,VfL Bochum 1848,71023433,9111392.0,2.0,103,207,101,1,1,7,212,2,0.3872717650172003,0.4581818181818181,0.5588235294117647,0.018559163852697,0.0789473684210526,0.0131578947368421,0.0122530632658164,0.0247561890472618,0.0505924720131114,0.1428571428571428,0.7441860465116279,0.5833333333333333,281,13,5,46,4,4938,13,67,187,1800000,62962.96296296296,5000000.0,1500000.0,100000.0,600000.0,3,2500000,-0.28,-0.4
118997,Aitor,Fernández,2024,331,Spain,Arrasate,Spain,03-05-91,Goalkeeper,Goalkeeper,Right,182.0,30-06-25,Unknown,https://img.a.transfermarkt.technology/portrait/header/118997-1683281584.jpg?lm=1,ES1,Club AtlÃ©tico Osasuna,1800000.0,10000000.0,33,139,145,2,2,1,1,10,1,9,1,1,1,11,3,3,10,12,14,12,13,14,9,14,14,3,9,3,13,14,12,12,14,12,12,14,11,12,10,14,8,14,8,1,13,13,14,5,13,13,15,16,14,8,13,14,13,8,12,14,14,14,10,20,1,1,1,1,1,1,1,1,1,1,1,1,1,78,10,20,347975206,6891,6891,5391,Mediterranean_Hispanic,138,0,0,25449.0,Unknown,67054783,1200000.0,1.0,89,94,89,2,1,3,51,5,0.6620799153215137,0.5712299465240641,0.6544117647058822,0.0245653032472743,0.0,0.0,0.0087521880470117,0.0497624406101525,0.0066390733075918,0.0,0.4418604651162785,0.625,0,0,0,0,0,0,4,39,114,1500000,41176.470588235294,10000000.0,2000000.0,100000.0,,5,900000,-0.16666666666666666,-0.4
119031,Kaan,Ayhan,2024,141,Germany,Gelsenkirchen,TÃ¼rkiye,10-11-94,Right-Back,Defender,Right,185.0,30-06-26,EMG Mundial,https://img.a.transfermarkt.technology/portrait/header/119031-1701181677.png?lm=1,TR1,Galatasaray Spor KulÃ¼bÃ¼,4800000.0,9000000.0,30,125,134,9,5,8,7,13,12,13,10,7,14,14,9,13,13,12,14,14,15,12,13,13,16,9,11,9,13,13,13,11,12,13,13,14,11,13,12,11,11,14,6,14,4,1,1,3,3,1,1,3,1,2,2,11,14,9,13,16,16,9,9,1,1,20,16,1,1,15,1,1,1,1,1,1,1,84,10,20,2743437,6250,6600,5300,Mediterranean_Hispanic,125,49,5,14808.0,Unknown,91100534,1986666.667,3.0,38,526,100,1,1,3,102,11,0.6235776660492194,0.5614973262032085,0.5588235294117647,0.0142901699196702,0.3223684210526316,0.0657894736842105,0.0237559389847461,0.0447611902975743,0.0110095650823633,0.2857142857142857,0.5116279069767438,0.5,403,52,38,81,3,7949,16,51,102,4600000,130303.0303030303,9000000.0,2000000.0,300000.0,5000000.0,5,4500000,-0.02127659574468085,0.022222222222222223
119037,Philipp,Hofmann,2024,80,Germany,Arnsberg,Germany,30-03-93,Centre-Forward,Attack,Left,195.0,30-06-26,ROOF,https://img.a.transfermarkt.technology/portrait/header/119037-1657284242.jpg?lm=1,L1,Verein fÃ¼r LeibesÃ¼bungen Bochum 1848 FuÃŸballgemeinschaft,1800000.0,2800000.0,31,125,125,5,8,9,14,13,9,15,13,4,8,12,13,7,11,10,13,16,13,14,10,15,11,9,10,13,8,15,13,10,11,14,17,12,12,14,17,13,5,14,5,4,2,3,1,1,2,3,1,2,3,3,2,11,14,6,10,14,12,15,15,1,1,1,1,1,1,1,1,1,1,1,1,1,20,89,20,8,2156022,6149,6149,4999,Northern_European,125,0,0,7499.0,Unknown,91100532,987500.0,4.0,38,92,40,0,0,7,212,3,0.5639057951839112,0.5293048128342246,0.5588235294117647,0.0072324733224089,0.0,0.0,0.0087521880470117,0.0137534383595899,0.0054584849579154,0.4285714285714285,0.7441860465116279,0.5416666666666665,483,165,45,55,0,5569,2,3,24,1500000,40714.28571428572,2800000.0,700000.0,100000.0,750000.0,10,2150000,-0.16666666666666666,-0.4
119211,Mitchell,Weiser,2024,86,Germany,Troisdorf,Germany,21-04-94,Right-Back,Defender,Right,177.0,Unknown,CN Sports,https://img.a.transfermarkt.technology/portrait/header/119211-1660208775.jpg?lm=1,L1,Sportverein Werder Bremen von 1899,6000000.0,14000000.0,30,127,137,10,13,14,9,13,12,6,11,10,10,13,9,11,13,10,12,8,12,10,12,13,8,13,7,11,10,12,9,14,15,11,8,13,14,11,9,8,7,13,14,18,2,3,3,3,3,1,1,1,2,2,2,7,12,14,10,13,8,9,7,1,13,1,20,13,20,1,12,1,17,12,1,15,1,71,12,20,2647272,6250,6250,5250,Northern_European,111,0,0,37499.0,Unknown,92016244,6400000.0,2.0,38,1526,40,1,1,7,194,11,0.5772691188145012,0.5561497326203209,0.4558823529411764,0.0362009913026852,0.0,0.0,0.0297574393598399,0.0697674418604651,0.0355287646879079,0.1428571428571428,0.3255813953488373,0.5,411,50,88,63,1,7356,27,74,71,5000000,133333.33333333334,14000000.0,4000000.0,1000000.0,750000.0,5,2750000,-0.16666666666666666,-0.16666666666666666
119234,Karim,Onisiwo,2024,39,Austria,Wien,Austria,17-03-92,Centre-Forward,Attack,Right,188.0,30-06-26,ROOF,https://img.a.transfermarkt.technology/portrait/header/119234-1722886304.jpg?lm=1,L1,1. FuÃŸball- und Sportverein Mainz 05,1500000.0,4500000.0,32,130,132,4,9,13,12,11,4,12,9,4,7,11,8,9,12,15,12,16,11,11,12,10,12,14,6,14,9,16,17,16,12,13,14,15,15,12,15,11,13,12,8,15,1,3,1,2,3,1,2,4,2,3,3,9,15,14,6,11,10,12,10,1,1,1,1,10,10,1,10,1,10,15,14,15,20,85,12,20,3353503,6497,6097,4997,Mixed_Race,126,18,1,24931.0,Unknown,16037392,9111392.0,2.0,6,1663,7,0,1,4,1,3,0.5570256681661815,0.5290909090909091,0.5661764705882353,0.0240651135034815,0.1184210526315789,0.0131578947368421,0.0072518129532383,0.0222555638909727,0.0505924720131114,0.1428571428571428,0.581395348837209,0.5833333333333333,393,89,68,27,0,4145,26,59,88,1000000,33000.0,4500000.0,1000000.0,,,1,0,-0.3333333333333333,-0.6428571428571429
119277,Yannick,Gerhardt,2024,82,Germany,WÃ¼rselen,Germany,13-03-94,Central Midfield,Midfield,Left,184.0,Unknown,Stephan Engels,https://img.a.transfermarkt.technology/portrait/header/119277-1657203024.jpg?lm=1,L1,Verein fÃ¼r LeibesÃ¼bungen Wolfsburg,4000000.0,12000000.0,30,134,140,11,11,11,11,13,7,12,9,6,12,12,6,14,12,13,13,14,12,12,12,13,13,10,8,14,12,17,16,12,11,12,12,17,13,16,12,13,8,13,7,18,2,3,3,3,1,3,1,1,3,1,1,9,12,8,16,12,17,13,13,1,15,1,1,15,1,17,12,20,10,12,15,10,1,79,20,13,7472536,6700,6700,5700,Northern_European,128,1,0,67122.0,Unknown,91105029,13000000.0,1.0,38,1678,40,3,0,7,213,1,0.6368086795448531,0.6042780748663101,0.5808823529411764,0.0648054715736761,0.006578947368421,0.0,0.0197549387346836,0.0597649412353088,0.0721964499013861,0.0,0.4883720930232553,0.5,0,0,0,0,0,0,10,49,75,3000000,88636.36363636363,12000000.0,3000000.0,,3500000.0,2,5775000,-0.25,-0.4
119296,Emre,Can,2024,16,Germany,Frankfurt am Main,Germany,12-01-94,Defensive Midfield,Midfield,Right,186.0,30-06-26,Unknown,https://img.a.transfermarkt.technology/portrait/header/119296-1709561046.jpg?lm=1,L1,Borussia Dortmund,10000000.0,40000000.0,30,146,155,9,10,14,11,14,9,13,13,10,13,16,10,16,16,17,12,17,14,9,13,9,17,15,13,13,13,14,17,13,10,18,13,16,13,16,16,10,13,10,12,19,2,1,4,4,3,2,1,2,1,2,1,12,15,12,7,13,14,10,13,1,14,15,15,10,10,20,8,20,8,1,10,1,1,86,12,20,24902182,7200,7200,6500,North_African__Middle_Eastern,142,37,1,163014.0,Unknown,92021718,14000000.0,3.0,38,507,40,3,1,6,41,4,0.702963747023022,0.6898395721925134,0.6838235294117647,0.1574004424458313,0.2434210526315789,0.0131578947368421,0.0497624406101525,0.1997999499874969,0.0777521597822161,0.2857142857142857,0.5348837209302322,0.5,520,48,29,124,3,10278,23,130,69,7000000,185135.13513513515,40000000.0,7000000.0,1500000.0,12000000.0,4,14000000,-0.3,-0.4166666666666667
119905,Hugo,Mallo,2024,605,Spain,MarÃ­n,Spain,22-06-91,Right-Back,Defender,Right,173.0,30-06-26,#LEADERS,https://img.a.transfermarkt.technology/portrait/header/119905-1692087868.jpg?lm=1,GR1,Aris Thessalonikis,1200000.0,15000000.0,33,143,152,4,13,11,11,12,7,10,6,14,13,12,9,15,12,15,14,16,14,16,10,13,15,7,14,13,15,15,16,14,13,12,11,13,14,15,13,13,13,13,7,8,1,3,2,1,1,2,1,1,1,3,3,13,13,3,15,11,11,8,6,1,9,16,20,6,18,1,1,1,8,1,1,1,1,69,12,20,9973138,7150,7150,5200,Mediterranean_Hispanic,143,0,0,49863.0,Unknown,67086276,9111392.0,2.0,89,923,89,1,1,3,20,11,0.696348240275205,0.5508021390374331,0.6911764705882353,0.0481398831796231,0.0,0.0,0.0057514378594648,0.0747686921730432,0.0505924720131114,0.1428571428571428,0.2325581395348837,0.625,484,15,29,126,4,4277,24,116,182,1000000,22500.0,15000000.0,6000000.0,700000.0,1800000.0,2,1300000,-0.3333333333333333,-0.5
120095,José,Campaña,2024,472,Spain,Sevilla,Spain,31-05-93,Central Midfield,Midfield,Right,179.0,30-06-25,Niagara Sur,https://img.a.transfermarkt.technology/portrait/header/120095-1601644816.jpg?lm=1,ES1,UniÃ³n Deportiva Las Palmas S.A.D.,1500000.0,25000000.0,31,145,152,15,13,12,9,16,13,9,13,5,8,16,12,11,16,10,15,11,16,15,15,15,14,15,12,13,12,15,12,12,14,12,9,12,12,14,10,15,6,14,11,10,3,2,2,3,1,2,2,2,1,2,1,12,15,7,12,14,15,14,14,1,1,1,1,1,1,17,14,20,12,10,18,10,1,72,10,20,15315091,7150,7150,5650,Mediterranean_Hispanic,141,1,0,23075.0,Unknown,67089223,1433333.333,3.0,89,1364,89,3,1,3,207,1,0.696348240275205,0.5989304812834224,0.6764705882352942,0.0222729278577684,0.006578947368421,0.0,0.0072518129532383,0.1247811952988247,0.0079354056112669,0.2857142857142857,0.3720930232558141,0.5416666666666665,378,27,44,74,2,5413,11,108,211,1300000,21621.62162162162,25000000.0,4000000.0,1500000.0,2000000.0,8,3100000,-0.13333333333333333,-0.48
120205,Michael,Gregoritsch,2024,60,Austria,Graz,Austria,18-04-94,Centre-Forward,Attack,Left,193.0,Unknown,ROGON,https://img.a.transfermarkt.technology/portrait/header/120205-1658413549.jpg?lm=1,L1,Sport-Club Freiburg,8000000.0,20000000.0,30,130,142,8,11,12,15,15,15,13,14,7,6,13,14,6,14,9,12,12,11,9,14,11,9,14,7,15,7,10,11,12,10,10,17,13,15,12,14,10,6,12,5,15,3,3,3,2,1,2,1,1,1,1,1,12,17,13,8,14,14,10,11,1,1,1,1,1,1,1,12,1,13,12,18,15,20,87,20,8,3737327,6500,6750,6000,Northern_European,126,39,7,19164.0,Unknown,16045723,2300000.0,4.0,6,557,7,0,0,7,189,3,0.6434241862926701,0.6363636363636364,0.5661764705882353,0.0184963987304064,0.256578947368421,0.0921052631578947,0.0397599399849962,0.0997749437359339,0.0127503541765049,0.4285714285714285,0.6976744186046511,0.5,466,108,36,61,0,9764,22,59,47,6000000,141666.66666666666,20000000.0,5000000.0,200000.0,600000.0,10,7500000,-0.25,-0.25
120629,Alphonse,Areola,2024,379,France,Paris,France,27-02-93,Goalkeeper,Goalkeeper,Right,195.0,30-06-27,Rafaela Pimenta,https://img.a.transfermarkt.technology/portrait/header/120629-1663243036.jpg?lm=1,GB1,West Ham United Football Club,10000000.0,17500000.0,31,143,154,2,3,2,1,10,4,1,12,2,1,10,5,3,10,8,14,13,15,14,9,12,14,8,10,8,14,15,13,12,14,17,15,15,12,15,14,14,8,12,7,1,14,12,13,8,14,14,14,15,12,12,13,11,15,5,15,12,16,17,17,20,1,1,1,1,1,1,1,1,1,1,1,1,1,94,8,20,30033738,7144,7144,6244,African_Caribbean,141,3,0,139190.0,Unknown,85027976,9300000.0,1.0,34,1122,36,2,1,1,220,5,0.695554379465467,0.6624598930481282,0.6764705882352942,0.1343955767004278,0.0197368421052631,0.0,0.0497624406101525,0.0872718179544886,0.051640323342315,0.0,0.7441860465116279,0.5416666666666665,0,0,0,0,0,0,3,6,16,10000000,250000.0,17500000.0,3000000.0,650000.0,1500000.0,7,5900000,0.0,0.0
120705,Unknown,Juan Carlos,2024,12321,Spain,Guadalajara,Spain,20-01-88,Goalkeeper,Goalkeeper,Right,187.0,30-06-25,Unknown,https://img.a.transfermarkt.technology/portrait/header/120705-1567159334.jpg?lm=1,ES1,Girona FÃºtbol Club S. A. D.,200000.0,1000000.0,36,131,135,4,2,3,3,12,7,2,1,2,3,13,2,1,9,2,12,9,12,14,9,11,2,5,5,5,12,12,11,13,14,13,13,13,11,12,13,12,4,10,8,12,14,13,13,6,15,13,14,16,13,14,13,7,11,3,9,11,12,13,16,20,1,1,1,1,1,1,1,1,1,1,1,1,1,82,5,20,892410,6400,6400,4000,Mediterranean_Hispanic,129,0,0,4245.0,Unknown,67039108,100000.0,1.0,89,571,89,2,1,3,107,5,0.5971156390579518,0.4224598930481283,0.588235294117647,0.004090354738815,0.0,0.0,0.0007501875468867,0.0047511877969492,0.0005277924386788,0.0,0.5581395348837206,0.75,0,0,0,0,0,0,2,7,44,100000,0.0,1000000.0,200000.0,,,6,600000,-0.5,-0.6666666666666666
120977,Callum,Mcgregor,2024,371,Scotland,Glasgow,Scotland,14-06-93,Central Midfield,Midfield,Left,178.0,31-05-28,Unknown,https://img.a.transfermarkt.technology/portrait/header/120977-1663161439.jpg?lm=1,SC1,The Celtic Football Club,8500000.0,9000000.0,31,141,145,8,8,14,11,14,7,10,12,4,10,15,13,12,16,15,13,11,14,13,13,13,16,10,18,13,13,15,16,11,13,12,9,18,12,17,10,13,8,15,4,12,3,2,2,2,2,2,1,1,3,1,3,14,13,4,18,13,15,16,12,1,1,1,1,1,1,16,1,20,1,1,1,1,1,67,20,15,24460511,7050,7050,6000,Northern_European,140,46,2,34798.0,Unknown,61036844,9111392.0,2.0,82,545,83,3,0,7,200,1,0.6831172267795713,0.6363636363636364,0.6691176470588234,0.0335928590671944,0.3026315789473684,0.0263157894736842,0.0422605651412853,0.0447611902975743,0.0505924720131114,0.1428571428571428,0.3488372093023257,0.5416666666666665,544,86,79,44,1,17049,3,21,72,7500000,367500.0,9000000.0,1000000.0,,150000.0,1,600000,-0.11764705882352941,-0.16666666666666666
121477,Craig,Dawson,2024,543,England,Rochdale,England,06-05-90,Centre-Back,Defender,Right,188.0,30-06-25,Unique Sports Group,https://img.a.transfermarkt.technology/portrait/header/121477-1700673087.jpg?lm=1,GB1,Wolverhampton Wanderers Football Club,2000000.0,8000000.0,34,138,140,2,12,9,10,12,2,18,6,4,15,11,10,15,11,15,13,17,11,13,7,13,17,7,13,6,15,15,12,11,10,11,16,18,11,15,15,14,4,14,2,8,3,3,3,1,3,1,2,2,1,1,3,6,18,3,4,10,7,9,8,1,1,20,12,1,1,1,1,1,1,1,1,1,1,83,10,20,17487441,6900,6900,4750,Northern_European,135,0,0,57996.0,Unknown,90000708,2472000.0,5.0,32,1242,33,1,1,7,222,2,0.6632707065361206,0.5026737967914437,0.6323529411764706,0.055993248404076,0.0,0.0,0.0097524381095273,0.0397599399849962,0.0137059362760076,0.5714285714285714,0.581395348837209,0.6666666666666665,522,55,16,81,1,9495,3,17,67,2000000,65833.33333333333,8000000.0,2000000.0,,,6,3500000,0.0,0.0
121483,Jan,Oblak,2024,13,Slovenia,Å kofja Loka,Slovenia,07-01-93,Goalkeeper,Goalkeeper,Right,188.0,30-06-28,Miha Mlakar,https://img.a.transfermarkt.technology/portrait/header/121483-1719350076.jpg?lm=1,ES1,Club AtlÃ©tico de Madrid S.A.D.,28000000.0,100000000.0,31,172,178,5,3,1,3,12,9,1,1,1,1,14,12,2,11,8,11,13,17,16,8,16,15,15,11,3,16,13,13,11,13,13,13,9,13,13,13,16,9,15,5,16,15,15,15,4,18,16,16,19,15,9,14,14,19,7,13,16,10,15,14,20,1,1,1,1,1,1,1,1,1,1,1,1,1,84,8,20,120000002,8600,8600,8050,Northern_European,168,50,0,356125.0,Unknown,64016316,10000000.0,2.0,87,1727,87,2,1,7,52,5,0.8881979359618948,0.8556149732620321,0.875,0.3438717583021358,0.3289473684210526,0.0,0.1397849462365591,0.4998749687421855,0.055529320258896,0.1428571428571428,0.581395348837209,0.5416666666666665,0,0,0,0,0,0,8,30,93,25000000,653947.3684210526,100000000.0,20000000.0,700000.0,3000000.0,5,14350000,-0.10714285714285714,-0.2857142857142857
121686,Cristian,Gamboa,2024,80,Costa Rica,Liberia,Costa Rica,24-10-89,Right-Back,Defender,Right,175.0,30-06-25,Wasserman,https://img.a.transfermarkt.technology/portrait/header/121686-1657283791.jpg?lm=1,L1,Verein fÃ¼r LeibesÃ¼bungen Bochum 1848 FuÃŸballgemeinschaft,500000.0,2000000.0,35,121,130,8,11,12,6,13,7,8,9,14,11,10,7,14,12,15,10,10,10,10,8,10,12,12,6,9,8,14,15,15,14,8,8,10,18,16,10,9,6,12,8,15,3,3,1,2,4,1,3,2,2,3,3,14,13,5,10,11,15,14,7,1,1,1,20,1,17,1,1,1,1,1,1,1,1,70,7,20,642498,5990,5990,4490,Mediterranean_Hispanic,110,79,3,10000.0,Unknown,80000968,1012500.0,4.0,22,828,23,1,1,3,212,11,0.5428684837258534,0.4748663101604277,0.4485294117647059,0.009647482104698,0.5197368421052632,0.0394736842105263,0.0022505626406601,0.0097524381095273,0.0055973777049362,0.4285714285714285,0.2790697674418605,0.7083333333333333,0,0,0,0,0,0,10,47,67,500000,16666.666666666668,2000000.0,500000.0,,50000.0,6,1650000,0.0,-0.16666666666666666
121985,Unknown,Juan Jesus,2024,6195,Brazil,Belo Horizonte,Brazil,10-06-91,Centre-Back,Defender,Left,185.0,30-06-25,Roberto Calenda,https://img.a.transfermarkt.technology/portrait/header/121985-1630496408.jpg?lm=1,IT1,SocietÃ  Sportiva Calcio Napoli,2500000.0,14000000.0,33,138,145,4,10,11,6,11,5,14,6,10,15,12,9,17,11,16,13,17,10,10,11,11,17,7,13,9,13,14,17,14,13,17,13,15,15,16,17,14,13,13,5,12,3,2,2,3,3,1,3,1,1,2,3,14,16,10,13,14,18,10,9,1,17,20,10,1,1,1,1,1,1,1,1,1,1,83,20,7,6306376,6900,6500,5500,Mixed_Race,138,4,0,35577.0,Unknown,19042304,5900000.0,2.0,10,168,11,1,0,4,184,2,0.6103466525535857,0.5828877005347594,0.6544117647058822,0.0343450749174155,0.0263157894736842,0.0,0.0122530632658164,0.0697674418604651,0.0327509097474929,0.1428571428571428,0.5116279069767438,0.625,377,7,6,98,1,10643,13,45,62,1500000,30769.23076923077,14000000.0,2000000.0,600000.0,5000000.0,3,1500000,-0.4,-0.5
122153,Paul,Pogba,2024,506,France,Lagny-sur-Marne,France,15-03-93,Central Midfield,Midfield,Right,191.0,30-06-26,Rafaela Pimenta,https://img.a.transfermarkt.technology/portrait/header/122153-1582114937.jpg?lm=1,IT1,Juventus Football Club,15000000.0,100000000.0,31,160,176,10,14,16,14,18,15,14,14,4,6,19,15,11,18,12,16,10,14,10,18,12,13,18,13,14,7,15,8,12,13,16,16,15,14,16,16,14,14,13,12,10,3,4,2,3,3,3,2,4,3,3,1,17,19,14,10,14,15,14,13,1,1,1,1,1,1,14,15,20,11,15,15,1,1,84,13,20,91437501,8000,8800,8000,African_Caribbean,159,91,11,197308.0,Unknown,85028014,105000000.0,1.0,34,788,36,3,1,1,116,1,0.9146599629531622,0.8502673796791443,0.8088235294117647,0.1905153209663511,0.5986842105263157,0.1447368421052631,0.0747686921730432,0.4998749687421855,0.5833217589377482,0.0,0.6511627906976742,0.5416666666666665,446,76,88,71,3,8972,23,188,166,0,-94594.5945945946,100000000.0,20000000.0,,45000000.0,3,25500000,,
122155,Unknown,Willian José,2024,232,Brazil,Porto Calvo,Brazil,23-11-91,Centre-Forward,Attack,Right,186.0,30-06-26,Un1que Football,https://img.a.transfermarkt.technology/portrait/header/122155-1720075360.png?lm=1,RU1,FK Spartak Moskva,4000000.0,30000000.0,33,142,155,10,10,15,14,14,15,16,17,7,5,14,16,8,15,13,12,15,14,11,13,12,15,15,9,14,13,14,12,11,12,11,14,13,12,12,17,13,15,13,10,7,1,2,1,3,2,2,1,3,1,2,1,12,15,12,7,12,14,9,8,1,1,1,1,1,1,1,1,1,1,9,18,8,20,87,13,20,14416398,7100,7000,5750,Mixed_Race,142,0,0,57999.0,Unknown,19081798,5657500.0,4.0,10,1172,11,0,1,4,82,3,0.6765017200317545,0.6096256684491979,0.6838235294117647,0.055996145255874,0.0,0.0,0.0197549387346836,0.1497874468617154,0.0314036501013917,0.4285714285714285,0.5348837209302322,0.625,551,152,38,46,5,11099,10,31,48,2000000,50000.0,30000000.0,6000000.0,400000.0,1500000.0,10,3600000,-0.6,-0.6666666666666666
122840,Loïc,Nego,2024,738,France,Paris,Hungary,15-01-91,Right-Back,Defender,Right,181.0,30-06-25,Sport Cover,https://img.a.transfermarkt.technology/portrait/header/122840-1700236720.jpg?lm=1,FR1,Le Havre Athletic Club,900000.0,2500000.0,33,128,148,8,10,12,11,12,7,6,6,4,9,12,7,13,12,12,14,13,15,15,8,13,17,10,6,13,10,16,16,14,11,9,11,15,15,16,8,16,8,15,3,16,3,3,1,1,2,3,1,2,3,1,1,15,8,2,16,18,19,14,17,1,1,1,15,1,20,1,1,10,16,1,8,18,1,71,9,20,1079431,6400,6000,4750,African_Caribbean,120,24,2,6737.0,Unknown,85030227,9111392.0,2.0,34,1122,47,1,1,1,126,11,0.5441915850754168,0.5026737967914437,0.5220588235294117,0.0064966729657099,0.1578947368421052,0.0263157894736842,0.0042510627656914,0.0122530632658164,0.0505924720131114,0.1428571428571428,0.418604651162791,0.625,451,49,60,67,1,10468,0,0,0,800000,23437.5,2500000.0,500000.0,50000.0,300000.0,5,350000,-0.1111111111111111,-0.2
123275,Tom,Cairney,2024,931,England,Nottingham,Scotland,20-01-91,Central Midfield,Midfield,Left,185.0,30-06-25,Unique Sports Group,https://img.a.transfermarkt.technology/portrait/header/123275-1651652849.jpg?lm=1,GB1,Fulham Football Club,2000000.0,18000000.0,33,126,135,12,14,13,13,15,14,7,15,6,7,15,13,10,15,13,14,9,14,12,14,15,11,15,15,14,12,14,11,10,13,14,10,15,10,13,9,13,5,14,7,13,1,4,3,3,1,2,2,2,1,2,1,12,14,7,11,14,11,7,18,1,1,1,1,1,1,1,1,20,13,1,20,13,1,72,20,7,3575474,6250,5634,5271,Northern_European,126,2,0,34798.0,Unknown,28025033,4200000.0,1.0,32,1055,83,3,0,7,95,1,0.4957660756813972,0.5583957219251336,0.5661764705882353,0.0335928590671944,0.0131578947368421,0.0,0.0097524381095273,0.0897724431107777,0.0233062029500819,0.0,0.5116279069767438,0.625,517,62,63,43,2,7932,20,118,289,2000000,62903.22580645161,18000000.0,3000000.0,,,2,1450000,0.0,0.0
123682,Callum,Wilson,2024,762,England,Coventry,England,27-02-92,Centre-Forward,Attack,Right,180.0,30-06-25,Unique Sports Group,https://img.a.transfermarkt.technology/portrait/header/123682-1668090039.jpg?lm=1,GB1,Newcastle United Football Club,13000000.0,30000000.0,32,144,155,6,8,14,16,13,6,11,9,4,4,13,14,5,13,10,15,12,14,13,11,15,15,11,9,15,8,12,15,16,14,14,10,16,16,14,15,13,5,13,15,7,1,1,3,3,2,2,3,3,1,3,2,12,13,7,14,12,15,12,12,1,1,1,1,1,1,1,1,1,1,1,1,1,20,66,10,20,54659950,7200,7200,6000,African_Caribbean,143,4,1,104393.0,Unknown,28030268,12975000.0,2.0,32,391,33,0,1,1,137,3,0.702963747023022,0.6363636363636364,0.6911764705882353,0.1007949926951053,0.0263157894736842,0.0131578947368421,0.0647661915478869,0.1497874468617154,0.0720575571543653,0.1428571428571428,0.3953488372093026,0.5833333333333333,377,141,46,47,0,4396,21,195,261,11000000,391071.4285714286,30000000.0,6000000.0,50000.0,,3,4350000,-0.15384615384615385,-0.15384615384615385
124028,Unknown,Ismaily,2024,1082,Brazil,Ivinhema,Brazil,11-01-90,Left-Back,Defender,Left,177.0,30-06-25,Unknown,https://img.a.transfermarkt.technology/portrait/header/124028-1666690981.jpg?lm=1,FR1,Lille Olympique Sporting Club Lille MÃ©tropole,1800000.0,19000000.0,34,130,165,11,16,17,9,14,13,11,14,10,11,13,12,13,14,11,13,11,13,12,12,13,15,13,9,15,11,15,17,13,13,14,8,15,14,12,12,18,9,13,7,11,1,4,1,1,2,2,1,1,1,1,3,9,11,6,13,12,15,13,13,1,20,1,1,18,1,1,10,1,1,10,1,1,1,86,20,6,4737274,7000,4730,5846,North_African__Middle_Eastern,128,0,0,32845.0,Unknown,19108573,4000000.0,1.0,10,679,11,1,0,6,128,8,0.3761577136808679,0.6198930481283422,0.5808823529411764,0.0317070085466784,0.0,0.0,0.0087521880470117,0.0947736934233558,0.0221950609739159,0.0,0.3255813953488373,0.6666666666666665,417,26,51,35,1,16608,21,96,232,1500000,46666.666666666664,19000000.0,4000000.0,,300000.0,4,3100000,-0.16666666666666666,-0.25
124182,Sergiy,Sydorchuk,2024,968,UdSSR,Zaporizhya,Ukraine,02-05-91,Defensive Midfield,Midfield,Right,189.0,30-06-26,ProStar,https://img.a.transfermarkt.technology/portrait/header/124182-1713449985.png?lm=1,BE1,Koninklijke Voetbal Club Westerlo,1500000.0,5000000.0,33,125,145,8,9,11,8,10,6,12,13,4,13,14,11,14,11,15,12,15,12,9,14,12,16,12,16,12,12,15,16,12,11,13,13,15,12,14,14,13,12,14,8,6,3,3,1,2,1,2,2,1,3,3,2,14,14,7,16,14,15,14,9,1,1,4,2,1,1,20,1,20,1,1,14,1,1,80,12,20,347975206,6279,6279,4512,Northern_European,125,52,2,22999.0,Unknown,71012671,700000.0,1.0,101,1698,101,3,1,7,123,4,0.581106112728235,0.4772192513368983,0.5588235294117647,0.0221995409455517,0.3421052631578947,0.0263157894736842,0.0072518129532383,0.0247561890472618,0.0038612183671768,0.0,0.6046511627906974,0.625,439,27,32,112,1,14599,4,37,189,1000000,27205.882352941175,5000000.0,1000000.0,150000.0,150000.0,3,1600000,-0.5,-0.5454545454545454
124410,Rani,Khedira,2024,89,Germany,Stuttgart,Germany,27-01-94,Defensive Midfield,Midfield,Right,189.0,30-06-25,NGM SPORTS,https://img.a.transfermarkt.technology/portrait/header/124410-1692707430.jpg?lm=1,L1,1. FC Union Berlin,5000000.0,10000000.0,30,138,138,6,7,10,7,12,6,13,8,10,14,13,9,14,12,15,16,16,13,17,11,14,13,6,14,14,14,17,17,12,11,14,15,18,11,17,15,18,10,14,6,16,3,2,1,2,3,1,4,1,1,3,4,12,17,5,13,10,16,16,18,1,1,12,1,1,1,20,1,20,1,1,1,1,1,85,10,20,3088038,6397,6397,4747,North_African__Middle_Eastern,138,0,0,17260.0,Unknown,92017509,500000.0,1.0,38,1432,40,3,1,6,0,4,0.5967187086530829,0.5023529411764706,0.6544117647058822,0.0166578634559248,0.0,0.0,0.0247561890472618,0.0497624406101525,0.0027500763910108,0.0,0.6046511627906974,0.5,450,24,16,89,1,7757,12,44,58,3000000,103571.42857142857,10000000.0,3000000.0,300000.0,1300000.0,4,1400000,-0.4,-0.625
124419,Odysseas,Vlachodimos,2024,762,Germany,Stuttgart,Greece,26-04-94,Goalkeeper,Goalkeeper,Right,191.0,Unknown,fair-sport GmbH,https://img.a.transfermarkt.technology/portrait/header/124419-1706829687.jpg?lm=1,GB1,Newcastle United Football Club,7000000.0,18000000.0,30,142,142,4,2,3,1,9,5,8,2,1,3,10,2,1,8,11,14,13,12,14,10,12,13,4,10,3,15,13,13,13,16,12,14,14,12,13,12,13,4,13,5,13,14,8,11,4,16,12,14,18,7,13,14,16,14,7,14,15,15,12,16,20,1,1,1,1,1,1,1,1,1,1,1,1,1,76,9,20,24299999,7050,6500,5550,Mediterranean_Hispanic,141,27,0,28960.0,Unknown,92017506,10300000.0,3.0,38,1432,42,2,1,3,137,5,0.6103466525535857,0.588235294117647,0.6764705882352942,0.0279555854682326,0.1776315789473684,0.0,0.0347586896724181,0.0897724431107777,0.057196033223145,0.2857142857142857,0.6511627906976742,0.5,0,0,0,0,0,0,4,8,39,7000000,206250.0,18000000.0,6000000.0,400000.0,450000.0,6,9500000,0.0,-0.3
124422,Robin,Yalç?N,2024,7160,Germany,Deggendorf,TÃ¼rkiye,25-01-94,Centre-Back,Defender,Right,185.0,30-06-25,o2football ,https://img.a.transfermarkt.technology/portrait/header/124422-1692697559.png?lm=1,TR1,EyÃ¼p Spor KulÃ¼bÃ¼,600000.0,2000000.0,30,120,125,7,12,10,10,12,7,10,14,8,12,13,7,14,12,13,13,13,13,12,12,13,13,9,14,7,13,14,15,10,10,13,10,13,10,14,14,13,10,14,12,16,2,3,3,3,1,1,3,4,1,3,1,12,14,5,10,12,14,16,13,1,1,18,18,1,13,20,1,15,10,1,1,1,1,77,8,20,1922353,5950,5500,5650,Northern_European,118,0,0,8295.0,Unknown,92017507,250000.0,1.0,38,405,100,1,1,7,66,2,0.4780365175972479,0.5989304812834224,0.5073529411764706,0.0080011046661523,0.0,0.0,0.0027506876719179,0.0097524381095273,0.0013611489208033,0.0,0.5116279069767438,0.5,445,23,28,83,1,6707,13,67,128,600000,11428.57142857143,2000000.0,800000.0,300000.0,400000.0,8,1400000,0.0,-0.14285714285714285
124502,Matthias,Ginter,2024,60,Germany,Freiburg im Breisgau,Germany,19-01-94,Centre-Back,Defender,Right,189.0,30-06-27,Unique Sports Group,https://img.a.transfermarkt.technology/portrait/header/124502-1658411624.jpg?lm=1,L1,Sport-Club Freiburg,10000000.0,35000000.0,30,141,148,6,9,7,7,13,7,15,10,11,14,13,11,14,13,7,15,12,15,15,12,15,14,8,13,10,15,15,14,11,9,13,14,16,11,14,14,15,6,13,7,16,1,1,2,3,2,3,1,3,2,2,2,8,15,3,15,15,16,18,18,1,1,20,15,1,11,14,1,12,1,1,10,1,8,86,12,20,10532532,6950,6950,6400,Northern_European,141,46,2,44999.0,Unknown,91107789,13500000.0,2.0,38,511,40,1,1,7,189,2,0.6698862132839376,0.6791443850267379,0.6764705882352942,0.0434431207977543,0.3026315789473684,0.0263157894736842,0.0497624406101525,0.1747936984246061,0.0749743048418011,0.1428571428571428,0.6046511627906974,0.5,530,55,25,36,0,10735,20,72,92,8000000,229411.76470588235,35000000.0,7000000.0,2500000.0,12000000.0,3,7000000,-0.2,-0.4666666666666667
124555,Cristiano,Biraghi,2024,430,Italy,Cernusco sul Naviglio,Italy,01-09-92,Left-Back,Defender,Left,185.0,30-06-25,Unknown,https://img.a.transfermarkt.technology/portrait/header/124555-1724827712.jpg?lm=1,IT1,Associazione Calcio Fiorentina,3500000.0,12000000.0,32,144,150,15,17,11,9,12,16,11,12,13,12,14,14,13,12,13,12,14,11,13,13,14,13,10,14,13,14,15,13,14,12,14,12,14,15,16,13,13,10,14,8,13,2,1,1,2,3,2,1,2,2,1,4,10,14,2,14,12,17,13,14,1,20,11,7,20,7,1,16,1,7,1,1,1,1,78,20,7,14298135,7200,7100,5550,Mediterranean_Hispanic,142,13,1,42692.0,Unknown,43029905,2212500.0,4.0,52,341,54,1,0,3,26,8,0.6897327335273882,0.588235294117647,0.6838235294117647,0.0412154417650711,0.0855263157894736,0.0131578947368421,0.0172543135783946,0.0597649412353088,0.0122642295619322,0.4285714285714285,0.5116279069767438,0.5833333333333333,0,0,0,0,0,0,11,15,15,2000000,60937.5,12000000.0,3500000.0,300000.0,1200000.0,11,5300000,-0.42857142857142855,-0.5
124884,Marco,Bizot,2024,3911,Netherlands,Hoorn,Netherlands,10-03-91,Goalkeeper,Goalkeeper,Right,193.0,30-06-26,Key United,https://img.a.transfermarkt.technology/portrait/header/124884-1707302509.jpg?lm=1,FR1,Stade brestois 29,4000000.0,7000000.0,33,133,136,6,1,6,2,10,9,8,2,2,2,11,3,3,10,9,11,14,13,14,9,12,14,10,13,8,14,12,14,11,13,14,15,13,11,12,14,13,12,13,9,14,15,12,12,5,11,13,13,16,12,19,14,6,12,7,9,15,15,12,10,20,1,1,1,1,1,1,1,1,1,1,1,1,1,88,7,20,347975206,6642,6642,5392,Northern_European,133,1,0,14383.0,Unknown,37005659,875000.0,3.0,67,633,68,2,1,7,196,5,0.6291346917173856,0.5713368983957219,0.6176470588235294,0.0138797825816163,0.006578947368421,0.0,0.0197549387346836,0.0347586896724181,0.0048334675963221,0.2857142857142857,0.6976744186046511,0.625,0,0,0,0,0,0,1,20,86,3500000,115000.0,7000000.0,1500000.0,,150000.0,4,1150000,-0.125,0.0
124895,Bart,Schenkeveld,2024,265,Netherlands,Den Hoorn,Netherlands,28-08-91,Centre-Back,Defender,Right,184.0,30-06-25,Prime11,https://img.a.transfermarkt.technology/portrait/header/124895-1660812822.jpg?lm=1,GR1,Panathinaikos Athlitikos Omilos,1200000.0,1500000.0,33,120,125,3,8,11,4,11,8,13,10,14,14,12,8,15,12,15,13,16,13,10,10,13,16,8,13,10,12,11,14,13,13,10,12,10,13,12,14,14,13,12,13,9,2,3,2,3,1,3,3,2,2,2,2,19,12,7,14,13,15,12,13,1,1,20,10,1,1,1,1,1,1,1,1,1,1,80,5,20,1396187,5999,5749,2999,Mediterranean_Hispanic,122,0,0,8278.0,Unknown,37001842,100000.0,1.0,67,408,68,1,1,3,150,2,0.5109817412013761,0.3154010695187165,0.536764705882353,0.0079846891726301,0.0,0.0,0.0057514378594648,0.0072518129532383,0.0005277924386788,0.0,0.4883720930232553,0.625,0,0,0,0,0,0,20,172,532,1000000,36000.0,1500000.0,300000.0,300000.0,,4,250000,-0.16666666666666666,-0.3333333333333333
125020,José Luis,Palomino,2024,1390,Argentina,San Miguel de TucumÃ¡n,Argentina,05-01-90,Centre-Back,Defender,Left,188.0,30-06-25,Unknown,https://img.a.transfermarkt.technology/portrait/header/125020-1663582906.jpg?lm=1,IT1,Cagliari Calcio,700000.0,10000000.0,34,145,150,4,8,10,5,12,3,15,4,10,16,12,4,17,12,17,16,17,12,13,10,12,17,8,12,5,14,15,15,14,13,14,14,16,14,14,15,17,9,14,5,8,2,2,1,1,3,2,1,3,2,1,3,15,14,6,13,15,16,11,10,1,14,20,1,1,1,1,1,1,1,1,1,1,1,87,20,10,4405627,7250,6800,5750,Mediterranean_Hispanic,144,0,0,28461.0,Unknown,14023020,4700000.0,1.0,4,1304,4,1,0,3,46,2,0.6500396930404869,0.6096256684491979,0.6985294117647058,0.027473742452494,0.0,0.0,0.0032508127031757,0.0497624406101525,0.0260840578904969,0.0,0.581395348837209,0.6666666666666665,404,16,7,63,2,10230,16,48,120,700000,20161.290322580644,10000000.0,5000000.0,,500000.0,6,1475000,0.0,-0.3
125103,Marvin,Ducksch,2024,86,Germany,Dortmund,Germany,07-03-94,Centre-Forward,Attack,Right,188.0,30-06-26,EMG Mundial,https://img.a.transfermarkt.technology/portrait/header/125103-1660206693.jpg?lm=1,L1,Sportverein Werder Bremen von 1899,9000000.0,9000000.0,30,128,132,13,11,10,15,12,14,15,14,6,5,12,13,7,12,11,14,10,12,11,13,11,10,13,5,12,6,12,9,13,14,10,14,11,14,13,13,10,8,13,12,12,3,2,1,1,1,3,3,1,3,2,1,5,14,14,12,11,8,8,8,1,1,1,1,1,1,1,12,1,12,12,14,12,20,79,12,20,5130302,6395,6395,5295,Northern_European,128,0,0,29753.0,Unknown,92023402,1937500.0,4.0,38,425,40,0,1,7,194,3,0.5964540883831702,0.5609625668449197,0.5808823529411764,0.0287213199601779,0.0,0.0,0.0447611902975743,0.0447611902975743,0.010736409344704,0.4285714285714285,0.581395348837209,0.5,448,218,108,58,1,6137,17,76,200,9000000,285483.87096774194,9000000.0,1000000.0,600000.0,1000000.0,8,2000000,0.0,0.0
125714,Mark,Flekken,2024,1148,Netherlands,Bocholtz,Netherlands,13-06-93,Goalkeeper,Goalkeeper,Right,195.0,30-06-27,SEG,https://img.a.transfermarkt.technology/portrait/header/125714-1658411484.jpg?lm=1,GB1,Brentford Football Club,12000000.0,12000000.0,31,138,142,6,2,1,1,13,7,7,3,3,2,12,3,3,12,10,12,13,15,12,9,12,14,2,14,1,11,14,10,11,15,13,15,12,10,10,16,13,12,14,7,15,15,12,14,13,12,14,14,16,15,9,14,13,16,8,10,16,14,12,10,20,1,1,1,1,1,1,1,1,1,1,1,1,1,82,7,20,6315334,6791,6641,4991,Northern_European,137,4,0,6999.0,Unknown,92056834,7500000.0,2.0,67,211,68,2,1,7,43,5,0.6290023815824293,0.5284491978609626,0.6470588235294117,0.0067496646894043,0.0263157894736842,0.0,0.0597649412353088,0.0597649412353088,0.041640045556821,0.1428571428571428,0.7441860465116279,0.5416666666666665,0,0,0,0,0,0,10,87,191,10000000,301515.1515151515,12000000.0,2000000.0,50000.0,250000.0,5,2200000,-0.16666666666666666,-0.16666666666666666
125781,Antoine,Griezmann,2024,13,France,MÃ¢con,France,21-03-91,Centre-Forward,Attack,Left,176.0,30-06-26,BY AND FOR,https://img.a.transfermarkt.technology/portrait/header/125781-1719928503.jpg?lm=1,ES1,Club AtlÃ©tico de Madrid S.A.D.,25000000.0,150000000.0,33,162,180,14,15,16,14,15,15,13,14,4,5,15,13,10,17,12,15,12,11,12,16,13,17,17,10,17,10,12,14,15,14,13,9,15,14,13,10,11,9,11,5,14,3,1,1,3,2,1,3,1,1,1,4,14,18,13,12,13,14,11,9,1,1,1,1,1,1,1,12,1,11,19,19,19,20,71,20,14,347975206,8100,8400,7500,Mediterranean_Hispanic,149,108,42,268492.0,Unknown,67086656,57333333.33,3.0,34,998,36,0,0,3,52,3,0.8617359089706271,0.7967914438502673,0.7352941176470587,0.2592518204299507,0.7105263157894737,0.5526315789473684,0.1247811952988247,0.7499374843710929,0.3184995879329981,0.2857142857142857,0.3023255813953489,0.625,728,283,125,89,2,11085,8,25,47,22000000,521428.5714285714,150000000.0,24000000.0,1000000.0,8000000.0,3,20000000,-0.12,-0.12
125858,Kerem,Demirbay,2024,141,Germany,Herten,Germany,03-07-93,Central Midfield,Midfield,Left,183.0,30-06-26,EMG Mundial,https://img.a.transfermarkt.technology/portrait/header/125858-1658913486.jpg?lm=1,TR1,Galatasaray Spor KulÃ¼bÃ¼,4400000.0,32000000.0,31,140,150,15,17,13,11,15,15,8,13,7,9,17,13,12,16,12,11,11,14,11,16,13,13,15,10,13,11,12,13,12,15,11,11,14,11,15,10,13,9,13,9,13,1,3,1,1,1,2,1,3,1,1,2,11,15,15,7,12,12,10,8,1,1,1,1,1,1,14,1,20,1,1,19,1,10,75,20,10,15231477,7000,7000,5750,North_African__Middle_Eastern,138,2,1,96154.0,Unknown,91104583,13466666.67,3.0,38,622,40,3,0,6,102,1,0.6765017200317545,0.6096256684491979,0.6544117647058822,0.0928392720404555,0.0131578947368421,0.0131578947368421,0.0217554388597149,0.1597899474868717,0.0747891145309591,0.2857142857142857,0.4651162790697669,0.5416666666666665,463,73,87,92,2,6261,26,73,75,3800000,115625.0,32000000.0,6000000.0,,,7,3100000,-0.20833333333333334,-0.19148936170212766
126414,Hakan,ÃÂ¡Alhano?Lu,2024,46,Germany,Mannheim,TÃ¼rkiye,08-02-94,Defensive Midfield,Midfield,Right,178.0,30-06-27,Unique Sports Group,https://img.a.transfermarkt.technology/portrait/header/126414-1709035146.jpg?lm=1,IT1,Football Club Internazionale Milano S.p.A.,45000000.0,45000000.0,30,153,159,18,17,11,13,17,16,7,17,4,8,18,16,11,16,11,14,10,14,12,18,15,12,16,9,14,11,15,10,13,14,13,8,16,12,13,9,13,8,11,5,16,2,1,2,2,3,1,3,2,1,1,4,12,16,6,7,13,14,16,14,1,1,1,1,1,1,12,17,20,11,16,17,10,7,69,12,20,30875000,7650,7350,6800,North_African__Middle_Eastern,151,72,16,178076.0,Unknown,92026209,13683333.33,3.0,38,906,100,3,1,6,89,4,0.7228102672664726,0.7219251336898395,0.75,0.171944569706462,0.4736842105263157,0.2105263157894736,0.2248062015503876,0.2248062015503876,0.0759928516347676,0.2857142857142857,0.3488372093023257,0.5,588,127,127,71,0,10522,31,62,18,40000000,1077027.027027027,45000000.0,5000000.0,2500000.0,18000000.0,4,13500000,-0.1111111111111111,0.0
126540,Samuel,Umtiti,2024,1082,Cameroon,YaoundÃ©,France,14-11-93,Centre-Back,Defender,Left,182.0,30-06-25,AC Talent,https://img.a.transfermarkt.technology/portrait/header/126540-1708342117.jpg?lm=1,FR1,Lille Olympique Sporting Club Lille MÃ©tropole,2500000.0,70000000.0,31,133,165,4,9,9,6,12,7,14,9,9,15,13,8,14,14,14,15,13,13,15,10,13,14,8,10,9,16,12,12,12,11,12,12,6,12,10,15,12,12,14,20,11,3,4,2,3,1,1,2,3,2,3,1,12,13,13,7,13,14,14,14,1,10,20,1,1,1,10,1,1,1,1,1,1,1,75,20,8,3470090,6639,7089,6589,African_Caribbean,131,31,4,102497.0,Salento,85059774,25000000.0,1.0,15,1682,36,1,0,1,128,2,0.6882773220428685,0.6993582887700535,0.6029411764705883,0.0989641823587519,0.2039473684210526,0.0526315789473684,0.0122530632658164,0.3498374593648412,0.1388649684713464,0.0,0.4418604651162785,0.5416666666666665,341,7,4,67,1,9509,22,196,364,2000000,47435.89743589744,70000000.0,25000000.0,2500000.0,9000000.0,4,11600000,-0.2,-0.3333333333333333
126557,Jonathan,Gradit,2024,826,France,Talence,France,24-11-92,Centre-Back,Defender,Right,180.0,30-06-26,Unknown,https://img.a.transfermarkt.technology/portrait/header/126557-1544023393.jpg?lm=1,FR1,Racing Club de Lens,4500000.0,5000000.0,32,126,130,5,12,15,5,14,6,12,6,13,13,13,6,14,12,14,13,13,14,13,12,13,14,7,12,13,13,15,16,14,12,13,11,15,13,15,14,13,10,10,12,7,3,1,3,4,1,3,3,2,2,1,1,13,13,5,15,10,14,14,14,1,1,20,15,1,1,1,1,1,1,1,1,1,1,75,6,20,4231958,6292,6292,3792,Northern_European,128,0,0,11769.0,Unknown,85052254,400000.0,1.0,34,1469,36,1,1,7,158,2,0.5828261444826673,0.4002139037433154,0.5808823529411764,0.0113556590482683,0.0,0.0,0.0222555638909727,0.0247561890472618,0.0021945054029278,0.0,0.3953488372093026,0.5833333333333333,348,3,8,63,4,4293,9,25,45,4000000,148000.0,5000000.0,500000.0,,,2,500000,-0.1111111111111111,-0.2
126625,Unknown,Juankar,2024,605,Spain,Boadilla del Monte,Spain,30-03-90,Left-Back,Defender,Left,179.0,30-06-25,Unknown,https://img.a.transfermarkt.technology/portrait/header/126625-1660812477.jpg?lm=1,GR1,Aris Thessalonikis,450000.0,2500000.0,34,125,135,12,15,13,9,13,10,7,10,7,12,12,10,12,13,14,11,10,14,11,11,12,14,12,11,12,12,12,13,14,15,12,9,13,14,13,9,14,14,13,12,8,2,2,2,3,2,1,3,3,1,1,4,16,13,8,16,13,13,12,9,1,20,1,7,19,6,1,16,1,6,10,1,7,1,68,20,10,347975206,6250,6350,3010,Mediterranean_Hispanic,120,0,0,10408.0,Unknown,67063767,2500000.0,1.0,89,208,89,1,0,3,20,8,0.590500132310135,0.3165775401069518,0.5220588235294117,0.0100414539492297,0.0,0.0,0.0020005001250312,0.0122530632658164,0.0138614961526709,0.0,0.3720930232558141,0.6666666666666665,410,24,38,77,5,9151,18,114,213,400000,-18750.0,2500000.0,1000000.0,,,5,350000,-0.2,-0.42857142857142855
126664,Lucas,Digne,2024,405,France,Meaux,France,20-07-93,Left-Back,Defender,Left,178.0,30-06-26,Beckster Int.,https://img.a.transfermarkt.technology/portrait/header/126664-1663014267.jpg?lm=1,GB1,Aston Villa Football Club,12000000.0,35000000.0,31,147,155,13,16,13,8,14,16,13,13,15,10,14,6,14,15,13,14,15,16,14,13,13,16,10,8,15,13,14,15,15,15,14,8,15,14,16,12,14,13,15,11,10,2,2,2,1,2,3,1,3,2,2,2,15,16,5,13,14,16,15,14,1,20,13,1,18,1,1,13,1,1,7,1,1,1,74,20,5,43775281,7350,7250,6250,Northern_European,145,46,0,139190.0,Unknown,85033423,20425000.0,4.0,34,935,36,1,0,7,30,8,0.7095792537708389,0.6631016042780749,0.7058823529411764,0.1343955767004278,0.3026315789473684,0.0,0.0597649412353088,0.1747936984246061,0.113447595766549,0.4285714285714285,0.3488372093023257,0.5416666666666665,446,18,48,62,3,7837,17,56,47,12000000,296250.0,35000000.0,7000000.0,2500000.0,10000000.0,6,12500000,0.0,-0.2
126665,Idrissa,Gueye,2024,29,Senegal,Dakar,Senegal,26-09-89,Central Midfield,Midfield,Right,174.0,30-06-25,Roc Nation Sports,https://img.a.transfermarkt.technology/portrait/header/126665-1602849128.jpg?lm=1,GB1,Everton Football Club,2000000.0,30000000.0,35,150,152,8,9,10,6,13,7,11,13,9,14,12,8,18,13,14,17,16,13,16,13,13,16,8,12,9,14,17,18,14,14,12,8,15,13,16,13,15,12,14,9,8,1,1,1,3,3,2,3,1,3,1,1,14,16,6,10,13,15,15,15,1,10,1,1,10,1,20,1,18,1,1,1,1,1,66,9,20,347975206,7500,7500,6750,African_Caribbean,148,88,7,150789.0,Unknown,85032335,12875000.0,4.0,83,402,84,3,1,1,65,1,0.7426567875099233,0.7165775401069518,0.7279411764705881,0.1455957713688687,0.5789473684210527,0.0921052631578947,0.0097524381095273,0.1497874468617154,0.0715019861662824,0.4285714285714285,0.2558139534883721,0.7083333333333333,523,22,19,93,2,7227,12,31,24,2000000,51388.88888888889,30000000.0,6000000.0,,150000.0,4,10500000,-0.3333333333333333,-0.5
126719,Juan,Bernat,2024,1050,Spain,Cullera,Spain,01-03-93,Left-Back,Defender,Left,170.0,30-06-25,InterStarDeporte,https://img.a.transfermarkt.technology/portrait/header/126719-1672304606.jpg?lm=1,ES1,Villarreal Club de FÃºtbol S.A.D.,4000000.0,20000000.0,31,144,151,13,14,15,10,14,10,8,10,13,10,14,12,12,14,17,13,15,15,10,12,13,16,13,9,16,12,15,17,15,16,15,7,12,14,15,9,14,8,14,13,10,2,2,3,3,1,3,3,3,1,3,2,12,15,6,13,12,14,10,11,1,20,1,1,20,1,1,15,1,1,15,1,1,1,67,20,8,15373066,7195,7195,6745,Mediterranean_Hispanic,136,11,1,161095.0,Unknown,67103536,7500000.0,2.0,89,397,89,1,0,3,216,8,0.7023021963482403,0.716042780748663,0.6397058823529411,0.1555474229123596,0.0723684210526315,0.0131578947368421,0.0197549387346836,0.0997749437359339,0.041640045556821,0.1428571428571428,0.1627906976744184,0.5416666666666665,361,22,33,44,1,8713,20,158,348,2500000,57142.857142857145,20000000.0,4000000.0,500000.0,4000000.0,5,12500000,-0.375,-0.5833333333333334
126729,Unknown,Patric,2024,398,Spain,Mula,Spain,17-04-93,Centre-Back,Defender,Right,184.0,30-06-27,Team Raiola,https://img.a.transfermarkt.technology/portrait/header/126729-1695026786.jpg?lm=1,IT1,SocietÃ  Sportiva Lazio S.p.A.,4000000.0,9000000.0,31,141,146,4,10,11,5,13,4,14,3,4,14,13,6,16,14,19,18,19,12,12,14,13,16,14,13,13,12,17,17,13,14,13,11,15,14,13,14,13,14,14,7,17,3,3,1,2,2,3,1,1,2,1,3,16,16,4,17,8,16,10,10,1,12,20,14,10,12,1,10,1,10,1,1,9,1,72,11,20,10642250,7050,6950,5500,Mediterranean_Hispanic,140,0,0,35577.0,Unknown,67100019,500000.0,1.0,89,992,89,1,1,3,185,2,0.6698862132839376,0.5828877005347594,0.6691176470588234,0.0343450749174155,0.0,0.0,0.0197549387346836,0.0447611902975743,0.0027500763910108,0.0,0.4883720930232553,0.5416666666666665,312,10,12,66,4,5473,29,60,103,4000000,122580.64516129032,9000000.0,2500000.0,,600000.0,1,0,0.0,0.0
126737,Unknown,Juanmi,2024,150,Spain,CoÃ­n,Spain,20-05-93,Left Winger,Attack,Right,172.0,30-06-26,FÃºtbol LLave,https://img.a.transfermarkt.technology/portrait/header/126737-1653043231.jpg?lm=1,ES1,Real Betis BalompiÃ© S.A.D.,6000000.0,15000000.0,31,142,150,7,11,14,14,15,13,10,11,6,6,13,10,8,15,10,15,9,13,12,13,12,15,14,9,16,9,13,14,16,15,12,7,12,15,12,7,12,7,14,10,7,1,3,3,1,3,1,3,3,3,2,2,7,15,5,16,12,12,14,12,1,1,1,1,1,1,1,12,1,6,20,13,11,20,63,11,20,12207392,6950,6950,5500,Mediterranean_Hispanic,137,1,0,20555.0,Unknown,67106568,6666666.667,3.0,89,393,89,0,1,3,164,7,0.6698862132839376,0.5828877005347594,0.6470588235294117,0.0198395723474252,0.006578947368421,0.0,0.0297574393598399,0.0747686921730432,0.0370102873246479,0.2857142857142857,0.2093023255813952,0.5416666666666665,409,87,25,43,0,9074,3,61,272,4000000,97297.2972972973,15000000.0,3000000.0,1500000.0,1500000.0,9,12500000,-0.3333333333333333,-0.5
126751,Iñigo,Ruiz De Galarreta,2024,621,Spain,Donostia-San SebastiÃ¡n,Spain,06-08-93,Central Midfield,Midfield,Right,175.0,30-06-25,Global Ases,https://img.a.transfermarkt.technology/portrait/header/126751-1709675810.png?lm=1,ES1,Athletic Club Bilbao,5000000.0,5000000.0,31,125,135,11,11,12,7,16,11,9,10,6,10,15,11,10,14,11,14,8,13,14,15,15,11,9,10,8,11,16,14,11,14,14,7,12,9,11,7,10,12,12,10,10,2,3,4,3,2,3,2,1,2,2,2,11,14,4,14,10,15,14,16,1,1,1,1,1,1,14,1,20,1,1,14,1,1,66,12,20,1534049,6200,6200,4000,Mediterranean_Hispanic,123,0,0,6023.0,Unknown,67088157,600000.0,2.0,89,423,89,3,1,3,33,1,0.5706536120666843,0.4224598930481283,0.5441176470588236,0.0058072222377793,0.0,0.0,0.0247561890472618,0.0247561890472618,0.0033056473790938,0.1428571428571428,0.2790697674418605,0.5416666666666665,0,0,0,0,0,0,18,130,244,4000000,96774.19354838709,5000000.0,1000000.0,,800000.0,11,2300000,-0.2,-0.2
127048,Cédric,Bakambu,2024,150,France,Ivry-sur-Seine,DR Congo,11-04-91,Centre-Forward,Attack,Right,182.0,30-06-26,CAA Stellar,https://img.a.transfermarkt.technology/portrait/header/127048-1563441766.jpg?lm=1,ES1,Real Betis BalompiÃ© S.A.D.,2500000.0,25000000.0,33,130,155,5,11,13,12,12,8,12,12,6,6,10,14,6,13,12,13,13,10,11,10,12,13,14,8,17,7,10,12,15,15,14,11,15,16,14,12,12,11,15,6,12,1,2,2,2,3,3,3,2,1,1,3,13,14,11,14,10,13,12,14,1,1,1,1,1,1,1,1,1,1,14,1,11,20,74,10,20,347975206,6500,6950,5500,African_Caribbean,127,40,13,23653.0,Unknown,34009930,11000000.0,5.0,34,680,29,0,1,1,164,3,0.6698862132839376,0.5828877005347594,0.5735294117647058,0.0228310546375217,0.2631578947368421,0.1710526315789473,0.0122530632658164,0.1247811952988247,0.0610850301397261,0.5714285714285714,0.4418604651162785,0.625,446,176,45,56,0,11813,7,41,141,1800000,45833.333333333336,25000000.0,7000000.0,,1000000.0,7,14900000,-0.28,-0.35714285714285715
127076,Jérôme,Roussillon,2024,89,France,Sarcelles,Guadeloupe,06-01-93,Left-Back,Defender,Left,172.0,Unknown,Only Pro Sport,https://img.a.transfermarkt.technology/portrait/header/127076-1691614715.jpg?lm=1,L1,1. FC Union Berlin,2500000.0,20000000.0,31,128,140,6,13,13,9,11,6,8,10,12,11,12,7,12,12,13,12,14,11,10,11,10,13,13,8,14,11,12,12,16,12,14,7,14,16,14,13,11,10,14,10,9,1,2,4,3,2,1,3,3,2,1,2,11,13,10,12,12,13,15,15,1,20,1,12,18,10,1,12,1,10,12,1,1,1,80,20,11,2419346,6400,6650,5500,African_Caribbean,118,0,0,72876.0,Unknown,85057004,5000000.0,1.0,34,1345,43,1,0,1,0,8,0.6301931727970362,0.5828877005347594,0.5073529411764706,0.0703616333222931,0.0,0.0,0.0122530632658164,0.0997749437359339,0.0277507708547459,0.0,0.2093023255813952,0.5416666666666665,335,12,25,34,0,5025,17,55,107,1200000,25000.0,20000000.0,6000000.0,,2000000.0,3,2000000,-0.52,-0.52
127108,Florian,Lejeune,2024,367,France,Paris,France,20-05-91,Centre-Back,Defender,Right,190.0,30-06-27,Wasserman,https://img.a.transfermarkt.technology/portrait/header/127108-1496825998.jpg?lm=1,ES1,Rayo Vallecano de Madrid S.A.D.,3000000.0,8000000.0,33,133,141,4,10,10,7,11,10,15,9,5,15,13,7,14,11,11,14,15,13,12,12,13,14,7,11,7,15,15,14,10,10,13,14,13,13,13,15,11,11,14,7,10,3,2,3,3,3,3,2,2,2,3,2,12,15,7,12,11,13,14,14,1,1,20,1,1,1,8,1,1,1,1,1,1,1,82,10,20,5654060,6639,6639,4639,Northern_European,133,0,0,32000.0,Vallecano,85063747,3060000.0,5.0,34,1122,36,1,1,7,163,2,0.6287377613125166,0.4908021390374331,0.6176470588235294,0.0308910619569006,0.0,0.0,0.0147536884221055,0.0397599399849962,0.0169726936859357,0.5714285714285714,0.6279069767441858,0.625,444,24,10,104,7,5064,8,64,213,2800000,76388.88888888889,8000000.0,2000000.0,450000.0,1000000.0,7,4400000,-0.06666666666666667,-0.2
127142,Jonas,Martin,2024,3911,France,BesanÃ§on,France,09-04-90,Defensive Midfield,Midfield,Right,184.0,30-06-25,Wasserman,https://img.a.transfermarkt.technology/portrait/header/127142-1676911402.jpg?lm=1,FR1,Stade brestois 29,1000000.0,5000000.0,34,129,131,10,12,14,12,14,12,11,13,11,13,14,13,12,15,15,13,13,12,12,13,14,14,12,13,12,13,13,15,13,13,14,10,11,12,14,14,13,7,16,14,8,2,3,4,2,2,2,2,2,3,3,2,17,14,6,14,14,14,14,14,1,1,1,1,1,1,13,12,20,12,12,17,12,1,76,5,20,347975206,6450,6450,4002,Northern_European,133,0,0,15502.0,Unknown,34008680,2700000.0,3.0,34,181,36,3,1,7,196,4,0.6037311458057687,0.4226737967914438,0.6176470588235294,0.0149603083022806,0.0,0.0,0.0047511877969492,0.0247561890472618,0.0149726381288369,0.2857142857142857,0.4883720930232553,0.6666666666666665,356,23,17,67,0,5816,22,106,105,800000,20312.5,5000000.0,1500000.0,,150000.0,7,3200000,-0.2,-0.3333333333333333
127156,Téji,Savanier,2024,969,France,Montpellier,France,22-12-91,Attacking Midfield,Midfield,Right,172.0,30-06-26,Unknown,https://img.a.transfermarkt.technology/portrait/header/127156-1702663364.JPG?lm=1,FR1,Montpellier HÃ©rault Sport Club,7000000.0,12000000.0,33,145,150,16,14,16,12,15,16,5,16,4,6,16,14,11,17,14,13,12,13,13,15,14,14,17,16,12,8,14,16,12,16,12,6,12,10,13,8,14,14,17,11,5,1,2,2,1,2,4,2,1,1,1,3,5,12,8,15,12,12,10,8,1,1,1,1,1,1,13,1,17,1,1,20,1,1,69,15,20,18916151,7250,7250,4750,Northern_European,145,0,0,39230.0,Unknown,85059749,9500000.0,1.0,34,978,36,3,1,7,133,0,0.7095792537708389,0.5026737967914437,0.7058823529411764,0.0378724747901472,0.0,0.0,0.0347586896724181,0.0597649412353088,0.052751465318481,0.0,0.2093023255813952,0.625,419,75,88,104,10,3197,3,13,79,5000000,167241.37931034484,12000000.0,2500000.0,,300000.0,2,100000,-0.4444444444444444,-0.4444444444444444
127181,Benjamin,Lecomte,2024,969,France,Paris,France,26-04-91,Goalkeeper,Goalkeeper,Left,186.0,30-06-27,Unknown,https://img.a.transfermarkt.technology/portrait/header/127181-1702663657.JPG?lm=1,FR1,Montpellier HÃ©rault Sport Club,3500000.0,17000000.0,33,132,141,4,3,2,2,11,8,10,2,2,3,11,3,2,12,8,12,14,11,15,11,11,14,6,12,10,14,13,12,11,14,15,14,14,10,13,14,13,8,13,9,1,12,12,11,8,14,13,14,15,13,13,12,14,14,5,15,13,15,14,15,20,1,1,1,1,1,1,1,1,1,1,1,1,1,78,20,6,4659598,6600,6800,4500,Northern_European,132,0,0,34520.0,Espanyol,85041077,6000000.0,3.0,34,1122,36,2,0,7,133,5,0.6500396930404869,0.4759358288770053,0.6102941176470589,0.0333244174672438,0.0,0.0,0.0172543135783946,0.0847711927981995,0.0333064807355759,0.2857142857142857,0.5348837209302322,0.625,0,0,0,0,0,0,7,43,85,3000000,83823.5294117647,17000000.0,3000000.0,,400000.0,7,6800000,-0.14285714285714285,-0.25
127182,Thomas,Monconduit,2024,618,France,Drancy,France,10-02-91,Defensive Midfield,Midfield,Right,184.0,30-06-25,BemavÃµ corp,https://img.a.transfermarkt.technology/portrait/header/127182-1727722128.jpg?lm=1,FR1,Association sportive de Saint-Ã‰tienne Loire,400000.0,3500000.0,33,121,127,9,12,12,9,13,6,10,16,7,12,14,6,11,13,13,13,15,13,14,7,14,15,8,13,10,13,14,15,11,9,14,12,14,12,14,13,12,13,14,10,12,2,3,1,3,1,1,1,3,2,2,4,13,13,6,12,14,14,15,15,1,1,1,10,1,10,19,10,20,10,1,1,1,1,83,12,20,1933112,6050,6050,3750,Northern_European,121,0,0,8769.0,Unknown,34012452,1250000.0,2.0,34,430,36,3,1,7,25,4,0.5508070918232336,0.3957219251336898,0.5294117647058822,0.0084588072502406,0.0,0.0,0.0017504376094023,0.0172543135783946,0.0069168588016333,0.1428571428571428,0.4883720930232553,0.625,314,13,19,55,2,1438,7,27,93,300000,10000.0,3500000.0,1000000.0,,100000.0,3,600000,-0.25,-0.4
127187,Abdoulaye,Doucouré,2024,29,France,Meulan-en-Yvelines,Mali,01-01-93,Central Midfield,Midfield,Right,183.0,30-06-25,DHC,https://img.a.transfermarkt.technology/portrait/header/127187-1687966805.jpg?lm=1,GB1,Everton Football Club,10000000.0,25000000.0,31,136,160,5,11,12,13,14,7,12,13,5,12,13,8,12,14,13,12,14,13,12,13,13,14,12,10,13,12,16,17,14,13,14,12,16,13,16,15,11,11,14,9,10,1,3,2,3,3,2,1,2,2,2,2,14,15,5,13,14,15,15,12,1,1,10,1,1,1,17,1,20,1,1,16,1,7,70,8,20,27051843,6800,6850,6000,African_Caribbean,136,2,0,139190.0,Unknown,85027988,16300000.0,2.0,34,946,61,3,1,1,65,1,0.6566551997883038,0.6363636363636364,0.6397058823529411,0.1343955767004278,0.0131578947368421,0.0,0.0497624406101525,0.1247811952988247,0.0905302925081252,0.1428571428571428,0.4651162790697669,0.5416666666666665,404,52,41,75,1,4595,6,109,223,8000000,262068.9655172414,25000000.0,6000000.0,,750000.0,3,5000000,-0.2,-0.3333333333333333
127188,Maxime,Dupé,2024,417,France,Malestroit,France,04-03-93,Goalkeeper,Goalkeeper,Right,188.0,30-06-26,SVF FOOT,https://img.a.transfermarkt.technology/portrait/header/127188-1676656357.jpg?lm=1,FR1,Olympique Gymnaste Club Nice CÃ´te d'Azur,1500000.0,2500000.0,31,124,127,4,2,1,3,9,7,1,1,3,3,10,2,3,9,7,12,14,12,12,10,13,14,3,11,2,13,12,10,8,13,14,14,14,11,12,15,13,7,5,7,1,13,12,14,7,13,12,12,14,7,13,12,9,13,6,15,9,14,12,18,20,1,1,1,1,1,1,1,1,1,1,1,1,1,88,8,20,1540280,6192,6192,3742,Northern_European,124,0,0,9693.0,Unknown,85027990,500000.0,1.0,34,901,36,2,1,7,142,5,0.5695951309870336,0.3948663101604278,0.5514705882352942,0.0093510376040331,0.0,0.0,0.0072518129532383,0.0122530632658164,0.0027500763910108,0.0,0.581395348837209,0.5416666666666665,0,0,0,0,0,0,0,0,0,1200000,35000.0,2500000.0,500000.0,150000.0,150000.0,4,1000000,-0.2,-0.4
127189,Geoffrey,Kondogbia,2024,244,France,Nemours,Central African Republic,15-02-93,Defensive Midfield,Midfield,Left,188.0,30-06-27,Sport Cover,https://img.a.transfermarkt.technology/portrait/header/127189-1703066053.jpg?lm=1,FR1,Olympique de Marseille,9000000.0,30000000.0,31,149,155,8,11,15,12,15,8,14,16,7,12,15,9,15,16,16,14,16,12,11,13,13,13,14,14,13,15,14,15,14,14,16,14,15,14,16,16,13,13,12,9,12,2,4,1,1,2,1,2,1,1,3,3,11,15,9,13,13,15,14,14,1,1,1,1,1,1,20,1,19,1,1,5,1,1,80,20,7,22274691,7400,7250,6600,African_Caribbean,152,13,1,124642.0,Unknown,85033422,17666666.67,6.0,34,1027,18,3,0,1,144,4,0.7095792537708389,0.7005347593582887,0.7573529411764706,0.1203477767145258,0.0855263157894736,0.0131578947368421,0.0447611902975743,0.1497874468617154,0.0981230960304452,0.7142857142857142,0.581395348837209,0.5416666666666665,454,16,22,89,3,7093,21,79,59,8000000,209459.45945945947,30000000.0,5500000.0,1500000.0,16000000.0,6,22500000,-0.3333333333333333,-0.4666666666666667
127202,Matz,Sels,2024,703,Belgium,Lint,Belgium,26-02-92,Goalkeeper,Goalkeeper,Right,188.0,30-06-27,Unknown,https://img.a.transfermarkt.technology/portrait/header/127202-1665067633.jpg?lm=1,GB1,Nottingham Forest Football Club,7000000.0,8000000.0,32,131,135,5,2,3,2,11,6,9,1,2,2,11,3,2,10,7,13,14,13,14,8,12,15,1,10,3,13,12,10,12,12,15,15,12,13,15,14,14,9,15,6,13,11,12,11,13,10,14,15,17,11,14,12,12,15,7,14,12,12,10,11,20,1,1,1,1,1,1,1,1,1,1,1,1,1,75,9,20,3669590,6545,6745,5245,Northern_European,130,2,0,20698.0,Unknown,18018791,4852500.0,4.0,7,840,8,2,1,7,140,5,0.6427626356178884,0.555614973262032,0.5955882352941175,0.0199776556164645,0.0131578947368421,0.0,0.0347586896724181,0.0397599399849962,0.0269313036473235,0.4285714285714285,0.581395348837209,0.5833333333333333,0,0,0,0,0,0,2,30,190,7000000,211363.63636363635,8000000.0,1500000.0,50000.0,800000.0,6,1300000,0.0,0.0
127573,Phillipp,Mwene,2024,39,Austria,Wien,Austria,29-01-94,Left-Back,Defender,Right,170.0,30-06-26,Unique Sports Group,https://img.a.transfermarkt.technology/portrait/header/127573-1722886402.jpg?lm=1,L1,1. FuÃŸball- und Sportverein Mainz 05,1800000.0,3000000.0,30,130,132,8,11,12,9,11,6,8,10,12,11,10,8,13,12,14,11,14,10,12,11,11,15,11,10,13,10,13,16,15,16,11,7,17,14,15,8,15,10,12,13,14,1,2,2,3,3,3,4,1,2,1,2,10,15,6,11,11,13,12,12,1,16,1,20,16,20,1,1,1,13,1,1,13,1,68,15,20,8520187,6500,5767,4800,Mixed_Race,122,1,0,14383.0,Unknown,16045742,1000000.0,1.0,6,1663,7,1,1,4,1,8,0.5133633236305901,0.5080213903743315,0.536764705882353,0.0138797825816163,0.006578947368421,0.0,0.0087521880470117,0.0147536884221055,0.0055279313314258,0.0,0.1627906976744184,0.5,356,12,28,47,2,5312,9,103,309,1800000,60344.8275862069,3000000.0,1500000.0,,200000.0,5,2550000,0.0,0.2
127679,Cican,Stankovic,2024,2441,Bosnia-Herzegovina,Bijeljina,Austria,04-11-92,Goalkeeper,Goalkeeper,Right,187.0,30-06-25,Unknown,https://img.a.transfermarkt.technology/portrait/header/127679-1728414786.png?lm=1,GR1,Athlitiki Enosi Konstantinoupoleos,1000000.0,4000000.0,32,120,130,1,7,8,1,10,1,7,4,5,3,9,5,3,9,9,12,12,12,10,11,10,10,10,12,2,15,13,14,10,13,13,16,12,10,12,12,11,6,11,12,1,13,12,12,3,14,12,13,14,6,9,12,15,12,3,12,10,15,15,16,20,1,1,1,1,1,1,1,1,1,1,1,1,1,82,12,20,1670624,6000,6550,3000,Northern_European,120,4,0,14783.0,Unknown,16057578,823333.3333,3.0,9,190,7,2,1,7,34,5,0.6169621593014025,0.3155080213903743,0.5220588235294117,0.01426602948802,0.0263157894736842,0.0,0.0047511877969492,0.0197549387346836,0.0045464225856273,0.2857142857142857,0.5581395348837206,0.5833333333333333,0,0,0,0,0,0,11,41,50,800000,21093.75,4000000.0,700000.0,,175000.0,3,875000,-0.4666666666666667,-0.4666666666666667
128011,Petros,Mantalos,2024,2441,Greece,Komotini,Greece,31-08-91,Attacking Midfield,Midfield,Right,177.0,30-06-26,feel soccer GmbH,https://img.a.transfermarkt.technology/portrait/header/128011-1728415934.png?lm=1,GR1,Athlitiki Enosi Konstantinoupoleos,1800000.0,4000000.0,33,125,130,14,14,13,10,14,13,10,11,5,9,15,13,8,15,10,13,11,12,11,16,12,14,13,14,12,9,14,13,12,13,12,7,12,12,13,8,12,12,11,8,10,3,2,2,3,3,1,2,3,3,4,3,18,12,6,16,10,16,12,11,1,1,1,1,1,1,1,14,16,10,16,20,14,1,73,10,20,3708024,6500,6500,4500,Mediterranean_Hispanic,124,47,5,15375.0,Unknown,36035173,500000.0,1.0,40,743,42,3,1,3,34,0,0.6103466525535857,0.4759358288770053,0.5514705882352942,0.0148376749094975,0.3092105263157894,0.0657894736842105,0.0087521880470117,0.0197549387346836,0.0027500763910108,0.0,0.3255813953488373,0.625,469,79,112,111,3,13989,10,70,177,1500000,42424.242424242424,4000000.0,800000.0,100000.0,600000.0,1,400000,-0.16666666666666666,-0.25
128223,Álvaro,Morata,2024,5,Spain,Madrid,Spain,23-10-92,Centre-Forward,Attack,Right,189.0,30-06-28,Unknown,https://img.a.transfermarkt.technology/portrait/header/128223-1719989301.jpg?lm=1,IT1,Associazione Calcio Milan,16000000.0,65000000.0,32,153,166,5,11,13,14,14,10,16,14,5,5,14,14,8,15,13,16,13,12,12,13,13,14,14,11,16,5,17,16,15,14,14,14,13,16,15,13,14,14,13,9,11,2,3,1,2,1,2,3,4,1,3,3,17,13,7,16,11,14,10,9,1,1,1,1,1,1,1,1,1,1,14,10,1,20,84,12,20,40000001,7700,7700,7400,Mediterranean_Hispanic,153,56,26,181817.0,Unknown,67117360,32800000.0,5.0,89,892,89,0,1,3,27,3,0.7691188145011907,0.7860962566844919,0.7647058823529411,0.1755569438986025,0.3684210526315789,0.3421052631578947,0.0797699424856214,0.3248312078019504,0.1821995055418206,0.5714285714285714,0.6046511627906974,0.5833333333333333,618,224,84,107,3,11795,26,65,50,13000000,200000.0,65000000.0,10000000.0,,12000000.0,8,36000000,-0.1875,-0.35
128899,Jack,Butland,2024,124,England,Bristol,England,10-03-93,Goalkeeper,Goalkeeper,Right,196.0,31-05-27,Triple S Sports,https://img.a.transfermarkt.technology/portrait/header/128899-1672916012.jpg?lm=1,SC1,Rangers Football Club,3000000.0,22000000.0,31,124,161,2,1,1,3,6,1,6,1,1,2,9,2,3,10,10,12,14,14,12,5,7,10,3,10,2,13,12,12,12,16,12,18,12,10,14,13,6,5,10,5,3,15,12,7,11,15,11,16,16,11,8,12,9,13,3,14,11,18,16,16,20,1,1,1,1,1,1,1,1,1,1,1,1,1,85,10,20,2227886,6200,6200,5250,Northern_European,124,9,0,46397.0,Unknown,28044979,2450000.0,2.0,32,259,33,2,1,7,161,5,0.5706536120666843,0.5561497326203209,0.5514705882352942,0.0447930537356352,0.0592105263157894,0.0,0.0147536884221055,0.1097774443610902,0.0135837106586294,0.1428571428571428,0.7674418604651163,0.5416666666666665,0,0,0,0,0,0,5,87,370,3000000,95161.29032258065,22000000.0,4000000.0,250000.0,5000000.0,6,1950000,0.0,0.0
128901,Conor,Coady,2024,1003,England,Liverpool,England,25-02-93,Centre-Back,Defender,Right,185.0,30-06-26,World in Motion,https://img.a.transfermarkt.technology/portrait/header/128901-1668090438.jpg?lm=1,GB1,Leicester City Football Club,3000000.0,25000000.0,31,137,144,5,7,11,9,13,7,14,9,8,13,15,10,13,15,15,13,16,15,14,15,13,17,6,18,12,14,14,16,12,13,14,13,15,12,14,13,16,13,14,4,15,2,2,3,1,2,3,1,2,4,2,2,15,16,8,14,16,16,16,11,1,1,20,10,1,1,10,1,10,1,1,1,1,1,80,9,20,43061932,7000,7200,5750,Northern_European,137,10,1,69595.0,Everton,28047452,3990000.0,3.0,32,845,33,1,1,7,127,2,0.702963747023022,0.6096256684491979,0.6470588235294117,0.0671934430725168,0.0657894736842105,0.0131578947368421,0.0147536884221055,0.1247811952988247,0.0221395038751076,0.2857142857142857,0.5116279069767438,0.5416666666666665,522,27,16,62,2,8728,1,4,19,3000000,90000.0,25000000.0,7000000.0,,300000.0,4,12450000,0.0,-0.5714285714285714
128969,Mathew,Ryan,2024,12,Australia,Plumpton,Australia,08-04-92,Goalkeeper,Goalkeeper,Right,184.0,30-06-25,CAA Stellar,https://img.a.transfermarkt.technology/portrait/header/128969-1699801002.jpg?lm=1,IT1,Associazione Sportiva Roma,3500000.0,10000000.0,32,133,144,6,3,2,1,11,8,6,2,12,1,14,3,3,13,13,13,14,13,13,13,13,16,8,14,2,15,10,11,10,15,10,12,14,10,13,10,13,8,16,6,15,10,10,14,8,14,15,13,15,14,13,12,17,17,4,14,16,18,14,17,20,1,1,1,1,1,1,1,1,1,1,1,1,1,84,9,20,4606691,6650,7200,6250,Northern_European,133,74,0,12435.0,Unknown,15016604,2825000.0,5.0,5,1154,6,2,1,7,29,5,0.702963747023022,0.6631016042780749,0.6176470588235294,0.0119987601474304,0.4868421052631578,0.0,0.0172543135783946,0.0497624406101525,0.0156671018639406,0.5714285714285714,0.4883720930232553,0.5833333333333333,0,0,0,0,0,0,11,42,76,2500000,71323.5294117647,10000000.0,2000000.0,200000.0,1000000.0,9,8200000,-0.2857142857142857,-0.375
129092,Rasmus,Thelander,2024,1177,Denmark,KÃ¸benhavn,Denmark,09-07-91,Centre-Back,Defender,Right,191.0,31-12-24,Elite Consulting,https://img.a.transfermarkt.technology/portrait/header/129092-1619283214.jpeg?lm=1,DK1,Silkeborg IdrÃ¦tsforening,300000.0,1250000.0,33,122,125,4,5,4,5,10,6,14,5,10,15,10,8,15,8,16,13,16,12,13,8,12,14,8,14,5,13,14,13,10,10,12,16,9,12,14,16,15,9,14,17,7,3,1,3,1,1,1,1,1,2,4,3,12,13,4,12,14,13,13,10,1,1,20,5,1,1,1,1,1,1,1,1,1,3,88,5,20,347975206,5866,5479,4233,Northern_European,121,0,0,4719.0,Unknown,27018942,216666.6667,3.0,28,778,30,1,1,7,182,2,0.4752580047631648,0.447379679144385,0.5294117647058822,0.0045480573229033,0.0,0.0,0.0012503125781445,0.0060015003750937,0.0011759585916275,0.2857142857142857,0.6511627906976742,0.625,336,20,10,53,4,12083,10,111,204,200000,6250.0,1250000.0,250000.0,25000.0,300000.0,8,650000,-0.3333333333333333,-0.42857142857142855
129444,David,López,2024,12321,Spain,Barcelona,Spain,09-10-89,Centre-Back,Defender,Right,185.0,30-06-26,Unknown,https://img.a.transfermarkt.technology/portrait/header/129444-1448529645.jpg?lm=1,ES1,Girona FÃºtbol Club S. A. D.,2500000.0,15000000.0,35,141,152,7,8,9,8,13,9,14,10,9,14,12,9,14,12,13,13,15,14,14,12,15,9,7,15,10,15,18,16,12,11,12,12,12,12,14,13,14,11,13,11,14,1,1,3,4,2,1,2,3,2,2,1,12,13,5,12,12,13,10,10,1,1,19,12,1,1,20,1,15,1,1,1,1,1,83,10,20,3871317,7000,7000,5550,Mediterranean_Hispanic,133,0,0,67077.0,Unknown,67155094,9111392.0,2.0,89,141,89,1,1,3,107,2,0.6765017200317545,0.588235294117647,0.6176470588235294,0.0647620187967057,0.0,0.0,0.0122530632658164,0.0747686921730432,0.0505924720131114,0.1428571428571428,0.5116279069767438,0.7083333333333333,490,32,13,79,0,5410,7,45,201,2000000,51612.903225806454,15000000.0,3000000.0,,,4,1900000,-0.2,-0.3333333333333333
129476,Gerard,Deulofeu,2024,410,Spain,Riudarenes,Spain,13-03-94,Centre-Forward,Attack,Right,177.0,30-06-26,Regenera Elite,https://img.a.transfermarkt.technology/portrait/header/129476-1695029603.jpg?lm=1,IT1,Udinese Calcio,1000000.0,25000000.0,30,144,150,14,14,17,14,16,14,8,14,4,5,14,12,5,17,7,13,10,12,10,14,13,14,17,8,15,7,13,11,15,16,14,7,14,14,11,7,14,8,12,13,13,3,3,3,1,3,2,3,2,2,1,3,13,16,12,9,9,13,7,10,1,1,1,1,1,1,1,11,1,11,19,5,17,20,73,10,20,12816255,7200,6600,5400,Mediterranean_Hispanic,129,4,1,24615.0,Unknown,67107391,12000000.0,4.0,89,1238,89,0,1,3,205,3,0.6235776660492194,0.5721925133689839,0.588235294117647,0.0237599784474226,0.0263157894736842,0.0131578947368421,0.0047511877969492,0.1247811952988247,0.0666407400205561,0.4285714285714285,0.3255813953488373,0.5,350,79,68,31,0,6097,15,162,762,1000000,0.0,25000000.0,6000000.0,10000000.0,12000000.0,8,17500000,0.0,-0.8571428571428571
129513,Alexandru,Maxim,2024,2832,Romania,Piatra Neam?,Romania,08-07-90,Attacking Midfield,Midfield,Right,177.0,30-06-25,Unknown,https://img.a.transfermarkt.technology/portrait/header/129513-1725480429.jpg?lm=1,TR1,Gaziantep Futbol KulÃ¼bÃ¼ A.?.,750000.0,7000000.0,34,130,143,16,14,13,14,15,13,5,13,4,5,14,16,6,16,8,11,7,14,10,16,11,12,15,5,12,6,12,10,12,12,8,7,11,11,10,9,13,5,12,6,13,3,3,3,2,1,3,1,2,1,3,3,14,16,14,12,10,9,10,8,1,1,1,1,1,1,10,14,14,14,14,20,14,8,70,15,20,347975206,6500,6600,5750,Northern_European,119,56,7,27999.0,Unknown,57024538,2250000.0,2.0,77,1142,80,3,1,7,103,0,0.6235776660492194,0.6096256684491979,0.5147058823529411,0.0270276272755977,0.3684210526315789,0.0921052631578947,0.0035008752188047,0.0347586896724181,0.0124725686824634,0.1428571428571428,0.3255813953488373,0.6666666666666665,454,80,80,67,0,5063,12,20,52,700000,12820.51282051282,7000000.0,2000000.0,,,5,2500000,-0.3,-0.5625
129554,Steven,Berghuis,2024,610,Netherlands,Apeldoorn,Netherlands,19-12-91,Right Winger,Attack,Left,182.0,30-06-25,PUM,https://img.a.transfermarkt.technology/portrait/header/129554-1668696215.jpg?lm=1,NL1,AFC Ajax Amsterdam,6000000.0,15000000.0,33,152,152,15,15,14,13,14,14,12,16,4,3,14,14,5,14,9,14,11,12,13,15,11,13,13,13,14,6,14,16,15,14,14,11,12,15,15,11,10,9,7,7,13,2,2,1,2,1,2,3,1,3,3,3,12,15,12,9,15,14,10,7,1,1,1,1,1,1,1,14,14,17,16,18,20,16,70,20,8,28631126,7300,7300,6250,Northern_European,144,36,2,74999.0,Unknown,37024265,4750000.0,4.0,67,79,68,0,0,7,6,10,0.7161947605186557,0.6631016042780749,0.6985294117647058,0.0724116387780306,0.2368421052631578,0.0263157894736842,0.0297574393598399,0.0747686921730432,0.0263618433845384,0.4285714285714285,0.4418604651162785,0.625,518,160,127,61,2,15486,15,72,88,5000000,145588.23529411765,15000000.0,3000000.0,,800000.0,5,4150000,-0.16666666666666666,-0.375
129586,Joris,Kayembe,2024,1184,Belgium,Brussel,DR Congo,08-08-94,Left-Back,Defender,Left,180.0,30-06-26,Stirr Associates,https://img.a.transfermarkt.technology/portrait/header/129586-1714036942.png?lm=1,BE1,Koninklijke Racing Club Genk,2500000.0,3500000.0,30,120,125,12,13,14,9,12,8,5,9,8,11,11,11,9,13,8,7,7,10,8,11,10,13,16,7,12,10,12,12,15,15,12,9,14,14,12,10,13,10,10,13,13,3,2,2,4,1,1,3,1,1,3,3,13,14,8,11,12,14,12,13,1,20,1,1,17,1,1,17,1,1,18,1,14,1,73,20,7,2091127,5995,5995,3245,African_Caribbean,98,2,0,2000.0,Unknown,55070229,2620000.0,1.0,7,265,29,1,0,1,122,8,0.5435300344006351,0.341711229946524,0.3602941176470588,0.0019225439766243,0.0131578947368421,0.0,0.0122530632658164,0.0172543135783946,0.0145281813383705,0.0,0.3953488372093026,0.5,311,20,31,24,1,4146,5,136,484,2500000,86956.52173913043,3500000.0,800000.0,,1100000.0,7,1200000,0.0,0.0
129588,Dennis,Praet,2024,1096,Belgium,Leuven,Belgium,14-05-94,Central Midfield,Midfield,Right,181.0,30-06-26,MARTIN RIHA,https://img.a.transfermarkt.technology/portrait/header/129588-1572887027.jpg?lm=1,BE1,Royal Antwerp Football Club,4000000.0,25000000.0,30,138,148,13,13,13,11,14,12,8,12,12,8,15,10,13,14,12,12,13,14,15,14,16,13,16,11,13,11,15,14,12,13,10,9,14,12,13,12,12,8,12,9,14,3,3,2,2,2,3,2,3,2,2,1,12,14,10,11,12,13,10,18,1,1,1,1,1,1,12,13,20,13,12,19,12,1,78,12,20,32690705,6899,7249,5849,Northern_European,137,15,2,86994.0,Unknown,18045342,9111392.0,2.0,7,826,8,3,1,7,173,1,0.7094469436358826,0.6202139037433154,0.6470588235294117,0.0839942178838111,0.0986842105263157,0.0263157894736842,0.0197549387346836,0.1247811952988247,0.0505924720131114,0.1428571428571428,0.418604651162791,0.5,440,39,56,36,0,11977,17,90,67,3500000,94285.71428571429,25000000.0,5000000.0,5000000.0,9000000.0,5,4500000,-0.125,-0.4166666666666667
130164,Jordan,Pickford,2024,29,England,Washington,England,07-03-94,Goalkeeper,Goalkeeper,Left,185.0,30-06-27,CAA Stellar,https://img.a.transfermarkt.technology/portrait/header/130164-1668499964.jpg?lm=1,GB1,Everton Football Club,22000000.0,40000000.0,30,146,152,7,2,1,1,11,8,8,2,2,3,12,2,2,14,16,14,15,10,14,15,12,14,1,14,1,14,10,11,8,16,12,14,15,8,13,13,14,12,13,5,13,14,15,14,12,14,16,16,16,14,11,12,11,12,6,13,12,14,10,7,20,1,1,1,1,1,1,1,1,1,1,1,1,1,77,20,9,47368125,7300,7800,6250,Northern_European,146,45,0,127591.0,Unknown,28054565,28500000.0,1.0,32,1647,33,2,0,7,65,5,0.7823498279968246,0.6631016042780749,0.713235294117647,0.123195382031987,0.2960526315789473,0.0,0.1097774443610902,0.1997999499874969,0.1583099530542515,0.0,0.5116279069767438,0.5,0,0,0,0,0,0,4,28,64,20000000,684482.7586206896,40000000.0,7000000.0,,250000.0,5,5750000,-0.09090909090909091,-0.09090909090909091
130353,Hördur,Magnússon,2024,265,Iceland,ReykjavÃ­k,Iceland,11-02-93,Centre-Back,Defender,Left,191.0,30-06-25,MD Management,https://img.a.transfermarkt.technology/portrait/header/130353-1660812641.jpg?lm=1,GR1,Panathinaikos Athlitikos Omilos,1200000.0,5000000.0,31,120,125,13,12,10,8,13,14,13,11,15,11,13,11,13,13,9,13,10,14,13,12,12,13,8,10,10,12,15,16,10,9,12,15,12,10,13,14,15,7,11,10,10,2,3,1,2,3,3,1,1,2,2,3,15,16,10,9,12,15,16,13,1,16,20,1,7,1,10,1,1,1,1,1,1,1,81,20,10,2227498,6000,5950,4004,Northern_European,120,41,2,18923.0,Unknown,39014574,1725000.0,4.0,46,1222,48,1,0,7,150,2,0.5375760783275999,0.4228877005347593,0.5220588235294117,0.0182636849692982,0.2697368421052631,0.0263157894736842,0.0057514378594648,0.0247561890472618,0.0095558209950276,0.4285714285714285,0.6511627906976742,0.5416666666666665,297,15,4,36,1,6136,12,139,274,900000,27419.354838709678,5000000.0,1000000.0,50000.0,200000.0,5,2650000,-0.4,-0.55
130360,Simone,Verdi,2024,1047,Italy,Broni,Italy,12-07-92,Attacking Midfield,Midfield,Left,174.0,30-06-25,Unknown,https://img.a.transfermarkt.technology/portrait/header/130360-1663671979.jpg?lm=1,IT1,Calcio Como,2500000.0,25000000.0,32,130,146,14,14,13,10,14,17,5,15,5,4,14,14,5,15,13,11,10,10,9,14,10,16,15,8,11,4,13,12,13,14,13,4,12,13,12,8,12,7,11,14,14,1,2,2,2,3,2,1,3,2,4,2,11,14,1,13,10,17,17,15,1,1,1,1,1,1,1,10,14,10,15,20,17,17,65,20,17,4889922,6500,6500,5400,Mediterranean_Hispanic,123,4,0,60480.0,Hellas Verona,43061356,10870000.0,5.0,52,260,54,3,0,3,47,0,0.6103466525535857,0.5721925133689839,0.5441176470588236,0.0583918416928429,0.0263157894736842,0.0,0.0122530632658164,0.1247811952988247,0.0603627878552181,0.5714285714285714,0.2558139534883721,0.5833333333333333,434,76,50,42,2,6544,22,163,374,2000000,45945.94594594595,25000000.0,4000000.0,400000.0,900000.0,12,9000000,-0.2,-0.2
130365,Alessandro,Florenzi,2024,5,Italy,Roma,Italy,11-03-91,Right-Back,Defender,Right,173.0,30-06-25,World Soccer Agency,https://img.a.transfermarkt.technology/portrait/header/130365-1663574873.jpg?lm=1,IT1,Associazione Calcio Milan,2000000.0,30000000.0,33,145,154,13,13,13,10,14,14,9,14,10,13,13,11,12,14,14,13,15,13,14,12,13,16,12,14,14,12,16,14,14,15,11,8,16,14,13,9,14,8,15,12,20,1,2,1,3,3,3,1,3,1,3,3,10,15,8,18,14,16,18,13,1,11,1,20,10,20,1,9,13,18,8,7,15,1,67,11,20,347975206,7250,7250,6200,Mediterranean_Hispanic,136,49,2,71154.0,Unknown,43041177,1383333.333,3.0,52,1244,54,1,1,3,27,11,0.7095792537708389,0.6577540106951871,0.6397058823529411,0.0686988403902252,0.3223684210526316,0.0263157894736842,0.0097524381095273,0.1497874468617154,0.0076576201172254,0.2857142857142857,0.2325581395348837,0.625,521,75,43,74,1,8796,30,187,277,1500000,38157.89473684211,30000000.0,6000000.0,50000.0,400000.0,6,19775000,-0.25,-0.25
130394,Gianluca,Lapadula,2024,1390,Italy,Torino,Peru,07-02-90,Centre-Forward,Attack,Left,178.0,30-06-26,Starbridge Srl,https://img.a.transfermarkt.technology/portrait/header/130394-1718677760.jpg?lm=1,IT1,Cagliari Calcio,1500000.0,8000000.0,34,129,139,8,9,12,15,12,10,12,10,9,9,11,15,10,12,14,14,18,14,14,10,13,18,14,12,16,8,13,18,13,13,14,9,15,13,13,12,14,8,16,13,9,2,2,3,2,1,2,2,1,4,3,2,13,18,1,10,13,11,16,14,1,1,1,1,1,1,1,1,1,1,7,1,7,20,69,20,9,2647256,6450,6550,5500,Mediterranean_Hispanic,129,22,7,32691.0,Unknown,43020298,5500000.0,5.0,52,1504,76,0,0,3,46,3,0.6169621593014025,0.5828877005347594,0.588235294117647,0.031558303487713,0.1447368421052631,0.0921052631578947,0.0072518129532383,0.0397599399849962,0.0305286257951609,0.5714285714285714,0.3488372093023257,0.6666666666666665,478,187,44,68,2,5791,17,69,87,1000000,27941.176470588234,8000000.0,1500000.0,,50000.0,12,5800000,-0.3333333333333333,-0.6
131075,Francesco,Acerbi,2024,46,Italy,Vizzolo Predabissi,Italy,10-02-88,Centre-Back,Defender,Left,192.0,30-06-25,Unknown,https://img.a.transfermarkt.technology/portrait/header/131075-1663572709.jpg?lm=1,IT1,Football Club Internazionale Milano S.p.A.,3500000.0,15000000.0,36,147,155,3,9,7,9,12,8,17,3,3,15,13,9,17,12,15,17,15,14,14,12,13,19,11,14,9,15,15,15,10,10,15,16,20,11,16,17,14,6,15,2,7,4,3,3,3,3,3,2,4,2,2,3,10,19,13,12,15,18,14,12,1,8,20,1,1,1,1,1,1,1,1,1,1,1,88,20,9,2361385,7350,7550,6500,Mediterranean_Hispanic,147,25,1,64038.0,FC Internazionale Milano,43017499,4628571.429,7.0,52,1619,54,1,0,3,89,2,0.7492722942577401,0.6898395721925134,0.7205882352941175,0.0618275079253037,0.1644736842105263,0.0131578947368421,0.0172543135783946,0.0747686921730432,0.0256872214728186,0.8571428571428572,0.6744186046511627,0.75,595,32,12,64,3,10140,16,81,167,3000000,75000.0,15000000.0,3000000.0,,,7,1700000,-0.14285714285714285,-0.25
131161,Unknown,Zeca,2024,265,Portugal,Lisboa,Greece,31-08-88,Central Midfield,Midfield,Right,182.0,30-06-25,Proeleven S.A.,https://img.a.transfermarkt.technology/portrait/header/131161-1668508115.jpg?lm=1,GR1,Panathinaikos Athlitikos Omilos,250000.0,2500000.0,36,132,144,7,10,9,7,12,7,8,10,7,15,12,8,18,12,16,15,16,13,13,10,13,20,7,16,8,14,17,17,13,14,13,11,18,13,15,11,12,10,15,15,14,2,2,1,2,2,2,2,4,1,3,3,18,14,2,18,15,18,17,14,1,1,1,1,1,1,16,1,20,16,1,1,1,1,67,7,20,1229149,6750,6750,4750,Mixed_Race,124,33,2,10082.0,Unknown,55027830,380000.0,1.0,76,843,42,3,1,4,150,1,0.6434241862926701,0.5026737967914437,0.5514705882352942,0.0097266627205107,0.2171052631578947,0.0263157894736842,0.0010002500625156,0.0122530632658164,0.0020833912053112,0.0,0.4418604651162785,0.75,501,18,36,103,4,17655,6,70,256,200000,0.0,2500000.0,1000000.0,,,3,1550000,-0.2,-0.3333333333333333
131225,Nicolás,Tagliafico,2024,1041,Argentina,Rafael Calzada,Argentina,31-08-92,Left-Back,Defender,Left,172.0,30-06-25,CAA Stellar,https://img.a.transfermarkt.technology/portrait/header/131225-1668181437.jpg?lm=1,FR1,Olympique Lyonnais,8000000.0,35000000.0,32,144,155,8,12,12,7,13,11,15,8,13,15,13,4,16,12,19,14,17,12,14,12,12,15,12,16,13,14,15,17,13,14,14,13,13,13,16,13,15,16,18,5,12,3,2,4,3,4,3,2,2,2,3,1,16,16,5,16,15,18,10,5,1,20,13,1,18,1,12,16,1,1,10,1,1,1,67,20,8,27914253,7200,7200,6500,Mediterranean_Hispanic,143,40,0,47944.0,Unknown,14008030,3660000.0,3.0,4,1203,4,1,0,3,143,8,0.702963747023022,0.6898395721925134,0.6911764705882353,0.0462868636461514,0.2631578947368421,0.0,0.0397599399849962,0.1747936984246061,0.0203061196144337,0.2857142857142857,0.2093023255813952,0.5833333333333333,463,28,37,98,3,11495,17,31,45,7000000,224193.5483870968,35000000.0,7000000.0,100000.0,500000.0,5,4800000,-0.125,-0.125
131506,Samu,Saiz,2024,7160,Spain,Madrid,Spain,22-01-91,Attacking Midfield,Midfield,Right,174.0,30-06-26,BelestSport,https://img.a.transfermarkt.technology/portrait/header/131506-1691661625.png?lm=1,TR1,EyÃ¼p Spor KulÃ¼bÃ¼,400000.0,3500000.0,33,129,138,13,12,15,12,15,13,6,13,3,5,15,10,5,16,12,14,15,15,10,15,14,14,16,8,15,6,11,12,13,14,13,4,8,12,10,7,9,17,13,6,12,3,2,2,3,2,3,2,1,1,1,1,6,13,16,10,12,14,3,4,1,1,1,1,1,1,1,13,16,13,15,20,15,1,69,13,20,1855348,6449,6449,4349,Mediterranean_Hispanic,129,0,0,4553.0,Unknown,67080313,3000000.0,2.0,89,892,89,3,1,3,66,0,0.6035988356708124,0.4597860962566844,0.588235294117647,0.0043877648567458,0.0,0.0,0.0017504376094023,0.0172543135783946,0.0166393510930859,0.1428571428571428,0.2558139534883721,0.625,482,86,51,96,6,8716,2,8,36,325000,10833.333333333334,3500000.0,1000000.0,,,6,3450000,-0.1875,-0.59375
131708,Kenneth,Omeruo,2024,10484,Nigeria,"Obuohia Okike, Abia State",Nigeria,17-10-93,Centre-Back,Defender,Right,185.0,30-06-25,ISC,https://img.a.transfermarkt.technology/portrait/header/131708-1727694705.jpg?lm=1,TR1,Kas?mpa?a Spor KulÃ¼bÃ¼,1600000.0,5000000.0,31,125,138,7,8,10,6,12,3,12,5,15,14,11,4,16,12,12,14,16,11,12,11,10,14,12,7,11,12,11,13,13,12,16,12,17,14,13,14,9,12,10,5,13,1,1,2,1,1,1,2,2,3,3,2,15,12,5,12,12,13,13,16,1,1,20,16,1,13,1,1,1,1,1,1,1,1,80,8,20,2424409,6245,6595,5395,African_Caribbean,120,59,1,14999.0,Unknown,12036026,3000000.0,2.0,69,1069,70,1,1,1,117,2,0.6229161153744377,0.5716577540106952,0.5220588235294117,0.014474602817478,0.3881578947368421,0.0131578947368421,0.0077519379844961,0.0247561890472618,0.0166393510930859,0.1428571428571428,0.5116279069767438,0.5416666666666665,309,10,8,75,2,2485,12,42,93,1400000,35937.5,5000000.0,2000000.0,500000.0,,8,2350000,-0.3,-0.3
131731,Mehdi,Bourabia,2024,3205,France,Dijon,Morocco,07-08-91,Central Midfield,Midfield,Right,183.0,30-06-25,Unknown,https://img.a.transfermarkt.technology/portrait/header/131731-1712924162.jpg?lm=1,TR1,Kayserispor KulÃ¼bÃ¼,850000.0,4000000.0,33,126,131,11,11,12,9,13,14,8,12,6,10,13,11,14,14,16,12,14,13,13,12,12,14,14,11,14,11,13,13,12,12,13,10,14,13,14,13,13,15,12,10,11,4,2,1,3,1,4,1,3,2,3,4,12,14,14,10,10,15,12,9,1,1,1,1,1,1,20,10,20,8,8,14,5,1,76,11,20,2263620,6299,6449,4499,North_African__Middle_Eastern,124,8,0,21346.0,Unknown,85046580,1125000.0,4.0,34,413,67,3,1,6,118,1,0.6035988356708124,0.4758288770053475,0.5514705882352942,0.0206033756048385,0.0526315789473684,0.0,0.0040010002500625,0.0197549387346836,0.0062223950665296,0.4285714285714285,0.4651162790697669,0.625,291,20,20,62,2,6993,11,46,94,800000,28846.153846153848,4000000.0,700000.0,50000.0,,7,3050000,-0.2,-0.2
131758,Jesse,Joronen,2024,607,Finland,RautjÃ¤rvi,Finland,21-03-93,Goalkeeper,Goalkeeper,Left,197.0,30-06-25,RDF Football,https://img.a.transfermarkt.technology/portrait/header/131758-1724827205.jpg?lm=1,IT1,Venezia Football Club,1000000.0,5000000.0,31,123,132,3,2,2,1,5,5,5,1,1,3,6,4,1,5,13,11,14,9,11,6,11,14,1,8,1,14,10,5,10,14,11,17,9,9,13,13,12,9,12,10,13,16,15,13,7,12,13,15,15,13,7,15,15,17,2,10,11,16,14,14,20,1,1,1,1,1,1,1,1,1,1,1,1,1,89,20,6,2375105,6150,6150,6000,Northern_European,122,16,0,17787.0,Unknown,33020908,9111392.0,2.0,33,1205,35,2,0,7,210,5,0.5640381053188674,0.6363636363636364,0.536764705882353,0.0171667437551117,0.1052631578947368,0.0,0.0047511877969492,0.0247561890472618,0.0505924720131114,0.1428571428571428,0.7906976744186047,0.5416666666666665,0,0,0,0,0,0,12,88,215,1000000,34090.90909090909,5000000.0,2000000.0,,,4,3950000,0.0,0.25
131978,Ross,Barkley,2024,405,England,Liverpool,England,05-12-93,Central Midfield,Midfield,Right,189.0,Unknown,Wasserman,https://img.a.transfermarkt.technology/portrait/header/131978-1662368517.jpg?lm=1,GB1,Aston Villa Football Club,8000000.0,30000000.0,31,141,159,11,11,16,12,16,14,12,14,9,6,15,12,8,16,8,14,11,13,11,14,9,12,15,11,11,11,11,11,15,11,14,12,12,14,12,16,8,6,10,12,8,1,1,2,1,2,3,3,3,2,3,3,5,14,12,15,13,14,12,13,1,1,1,1,1,1,12,1,20,1,13,20,13,1,76,15,20,11700351,6900,6900,6000,Northern_European,135,33,6,29352.0,Unknown,28058224,9111392.0,2.0,32,845,33,3,1,7,30,1,0.6632707065361206,0.6363636363636364,0.6323529411764706,0.0283341074365082,0.2171052631578947,0.0789473684210526,0.0397599399849962,0.1497874468617154,0.0505924720131114,0.1428571428571428,0.6046511627906974,0.5416666666666665,438,66,51,38,1,9236,12,112,135,8000000,213888.88888888888,30000000.0,5500000.0,4500000.0,15000000.0,6,3500000,0.0,0.14285714285714285
131996,Bertrand,Traoré,2024,610,Burkina Faso,Bobo-Dioulasso,Burkina Faso,06-09-95,Right Winger,Attack,Left,181.0,30-06-26,MISTRA,https://img.a.transfermarkt.technology/portrait/header/131996-1696603763.jpg?lm=1,NL1,AFC Ajax Amsterdam,9000000.0,20000000.0,29,133,145,13,12,14,14,15,12,12,13,4,6,12,8,5,14,8,12,9,10,10,11,9,13,14,7,13,10,9,11,16,16,10,10,12,16,12,10,9,10,12,13,13,2,3,4,1,2,3,3,2,3,1,3,13,14,9,12,13,12,14,14,1,1,1,1,1,1,1,15,1,15,17,1,20,19,73,20,6,19622844,6700,6900,5650,African_Caribbean,124,64,12,69595.0,BaÅŸakÅŸehir Futbol KulÃ¼bÃ¼,13112706,14200000.0,2.0,12,209,13,0,0,1,6,10,0.6632707065361206,0.5989304812834224,0.5514705882352942,0.0671934430725168,0.4210526315789473,0.1578947368421052,0.0447611902975743,0.0997749437359339,0.0788633017583821,0.1428571428571428,0.418604651162791,0.4583333333333332,365,96,44,39,1,7494,14,67,67,9000000,339423.07692307694,20000000.0,4000000.0,1500000.0,4000000.0,9,15500000,0.0,-0.1
132098,Harry,Kane,2024,27,England,London,England,28-07-93,Centre-Forward,Attack,Right,188.0,30-06-27,CK66,https://img.a.transfermarkt.technology/portrait/header/132098-1700211169.jpg?lm=1,L1,FC Bayern MÃ¼nchen,100000000.0,150000000.0,31,183,185,9,15,14,19,15,10,15,15,6,10,18,20,11,16,11,15,14,18,15,18,18,19,12,15,16,12,18,16,12,12,14,13,16,14,16,15,17,8,14,12,9,1,1,3,1,3,2,1,2,2,3,1,10,18,12,18,18,20,11,16,1,1,1,1,1,1,1,1,11,1,13,15,1,20,86,19,20,347975206,9200,9200,8750,Northern_European,183,73,50,231983.0,Unknown,28049320,95000000.0,1.0,32,858,33,0,1,7,68,3,0.9675840169356972,0.9304812834224598,0.9852941176470588,0.2239980996652205,0.4802631578947368,0.6578947368421052,0.4998749687421855,0.7499374843710929,0.527764660129448,0.0,0.581395348837209,0.5416666666666665,589,380,99,53,0,12639,20,96,68,90000000,3196428.5714285714,150000000.0,30000000.0,,,2,22500000,-0.1,-0.18181818181818182
133179,Marten,De Roon,2024,800,Netherlands,Zwijndrecht,Netherlands,29-03-91,Defensive Midfield,Midfield,Right,185.0,30-06-26,SEG,https://img.a.transfermarkt.technology/portrait/header/133179-1663582942.jpg?lm=1,IT1,Atalanta Bergamasca Calcio S.p.a.,7000000.0,24000000.0,33,147,152,7,8,10,8,13,5,14,10,10,13,13,6,17,12,16,16,15,14,14,12,15,16,8,13,12,16,18,17,12,11,13,14,16,12,17,15,14,14,14,4,12,1,3,1,3,3,2,2,3,3,1,3,15,14,9,16,13,17,12,10,1,1,10,1,1,1,20,1,20,1,1,1,1,1,76,9,20,347975206,7350,7250,6300,Northern_European,145,27,0,35577.0,Unknown,37001813,9111392.0,2.0,67,1709,68,3,1,7,31,4,0.7095792537708389,0.6684491978609625,0.7058823529411764,0.0343450749174155,0.1776315789473684,0.0,0.0347586896724181,0.1197799449862465,0.0505924720131114,0.1428571428571428,0.5116279069767438,0.625,592,34,34,130,2,10162,12,31,65,7000000,210606.0606060606,24000000.0,5000000.0,50000.0,125000.0,5,8050000,0.0,-0.125
134270,Dan,Burn,2024,762,England,Blyth,England,09-05-92,Centre-Back,Defender,Left,201.0,30-06-25,Unknown,https://img.a.transfermarkt.technology/portrait/header/134270-1682340860.jpg?lm=1,GB1,Newcastle United Football Club,8000000.0,12000000.0,32,137,142,7,9,9,9,12,4,16,4,13,14,13,5,15,12,13,15,17,13,13,12,13,16,8,13,9,13,17,17,9,8,8,19,12,14,15,16,14,5,12,5,5,3,1,4,3,2,3,1,1,3,3,3,8,14,4,14,12,18,15,10,1,17,20,1,14,1,1,1,1,1,1,1,1,1,87,20,8,36895465,6850,6850,5500,Northern_European,137,0,0,57996.0,Unknown,29061164,9275000.0,2.0,32,206,33,1,0,7,137,2,0.6566551997883038,0.5828877005347594,0.6470588235294117,0.055993248404076,0.0,0.0,0.0397599399849962,0.0597649412353088,0.0515014305952943,0.1428571428571428,0.8837209302325584,0.5833333333333333,507,21,8,88,0,7360,6,26,50,7000000,279000.0,12000000.0,2000000.0,,,6,4025000,-0.125,-0.3
134294,Danny,Ings,2024,379,England,Winchester,England,23-07-92,Centre-Forward,Attack,Right,177.0,30-06-25,EAA,https://img.a.transfermarkt.technology/portrait/header/134294-1674218597.jpg?lm=1,GB1,West Ham United Football Club,8000000.0,22000000.0,32,143,160,4,11,13,16,13,10,13,12,3,8,13,13,11,16,13,14,14,14,14,14,12,18,14,14,14,10,16,15,14,14,15,11,13,13,14,14,14,5,10,13,9,1,4,2,1,2,2,2,2,2,1,2,13,17,8,15,14,18,13,16,1,1,1,1,1,1,1,1,1,1,10,12,12,20,74,10,20,38207678,7147,7147,5997,Northern_European,142,3,1,144990.0,Unknown,29030379,15190000.0,5.0,32,1669,33,0,1,7,220,3,0.695951309870336,0.636042780748663,0.6838235294117647,0.1399961568432813,0.0197368421052631,0.0131578947368421,0.0397599399849962,0.1097774443610902,0.0843634545404038,0.5714285714285714,0.3255813953488373,0.5833333333333333,418,125,41,32,0,7784,12,134,289,7000000,205147.0588235294,22000000.0,4500000.0,75000.0,500000.0,6,8450000,-0.125,-0.2222222222222222
134425,Raheem,Sterling,2024,11,Jamaica,Kingston,England,08-12-94,Left Winger,Attack,Right,170.0,31-05-25,Unknown,https://img.a.transfermarkt.technology/portrait/header/134425-1684165974.jpg?lm=1,GB1,Arsenal Football Club,35000000.0,160000000.0,30,168,180,8,13,15,13,13,10,12,12,5,7,13,8,8,13,12,18,11,12,13,13,13,13,14,12,20,9,14,15,18,18,14,8,20,17,18,12,14,4,13,2,14,2,2,3,3,2,1,3,2,1,2,3,18,16,12,8,11,17,10,14,1,1,1,1,1,1,1,16,1,17,20,12,20,12,69,8,20,197383136,8400,8400,7750,African_Caribbean,162,77,19,405971.0,Unknown,28054109,40200000.0,3.0,53,728,33,0,1,1,21,7,0.8617359089706271,0.8235294117647058,0.8308823529411764,0.3920039165436309,0.506578947368421,0.25,0.1747936984246061,0.7999499874968743,0.2233117586599627,0.2857142857142857,0.1627906976744184,0.5,590,182,113,69,0,12770,16,63,101,22000000,590909.0909090909,160000000.0,32000000.0,12500000.0,50000000.0,3,23000000,-0.37142857142857144,-0.5111111111111111
134602,Unknown,Zé Luís,2024,110302,Cape Verde,Fogo,Cape Verde,24-01-91,Centre-Forward,Attack,Left,184.0,30-06-25,ACE,https://img.a.transfermarkt.technology/portrait/header/134602-1617369617.png?lm=1,PO1,Avs Futebol SAD,300000.0,10000000.0,33,127,138,7,8,13,13,14,9,15,12,10,9,11,12,8,14,14,13,12,10,10,13,13,13,14,10,12,6,13,8,12,11,14,15,10,13,11,16,12,8,12,13,5,1,3,3,1,2,1,1,3,2,3,1,13,12,13,13,14,10,14,12,1,1,1,1,1,1,1,1,1,1,6,6,6,20,88,20,13,2676921,6350,6500,5500,Mixed_Race,126,19,3,19999.0,Unknown,55027773,9111392.0,2.0,17,496,17,0,0,4,35,3,0.6103466525535857,0.5828877005347594,0.5661764705882353,0.0193026891475241,0.125,0.0394736842105263,0.0012503125781445,0.0497624406101525,0.0505924720131114,0.1428571428571428,0.4883720930232553,0.625,351,104,43,45,1,7666,18,97,142,200000,4687.5,10000000.0,2500000.0,50000.0,900000.0,10,5800000,-0.3333333333333333,-0.3333333333333333
134999,Jens,Toornstra,2024,200,Netherlands,Alphen aan den Rijn,Netherlands,04-04-89,Attacking Midfield,Midfield,Right,178.0,30-06-25,SEG,https://img.a.transfermarkt.technology/portrait/header/134999-1723461038.jpg?lm=1,NL1,Football Club Utrecht,450000.0,7500000.0,35,133,141,12,11,14,9,14,12,8,13,9,7,14,14,7,14,12,15,13,12,14,15,14,16,13,17,14,9,17,17,12,13,12,9,14,12,14,10,14,11,13,5,12,1,2,3,1,3,1,2,1,3,1,3,9,10,4,12,16,18,17,11,1,1,1,1,1,1,1,16,20,18,16,19,19,5,76,8,20,347975206,6650,6650,5900,Northern_European,129,4,0,5999.0,Unknown,37017526,2225000.0,2.0,67,52,68,3,1,7,92,0,0.6301931727970362,0.6256684491978609,0.588235294117647,0.0057840474233951,0.0263157894736842,0.0,0.0020005001250312,0.0372593148287071,0.0123336759354426,0.1428571428571428,0.3488372093023257,0.7083333333333333,591,117,105,65,0,10482,10,22,48,350000,8333.333333333334,7500000.0,1500000.0,,50000.0,4,2900000,-0.2222222222222222,-0.36363636363636365
135343,Fabian,Schär,2024,762,Switzerland,Wil,Switzerland,20-12-91,Centre-Back,Defender,Right,186.0,30-06-25,Sports360 GmbH,https://img.a.transfermarkt.technology/portrait/header/135343-1667990394.jpg?lm=1,GB1,Newcastle United Football Club,10000000.0,16000000.0,33,138,138,6,9,12,10,13,12,15,12,8,15,13,14,15,12,17,13,13,14,14,14,12,12,9,11,9,15,16,12,10,10,12,14,12,13,13,15,12,15,14,10,4,4,2,3,2,2,1,2,1,1,2,2,10,13,6,12,14,15,14,16,1,1,20,10,1,8,13,1,1,1,1,1,1,1,84,12,20,38768484,6900,6750,5500,Northern_European,138,71,8,52196.0,Unknown,98007212,3666666.667,3.0,92,1667,92,1,1,7,137,2,0.6434241862926701,0.5828877005347594,0.6544117647058822,0.0503926682612226,0.4671052631578947,0.1052631578947368,0.0497624406101525,0.0797699424856214,0.0203431576821578,0.2857142857142857,0.5348837209302322,0.625,446,46,19,110,2,6333,32,86,88,9000000,235526.31578947368,16000000.0,3500000.0,50000.0,500000.0,4,5400000,-0.1,-0.1
135492,Youssouf,Sabaly,2024,150,France,Chesnay,Senegal,05-03-93,Right-Back,Defender,Right,173.0,30-06-26,NTS Management,https://img.a.transfermarkt.technology/portrait/header/135492-1532700291.jpg?lm=1,ES1,Real Betis BalompiÃ© S.A.D.,2500000.0,10000000.0,31,136,141,8,14,12,7,12,7,10,10,12,13,12,10,14,12,14,14,12,13,14,10,13,15,12,10,16,10,14,16,14,13,15,10,16,14,15,15,14,12,12,15,12,1,1,1,1,1,2,2,3,2,1,1,14,15,6,15,12,13,12,14,1,14,1,20,12,17,1,1,1,1,1,1,1,1,68,10,20,4121075,6450,6550,4500,African_Caribbean,135,24,0,20698.0,Unknown,85057304,4000000.0,1.0,34,354,84,1,1,1,164,11,0.6169621593014025,0.4759358288770053,0.6323529411764706,0.0199776556164645,0.1578947368421052,0.0,0.0122530632658164,0.0497624406101525,0.0221950609739159,0.0,0.2325581395348837,0.5416666666666665,329,5,27,34,1,6143,8,82,111,2000000,60344.8275862069,10000000.0,3500000.0,,1500000.0,5,4650000,-0.2,-0.5
136111,Nicola,Leali,2024,252,Italy,Castiglione delle Stiviere,Italy,17-02-93,Goalkeeper,Goalkeeper,Right,188.0,30-06-26,GB1,https://img.a.transfermarkt.technology/portrait/header/136111-1692963337.jpg?lm=1,IT1,Genoa Cricket and Football Club,600000.0,6000000.0,31,120,125,5,2,1,3,8,8,6,3,2,3,10,3,2,8,8,11,11,10,12,12,12,15,3,14,8,13,13,13,11,15,11,16,16,11,14,11,10,3,14,3,15,12,12,12,6,13,11,14,14,8,6,12,11,11,6,16,7,15,12,14,20,1,1,1,1,1,1,1,1,1,1,1,1,1,82,5,20,961916,5980,5980,3630,Mediterranean_Hispanic,119,0,0,9336.0,Unknown,43067875,3150000.0,2.0,52,331,54,2,1,3,104,5,0.54154538237629,0.3828877005347593,0.5147058823529411,0.0090063122400679,0.0,0.0,0.0027506876719179,0.0297574393598399,0.0174727075752104,0.1428571428571428,0.581395348837209,0.5416666666666665,0,0,0,0,0,0,4,17,62,800000,22727.272727272728,6000000.0,1500000.0,2600000.0,5500000.0,13,6650000,0.3333333333333333,-0.1111111111111111
136180,Fredrik,Midtsjø,2024,7160,Norway,StjÃ¸rdal,Norway,11-08-93,Central Midfield,Midfield,Right,176.0,30-06-25,Nordic Sky,https://img.a.transfermarkt.technology/portrait/header/136180-1671097018.png?lm=1,TR1,EyÃ¼p Spor KulÃ¼bÃ¼,2000000.0,10000000.0,31,135,143,10,11,14,7,12,11,9,9,5,11,12,8,12,12,14,15,14,13,15,13,14,16,13,14,13,13,16,17,12,13,14,11,15,13,16,13,16,6,12,5,16,1,1,1,3,3,2,2,2,3,1,3,15,15,3,16,12,15,15,5,1,1,10,12,1,1,19,1,20,17,1,13,1,1,69,12,20,8723286,6900,6350,5450,Northern_European,134,11,0,31249.0,Unknown,53049614,2900000.0,3.0,71,1425,73,3,1,7,66,1,0.590500132310135,0.5775401069518716,0.625,0.0301658833901277,0.0723684210526315,0.0,0.0097524381095273,0.0497624406101525,0.0160837801050029,0.2857142857142857,0.3023255813953489,0.5416666666666665,448,37,74,53,0,11318,12,63,220,1600000,40909.09090909091,10000000.0,2000000.0,500000.0,300000.0,6,4350000,-0.2,-0.42857142857142855
136184,Jonas,Svensson,2024,114,Norway,Verdal,Norway,06-03-93,Right-Back,Defender,Right,170.0,30-06-25,SEG,https://img.a.transfermarkt.technology/portrait/header/136184-1727356799.png?lm=1,TR1,Be?ikta? Jimnastik KulÃ¼bÃ¼,1800000.0,5500000.0,31,125,137,7,11,12,7,13,9,5,7,11,8,13,10,12,11,16,11,18,12,13,11,12,16,11,10,12,13,16,18,13,13,13,9,18,12,18,12,15,9,10,2,15,1,3,2,3,3,2,3,4,1,1,3,14,15,2,16,13,19,18,12,1,8,4,20,4,16,6,1,4,12,1,2,8,1,65,8,20,7113975,6400,6500,5000,Northern_European,123,23,1,29999.0,Unknown,53049626,1700000.0,1.0,71,1574,73,1,1,7,37,11,0.6103466525535857,0.5294117647058822,0.5441176470588236,0.0289588618076162,0.1513157894736842,0.0131578947368421,0.0087521880470117,0.0272568142035508,0.0094169282480068,0.0,0.1627906976744184,0.5416666666666665,511,27,78,70,3,12834,12,40,86,1700000,45833.333333333336,5500000.0,1000000.0,900000.0,1400000.0,3,1750000,0.0,-0.34615384615384615
136514,Charalampos,Lykogiannis,2024,1025,Greece,PirÃ¤us,Greece,22-10-93,Left-Back,Defender,Left,191.0,30-06-25,BSP FOOTBALL AGENCY,https://img.a.transfermarkt.technology/portrait/header/136514-1663656826.jpg?lm=1,IT1,Bologna Football Club 1909,1000000.0,2500000.0,31,124,133,14,13,11,10,11,15,12,15,15,11,11,10,12,12,15,13,14,13,13,11,12,15,10,9,13,11,13,10,13,12,14,13,14,14,13,13,13,12,12,8,12,3,1,4,1,1,3,2,2,1,3,2,13,13,6,13,14,14,10,9,1,20,16,1,19,1,10,13,5,1,9,1,1,1,82,20,7,1917357,6200,5750,5400,Mediterranean_Hispanic,123,6,0,17787.0,Unknown,36045542,800000.0,1.0,40,1150,42,1,0,3,40,8,0.5111140513363324,0.5721925133689839,0.5441176470588236,0.0171667437551117,0.0394736842105263,0.0,0.0047511877969492,0.0122530632658164,0.0044167893552598,0.0,0.6511627906976742,0.5416666666666665,321,18,21,62,0,6604,11,45,52,1000000,25862.068965517243,2500000.0,700000.0,400000.0,500000.0,5,900000,0.0,0.0
137206,Magomed,Ozdoev,2024,1091,Russia,Grozny,Russia,05-11-92,Central Midfield,Midfield,Right,184.0,30-06-25,Unknown,https://img.a.transfermarkt.technology/portrait/header/137206-1727967396.png?lm=1,GR1,Panthessalonikios Athlitikos Omilos Konstantinoupoliton,2000000.0,7000000.0,32,130,139,10,10,11,10,12,11,10,13,8,13,14,13,13,14,13,13,12,10,13,13,13,13,13,13,12,12,14,14,13,13,12,11,14,13,13,11,13,9,11,8,13,2,3,3,1,3,2,2,1,2,2,4,10,14,12,11,11,11,8,7,1,1,1,1,1,1,18,10,20,1,5,14,1,5,77,12,20,5452053,6450,6500,5000,North_African__Middle_Eastern,130,35,4,19999.0,Unknown,58031133,1283333.333,3.0,78,566,81,3,1,6,153,1,0.6103466525535857,0.5294117647058822,0.5955882352941175,0.0193026891475241,0.2302631578947368,0.0526315789473684,0.0097524381095273,0.0347586896724181,0.0071020491291424,0.2857142857142857,0.4883720930232553,0.5833333333333333,454,36,36,77,1,11059,5,32,115,1800000,50000.0,7000000.0,1500000.0,1000000.0,2000000.0,6,2200000,-0.1,-0.1
137326,Hendrik,Van Crombrugge,2024,1184,Belgium,Leuven,Belgium,30-04-93,Goalkeeper,Goalkeeper,Left,187.0,30-06-26,Stirr Associates,https://img.a.transfermarkt.technology/portrait/header/137326-1714036449.png?lm=1,BE1,Koninklijke Racing Club Genk,1500000.0,7000000.0,31,128,138,4,3,10,1,12,6,12,2,2,2,14,12,2,11,12,11,14,13,14,10,13,13,3,12,2,10,14,14,12,12,12,14,10,12,12,11,15,11,12,9,11,13,10,12,10,12,15,11,16,8,10,10,16,12,6,15,14,14,12,10,20,1,1,1,1,1,1,1,1,1,1,1,1,1,85,20,8,8226898,6554,6554,5005,Northern_European,128,1,0,22499.0,Unknown,18027244,1775000.0,2.0,7,826,8,2,0,7,122,5,0.6174913998412278,0.5299465240641711,0.5808823529411764,0.0217167323125471,0.006578947368421,0.0,0.0072518129532383,0.0347586896724181,0.0098336064890691,0.1428571428571428,0.5581395348837206,0.5416666666666665,0,0,0,0,0,0,6,47,220,2000000,70370.37037037036,7000000.0,1500000.0,100000.0,,3,1900000,0.3333333333333333,0.1111111111111111
137576,Hans,Vanaken,2024,2282,Belgium,Neerpelt,Belgium,24-08-92,Attacking Midfield,Midfield,Right,195.0,30-06-27,SportPlus,https://img.a.transfermarkt.technology/portrait/header/137576-1705414489.jpg?lm=1,BE1,Club Brugge Koninklijke Voetbalvereniging,7000000.0,16000000.0,32,135,135,13,11,12,13,13,13,15,13,8,8,15,14,8,13,14,11,13,16,14,17,16,12,14,14,16,11,14,14,9,14,10,14,15,9,14,13,15,12,12,8,12,1,2,2,1,2,1,4,3,1,1,3,12,9,14,12,13,14,12,16,1,1,1,1,1,1,1,1,19,1,1,20,1,1,77,10,20,17820001,6900,6750,5250,Northern_European,133,21,5,79999.0,Unknown,18051194,2212500.0,2.0,7,1025,8,3,1,7,53,0,0.6434241862926701,0.5561497326203209,0.6176470588235294,0.0772397251080767,0.1381578947368421,0.0657894736842105,0.0347586896724181,0.0797699424856214,0.0122642295619322,0.1428571428571428,0.7441860465116279,0.5833333333333333,667,180,133,77,2,19696,4,6,16,6000000,160810.8108108108,16000000.0,3000000.0,150000.0,700000.0,2,1300000,-0.14285714285714285,-0.29411764705882354
137616,Okay,Yoku?Lu,2024,449,TÃ¼rkiye,Izmir,TÃ¼rkiye,09-03-94,Defensive Midfield,Midfield,Right,191.0,30-06-27,FutureBall,https://img.a.transfermarkt.technology/portrait/header/137616-1723801909.jpg?lm=1,TR1,Trabzonspor KulÃ¼bÃ¼,3000000.0,12000000.0,30,132,146,8,10,11,11,14,12,15,11,5,13,14,13,15,14,12,15,13,13,11,12,12,12,13,11,13,14,14,14,10,10,15,15,12,12,14,15,11,13,11,10,10,3,2,1,2,2,3,2,2,3,2,1,9,15,5,15,12,15,14,12,1,1,13,1,1,1,20,1,18,1,1,10,1,1,79,10,20,11267518,6596,6596,4996,Mediterranean_Hispanic,132,38,1,34798.0,Unknown,70052844,2662500.0,4.0,100,682,100,3,1,3,204,4,0.623048425509394,0.5289839572192513,0.6102941176470589,0.0335928590671944,0.25,0.0131578947368421,0.0147536884221055,0.0597649412353088,0.0147642990083057,0.4285714285714285,0.6511627906976742,0.5,464,30,18,96,2,7231,17,40,48,3000000,77142.85714285714,12000000.0,4500000.0,2500000.0,3000000.0,8,7000000,0.0,0.0
137648,Sverrir Ingi,Ingason,2024,265,Iceland,KÃ³pavogur,Iceland,05-08-93,Centre-Back,Defender,Right,188.0,30-06-28,SEG,https://img.a.transfermarkt.technology/portrait/header/137648-1613846710.jpg?lm=1,GR1,Panathinaikos Athlitikos Omilos,3500000.0,6000000.0,31,125,130,8,8,10,10,10,8,13,11,13,14,11,8,15,8,13,16,14,12,14,7,12,16,10,16,9,12,14,16,11,11,14,14,14,12,13,12,14,6,15,6,5,1,1,1,1,1,2,2,1,2,2,4,14,15,3,10,14,13,14,12,1,1,20,1,1,1,10,1,1,1,1,1,1,1,75,6,20,4410448,6250,5750,4259,Northern_European,124,39,3,28384.0,Unknown,39017860,2976000.0,5.0,46,776,48,1,1,7,150,2,0.5111140513363324,0.4501604278074866,0.5514705882352942,0.0273993899230113,0.256578947368421,0.0394736842105263,0.0172543135783946,0.0297574393598399,0.0165060140559459,0.5714285714285714,0.581395348837209,0.5416666666666665,444,35,12,81,0,14124,5,36,175,3000000,101724.13793103448,6000000.0,1000000.0,,500000.0,7,2450000,-0.25,-0.25
138055,Haris,Belkebla,2024,1420,France,Drancy,Algeria,28-01-94,Central Midfield,Midfield,Right,177.0,30-06-26,Unknown,https://img.a.transfermarkt.technology/portrait/header/138055-1617877225.jpg?lm=1,FR1,Angers Sporting Club de l'Ouest,1500000.0,4000000.0,30,126,127,10,10,12,10,14,9,8,10,7,11,14,9,14,13,15,14,15,13,14,13,13,14,12,13,12,12,14,16,12,11,15,8,15,11,17,11,13,13,13,6,13,1,2,3,1,3,2,3,1,2,1,2,9,14,7,12,9,12,10,8,1,1,1,1,1,1,19,1,20,1,1,1,1,1,68,7,20,2567265,6291,6291,3791,North_African__Middle_Eastern,126,10,0,6898.0,Unknown,85099581,9111392.0,2.0,34,430,1,3,1,6,18,1,0.582693834347711,0.4001069518716577,0.5661764705882353,0.0066521373455374,0.0657894736842105,0.0,0.0072518129532383,0.0197549387346836,0.0505924720131114,0.1428571428571428,0.3255813953488373,0.5,373,11,6,59,1,2677,4,11,48,2000000,68000.0,4000000.0,1000000.0,,300000.0,3,700000,0.17647058823529413,-0.2
138927,Daniel,Carvajal,2024,418,Spain,LeganÃ©s,Spain,11-01-92,Right-Back,Defender,Right,173.0,30-06-26,Unknown,https://img.a.transfermarkt.technology/portrait/header/138927-1721026790.jpg?lm=1,ES1,Real Madrid Club de FÃºtbol,12000000.0,60000000.0,32,152,162,11,14,13,8,13,8,10,10,13,14,13,9,15,12,17,13,18,13,13,12,13,16,12,14,17,14,16,18,15,14,17,8,14,14,16,13,14,12,12,18,13,3,1,1,1,1,1,3,1,3,2,3,15,15,5,19,14,19,8,9,1,14,1,20,10,18,1,1,1,8,1,1,1,1,74,10,20,23822102,7592,7592,6992,Mediterranean_Hispanic,150,29,0,178081.0,Unknown,67139735,5750000.0,2.0,89,811,89,1,1,3,167,11,0.7548293199259064,0.7424598930481283,0.7426470588235294,0.171949397792792,0.1907894736842105,0.0,0.0597649412353088,0.2998249562390597,0.0319175532653684,0.1428571428571428,0.2325581395348837,0.5833333333333333,531,18,82,152,2,14205,29,209,300,10000000,125000.0,60000000.0,10000000.0,,6000000.0,1,0,-0.16666666666666666,-0.16666666666666666
139208,Virgil,Van Dijk,2024,31,Netherlands,Breda,Netherlands,08-07-91,Centre-Back,Defender,Right,195.0,30-06-25,ROOF,https://img.a.transfermarkt.technology/portrait/header/139208-1702049837.jpg?lm=1,GB1,Liverpool Football Club,30000000.0,100000000.0,33,181,183,3,5,13,8,17,12,18,7,8,17,16,7,17,16,17,17,15,17,16,14,17,16,12,17,8,17,14,12,15,12,15,17,17,16,14,17,18,12,18,5,4,3,2,1,3,3,2,3,1,3,2,3,18,18,10,12,17,16,12,18,1,1,20,1,1,1,12,1,1,1,1,1,1,10,92,9,20,347975206,9150,8700,8500,African_Caribbean,182,47,5,278380.0,Unknown,37024025,34366666.67,3.0,67,248,68,1,1,1,129,2,0.9014289494575284,0.9037433155080212,0.977941176470588,0.2687998439562498,0.3092105263157894,0.0657894736842105,0.1497874468617154,0.4998749687421855,0.1909034510403066,0.2857142857142857,0.7441860465116279,0.625,569,56,25,55,4,13660,17,136,255,28000000,822058.8235294118,100000000.0,20000000.0,,1250000.0,4,26350000,-0.06666666666666667,-0.125
139279,Nicolas,Pallois,2024,995,France,Elbeuf,France,19-09-87,Centre-Back,Defender,Left,189.0,30-06-25,Sport Cover,https://img.a.transfermarkt.technology/portrait/header/139279-1704213256.jpg?lm=1,FR1,Football Club de Nantes,600000.0,3500000.0,37,130,133,5,8,8,7,7,7,15,11,9,15,9,6,15,9,18,14,17,11,14,10,11,15,6,14,7,14,14,15,11,11,16,13,14,13,15,16,14,15,14,9,8,2,4,3,3,1,2,2,1,3,1,4,12,14,12,14,8,14,13,9,1,12,20,1,10,1,1,1,1,1,1,1,1,1,89,20,8,347975206,6500,6500,4007,Northern_European,130,0,0,25298.0,Unknown,85074521,1250000.0,2.0,34,456,36,1,0,7,93,2,0.6103466525535857,0.4232085561497326,0.5955882352941175,0.0244194950401069,0.0,0.0,0.0027506876719179,0.0172543135783946,0.0069168588016333,0.1428571428571428,0.6046511627906974,0.7916666666666665,460,17,11,95,4,7071,13,57,141,500000,8064.5161290322585,3500000.0,1500000.0,,,4,1600000,-0.16666666666666666,-0.375
139336,Paulo,Oliveira,2024,1075,Portugal,Vila Nova de FamalicÃ£o,Portugal,08-01-92,Centre-Back,Defender,Right,187.0,30-06-25,PromoSport,https://img.a.transfermarkt.technology/portrait/header/139336-1445431882.jpg?lm=1,PO1,Sporting Clube de Braga,1500000.0,8500000.0,32,133,144,6,6,7,7,11,10,12,7,8,14,10,11,15,9,10,15,11,10,15,10,14,15,5,13,7,14,14,14,12,14,13,15,14,13,13,13,14,6,12,6,11,2,3,1,1,2,2,2,1,4,2,1,13,14,10,12,12,17,10,14,1,1,20,1,1,1,1,1,1,1,1,1,1,1,82,9,20,7245164,6650,6500,5150,Mediterranean_Hispanic,134,1,0,6499.0,Unknown,55024825,2900000.0,2.0,76,1588,79,1,1,3,192,2,0.6103466525535857,0.5454545454545454,0.625,0.0062668560563997,0.006578947368421,0.0,0.0072518129532383,0.0422605651412853,0.0160837801050029,0.1428571428571428,0.5581395348837206,0.5833333333333333,450,11,5,78,0,10663,6,33,57,1000000,30000.0,8500000.0,3500000.0,100000.0,700000.0,5,3300000,-0.3333333333333333,-0.5
139341,Josué,Sá,2024,2424,Portugal,Lisboa,Portugal,17-06-92,Centre-Back,Defender,Right,187.0,30-06-27,MadeinFootball,https://img.a.transfermarkt.technology/portrait/header/139341-1676542787.jpg?lm=1,PO1,Gil Vicente Futebol Clube,500000.0,2500000.0,32,122,131,5,6,8,7,11,7,13,6,10,14,12,10,12,9,10,14,13,12,14,12,13,13,3,12,8,15,14,12,11,11,13,13,13,11,12,13,14,11,12,9,8,3,1,3,2,3,2,3,2,3,1,3,15,10,8,19,14,16,14,15,1,1,20,1,1,1,10,1,1,1,1,1,1,1,75,8,20,962278,6100,6100,5000,Mediterranean_Hispanic,121,0,0,2500.0,Unknown,55028148,1200000.0,2.0,76,843,79,1,1,3,106,2,0.5574225985710506,0.5294117647058822,0.5294117647058822,0.0024053526096289,0.0,0.0,0.0022505626406601,0.0122530632658164,0.0066390733075918,0.1428571428571428,0.5581395348837206,0.5833333333333333,328,15,8,64,2,7847,9,28,64,400000,11111.111111111111,2500000.0,600000.0,,400000.0,8,2050000,-0.2,-0.2
139393,Unknown,Tomané,2024,4294,Portugal,Fafe,Portugal,23-10-92,Centre-Forward,Attack,Right,186.0,30-06-26,Footleet,https://img.a.transfermarkt.technology/portrait/header/139393-1633107752.png?lm=1,PO1,Sporting Clube Farense,200000.0,2500000.0,32,120,125,7,7,11,12,12,7,14,8,5,6,11,12,6,14,11,13,14,13,13,9,12,16,11,10,15,7,15,16,12,13,14,14,13,12,14,13,12,6,10,11,14,3,3,3,3,3,2,1,3,1,2,2,8,12,10,15,12,15,11,12,1,1,1,1,1,1,1,1,1,1,1,1,1,20,75,9,20,1821177,5950,5700,3950,Mediterranean_Hispanic,120,0,0,9000.0,Unknown,55024252,483333.3333,3.0,76,480,79,0,1,3,191,3,0.5044985445885155,0.4171122994652406,0.5220588235294117,0.0086818648386888,0.0,0.0,0.0007501875468867,0.0122530632658164,0.0026574812261451,0.2857142857142857,0.5348837209302322,0.5833333333333333,354,69,48,50,1,5850,5,44,141,200000,3030.3030303030305,2500000.0,1300000.0,100000.0,800000.0,9,2500000,0.0,-0.2727272727272727
139395,Ricardo,Esgaio,2024,336,Portugal,NazarÃ©,Portugal,16-05-93,Right-Back,Defender,Right,172.0,30-06-26,Proeleven S.A.,https://img.a.transfermarkt.technology/portrait/header/139395-1591776235.png?lm=1,PO1,Sporting Clube de Portugal,3000000.0,6000000.0,31,128,136,12,13,12,9,12,10,7,11,11,11,13,14,14,12,13,11,13,11,9,13,12,15,12,12,13,11,14,15,13,12,12,7,15,13,14,10,16,7,12,6,20,1,3,1,2,1,3,1,2,3,4,2,13,13,6,16,9,17,12,13,1,15,12,20,12,20,1,1,13,18,1,1,14,1,73,10,20,6368625,6750,6400,5000,Mediterranean_Hispanic,116,0,0,16874.0,Unknown,55022375,5500000.0,1.0,76,1021,79,1,1,3,193,11,0.5971156390579518,0.5294117647058822,0.4926470588235294,0.0162851351912453,0.0,0.0,0.0147536884221055,0.0297574393598399,0.0305286257951609,0.0,0.2093023255813952,0.5416666666666665,464,44,60,112,0,13345,3,6,14,2000000,18518.51851851852,6000000.0,1500000.0,,2000000.0,4,3000000,-0.3333333333333333,-0.42857142857142855
139396,Unknown,Bruma,2024,1075,Guinea-Bissau,Bissau,Portugal,24-10-94,Left Winger,Attack,Right,173.0,30-06-27,CatiÃ³ BaldÃ©,https://img.a.transfermarkt.technology/portrait/header/139396-1700235976.jpg?lm=1,PO1,Sporting Clube de Braga,7000000.0,12500000.0,30,125,135,11,11,16,12,13,10,7,13,4,6,12,11,6,14,12,11,8,9,7,13,8,13,17,5,13,7,12,14,16,15,11,7,12,16,12,8,8,6,12,12,13,4,4,1,3,2,1,2,1,3,3,2,9,17,14,7,12,12,14,10,1,1,1,1,1,1,1,19,1,16,20,10,16,9,70,8,20,2846249,6250,6895,4996,African_Caribbean,120,9,1,23972.0,FenerbahÃ§e A.Åž.,55026952,10150000.0,5.0,44,202,79,0,1,1,192,7,0.662609155861339,0.5289839572192513,0.5220588235294117,0.0231390865453787,0.0592105263157894,0.0131578947368421,0.0347586896724181,0.0622655663915979,0.0563626767410205,0.5714285714285714,0.2325581395348837,0.5,434,87,69,33,2,12578,17,133,166,8000000,203225.8064516129,12500000.0,2500000.0,10000000.0,7000000.0,10,15350000,0.14285714285714285,0.23076923076923078
139435,Dani,Rodríguez,2024,237,Spain,Betanzos,Spain,06-06-88,Attacking Midfield,Midfield,Right,178.0,30-06-25,PROTIO SPORT,https://img.a.transfermarkt.technology/portrait/header/139435-1583332711.jpg?lm=1,ES1,Real Club Deportivo Mallorca S.A.D.,1000000.0,1500000.0,36,128,130,10,12,14,13,13,11,11,16,3,5,12,10,6,13,13,12,12,13,12,13,14,15,13,13,13,8,14,14,12,13,12,9,12,14,13,10,14,6,11,4,8,3,4,1,1,1,2,3,2,3,2,3,14,10,3,8,13,12,13,14,1,1,1,1,1,1,18,1,20,1,15,16,15,1,69,12,20,379939,6350,6350,3750,Mediterranean_Hispanic,121,0,0,7875.0,Unknown,1509441,9111392.0,2.0,89,182,89,3,1,3,166,0,0.590500132310135,0.3957219251336898,0.5294117647058822,0.0075955454144284,0.0,0.0,0.0047511877969492,0.0072518129532383,0.0505924720131114,0.1428571428571428,0.3488372093023257,0.75,565,60,43,115,4,3329,0,0,0,900000,42857.142857142855,1500000.0,300000.0,,,2,350000,-0.1,-0.25
140554,Martin,Boyle,2024,903,Scotland,Aberdeen,Australia,25-04-93,Right Winger,Attack,Right,172.0,31-05-25,FullNinety,https://img.a.transfermarkt.technology/portrait/header/140554-1668506185.jpg?lm=1,SC1,Hibernian Football Club,1300000.0,2500000.0,31,123,130,9,12,11,14,10,6,5,10,2,2,8,12,5,10,10,9,7,10,7,8,8,14,12,5,12,9,13,15,16,11,12,4,13,17,12,11,11,4,11,8,7,1,1,1,1,1,1,1,1,1,1,1,7,12,5,11,10,11,8,14,1,1,1,1,1,16,1,1,1,16,1,1,20,15,0,10,20,4088013,6150,6150,4500,Northern_European,104,18,5,8699.0,Unknown,61039990,3450000.0,1.0,82,13,6,0,1,7,114,10,0.5640381053188674,0.4759358288770053,0.4044117647058823,0.00839121404162,0.1184210526315789,0.0657894736842105,0.0062515628907226,0.0122530632658164,0.0191394205394594,0.0,0.2093023255813952,0.5416666666666665,523,137,93,62,2,11624,10,87,191,800000,32608.695652173912,2500000.0,500000.0,,50000.0,5,700000,-0.38461538461538464,-0.5555555555555556
140808,Davy,Roef,2024,157,Belgium,Rumst,Belgium,06-02-94,Goalkeeper,Goalkeeper,Right,187.0,30-06-25,SportPlus,https://img.a.transfermarkt.technology/portrait/header/140808-1660750049.jpg?lm=1,BE1,Koninklijke Atletiek Associatie Gent,2000000.0,2500000.0,30,122,122,6,3,3,3,13,8,13,2,2,3,13,5,1,12,10,14,11,14,12,11,16,14,1,4,3,13,11,15,13,14,10,14,16,12,14,10,14,7,9,13,12,13,12,5,5,13,12,13,14,12,8,12,12,14,2,11,10,18,11,15,20,1,1,1,1,1,1,1,1,1,1,1,1,1,84,5,20,2699999,6100,6100,5000,Northern_European,124,0,0,9500.0,Unknown,18050692,9111392.0,2.0,7,1260,8,2,1,7,120,5,0.5574225985710506,0.5294117647058822,0.5514705882352942,0.0091646734716934,0.0,0.0,0.0097524381095273,0.0122530632658164,0.0505924720131114,0.1428571428571428,0.5581395348837206,0.5,0,0,0,0,0,0,3,13,36,2500000,72727.27272727272,2500000.0,500000.0,,1000000.0,5,1075000,0.6666666666666666,0.3888888888888889
142021,Sergi,Darder,2024,237,Spain,ArtÃ ,Spain,22-12-93,Central Midfield,Midfield,Right,180.0,30-06-28,LIAN Sports Group,https://img.a.transfermarkt.technology/portrait/header/142021-1664975574.jpg?lm=1,ES1,Real Club Deportivo Mallorca S.A.D.,6000000.0,16000000.0,31,145,154,7,9,11,7,15,11,10,12,5,14,16,10,15,16,13,14,13,13,14,17,13,15,12,8,16,14,13,13,13,13,13,10,12,12,13,12,13,10,12,7,11,1,2,3,3,1,1,2,2,3,2,3,12,15,7,12,16,15,11,12,1,1,1,1,1,1,18,1,20,1,1,1,1,1,72,12,20,15315091,7150,7150,5750,Mediterranean_Hispanic,144,0,0,36413.0,Unknown,67118372,9700000.0,3.0,89,96,89,3,1,3,166,1,0.696348240275205,0.6096256684491979,0.6985294117647058,0.0351523309517992,0.0,0.0,0.0297574393598399,0.0797699424856214,0.053862607294647,0.2857142857142857,0.3953488372093026,0.5416666666666665,452,38,42,66,2,3726,2,2,7,4000000,106060.60606060606,16000000.0,8000000.0,,2500000.0,3,12500000,-0.3333333333333333,-0.5
142031,Omar,Mascarell,2024,237,Spain,Santa Cruz de Tenerife,Equatorial Guinea,02-02-93,Defensive Midfield,Midfield,Right,181.0,30-06-26,LEADERBROCK,https://img.a.transfermarkt.technology/portrait/header/142031-1531813358.jpg?lm=1,ES1,Real Club Deportivo Mallorca S.A.D.,1000000.0,14000000.0,31,133,138,12,11,11,8,13,10,6,10,8,12,14,13,13,15,10,15,15,15,12,12,15,17,9,15,10,14,16,14,9,13,15,9,13,11,16,13,13,14,13,12,8,1,3,3,3,3,2,2,3,2,1,1,12,16,9,12,14,14,8,11,1,1,1,1,1,1,20,1,20,1,1,12,1,1,76,8,20,4135917,6500,6500,4500,North_African__Middle_Eastern,131,0,0,28766.0,Unknown,67153634,3900000.0,4.0,89,1324,34,3,1,6,166,4,0.6103466525535857,0.4759358288770053,0.6029411764705883,0.0277682557186268,0.0,0.0,0.0047511877969492,0.0697674418604651,0.0216394899858329,0.4285714285714285,0.418604651162791,0.5416666666666665,391,13,14,90,1,5085,12,77,137,900000,18750.0,14000000.0,3000000.0,,400000.0,6,4500000,-0.1,-0.1
142310,Willy,Boly,2024,703,France,Melun,Cote d'Ivoire,03-02-91,Centre-Back,Defender,Right,195.0,30-06-25,Sport Cover,https://img.a.transfermarkt.technology/portrait/header/142310-1663057112.jpg?lm=1,GB1,Nottingham Forest Football Club,2500000.0,18000000.0,33,137,150,2,4,12,9,11,3,16,9,5,13,13,5,15,13,17,15,14,13,11,11,12,13,13,12,9,15,13,13,12,11,16,17,10,12,11,17,12,13,13,17,6,3,1,3,1,4,2,1,2,1,1,1,13,15,8,9,14,11,14,14,1,1,20,1,1,1,1,1,1,1,1,1,1,1,97,8,20,347975206,6900,5833,5833,African_Caribbean,134,13,1,57996.0,Unknown,85009974,7033333.333,3.0,34,940,24,1,1,1,140,2,0.5220957925377084,0.6185026737967914,0.625,0.055993248404076,0.0855263157894736,0.0131578947368421,0.0122530632658164,0.0897724431107777,0.0390473809439151,0.2857142857142857,0.7441860465116279,0.625,375,20,8,44,4,8270,9,78,89,2000000,44117.64705882353,18000000.0,4000000.0,,2000000.0,5,5500000,-0.2,-0.2
142389,Mark,Gillespie,2024,762,England,Newcastle upon Tyne,England,27-03-92,Goalkeeper,Goalkeeper,Right,191.0,30-06-25,Unknown,https://img.a.transfermarkt.technology/portrait/header/142389-1600681751.jpg?lm=1,GB1,Newcastle United Football Club,300000.0,500000.0,32,120,135,3,2,1,3,8,1,9,2,3,3,9,2,3,11,9,10,13,10,11,8,12,11,5,7,9,11,7,11,9,12,9,12,13,9,14,13,13,7,13,6,3,14,15,13,4,16,11,12,14,16,4,17,12,11,2,8,11,12,12,10,20,1,1,1,1,1,1,1,1,1,1,1,1,1,83,7,20,1911177,6000,6000,3750,Northern_European,118,0,0,6960.0,Unknown,29036230,9111392.0,2.0,32,1037,33,2,1,7,137,5,0.5441915850754168,0.3957219251336898,0.5073529411764706,0.00671200561603,0.0,0.0,0.0012503125781445,0.0022505626406601,0.0505924720131114,0.1428571428571428,0.6511627906976742,0.5833333333333333,0,0,0,0,0,0,2,50,171,300000,13888.888888888889,500000.0,100000.0,50000.0,,2,150000,0.0,0.0
143424,Alex,Oxlade-Chamberlain,2024,114,England,Portsmouth,England,15-08-93,Central Midfield,Midfield,Right,180.0,30-06-26,Cassius Sports,https://img.a.transfermarkt.technology/portrait/header/143424-1727356614.png?lm=1,TR1,Be?ikta? Jimnastik KulÃ¼bÃ¼,3000000.0,40000000.0,31,149,158,11,14,15,12,15,11,8,14,12,11,15,12,11,15,11,13,12,14,13,14,13,14,15,9,15,12,15,14,14,15,15,9,13,15,14,14,12,6,13,14,15,2,2,1,2,3,1,3,3,3,3,2,16,14,9,14,12,16,14,14,1,1,1,1,1,14,8,12,20,15,14,16,17,12,72,9,20,29222958,7450,7150,6000,Mixed_Race,147,35,7,144990.0,Unknown,28046572,9111392.0,2.0,32,1173,33,3,1,4,37,1,0.696348240275205,0.6363636363636364,0.7205882352941175,0.1399961568432813,0.2302631578947368,0.0921052631578947,0.0147536884221055,0.1997999499874969,0.0505924720131114,0.1428571428571428,0.3953488372093026,0.5416666666666665,432,53,51,14,1,12560,21,244,317,2300000,59210.52631578947,40000000.0,7000000.0,13500000.0,17000000.0,4,12550000,-0.4523809523809524,-0.6166666666666667
143559,Matija,Nastasic,2024,1244,Yugoslavia (Republic),Valjevo,Serbia,28-03-93,Centre-Back,Defender,Left,188.0,30-06-26,LIAN Sports Group,https://img.a.transfermarkt.technology/portrait/header/143559-1531813376.jpg?lm=1,ES1,Club Deportivo LeganÃ©s S.A.D.,1500000.0,22000000.0,31,125,146,5,7,7,5,11,5,13,6,6,14,12,6,15,11,6,15,15,13,11,8,13,12,8,10,4,14,16,9,11,11,13,15,12,12,12,15,11,10,15,14,7,1,3,1,3,2,1,3,3,1,1,1,15,11,8,10,13,14,12,17,1,14,20,1,10,1,1,1,1,1,1,1,1,1,83,20,9,1794209,6250,6400,5500,Northern_European,124,34,0,6639.0,Unknown,62055271,6925000.0,4.0,110,1557,85,1,0,7,54,2,0.5971156390579518,0.5828877005347594,0.5514705882352942,0.006402042473641,0.2236842105263157,0.0,0.0072518129532383,0.1097774443610902,0.0384455123753437,0.4285714285714285,0.581395348837209,0.5416666666666665,336,8,2,63,1,8203,22,182,246,1300000,29729.72972972973,22000000.0,8000000.0,4000000.0,21000000.0,6,21400000,-0.13333333333333333,-0.13333333333333333
143798,Pavel,Kaderabek,2024,533,CSSR,Praha,Czech Republic,25-04-92,Right-Back,Defender,Right,182.0,30-06-25,SPORT INVEST,https://img.a.transfermarkt.technology/portrait/header/143798-1657200722.jpg?lm=1,L1,TSG 1899 Hoffenheim FuÃŸball-Spielbetriebs GmbH,3000000.0,20000000.0,32,135,139,7,14,11,9,10,7,11,11,15,11,10,11,13,10,13,10,15,8,13,10,9,16,10,12,14,11,14,16,14,11,16,11,14,16,17,14,15,12,14,11,10,1,3,1,2,2,3,2,2,3,2,1,12,15,3,13,12,16,14,17,1,12,1,20,10,20,1,1,1,15,1,1,15,1,81,10,20,6832812,6743,6843,6493,Northern_European,124,48,3,38462.0,Unknown,25019787,3500000.0,1.0,14,1180,28,1,1,7,199,11,0.6557290288436094,0.6890909090909091,0.5514705882352942,0.0371308807298521,0.3157894736842105,0.0394736842105263,0.0147536884221055,0.0997749437359339,0.0194172060335009,0.0,0.4418604651162785,0.5833333333333333,440,32,57,61,0,7406,28,85,63,2500000,68571.42857142857,20000000.0,3500000.0,100000.0,1000000.0,3,850000,-0.16666666666666666,-0.16666666666666666
143812,Matías,Vecino,2024,398,Uruguay,San Jacinto,Uruguay,24-08-91,Central Midfield,Midfield,Right,187.0,30-06-25,World Soccer Agency,https://img.a.transfermarkt.technology/portrait/header/143812-1695026891.jpg?lm=1,IT1,SocietÃ  Sportiva Lazio S.p.A.,2500000.0,25000000.0,33,140,148,13,12,10,13,13,12,16,14,5,13,14,13,12,14,14,16,14,14,12,13,13,16,12,13,17,14,16,15,10,12,17,14,14,12,14,13,13,11,17,11,15,2,2,3,3,4,1,1,3,3,2,3,13,16,7,10,14,16,13,13,1,1,1,1,1,1,15,1,20,1,1,12,1,5,81,11,20,8397173,7000,7400,6500,Mediterranean_Hispanic,141,60,4,67692.0,Unknown,78040720,8875666.667,3.0,106,1300,103,3,1,3,185,1,0.7294257740142895,0.6898395721925134,0.6764705882352942,0.0653558734153013,0.3947368421052631,0.0526315789473684,0.0122530632658164,0.1247811952988247,0.0492828504514014,0.2857142857142857,0.5581395348837206,0.625,415,43,28,77,1,9466,26,117,199,2500000,67857.14285714286,25000000.0,4500000.0,125000.0,500000.0,6,8525000,0.0,-0.16666666666666666
143891,Maximilian,Philipp,2024,60,Germany,Berlin,Germany,01-03-94,Second Striker,Attack,Right,183.0,Unknown,Unique Sports Group,https://img.a.transfermarkt.technology/portrait/header/143891-1723189806.jpg?lm=1,L1,Sport-Club Freiburg,1200000.0,20000000.0,30,131,143,13,11,13,12,16,14,8,15,4,6,12,16,7,16,13,12,9,12,10,14,12,11,14,6,13,7,11,9,14,13,12,11,12,14,12,11,10,4,12,11,13,2,2,3,3,2,1,1,1,3,4,3,12,12,5,7,11,15,18,17,1,1,1,1,1,1,1,10,12,10,15,20,15,14,77,14,20,3641623,6550,6550,5050,Northern_European,130,0,0,76711.0,Unknown,91108767,12125000.0,4.0,38,178,40,0,1,7,189,12,0.6169621593014025,0.53475935828877,0.5955882352941175,0.0740647755374384,0.0,0.0,0.0057514378594648,0.0997749437359339,0.0673352037556598,0.4285714285714285,0.4651162790697669,0.5,373,100,58,34,1,6306,19,68,86,1000000,25657.894736842107,20000000.0,3000000.0,,1000000.0,7,7725000,-0.5,-0.5
144028,Leandro,Trossard,2024,11,Belgium,Waterschei,Belgium,04-12-94,Left Winger,Attack,Right,172.0,30-06-26,Unknown,https://img.a.transfermarkt.technology/portrait/header/144028-1702412939.jpg?lm=1,GB1,Arsenal Football Club,35000000.0,38000000.0,30,152,157,14,12,15,14,14,12,5,13,4,6,14,15,4,16,13,12,13,13,14,15,13,11,15,8,15,9,10,12,16,13,13,6,10,15,13,9,14,8,15,8,17,1,2,3,1,3,2,2,1,2,3,2,12,14,6,8,12,11,12,11,1,1,1,1,17,1,1,17,1,1,20,19,14,15,67,15,20,50900273,7600,7600,6250,Northern_European,143,19,5,69595.0,Unknown,18054004,19780000.0,2.0,7,1648,8,0,1,7,21,7,0.755887801005557,0.6631016042780749,0.6911764705882353,0.0671934430725168,0.125,0.0657894736842105,0.1747936984246061,0.1897974493623406,0.1098641628934136,0.1428571428571428,0.2093023255813952,0.5,450,124,61,23,0,9284,10,55,111,30000000,998333.3333333334,38000000.0,5000000.0,200000.0,700000.0,5,5200000,-0.14285714285714285,-0.21052631578947367
144244,Pantelis,Hatzidiakos,2024,190,Greece,Rhodos,Greece,18-01-97,Centre-Back,Defender,Right,185.0,30-06-25,Sports360 GmbH,https://img.a.transfermarkt.technology/portrait/header/144244-1695033693.jpg?lm=1,DK1,Football Club KÃ¸benhavn,2500000.0,4000000.0,27,128,132,5,6,10,6,13,5,12,5,6,13,11,7,13,12,14,14,13,13,14,11,10,16,10,14,11,15,16,15,13,13,14,13,15,13,15,13,13,6,5,5,12,1,3,2,4,4,3,1,3,2,4,1,14,13,6,17,8,16,15,12,1,1,20,18,1,10,12,1,1,1,1,1,1,1,74,12,20,6538599,6235,6235,4987,Mediterranean_Hispanic,128,19,0,3356.0,Unknown,37053040,2000000.0,1.0,40,1225,42,1,1,3,90,2,0.5752844667901561,0.5280213903743315,0.5808823529411764,0.0032319209893328,0.125,0.0,0.0122530632658164,0.0197549387346836,0.0110836412122558,0.0,0.5116279069767438,0.375,329,10,13,53,0,11112,7,42,279,2800000,130952.38095238095,4000000.0,1300000.0,50000.0,900000.0,2,500000,0.12,-0.2631578947368421
145707,Unknown,Danilo,2024,506,Brazil,Bicas,Brazil,15-07-91,Centre-Back,Defender,Right,184.0,30-06-25,B2F,https://img.a.transfermarkt.technology/portrait/header/145707-1663577215.jpg?lm=1,IT1,Juventus Football Club,10000000.0,25000000.0,33,150,156,7,14,12,10,14,9,11,12,7,12,15,11,14,14,11,15,15,13,14,15,13,16,12,12,13,15,16,14,13,12,13,12,13,14,14,13,15,14,12,12,18,2,1,2,1,3,1,2,3,3,3,2,14,12,6,13,13,18,13,16,1,17,17,20,14,16,12,1,10,9,1,1,1,1,78,14,20,347975206,7500,8100,7250,Mediterranean_Hispanic,145,45,1,98653.0,Unknown,19099575,22480000.0,5.0,10,186,11,1,1,3,116,2,0.8220428684837258,0.7700534759358288,0.7058823529411764,0.0952523495882125,0.2960526315789473,0.0131578947368421,0.0497624406101525,0.1247811952988247,0.1248645795716547,0.5714285714285714,0.4883720930232553,0.625,559,39,47,111,0,15462,21,84,73,4000000,89473.68421052632,25000000.0,5000000.0,1000000.0,10000000.0,5,7400000,-0.6,-0.6666666666666666
145988,Wilfried,Zaha,2024,1041,Cote d'Ivoire,Abidjan,Cote d'Ivoire,10-11-92,Left Winger,Attack,Right,180.0,30-06-25,Unknown,https://img.a.transfermarkt.technology/portrait/header/145988-1701182730.png?lm=1,FR1,Olympique Lyonnais,10000000.0,55000000.0,32,150,154,8,11,17,14,14,10,7,14,7,8,11,14,6,15,13,12,11,15,11,11,14,14,17,11,13,8,12,12,15,15,14,11,16,15,15,13,15,12,16,7,15,3,3,1,1,1,3,3,1,3,2,2,12,18,11,10,15,9,9,7,1,1,1,1,1,1,1,15,1,12,20,1,17,18,74,11,20,33585767,7496,7496,6496,African_Caribbean,144,26,5,150789.0,Unknown,28051378,7775000.0,2.0,23,14,24,0,1,1,143,7,0.7421275469700979,0.6894117647058823,0.6985294117647058,0.1455957713688687,0.1710526315789473,0.0657894736842105,0.0497624406101525,0.274818704676169,0.0431678657740492,0.1428571428571428,0.3953488372093026,0.5833333333333333,527,101,59,76,3,5168,23,72,85,8000000,207142.85714285713,55000000.0,11000000.0,,12000000.0,6,6000000,-0.2727272727272727,-0.5294117647058824
146227,Jasper,Cillessen,2024,472,Netherlands,Nijmegen,Netherlands,22-04-89,Goalkeeper,Goalkeeper,Right,187.0,30-06-26,SEG,https://img.a.transfermarkt.technology/portrait/header/146227-1660814229.jpg?lm=1,ES1,UniÃ³n Deportiva Las Palmas S.A.D.,1300000.0,20000000.0,35,140,155,5,3,2,2,10,10,4,2,2,2,10,6,3,8,12,14,14,15,13,9,12,16,8,10,3,13,13,14,11,13,13,16,12,11,10,11,12,3,14,16,13,16,14,14,11,16,13,15,14,12,10,13,12,16,9,15,16,17,14,13,20,1,1,1,1,1,1,1,1,1,1,1,1,1,83,10,20,347975206,7000,7000,6000,Northern_European,140,63,0,3999.0,Unknown,37002936,10546000.0,5.0,67,1047,68,2,1,7,207,5,0.6765017200317545,0.6363636363636364,0.6691176470588234,0.0038528128913767,0.4144736842105262,0.0,0.0062515628907226,0.0997749437359339,0.0585627378538292,0.5714285714285714,0.5581395348837206,0.7083333333333333,0,0,0,0,0,0,22,88,102,900000,23611.11111111111,20000000.0,4000000.0,,,5,2050000,-0.3076923076923077,-0.4
146310,Wataru,Endo,2024,31,Japan,"Yokohama, Kanagawa",Japan,09-02-93,Defensive Midfield,Midfield,Right,178.0,30-06-27,Unknown,https://img.a.transfermarkt.technology/portrait/header/146310-1657181542.jpg?lm=1,GB1,Liverpool Football Club,13000000.0,13000000.0,31,136,137,8,10,11,8,12,7,12,8,9,12,13,8,16,13,15,14,15,13,15,12,12,15,10,15,13,14,17,16,12,13,12,12,15,12,15,12,16,8,15,8,17,2,3,3,3,2,2,2,2,3,3,2,13,16,5,13,16,17,14,16,1,1,16,10,1,1,20,1,19,1,1,1,1,1,76,11,20,11022902,6849,7099,4999,10,133,41,2,10000.0,Unknown,45030953,10850000.0,2.0,54,1686,56,3,1,0,129,4,0.6896004233924319,0.5293048128342246,0.6176470588235294,0.009647482104698,0.2697368421052631,0.0263157894736842,0.0647661915478869,0.0647661915478869,0.0602516736576015,0.1428571428571428,0.3488372093023257,0.5416666666666665,503,49,29,46,2,8950,15,46,57,12000000,470833.3333333333,13000000.0,2000000.0,,600000.0,4,6900000,-0.07692307692307693,-0.07692307692307693
146710,Martin,Frydek,2024,605,CSSR,Hradec KrÃ¡lovÃ©,Czech Republic,24-03-92,Left-Back,Defender,Left,179.0,30-06-26,SPORT INVEST,https://img.a.transfermarkt.technology/portrait/header/146710-1652899409.png?lm=1,GR1,Aris Thessalonikis,400000.0,2250000.0,32,121,132,11,10,14,11,11,12,12,11,14,13,11,14,12,12,16,12,16,10,14,11,12,16,13,11,13,12,12,16,12,9,15,11,13,13,13,12,12,14,17,7,16,3,1,2,2,3,2,4,2,1,1,3,10,12,9,19,13,13,10,11,1,17,1,7,19,5,5,17,20,5,5,7,1,1,75,20,9,1595760,6048,6047,3599,Northern_European,116,7,0,7012.0,Unknown,25032760,9111392.0,2.0,14,639,28,1,0,7,20,8,0.5504101614183646,0.3795721925133689,0.4926470588235294,0.0067622177138624,0.0460526315789473,0.0,0.0017504376094023,0.0110027506876719,0.0505924720131114,0.1428571428571428,0.3720930232558141,0.5833333333333333,427,21,51,98,1,9123,15,89,350,350000,7142.857142857143,2250000.0,400000.0,,300000.0,5,650000,-0.125,-0.3
146752,Gianluca,Caprari,2024,2919,Italy,Roma,Italy,30-07-93,Second Striker,Attack,Right,171.0,30-06-26,SP GROUP,https://img.a.transfermarkt.technology/portrait/header/146752-1663659110.jpg?lm=1,IT1,Associazione Calcio Monza,4000000.0,10000000.0,31,138,142,13,13,15,13,15,13,7,13,3,4,14,10,4,16,10,14,11,13,11,14,12,16,16,11,15,4,12,12,15,17,15,7,13,13,12,7,15,5,14,5,14,1,3,2,2,2,1,2,3,3,1,1,13,14,3,12,10,13,15,17,1,1,1,1,1,1,1,1,1,1,20,20,15,17,72,9,20,7972902,6900,6800,5300,Mediterranean_Hispanic,131,1,0,14383.0,Brianza,43067331,5885714.286,7.0,52,1244,54,0,1,3,28,12,0.6500396930404869,0.5614973262032085,0.6029411764705883,0.0138797825816163,0.006578947368421,0.0,0.0197549387346836,0.0497624406101525,0.0326715424650684,0.8571428571428572,0.1860465116279068,0.5416666666666665,437,94,41,46,1,7347,17,115,224,2500000,72058.82352941176,10000000.0,3000000.0,1800000.0,1600000.0,8,6100000,-0.375,-0.5
146795,Ryan,Fraser,2024,180,Scotland,Aberdeen,Scotland,24-02-94,Left Winger,Attack,Right,163.0,30-06-26,Wasserman,https://img.a.transfermarkt.technology/portrait/header/146795-1720190677.jpg?lm=1,GB1,Southampton Football Club,3000000.0,30000000.0,30,134,150,13,14,13,13,13,12,2,12,2,6,14,6,7,12,7,13,13,12,10,11,12,13,12,10,15,10,15,17,15,13,14,3,12,15,12,12,11,5,10,13,16,2,3,3,2,2,1,1,1,3,3,3,11,12,3,12,9,12,13,8,1,1,1,1,10,12,1,18,1,18,20,13,20,13,70,9,20,11906084,6695,7095,5495,Northern_European,129,22,4,75395.0,Unknown,61036775,480000.0,1.0,82,13,83,0,1,7,186,7,0.6890711828526065,0.5823529411764705,0.588235294117647,0.0727940232153703,0.1447368421052631,0.0526315789473684,0.0147536884221055,0.1497874468617154,0.0026389621933942,0.0,0.0,0.5,366,42,51,26,1,5322,21,79,2671,3000000,92187.5,30000000.0,8000000.0,250000.0,,5,3700000,0.0,0.0
146799,Alberto,Brignoli,2024,2441,Italy,Trescore Balneario,Italy,19-08-91,Goalkeeper,Goalkeeper,Left,188.0,30-06-27,Unknown,https://img.a.transfermarkt.technology/portrait/header/146799-1728414729.png?lm=1,GR1,Athlitiki Enosi Konstantinoupoleos,1200000.0,1800000.0,33,125,130,2,1,3,6,13,6,10,3,2,1,12,6,2,12,10,14,12,13,11,13,13,17,10,12,3,14,13,12,9,14,10,13,14,10,12,11,15,6,14,2,12,12,11,10,9,14,14,14,14,15,12,14,12,13,7,12,17,18,16,10,20,1,1,1,1,1,1,1,1,1,1,1,1,1,74,20,7,2041874,6000,6150,3000,Mediterranean_Hispanic,125,0,0,6385.0,Unknown,43038613,1675000.0,2.0,52,1520,54,2,0,3,34,5,0.5640381053188674,0.3155080213903743,0.5588235294117647,0.0061567756880747,0.0,0.0,0.0057514378594648,0.0087521880470117,0.0092780355009861,0.1428571428571428,0.581395348837209,0.625,0,0,0,0,0,0,4,15,63,1000000,29838.709677419356,1800000.0,300000.0,,300000.0,9,1250000,-0.3333333333333333,-0.4444444444444444
147462,Alexander,Callens,2024,2441,Peru,Callao,Peru,04-05-92,Centre-Back,Defender,Left,186.0,30-06-26,DV7 Management,https://img.a.transfermarkt.technology/portrait/header/147462-1728415118.png?lm=1,GR1,Athlitiki Enosi Konstantinoupoleos,1200000.0,2200000.0,32,123,125,6,6,8,8,9,4,13,6,10,14,12,12,13,10,14,14,14,11,12,8,11,10,9,13,7,13,13,14,12,13,12,14,13,13,15,15,12,12,12,8,13,3,1,1,2,1,3,2,1,3,1,3,13,13,6,11,9,11,8,13,1,15,20,1,1,1,1,1,1,1,1,1,1,1,82,20,7,808736,6092,5911,4715,African_Caribbean,123,33,1,14813.0,Unknown,77012995,300000.0,1.0,74,304,76,1,0,1,34,2,0.5324159830643027,0.4989304812834224,0.5441176470588236,0.0142949980060003,0.2171052631578947,0.0131578947368421,0.0057514378594648,0.010752688172043,0.0016389344148448,0.0,0.5348837209302322,0.5833333333333333,394,26,2,76,4,6184,5,24,153,1000000,43478.260869565216,2200000.0,300000.0,,,4,800000,-0.16666666666666666,-0.3333333333333333
147487,Vincent,Aboubakar,2024,7775,Cameroon,Garoua,Cameroon,22-01-92,Centre-Forward,Attack,Right,184.0,30-06-25,Gol International,https://img.a.transfermarkt.technology/portrait/header/147487-1674477789.png?lm=1,TR1,Hatayspor Futbol KulÃ¼bÃ¼,2800000.0,18000000.0,32,132,144,5,8,14,15,13,8,14,12,6,6,12,16,6,14,14,12,12,14,13,14,13,13,14,6,15,7,12,8,13,12,15,13,9,14,8,14,13,10,14,15,10,2,1,1,3,3,1,1,1,3,2,3,14,13,11,10,13,15,16,14,1,1,1,1,1,1,1,1,1,1,1,1,1,20,83,12,20,8150350,6600,6500,6100,African_Caribbean,130,87,33,115384.0,Unknown,12028932,12300000.0,1.0,15,523,15,0,1,1,111,3,0.6103466525535857,0.6470588235294117,0.5955882352941175,0.1114080920658126,0.5723684210526315,0.4342105263157894,0.0137534383595899,0.0897724431107777,0.0683074529848051,0.0,0.4883720930232553,0.5833333333333333,423,170,55,32,2,8274,16,96,199,2000000,43902.439024390245,18000000.0,5000000.0,750000.0,2500000.0,9,9650000,-0.4117647058823529,-0.6666666666666666
148153,Lewis,Dunk,2024,1237,England,Brighton,England,21-11-91,Centre-Back,Defender,Right,192.0,30-06-26,CAA Stellar,https://img.a.transfermarkt.technology/portrait/header/148153-1716297176.jpg?lm=1,GB1,Brighton and Hove Albion Football Club,12000000.0,27000000.0,33,147,150,5,7,9,6,13,9,14,5,6,14,14,10,16,13,13,14,17,14,15,12,15,14,8,15,7,15,14,14,11,11,10,16,13,14,15,14,14,13,14,6,14,2,3,2,3,3,3,3,1,2,3,1,20,14,5,16,9,15,13,11,1,1,20,1,1,1,1,1,1,1,1,1,1,1,78,11,20,41000123,7350,7050,6250,Northern_European,146,1,0,92793.0,Unknown,29036189,9111392.0,2.0,32,258,33,1,1,7,44,2,0.6831172267795713,0.6631016042780749,0.713235294117647,0.0895938324093985,0.006578947368421,0.0,0.0597649412353088,0.134783695923981,0.0505924720131114,0.1428571428571428,0.6744186046511627,0.625,482,31,15,93,5,5680,5,16,53,10000000,310937.5,27000000.0,4000000.0,50000.0,1000000.0,0,0,-0.16666666666666666,-0.2857142857142857
148252,Remo,Freuler,2024,1025,Switzerland,Ennenda,Switzerland,15-04-92,Central Midfield,Midfield,Right,180.0,30-06-26,ESHA,https://img.a.transfermarkt.technology/portrait/header/148252-1688044464.jpg?lm=1,IT1,Bologna Football Club 1909,6500000.0,25000000.0,32,144,152,8,12,14,9,15,8,9,12,6,11,14,11,13,14,14,15,14,13,13,15,14,15,12,11,12,14,16,16,13,14,14,10,15,12,16,12,14,9,13,6,14,2,3,2,3,3,3,3,2,3,3,1,13,14,7,12,14,16,13,13,1,1,1,1,1,1,18,9,20,7,1,11,1,1,80,11,20,29672542,7200,7250,6350,Northern_European,144,46,4,52196.0,Unknown,98006034,5416666.667,3.0,92,464,92,3,1,7,40,1,0.7095792537708389,0.6737967914438502,0.6985294117647058,0.0503926682612226,0.3026315789473684,0.0526315789473684,0.032258064516129,0.1247811952988247,0.0300656499736103,0.2857142857142857,0.3953488372093026,0.5833333333333333,575,59,44,96,3,11974,2,5,13,6500000,195454.54545454544,25000000.0,7000000.0,50000.0,250000.0,5,8800000,0.0,0.0
148355,Jens,Jönsson,2024,2441,Denmark,Aarhus,Denmark,10-01-93,Defensive Midfield,Midfield,Right,182.0,30-06-26,Beckster Int.,https://img.a.transfermarkt.technology/portrait/header/148355-1728415569.png?lm=1,GR1,Athlitiki Enosi Konstantinoupoleos,2500000.0,4000000.0,31,130,135,8,9,11,5,12,7,11,10,10,13,14,7,13,12,14,13,14,16,14,13,13,14,9,12,11,13,15,16,12,12,13,13,16,12,15,13,12,8,13,8,16,1,2,1,3,3,2,2,3,4,1,2,14,15,7,9,14,15,12,13,1,1,10,6,1,1,20,1,19,1,1,10,1,1,78,12,20,4630642,6246,6046,4496,Northern_European,130,3,0,22470.0,Unknown,27023729,335000.0,1.0,28,12,30,3,1,7,34,4,0.5502778512834083,0.4755080213903743,0.5955882352941175,0.0216887294118328,0.0197368421052631,0.0,0.0122530632658164,0.0197549387346836,0.0018333842606739,0.0,0.4418604651162785,0.5416666666666665,400,11,10,57,0,7864,11,44,43,2000000,67241.37931034483,4000000.0,1000000.0,50000.0,350000.0,4,1300000,-0.2,-0.3333333333333333
148365,Casper,Nielsen,2024,2282,Denmark,Esbjerg,Denmark,29-04-94,Central Midfield,Midfield,Right,182.0,30-06-26,Libera Sports,https://img.a.transfermarkt.technology/portrait/header/148365-1642262961.jpg?lm=1,BE1,Club Brugge Koninklijke Voetbalvereniging,3500000.0,8000000.0,30,130,130,14,12,13,10,14,12,5,12,9,9,15,12,8,13,14,14,10,13,11,15,12,8,14,14,13,8,13,15,13,12,11,11,10,11,15,11,15,5,7,7,10,1,1,2,2,2,2,1,1,2,3,2,19,13,3,11,7,10,14,17,1,1,1,1,1,1,7,13,20,14,12,18,13,8,71,13,20,6626249,6350,6200,2650,Northern_European,128,0,0,17500.0,Unknown,27043900,4015000.0,2.0,28,469,30,3,1,7,53,1,0.5706536120666843,0.2780748663101604,0.5808823529411764,0.016889611599767,0.0,0.0,0.0172543135783946,0.0397599399849962,0.0222783966221283,0.1428571428571428,0.4418604651162785,0.5,407,45,41,36,0,8591,5,22,33,3000000,95161.29032258065,8000000.0,1500000.0,50000.0,250000.0,3,2750000,-0.14285714285714285,-0.4
148367,Christian,Nørgaard,2024,1148,Denmark,KÃ¸benhavn,Denmark,10-03-94,Defensive Midfield,Midfield,Right,187.0,30-06-25,PEP Consulting,https://img.a.transfermarkt.technology/portrait/header/148367-1699799827.jpg?lm=1,GB1,Brentford Football Club,18000000.0,20000000.0,30,136,139,9,10,12,8,13,9,12,9,8,13,14,8,14,14,14,13,14,14,15,15,13,13,12,14,12,15,15,16,11,11,12,14,15,12,16,12,15,3,14,11,16,3,1,2,2,4,1,3,1,1,1,3,14,14,4,14,13,13,16,14,1,1,13,1,1,1,20,1,18,1,1,10,1,1,76,12,20,27341164,6800,7000,5750,Northern_European,136,17,1,46397.0,Unknown,27039017,1937500.0,4.0,28,778,30,3,1,7,43,4,0.6765017200317545,0.6096256684491979,0.6397058823529411,0.0447930537356352,0.1118421052631578,0.0131578947368421,0.0897724431107777,0.0997749437359339,0.010736409344704,0.4285714285714285,0.5581395348837206,0.5,376,28,26,71,1,8505,10,105,74,15000000,446969.69696969696,20000000.0,3000000.0,400000.0,500000.0,3,1100000,-0.16666666666666666,-0.25
148455,Unknown,Mohamed Salah,2024,31,Egypt,"Nagrig, Basyoun",Egypt,15-06-92,Right Winger,Attack,Left,175.0,30-06-25,Unknown,https://img.a.transfermarkt.technology/portrait/header/148455-1727337594.jpg?lm=1,GB1,Liverpool Football Club,55000000.0,150000000.0,32,185,187,12,14,17,17,17,12,10,13,6,7,15,17,7,17,11,16,11,15,15,17,15,18,15,11,18,9,15,16,18,16,18,8,17,18,15,15,15,6,16,4,7,3,2,2,1,2,1,3,2,3,3,2,16,19,8,13,16,18,16,17,1,1,1,1,1,1,1,1,1,1,17,12,20,19,72,20,8,347975206,9400,9445,8750,North_African__Middle_Eastern,181,85,47,405971.0,Unknown,98028755,19000000.0,4.0,31,1012,32,0,0,6,129,10,1.0,0.9304812834224598,0.9705882352941176,0.3920039165436309,0.5592105263157895,0.6184210526315789,0.274818704676169,0.7499374843710929,0.1055307091863662,0.4285714285714285,0.2790697674418605,0.5833333333333333,637,316,154,23,0,13131,12,38,29,55000000,1374375.0,150000000.0,30000000.0,50000.0,5000000.0,6,21500000,0.0,-0.15384615384615385
149498,Unknown,Gabriel Paulista,2024,114,Brazil,SÃ£o Paulo,Brazil,26-11-90,Centre-Back,Defender,Right,185.0,30-06-27,ADM Esporte,https://img.a.transfermarkt.technology/portrait/header/149498-1727355000.png?lm=1,TR1,Be?ikta? Jimnastik KulÃ¼bÃ¼,2000000.0,22000000.0,34,150,155,5,10,10,8,12,8,15,10,10,14,12,6,15,12,17,15,16,12,14,10,13,17,6,15,11,14,15,17,15,13,14,15,15,15,15,15,14,15,12,7,14,3,2,2,1,2,1,2,1,3,1,3,14,15,10,10,13,15,9,10,1,12,20,14,8,8,1,1,1,1,1,1,1,1,72,10,20,347975206,7250,7000,6000,Mixed_Race,151,0,0,90479.0,Unknown,19127830,9766666.667,3.0,10,1456,11,1,1,4,37,2,0.6765017200317545,0.6363636363636364,0.75,0.0873593940558532,0.0,0.0,0.0097524381095273,0.1097774443610902,0.0542329879552209,0.2857142857142857,0.5116279069767438,0.6666666666666665,450,12,8,76,5,10269,13,72,139,1400000,25806.451612903227,22000000.0,5000000.0,,,5,6500000,-0.3,-0.44
149729,Unknown,João Mário,2024,114,Portugal,Porto,Portugal,19-01-93,Central Midfield,Midfield,Right,179.0,30-06-25,Unknown,https://img.a.transfermarkt.technology/portrait/header/149729-1727355794.png?lm=1,TR1,Be?ikta? Jimnastik KulÃ¼bÃ¼,3800000.0,35000000.0,31,149,155,14,14,14,13,16,12,7,11,4,6,16,18,7,16,10,13,10,18,12,15,16,11,12,13,13,12,13,10,12,14,16,9,14,13,14,11,16,8,14,6,10,2,3,3,1,2,1,2,3,4,2,3,9,14,6,12,11,18,18,14,1,1,1,1,1,1,11,18,20,18,15,18,12,1,73,13,20,18809999,7250,7250,6250,Mixed_Race,144,50,2,50511.0,Unknown,55022391,23390000.0,2.0,76,1170,79,3,1,4,37,1,0.7095792537708389,0.6631016042780749,0.6985294117647058,0.0487656031679971,0.3289473684210526,0.0263157894736842,0.018754688672168,0.1747936984246061,0.1299202755632101,0.1428571428571428,0.3720930232558141,0.5416666666666665,463,64,86,63,1,10101,9,29,36,2800000,42424.242424242424,35000000.0,5000000.0,,2000000.0,8,11200000,-0.3,-0.6888888888888889
149829,Miha,Zajc,2024,415,Slovenia,Sempeter pri Gorici,Slovenia,01-07-94,Central Midfield,Midfield,Right,178.0,30-06-25,SEG,https://img.a.transfermarkt.technology/portrait/header/149829-1696449687.png?lm=1,FR1,Toulouse Football Club,2000000.0,6000000.0,30,130,135,10,12,12,13,14,12,8,15,3,9,16,11,8,15,8,12,12,16,10,15,12,12,14,12,15,8,14,15,12,9,11,10,12,10,15,13,16,9,13,9,10,3,1,2,1,3,2,1,1,2,3,1,10,12,9,16,14,12,11,13,1,1,1,1,1,1,18,11,20,11,11,14,11,1,76,12,20,6450495,6495,6895,4995,Northern_European,128,34,7,33937.0,Unknown,62115981,2066666.667,3.0,87,1360,87,3,1,7,203,1,0.662609155861339,0.5288770053475935,0.5808823529411764,0.0327614626011604,0.2236842105263157,0.0921052631578947,0.0097524381095273,0.0297574393598399,0.0114540218728298,0.2857142857142857,0.3488372093023257,0.5,386,56,49,49,0,6309,11,40,66,1800000,46969.69696969697,6000000.0,1500000.0,250000.0,750000.0,6,2400000,-0.25,-0.5263157894736842
149928,Unknown,Jubal,2024,290,Brazil,Inhumas,Brazil,29-08-93,Centre-Back,Defender,Right,190.0,30-06-25,LEFT Sports,https://img.a.transfermarkt.technology/portrait/header/149928-1478101058.jpg?lm=1,FR1,Association de la Jeunesse auxerroise,2000000.0,2000000.0,31,120,130,5,6,8,7,8,5,14,7,6,13,10,5,13,11,14,14,15,11,15,9,12,14,8,11,10,12,13,13,12,12,13,15,14,13,13,13,13,14,13,6,6,1,1,2,2,2,3,4,1,3,3,1,14,13,12,7,11,7,13,12,1,1,20,5,1,1,1,1,1,1,1,1,1,1,82,8,20,1498951,5991,5991,3491,African_Caribbean,119,0,0,6395.0,Unknown,19172374,9111392.0,2.0,10,657,11,1,1,1,23,2,0.5430007938608098,0.3680213903743315,0.5147058823529411,0.0061664318607348,0.0,0.0,0.0097524381095273,0.0097524381095273,0.0505924720131114,0.1428571428571428,0.6279069767441858,0.5416666666666665,322,23,6,67,1,6793,7,33,216,2000000,76000.0,2000000.0,300000.0,100000.0,100000.0,7,850000,0.0,0.0
153084,Leon,Goretzka,2024,27,Germany,Bochum,Germany,06-02-95,Central Midfield,Midfield,Right,189.0,30-06-26,Neubauer 13 GmbH,https://img.a.transfermarkt.technology/portrait/header/153084-1700040179.jpg?lm=1,L1,FC Bayern MÃ¼nchen,22000000.0,70000000.0,29,164,170,5,11,12,14,15,6,16,15,6,12,15,11,15,15,14,17,16,16,15,15,15,18,12,14,18,13,17,18,12,11,15,16,12,15,17,17,16,9,14,14,18,2,1,2,3,2,3,2,3,2,1,1,12,18,10,10,16,18,15,8,1,10,1,10,10,10,17,12,20,12,10,16,10,1,82,10,20,89723700,8200,8200,8000,Northern_European,164,44,14,268492.0,Unknown,91104807,3250000.0,1.0,38,212,40,3,1,7,68,1,0.8352738819793597,0.8502673796791443,0.8455882352941175,0.2592518204299507,0.2894736842105263,0.1842105263157894,0.1097774443610902,0.3498374593648412,0.0180282785632934,0.0,0.6046511627906974,0.4583333333333332,475,95,76,42,0,9104,46,200,221,22000000,648484.8484848485,70000000.0,20000000.0,4500000.0,10000000.0,2,3000000,-0.26666666666666666,-0.45
153190,Thomas,Murg,2024,1091,Austria,Voitsberg,Austria,14-11-94,Attacking Midfield,Midfield,Left,173.0,30-06-26,ROGON,https://img.a.transfermarkt.technology/portrait/header/153190-1727967489.png?lm=1,GR1,Panthessalonikios Athlitikos Omilos Konstantinoupoliton,1800000.0,3500000.0,30,120,125,14,12,13,12,12,16,7,10,8,8,13,13,7,14,9,12,8,9,10,13,12,10,13,8,14,9,13,12,13,13,10,8,10,13,11,9,10,10,9,12,10,1,1,1,1,2,1,3,2,2,2,3,9,15,14,9,10,6,9,16,1,6,1,1,7,1,1,16,14,19,16,17,20,14,70,20,12,1479504,5747,6347,2754,Northern_European,116,0,0,8246.0,Unknown,16060932,966666.6667,3.0,6,1624,7,3,0,7,153,0,0.590103201905266,0.2891978609625668,0.4926470588235294,0.0079537894201178,0.0,0.0,0.0087521880470117,0.0172543135783946,0.00534274100225,0.2857142857142857,0.2325581395348837,0.5,461,93,68,52,2,13916,20,88,80,1600000,43548.3870967742,3500000.0,1000000.0,350000.0,600000.0,3,50000,-0.1111111111111111,0.3333333333333333
153678,Kingsley,Schindler,2024,152,Germany,Hamburg,Ghana,12-07-93,Right Winger,Attack,Right,183.0,30-06-25,11WINS,https://img.a.transfermarkt.technology/portrait/header/153678-1727719441.png?lm=1,TR1,Samsunspor,750000.0,3000000.0,31,124,129,7,11,12,11,11,7,8,10,10,8,10,13,8,12,15,11,14,11,12,10,9,12,13,8,13,7,12,14,15,13,13,11,16,14,13,12,13,6,14,6,16,3,2,2,1,1,3,4,3,3,3,1,6,12,6,11,13,13,13,13,1,1,1,13,1,13,1,1,1,20,1,1,20,16,77,12,20,1877798,6200,6200,4500,African_Caribbean,114,0,0,19164.0,Unknown,91137354,9111392.0,2.0,38,594,41,0,1,1,180,10,0.5706536120666843,0.4759358288770053,0.4779411764705882,0.0184963987304064,0.0,0.0,0.0035008752188047,0.0147536884221055,0.0505924720131114,0.1428571428571428,0.4651162790697669,0.5416666666666665,364,57,56,30,0,5099,7,24,43,850000,26612.90322580645,3000000.0,1000000.0,,100000.0,6,475000,0.7,0.0625
154147,Hauke,Wahl,2024,35,Germany,Hamburg,Germany,15-04-94,Centre-Back,Defender,Right,189.0,Unknown,Unknown,https://img.a.transfermarkt.technology/portrait/header/154147-1723631071.jpeg?lm=1,L1,FuÃŸball-Club St. Pauli von 1910,1500000.0,2000000.0,30,125,130,5,7,11,8,11,6,14,8,8,12,13,7,12,11,11,15,13,15,12,11,14,12,9,15,8,13,15,13,12,8,13,14,12,12,12,15,16,6,16,5,5,2,3,2,4,2,1,2,1,3,1,3,8,16,5,11,13,16,14,17,1,1,20,1,1,1,10,1,1,1,1,1,1,1,85,10,20,1630720,6200,6200,4500,Northern_European,125,0,0,8151.0,Unknown,92064816,550000.0,2.0,38,594,40,1,1,7,101,2,0.5706536120666843,0.4759358288770053,0.5588235294117647,0.0078620557798469,0.0,0.0,0.0072518129532383,0.0097524381095273,0.0030278618850523,0.1428571428571428,0.6046511627906974,0.5,421,17,8,43,0,3836,1,17,186,1500000,46551.724137931036,2000000.0,300000.0,,450000.0,6,950000,0.0,0.0
155396,Cláudio,Ramos,2024,720,Portugal,Viseu,Portugal,16-11-91,Goalkeeper,Goalkeeper,Right,183.0,30-06-27,Unknown,https://img.a.transfermarkt.technology/portrait/header/155396-1606395113.png?lm=1,PO1,Futebol Clube do Porto,1500000.0,2000000.0,33,125,130,4,1,3,1,10,8,8,3,3,2,12,1,2,10,11,12,13,12,12,10,13,16,1,14,1,13,13,14,11,14,12,12,13,11,12,11,14,12,12,3,11,12,11,13,14,12,14,12,15,15,8,10,13,12,5,16,12,16,15,16,20,1,1,1,1,1,1,1,1,1,1,1,1,1,83,7,20,1366873,6250,6250,4750,Mediterranean_Hispanic,125,1,0,6250.0,Unknown,55022080,9111392.0,2.0,76,1615,79,2,1,3,100,5,0.5772691188145012,0.5026737967914437,0.5588235294117647,0.0060264173571634,0.006578947368421,0.0,0.0072518129532383,0.0097524381095273,0.0505924720131114,0.1428571428571428,0.4651162790697669,0.625,0,0,0,0,0,0,3,12,90,1500000,58333.333333333336,2000000.0,500000.0,100000.0,,2,700000,0.0,0.0
156941,John,Lundstram,2024,449,England,Liverpool,England,18-02-94,Defensive Midfield,Midfield,Right,181.0,30-06-27,Wasserman,https://img.a.transfermarkt.technology/portrait/header/156941-1723801542.jpg?lm=1,TR1,Trabzonspor KulÃ¼bÃ¼,4000000.0,10000000.0,30,126,134,9,12,11,11,12,9,10,10,4,12,13,8,12,14,15,13,13,13,13,13,12,17,10,14,11,12,13,16,12,12,11,11,14,12,15,12,11,13,12,9,11,2,3,3,3,2,1,1,2,1,2,2,10,10,7,10,12,13,12,11,1,1,1,1,1,1,15,1,20,1,1,1,1,1,74,14,20,6321283,6298,6298,4998,Northern_European,127,0,0,25518.0,Unknown,28058230,560000.0,1.0,32,845,33,3,1,7,204,4,0.5836200052924054,0.5291978609625668,0.5735294117647058,0.0246319308386289,0.0,0.0,0.0197549387346836,0.0497624406101525,0.0030834189838606,0.0,0.418604651162791,0.5,520,33,33,60,4,12314,3,4,9,3600000,150000.0,10000000.0,2000000.0,,,5,2700000,-0.28,-0.4461538461538462
156990,Marco,Friedl,2024,86,Austria,Kirchbichl,Austria,16-03-98,Centre-Back,Defender,Left,187.0,30-06-26,YOU FIRST,https://img.a.transfermarkt.technology/portrait/header/156990-1660207986.jpg?lm=1,L1,Sportverein Werder Bremen von 1899,7500000.0,7500000.0,26,124,139,10,12,8,7,12,14,11,10,15,11,13,12,12,14,12,11,13,15,12,12,11,14,8,9,9,11,14,12,12,12,13,15,16,14,15,13,12,9,15,7,16,2,3,1,2,2,2,3,2,2,1,2,12,16,9,12,15,13,10,8,1,18,20,10,16,8,12,12,11,1,8,1,1,1,78,20,8,2616127,6200,6200,4250,Northern_European,117,5,0,10805.0,Unknown,91143703,3500000.0,1.0,6,730,7,1,0,7,194,2,0.5706536120666843,0.4491978609625668,0.4999999999999999,0.0104248040038354,0.0328947368421052,0.0,0.0372593148287071,0.0372593148287071,0.0194172060335009,0.0,0.5581395348837206,0.3333333333333332,279,20,16,72,4,4960,16,35,35,10000000,450000.0,10000000.0,3000000.0,,1500000.0,1,750000,0.3333333333333333,0.8181818181818182
157036,Dyego,Sousa,2024,982,Brazil,SÃ£o JosÃ© de Ribamar,Portugal,14-09-89,Centre-Forward,Attack,Right,189.0,30-06-25,Unknown,https://img.a.transfermarkt.technology/portrait/header/157036-1702510410.png?lm=1,PO1,Clube Desportivo Nacional,400000.0,12000000.0,35,125,142,4,7,11,14,11,8,16,11,5,5,11,13,8,11,15,12,15,13,13,13,12,14,8,10,12,8,13,13,11,10,15,16,15,12,13,16,12,14,11,5,5,1,2,1,3,4,1,3,1,3,1,3,12,15,14,10,11,16,8,8,1,1,1,1,1,1,1,1,1,1,10,7,7,20,85,12,20,1307705,6250,6500,4800,African_Caribbean,123,2,0,6673.0,Unknown,19102543,9111392.0,2.0,10,1451,79,0,1,1,56,3,0.6103466525535857,0.5080213903743315,0.5441176470588236,0.0064348734606853,0.0131578947368421,0.0,0.0017504376094023,0.0597649412353088,0.0505924720131114,0.1428571428571428,0.6046511627906974,0.7083333333333333,331,87,32,43,3,8020,8,21,91,100000,-1666.6666666666667,12000000.0,5000000.0,,,11,6100000,-0.75,-0.875
157396,Rob,Schoofs,2024,354,Belgium,Herk-de-Stad,Belgium,23-03-94,Central Midfield,Midfield,Right,178.0,30-06-27,Unknown,https://img.a.transfermarkt.technology/portrait/header/157396-1705489412.jpg?lm=1,BE1,Yellow-Red Koninklijke Voetbalclub Mechelen,2200000.0,2500000.0,30,123,123,11,12,11,11,12,10,9,11,5,8,15,10,5,12,11,11,12,12,13,16,13,16,13,14,14,10,14,14,13,12,6,7,6,14,14,6,14,6,12,6,12,4,3,1,4,3,3,2,2,1,3,1,14,15,4,11,12,17,14,12,1,1,10,1,1,1,20,10,19,14,10,18,14,10,66,8,20,1948713,6006,6006,4503,Northern_European,102,0,0,8500.0,Unknown,18051993,1000000.0,2.0,7,617,8,3,1,7,223,1,0.5449854458851549,0.4762566844919785,0.3897058823529412,0.0081990562056842,0.0,0.0,0.010752688172043,0.0122530632658164,0.0055279313314258,0.1428571428571428,0.3488372093023257,0.5,404,52,56,64,3,6323,3,8,30,2200000,74137.93103448275,2500000.0,400000.0,250000.0,400000.0,2,700000,0.0,0.1
157506,Jeffrey,Schlupp,2024,873,Germany,Hamburg,Ghana,23-12-92,Left Midfield,Midfield,Left,178.0,30-06-25,Unique Sports Group,https://img.a.transfermarkt.technology/portrait/header/157506-1700672108.jpg?lm=1,GB1,Crystal Palace Football Club,7000000.0,12000000.0,32,133,137,9,11,13,12,12,9,10,9,10,12,11,10,11,13,10,13,14,13,12,10,11,13,12,8,13,12,15,14,15,15,13,11,13,15,15,12,11,9,10,13,18,3,1,1,3,1,1,3,1,2,1,1,16,11,9,10,14,13,11,12,1,12,1,1,14,1,13,20,16,8,17,11,10,11,74,20,8,10446929,6649,6649,5499,African_Caribbean,128,19,1,69595.0,Unknown,29045055,9111392.0,2.0,38,594,41,3,0,1,58,6,0.63006086266208,0.5827807486631016,0.5808823529411764,0.0671934430725168,0.125,0.0131578947368421,0.0347586896724181,0.0597649412353088,0.0505924720131114,0.1428571428571428,0.3488372093023257,0.5833333333333333,419,44,26,33,0,6331,9,71,125,6000000,191935.48387096773,12000000.0,2500000.0,250000.0,1000000.0,1,0,-0.14285714285714285,-0.14285714285714285
157507,Adrien,Tamèze,2024,416,France,Lille,France,04-02-94,Defensive Midfield,Midfield,Right,182.0,30-06-26,Andrea Cattoli,https://img.a.transfermarkt.technology/portrait/header/157507-1663672063.jpg?lm=1,IT1,Torino Calcio,5000000.0,10000000.0,30,135,139,5,9,12,10,13,5,11,11,7,11,13,9,14,13,13,14,14,12,14,12,14,14,10,8,14,12,16,17,13,14,15,10,16,14,16,13,14,7,12,6,17,1,1,4,3,1,4,2,1,3,3,1,13,14,6,15,12,16,14,16,1,10,10,1,11,1,16,10,20,1,1,17,1,10,78,9,20,6193901,6750,6550,5200,African_Caribbean,134,0,0,12308.0,Unknown,85065498,2500000.0,3.0,34,834,36,3,1,1,201,4,0.6169621593014025,0.5508021390374331,0.625,0.0118761267546472,0.0,0.0,0.0247561890472618,0.0497624406101525,0.0138614961526709,0.2857142857142857,0.4418604651162785,0.5,323,8,11,46,1,3208,4,10,24,3500000,145454.54545454544,10000000.0,2000000.0,,,5,4200000,-0.3,-0.4166666666666667
157635,Yussuf,Poulsen,2024,23826,Denmark,Kopenhagen,Denmark,15-06-94,Centre-Forward,Attack,Right,192.0,30-06-26,PEP Consulting,https://img.a.transfermarkt.technology/portrait/header/157635-1717097740.jpg?lm=1,L1,RasenBallsport Leipzig,6000000.0,35000000.0,30,138,145,6,9,12,13,12,7,14,9,11,7,11,10,9,11,18,11,18,11,14,12,13,16,13,11,16,7,17,18,13,11,15,17,17,14,15,16,14,8,15,12,8,2,1,4,3,1,2,3,4,1,3,2,15,17,9,8,12,13,15,9,1,1,1,1,1,1,1,10,1,15,10,8,15,20,84,12,20,5207341,6900,6900,6100,Mixed_Race,136,68,11,64923.0,Unknown,27051813,1550000.0,1.0,28,745,30,0,1,4,162,3,0.6632707065361206,0.6470588235294117,0.6397058823529411,0.0626820792057218,0.4473684210526315,0.1447368421052631,0.0297574393598399,0.1747936984246061,0.0085835717658823,0.0,0.6744186046511627,0.5,471,115,75,44,0,5950,27,77,88,5000000,154687.5,35000000.0,7000000.0,400000.0,2500000.0,1,100000,-0.16666666666666666,-0.2857142857142857
157672,Vladimír,Coufal,2024,379,CSSR,Ostrava,Czech Republic,22-08-92,Right-Back,Defender,Right,174.0,30-06-25,Unknown,https://img.a.transfermarkt.technology/portrait/header/157672-1667897675.jpg?lm=1,GB1,West Ham United Football Club,8000000.0,12000000.0,32,140,140,7,14,9,10,11,8,15,10,15,14,10,12,16,10,14,11,17,11,15,9,13,17,6,12,11,14,14,16,14,13,16,10,14,14,16,14,17,12,16,7,12,3,1,4,2,1,3,2,3,4,3,2,9,13,10,13,16,12,9,8,1,1,13,20,1,18,1,1,1,12,1,1,1,1,76,8,20,34162464,7000,6500,5500,Northern_European,140,30,1,63795.0,Unknown,25038517,3350000.0,2.0,14,1099,28,1,1,7,220,11,0.6103466525535857,0.5828877005347594,0.6691176470588234,0.0615928629296634,0.1973684210526315,0.0131578947368421,0.0397599399849962,0.0597649412353088,0.0185838495513764,0.1428571428571428,0.2558139534883721,0.5833333333333333,448,14,39,54,1,12373,6,40,74,7000000,237931.0344827586,12000000.0,3000000.0,,100000.0,2,4100000,-0.125,-0.2222222222222222
158106,Peter,Michorl,2024,3060,Austria,Wien,Austria,09-05-95,Central Midfield,Midfield,Left,176.0,30-06-26,Unknown,https://img.a.transfermarkt.technology/portrait/header/158106-1693859420.jpg?lm=1,GR1,APS Atromitos Athinon,500000.0,3000000.0,29,123,129,16,10,14,8,13,14,8,7,9,11,14,14,12,14,13,13,12,12,11,12,13,14,14,12,15,14,14,14,13,12,10,9,14,12,13,12,15,7,10,6,12,2,3,3,1,3,3,3,2,1,2,2,12,13,8,13,10,13,12,9,1,1,1,1,1,1,17,17,20,1,14,14,1,1,71,20,10,3291748,6200,6200,4204,Northern_European,125,0,0,9047.0,Unknown,16067268,9111392.0,2.0,6,1663,7,3,0,7,9,1,0.5706536120666843,0.4442780748663101,0.5588235294117647,0.0087272488501912,0.0,0.0,0.0022505626406601,0.0147536884221055,0.0505924720131114,0.1428571428571428,0.3023255813953489,0.4583333333333332,488,80,103,110,1,12194,4,13,63,500000,12962.962962962964,3000000.0,1000000.0,150000.0,250000.0,3,1325000,0.0,0.0
158863,Iñigo,Martínez,2024,131,Spain,Ondarroa,Spain,17-05-91,Centre-Back,Defender,Left,182.0,30-06-25,Carmelo SÃ¡nchez,https://img.a.transfermarkt.technology/portrait/header/158863-1652716587.jpg?lm=1,ES1,Futbol Club Barcelona,5000000.0,32000000.0,33,145,165,7,7,9,8,12,12,14,16,7,15,15,7,16,15,17,15,16,14,11,13,11,16,13,15,7,17,15,15,14,12,13,12,12,13,13,15,13,14,13,9,5,1,2,2,1,2,2,1,1,1,1,3,14,14,10,10,13,14,14,11,1,10,20,1,1,1,1,1,1,1,1,1,1,1,77,20,10,37342354,7250,7250,6500,Mediterranean_Hispanic,144,19,1,96155.0,Unknown,67104772,32000000.0,1.0,89,1086,89,1,0,3,96,2,0.7095792537708389,0.6898395721925134,0.6985294117647058,0.0928402376577215,0.125,0.0131578947368421,0.0247561890472618,0.1597899474868717,0.1777549376371565,0.0,0.4418604651162785,0.625,502,28,17,133,4,6536,28,120,91,5000000,130555.55555555556,32000000.0,8000000.0,,2500000.0,2,9000000,0.0,-0.375
159088,Robert,Andrich,2024,15,Germany,Potsdam,Germany,22-09-94,Defensive Midfield,Midfield,Right,187.0,30-06-28,Unknown,https://img.a.transfermarkt.technology/portrait/header/159088-1689710866.jpg?lm=1,L1,Bayer 04 Leverkusen FuÃŸball,17000000.0,17000000.0,30,138,139,12,10,11,8,12,14,12,13,10,13,13,10,14,12,17,14,16,15,14,12,13,17,8,15,13,12,15,16,12,11,12,14,14,13,16,14,16,14,15,5,11,2,1,3,1,1,1,3,1,2,2,3,10,14,12,8,16,12,8,13,1,1,1,1,1,1,19,1,20,1,1,14,1,1,86,12,20,13356831,6900,6900,4600,Northern_European,137,0,0,28766.0,Unknown,91108805,4825000.0,2.0,38,1177,40,3,1,7,36,4,0.6632707065361206,0.4866310160427807,0.6470588235294117,0.0277682557186268,0.0,0.0,0.0847711927981995,0.0847711927981995,0.0267785216256007,0.1428571428571428,0.5581395348837206,0.5,432,63,33,113,6,7173,9,21,82,15000000,499166.6666666667,17000000.0,2000000.0,150000.0,150000.0,5,4550000,-0.11764705882352941,0.36363636363636365
159098,Brecht,Dejaegere,2024,601,Belgium,Oostende,Belgium,29-05-91,Central Midfield,Midfield,Right,173.0,30-06-26,Unknown,https://img.a.transfermarkt.technology/portrait/header/159098-1709368362.jpg?lm=1,BE1,Koninklijke Voetbalclub Kortrijk,1000000.0,4000000.0,33,124,128,12,12,13,12,13,10,6,11,10,6,14,9,10,13,12,12,15,13,14,14,14,15,13,15,14,11,15,15,14,12,12,9,14,14,11,9,13,15,12,13,10,2,2,3,4,2,3,2,2,1,2,2,13,11,11,15,14,15,12,14,1,1,1,1,1,1,15,12,20,12,12,15,12,1,71,8,20,1702313,6200,6200,4500,Northern_European,123,0,0,13999.0,Unknown,18004488,1350000.0,2.0,7,1087,8,3,1,7,124,1,0.5706536120666843,0.4759358288770053,0.5441176470588236,0.0135089855514688,0.0,0.0,0.0047511877969492,0.0197549387346836,0.0074724297897163,0.1428571428571428,0.2325581395348837,0.625,474,40,52,75,1,11864,11,43,185,800000,22727.272727272728,4000000.0,600000.0,,300000.0,4,1100000,-0.2,-0.3333333333333333
159142,Aderllan,Santos,2024,2425,Brazil,Salgueiro,Brazil,09-04-89,Centre-Back,Defender,Right,193.0,30-06-25,Unknown,https://img.a.transfermarkt.technology/portrait/header/159142-1676543087.jpg?lm=1,PO1,Rio Ave Futebol Clube,200000.0,7500000.0,35,121,135,5,6,8,8,9,8,14,11,10,15,12,10,13,10,15,13,16,10,9,11,10,14,6,15,8,15,13,12,12,10,10,14,12,11,13,15,11,14,9,7,7,2,2,2,3,2,4,3,2,1,1,2,12,13,8,11,12,11,15,13,1,1,20,1,1,1,1,1,1,1,1,1,1,1,84,10,20,347975206,6028,6028,4978,Mixed_Race,121,0,0,3749.0,Unknown,19076427,7250000.0,2.0,10,1286,11,1,1,4,171,2,0.5478962688541943,0.5270588235294117,0.5294117647058822,0.0036114085748744,0.0,0.0,0.0007501875468867,0.0372593148287071,0.0402511180866135,0.1428571428571428,0.6976744186046511,0.7083333333333333,434,33,3,69,4,9260,1,2,11,200000,1785.7142857142858,7500000.0,2000000.0,,,7,4150000,0.0,0.0
159471,Serge,Gnabry,2024,27,Germany,Stuttgart,Germany,14-07-95,Right Winger,Attack,Right,176.0,30-06-26,ROOF,https://img.a.transfermarkt.technology/portrait/header/159471-1712776387.jpg?lm=1,L1,FC Bayern MÃ¼nchen,40000000.0,90000000.0,29,160,170,12,11,15,15,14,11,11,16,6,8,13,11,9,15,11,16,12,14,11,14,12,12,15,5,17,8,12,12,16,15,16,8,13,15,12,12,12,6,14,10,16,1,1,3,2,2,2,1,2,3,3,3,14,18,12,14,12,14,14,13,1,1,1,1,10,14,1,15,10,15,18,12,20,18,77,16,20,78165002,7998,7998,7498,Mixed_Race,151,34,20,306848.0,Unknown,28066083,4366666.667,3.0,38,1432,40,0,1,4,68,10,0.8085472347181795,0.7965775401069518,0.75,0.296289036285,0.2236842105263157,0.2631578947368421,0.1997999499874969,0.4498624656164041,0.0242321545987388,0.2857142857142857,0.3023255813953489,0.4583333333333332,395,131,77,12,0,11289,42,172,151,35000000,1078125.0,90000000.0,20000000.0,4000000.0,3000000.0,3,12500000,-0.125,-0.2222222222222222
159668,Sam,Larsson,2024,589,Sweden,GÃ¶teborg,Sweden,10-04-93,Left Winger,Attack,Right,180.0,30-06-25,TIAgency,https://img.a.transfermarkt.technology/portrait/header/159668-1726736544.jpg?lm=1,TR1,Antalyaspor,1500000.0,7000000.0,31,125,134,13,14,16,11,15,13,8,13,5,5,14,11,5,15,7,11,12,13,11,13,11,12,15,5,12,7,9,11,14,13,11,9,11,13,13,11,8,6,10,7,8,1,1,3,2,3,2,2,3,1,2,3,16,14,6,3,10,8,7,7,1,1,1,1,1,1,5,17,14,13,20,16,14,13,70,9,20,4208602,6250,6250,5000,Northern_European,124,4,1,29999.0,Unknown,93020727,3500000.0,3.0,91,582,91,0,1,7,19,7,0.5772691188145012,0.5294117647058822,0.5514705882352942,0.0289588618076162,0.0263157894736842,0.0131578947368421,0.0072518129532383,0.0347586896724181,0.0194172060335009,0.2857142857142857,0.3953488372093026,0.5416666666666665,396,79,86,18,0,7655,15,50,54,1500000,50000.0,7000000.0,1000000.0,50000.0,1000000.0,5,3325000,0.0,-0.0625
159844,Christopher,Lenz,2024,533,Germany,Berlin,Germany,22-09-94,Left-Back,Defender,Left,180.0,Unknown,ROOF,https://img.a.transfermarkt.technology/portrait/header/159844-1663065776.jpg?lm=1,L1,TSG 1899 Hoffenheim FuÃŸball-Spielbetriebs GmbH,1500000.0,5000000.0,30,134,135,9,12,12,6,12,9,11,9,12,13,12,9,14,13,13,12,14,13,14,11,13,12,11,12,11,13,16,14,13,12,13,12,14,12,16,12,15,5,13,12,6,3,2,2,1,2,3,1,2,1,2,2,6,12,6,11,13,13,13,13,1,20,14,1,19,1,1,16,1,1,8,1,1,1,75,20,11,6659860,6698,6548,4748,Northern_European,132,0,0,8000.0,Unknown,91119808,1000000.0,1.0,38,178,40,1,0,7,199,8,0.6166975390314898,0.5024598930481283,0.6102941176470589,0.0077162475726795,0.0,0.0,0.0072518129532383,0.0247561890472618,0.0055279313314258,0.0,0.3953488372093026,0.5,320,15,23,34,2,6079,20,109,173,800000,24193.548387096773,5000000.0,2500000.0,75000.0,150000.0,6,1200000,-0.4666666666666667,-0.6
160241,Kevin,Akpoguma,2024,533,Germany,Neustadt an der WeinstraÃŸe,Nigeria,19-04-95,Centre-Back,Defender,Right,192.0,30-06-26,Unique Sports Group,https://img.a.transfermarkt.technology/portrait/header/160241-1723920979.jpg?lm=1,L1,TSG 1899 Hoffenheim FuÃŸball-Spielbetriebs GmbH,3000000.0,12000000.0,29,134,137,5,9,9,10,11,8,15,11,15,13,12,10,14,11,12,13,15,11,12,9,11,14,10,9,10,11,15,13,14,12,15,17,16,16,14,14,14,12,12,7,18,2,1,2,2,3,2,2,1,2,1,1,9,15,8,7,11,13,10,11,1,15,20,16,13,14,11,1,11,1,1,1,1,8,85,10,20,5925844,6597,6597,4747,Mixed_Race,133,4,0,19164.0,Unknown,91109389,1000000.0,1.0,38,1033,70,1,1,4,199,2,0.6231807356443504,0.5023529411764706,0.6176470588235294,0.0184963987304064,0.0263157894736842,0.0,0.0147536884221055,0.0597649412353088,0.0055279313314258,0.0,0.6744186046511627,0.4583333333333332,376,19,7,64,1,6110,14,64,121,2500000,70588.23529411765,12000000.0,3500000.0,600000.0,400000.0,5,8300000,-0.16666666666666666,-0.2857142857142857
160938,Marc Oliver,Kempf,2024,1047,Germany,Lich,Germany,28-01-95,Centre-Back,Defender,Left,186.0,30-06-27,Dirk Hebel,https://img.a.transfermarkt.technology/portrait/header/160938-1657098066.jpg?lm=1,IT1,Calcio Como,1500000.0,8000000.0,29,127,134,5,8,9,6,12,5,15,6,10,13,13,8,15,13,15,12,16,14,10,13,10,16,7,14,6,13,16,13,12,11,14,15,11,14,12,16,12,10,14,10,10,2,3,3,1,3,1,1,4,3,3,1,9,14,7,10,11,12,10,14,1,1,20,1,1,1,14,1,12,1,1,1,1,1,87,20,10,4248218,6342,6342,4692,Northern_European,127,0,0,19230.0,Unknown,92027023,9111392.0,2.0,38,830,40,1,0,7,47,2,0.5894416512304843,0.4964705882352941,0.5735294117647058,0.018560129469963,0.0,0.0,0.0072518129532383,0.0397599399849962,0.0505924720131114,0.1428571428571428,0.5348837209302322,0.4583333333333332,351,43,10,50,4,6323,25,103,165,2500000,78333.33333333333,8000000.0,1500000.0,500000.0,3000000.0,4,4500000,0.6666666666666666,0.25
160954,Jannik,Huth,2024,60,Germany,Bad Kreuznach,Germany,15-04-94,Goalkeeper,Goalkeeper,Right,185.0,Unknown,Sports360 GmbH,https://img.a.transfermarkt.technology/portrait/header/160954-1723190117.jpg?lm=1,L1,Sport-Club Freiburg,400000.0,1000000.0,30,123,126,3,1,1,2,9,4,7,3,3,2,12,7,1,11,10,14,12,16,13,8,12,14,2,8,3,10,15,12,13,12,13,13,15,10,10,14,15,4,14,5,12,13,12,12,12,14,13,13,13,17,10,15,10,12,6,12,16,15,13,13,20,1,1,1,1,1,1,1,1,1,1,1,1,1,79,6,20,1305261,6008,6008,4253,Northern_European,125,0,0,6310.0,Unknown,91136179,9111392.0,2.0,38,120,40,2,1,7,189,5,0.5452500661550674,0.44951871657754,0.5588235294117647,0.006084354393124,0.0,0.0,0.0017504376094023,0.0047511877969492,0.0505924720131114,0.1428571428571428,0.5116279069767438,0.5,0,0,0,0,0,0,8,31,71,400000,12500.0,1000000.0,500000.0,,150000.0,4,950000,0.0,-0.3333333333333333
160963,Robin,Zentner,2024,39,Germany,RÃ¼desheim am Rhein,Germany,28-10-94,Goalkeeper,Goalkeeper,Right,195.0,30-06-25,W&K Fairplay,https://img.a.transfermarkt.technology/portrait/header/160963-1676499369.jpg?lm=1,L1,1. FuÃŸball- und Sportverein Mainz 05,3000000.0,5000000.0,30,128,132,5,3,2,2,8,6,6,3,2,3,8,2,1,8,8,12,12,12,12,8,12,16,5,14,3,12,12,12,11,15,13,17,14,11,12,16,13,5,14,13,11,14,15,14,8,13,11,13,13,16,10,12,7,13,6,19,13,16,14,10,20,1,1,1,1,1,1,1,1,1,1,1,1,1,96,7,20,2943143,6400,6400,4900,Northern_European,128,0,0,28766.0,Unknown,91105813,9111392.0,2.0,38,1263,40,2,1,7,1,5,0.5971156390579518,0.5187165775401069,0.5808823529411764,0.0277682557186268,0.0,0.0,0.0147536884221055,0.0247561890472618,0.0505924720131114,0.1428571428571428,0.7441860465116279,0.5,0,0,0,0,0,0,12,47,114,3000000,102586.20689655172,5000000.0,1500000.0,,250000.0,2,425000,0.0,-0.4
161011,Filip,Kosti?,2024,36,Yugoslavia (Republic),Kragujevac,Serbia,01-11-92,Left Midfield,Midfield,Left,184.0,30-06-25,World Soccer Agency,https://img.a.transfermarkt.technology/portrait/header/161011-1728391991.JPG?lm=1,TR1,FenerbahÃ§e Spor KulÃ¼bÃ¼,6500000.0,40000000.0,32,148,155,15,18,13,10,13,12,6,13,10,7,15,11,8,14,13,11,14,11,11,13,12,15,12,7,13,8,13,14,15,13,16,10,16,16,16,13,13,8,13,5,16,1,3,2,1,3,1,2,3,1,1,2,13,17,12,10,14,13,10,12,1,10,1,1,18,1,1,20,10,14,18,10,14,1,84,20,7,18833967,7400,7400,6500,Mediterranean_Hispanic,138,48,3,61731.0,Unknown,62070416,8450000.0,5.0,110,755,85,3,0,3,84,6,0.7294257740142895,0.6898395721925134,0.6544117647058822,0.0595998288926204,0.3157894736842105,0.0394736842105263,0.032258064516129,0.1997999499874969,0.0469179699436095,0.5714285714285714,0.4883720930232553,0.5833333333333333,538,79,123,64,3,5295,21,33,57,6000000,152631.57894736843,40000000.0,15000000.0,600000.0,1000000.0,6,7750000,-0.07692307692307693,-0.5
161056,Joshua,Kimmich,2024,27,Germany,Rottweil,Germany,08-02-95,Defensive Midfield,Midfield,Right,177.0,30-06-25,Unknown,https://img.a.transfermarkt.technology/portrait/header/161056-1700039639.jpg?lm=1,L1,FC Bayern MÃ¼nchen,50000000.0,90000000.0,29,178,183,15,17,12,11,16,15,11,14,12,13,18,11,12,16,15,15,15,17,13,18,16,20,13,16,12,13,17,20,12,12,13,10,20,12,20,11,18,11,17,6,19,2,3,3,2,3,3,1,1,3,2,2,14,20,8,16,16,20,12,10,1,1,14,16,1,15,20,10,18,12,8,11,8,1,75,12,20,120657610,8900,8900,8500,Northern_European,164,68,5,345204.0,Unknown,92039023,3500000.0,3.0,38,1254,40,3,1,7,68,4,0.927890976448796,0.9037433155080212,0.8455882352941175,0.3333262521400492,0.4473684210526315,0.0657894736842105,0.2498124531132783,0.4498624656164041,0.0194172060335009,0.2857142857142857,0.3255813953488373,0.4583333333333332,539,55,130,79,2,11551,19,51,47,50000000,1603225.8064516129,90000000.0,16000000.0,500000.0,5000000.0,2,3000000,0.0,-0.3333333333333333
161869,Djibril,Sidibé,2024,415,France,Troyes,France,29-07-92,Right-Back,Defender,Right,183.0,30-06-25,Unknown,https://img.a.transfermarkt.technology/portrait/header/161869-1604261378.jpg?lm=1,FR1,Toulouse Football Club,1500000.0,23000000.0,32,125,145,10,12,12,8,13,10,11,9,14,11,13,12,14,13,12,13,13,12,11,12,12,12,12,10,10,10,12,14,13,13,15,12,10,14,12,14,11,10,11,14,14,2,2,3,2,4,2,3,1,2,1,3,20,15,7,14,13,15,15,16,1,16,10,20,10,14,1,10,1,10,1,1,1,1,71,10,20,5049000,6500,6450,5000,African_Caribbean,124,18,1,15375.0,Unknown,167575,9111392.0,2.0,34,1529,36,1,1,1,203,11,0.6037311458057687,0.5294117647058822,0.5514705882352942,0.0148376749094975,0.1184210526315789,0.0131578947368421,0.0072518129532383,0.1147786946736684,0.0505924720131114,0.1428571428571428,0.4651162790697669,0.5833333333333333,427,21,42,69,2,10350,16,60,56,1200000,25000.0,23000000.0,5000000.0,300000.0,3000000.0,6,14550000,-0.2,-0.4
162029,Javier,Manquillo,2024,940,Spain,Madrid,Spain,05-05-94,Right-Back,Defender,Right,178.0,30-06-25,CAA Stellar,https://img.a.transfermarkt.technology/portrait/header/162029-1700647906.jpg?lm=1,ES1,Real Club Celta de Vigo S. A. D.,1800000.0,6000000.0,30,126,130,5,12,11,5,12,7,11,8,12,13,11,7,14,12,13,13,13,12,14,9,13,16,11,9,13,14,15,15,13,14,9,11,12,15,15,12,12,7,12,8,13,1,3,1,4,2,3,2,2,1,3,1,13,14,2,15,9,15,10,13,1,15,1,20,13,19,1,1,1,10,1,1,1,1,76,5,20,4832549,6300,6200,5250,Mediterranean_Hispanic,125,0,0,46397.0,Unknown,67141802,5000000.0,1.0,89,892,89,1,1,3,165,11,0.5706536120666843,0.5561497326203209,0.5588235294117647,0.0447930537356352,0.0,0.0,0.0087521880470117,0.0297574393598399,0.0277507708547459,0.0,0.3488372093023257,0.5,276,2,14,34,0,7964,10,44,58,1800000,48275.862068965514,6000000.0,1000000.0,1000000.0,6000000.0,8,7200000,0.0,-0.1
162038,Raúl,De Tomás,2024,367,Spain,Madrid,Spain,17-10-94,Centre-Forward,Attack,Right,180.0,30-06-27,Unknown,https://img.a.transfermarkt.technology/portrait/header/162038-1653044438.jpg?lm=1,ES1,Rayo Vallecano de Madrid S.A.D.,2000000.0,25000000.0,30,145,150,10,13,14,16,14,13,15,15,5,5,12,15,7,14,7,13,8,16,12,13,14,11,15,9,14,6,12,11,13,12,14,11,13,13,13,13,13,13,11,7,8,3,1,2,1,2,2,2,3,1,1,3,5,13,14,11,10,12,10,9,1,1,1,1,1,1,1,1,1,1,10,14,10,20,72,14,20,9144328,7250,7250,6000,Mediterranean_Hispanic,143,4,0,61590.0,Unknown,67156425,17833333.33,3.0,89,892,89,0,1,3,163,3,0.7095792537708389,0.6363636363636364,0.6911764705882353,0.0594636768581131,0.0263157894736842,0.0,0.0097524381095273,0.1247811952988247,0.0990490476402122,0.2857142857142857,0.3953488372093026,0.5,364,137,24,65,1,3936,5,15,31,800000,5000.0,25000000.0,13000000.0,600000.0,500000.0,10,25200000,-0.6,-0.84
162101,Andreas,Hansen,2024,2778,Denmark,BrÃ¸ndbyÃ¸ster,Denmark,11-08-95,Goalkeeper,Goalkeeper,Right,186.0,30-06-26,Nordic Sky,https://img.a.transfermarkt.technology/portrait/header/162101-1701443502.jpg?lm=1,DK1,Fodbold Club NordsjÃ¦lland,1000000.0,1000000.0,29,128,134,3,3,1,2,8,4,4,2,10,3,9,4,6,8,8,14,14,14,13,9,12,16,6,15,3,13,14,11,10,14,12,13,14,10,8,13,16,2,16,5,1,12,13,14,5,12,13,14,12,12,14,13,16,16,5,16,17,17,18,12,20,1,1,1,1,1,1,1,1,1,1,1,1,1,87,14,20,347975206,6401,6401,5691,Northern_European,128,11,0,4540.0,Unknown,53020679,1080000.0,1.0,28,268,30,2,1,7,87,5,0.5972479491929081,0.6033155080213903,0.5808823529411764,0.0043752118322877,0.0723684210526315,0.0,0.0047511877969492,0.0047511877969492,0.0059723881218922,0.0,0.5348837209302322,0.4583333333333332,0,0,0,0,0,0,1,7,33,1300000,52083.333333333336,1300000.0,50000.0,50000.0,50000.0,4,50000,0.3,0.8571428571428571
162434,Niklas,Stark,2024,86,Germany,Neustadt an der Aisch,Germany,14-04-95,Centre-Back,Defender,Right,190.0,30-06-26,Sports360 GmbH,https://img.a.transfermarkt.technology/portrait/header/162434-1660208662.jpg?lm=1,L1,Sportverein Werder Bremen von 1899,5500000.0,20000000.0,29,135,138,6,8,10,9,12,7,13,10,10,13,12,8,13,11,13,13,14,13,11,10,13,13,7,11,10,13,18,16,13,12,13,15,15,14,14,14,10,11,12,13,14,3,3,1,2,1,3,2,1,4,2,4,11,17,8,13,9,18,15,14,1,10,20,1,1,1,12,1,8,1,1,1,1,1,88,12,20,9909595,6878,6878,6228,Northern_European,133,2,0,27499.0,Unknown,91109615,3000000.0,1.0,38,1032,40,1,1,7,194,2,0.6603598835670812,0.6607486631016042,0.6176470588235294,0.0265448186425931,0.0131578947368421,0.0,0.0272568142035508,0.0997749437359339,0.0166393510930859,0.0,0.6279069767441858,0.4583333333333332,378,25,9,66,0,3754,36,101,92,5000000,134722.22222222222,20000000.0,4000000.0,2000000.0,3500000.0,2,2500000,-0.09090909090909091,-0.09090909090909091
162571,Anastasios,Bakasetas,2024,265,Greece,Korinth,Greece,28-06-93,Attacking Midfield,Midfield,Left,181.0,30-06-27,Unknown,https://img.a.transfermarkt.technology/portrait/header/162571-1717794428.jpg?lm=1,GR1,Panathinaikos Athlitikos Omilos,5000000.0,11000000.0,31,135,140,13,12,12,13,11,14,11,17,8,7,15,17,8,16,17,13,14,13,13,14,12,13,14,14,13,8,12,13,12,12,14,12,15,12,14,14,13,10,14,9,10,1,2,3,3,1,1,4,3,1,1,3,17,14,4,15,13,14,12,13,1,1,1,1,1,1,1,1,15,1,12,20,16,10,75,20,12,5086844,6750,6750,5000,Mediterranean_Hispanic,134,49,8,40064.0,Unknown,36039032,1200000.0,4.0,40,748,42,3,0,3,150,0,0.6434241862926701,0.5294117647058822,0.625,0.0386777995899989,0.3223684210526316,0.1052631578947368,0.0247561890472618,0.0547636909227306,0.0066390733075918,0.4285714285714285,0.418604651162791,0.5416666666666665,479,107,69,82,4,12274,10,22,22,4500000,118918.91891891892,11000000.0,2000000.0,350000.0,500000.0,7,4700000,-0.25,-0.5
162959,Daniele,Rugani,2024,610,Italy,Lucca,Italy,29-07-94,Centre-Back,Defender,Right,190.0,30-06-25,Davide Torchia,https://img.a.transfermarkt.technology/portrait/header/162959-1595858253.jpg?lm=1,NL1,AFC Ajax Amsterdam,4000000.0,22000000.0,30,134,140,5,8,9,9,13,5,15,7,7,14,12,6,14,12,7,14,12,10,16,12,11,12,10,7,6,14,17,15,12,12,15,16,15,14,15,14,15,4,11,5,8,1,1,2,3,1,2,1,3,1,3,2,10,15,2,14,11,18,18,20,1,1,20,7,1,1,1,1,1,1,1,1,1,1,84,10,20,5510878,6695,6695,5745,Mediterranean_Hispanic,134,7,0,124615.0,Unknown,43083931,4000000.0,1.0,52,870,54,1,1,3,6,2,0.6361471288700714,0.609090909090909,0.625,0.1203217050483436,0.0460526315789473,0.0,0.0197549387346836,0.1097774443610902,0.0221950609739159,0.0,0.6279069767441858,0.5,313,20,4,29,0,6735,11,50,85,3500000,113333.33333333333,22000000.0,5000000.0,200000.0,10000000.0,7,10800000,-0.125,-0.125
163048,Alberto,Paleari,2024,416,Italy,Giussano,Italy,29-08-92,Goalkeeper,Goalkeeper,Right,193.0,30-06-26,Keyscout Football,https://img.a.transfermarkt.technology/portrait/header/163048-1602149171.jpg?lm=1,IT1,Torino Calcio,500000.0,1100000.0,32,120,125,4,2,1,1,9,8,5,1,3,2,11,1,1,6,10,12,12,11,12,8,12,12,6,8,3,12,14,14,8,12,14,16,7,10,15,14,15,5,13,5,12,14,13,13,5,14,12,13,14,12,9,12,12,12,8,12,12,12,14,12,20,1,1,1,1,1,1,1,1,1,1,1,1,1,88,8,20,1170723,5988,5988,4047,Mediterranean_Hispanic,121,0,0,614.0,Unknown,43061318,9111392.0,2.0,52,541,54,2,1,3,201,5,0.5426038634559407,0.4274866310160427,0.5294117647058822,0.0005841984459355,0.0,0.0,0.0022505626406601,0.005251312828207,0.0505924720131114,0.1428571428571428,0.6976744186046511,0.5833333333333333,0,0,0,0,0,0,2,17,85,500000,16666.666666666668,1100000.0,300000.0,50000.0,75000.0,7,375000,0.0,-0.23076923076923078
163053,Mame,Thiam,2024,7160,Senegal,Nguidile,Senegal,09-10-92,Centre-Forward,Attack,Right,185.0,30-06-26, EB SPORTS ,https://img.a.transfermarkt.technology/portrait/header/163053-1694079288.png?lm=1,TR1,EyÃ¼p Spor KulÃ¼bÃ¼,2700000.0,3200000.0,32,125,135,7,9,14,12,12,5,13,9,4,5,10,10,10,14,15,13,11,14,12,12,12,12,13,12,13,9,13,13,13,12,13,11,14,13,13,14,13,9,13,6,10,1,1,1,1,2,2,3,1,3,2,4,12,14,5,12,10,12,12,13,1,1,1,1,1,1,1,1,1,1,20,1,16,18,79,12,20,347975206,6300,5458,5840,African_Caribbean,121,4,0,25000.0,Unknown,43055080,1226750.0,4.0,83,1040,84,0,1,1,66,3,0.4724794919290818,0.6192513368983956,0.5294117647058822,0.0241317410948361,0.0263157894736842,0.0,0.013253313328332,0.0157539384846211,0.006787688546904,0.4285714285714285,0.5116279069767438,0.5833333333333333,434,136,46,52,3,4623,14,47,58,2400000,61842.10526315789,3200000.0,500000.0,75000.0,375000.0,15,3275000,-0.2,-0.14285714285714285
163744,Jack,Stephens,2024,180,England,Torpoint,England,27-01-94,Centre-Back,Defender,Right,185.0,30-06-25,CAA Stellar,https://img.a.transfermarkt.technology/portrait/header/163744-1720190433.jpg?lm=1,GB1,Southampton Football Club,2000000.0,8000000.0,30,128,138,9,10,11,7,13,10,14,8,10,14,13,9,14,13,13,14,14,14,13,12,12,14,11,14,10,13,13,12,11,11,11,14,13,11,13,14,12,6,11,6,16,1,4,2,2,1,3,1,2,1,1,1,12,10,11,12,12,14,14,12,1,1,20,14,1,14,15,1,10,10,1,1,1,1,84,9,20,9496935,6399,6399,4999,Northern_European,128,0,0,52196.0,AFC Bournemouth,29071914,170000.0,1.0,32,1505,33,1,1,7,186,2,0.5969833289229955,0.5293048128342246,0.5808823529411764,0.0503926682612226,0.0,0.0,0.0097524381095273,0.0397599399849962,0.0009166921303369,0.0,0.5116279069767438,0.5,338,10,13,51,4,8809,4,24,74,2000000,62903.22580645161,8000000.0,2000000.0,0.0,,8,3825000,0.0,-0.2
163847,Eli,Dasa,2024,121,Israel,Netanya,Israel,03-12-92,Right-Back,Defender,Right,177.0,30-06-25,BG Sports,https://img.a.transfermarkt.technology/portrait/header/163847-1721727736.png?lm=1,RU1,FK Dinamo Moskva,1500000.0,2000000.0,32,127,139,10,13,12,7,12,8,9,9,12,10,13,12,12,11,11,11,10,11,11,12,11,13,14,12,13,11,14,15,13,14,8,10,8,14,16,10,10,8,7,14,10,2,2,3,1,1,4,1,2,3,1,3,11,14,4,13,7,15,13,9,1,10,7,20,11,19,14,11,13,14,8,1,11,1,69,11,20,5886307,6300,6150,4500,African_Caribbean,118,48,0,28766.0,Unknown,42017841,600000.0,1.0,51,1028,53,1,1,1,74,11,0.5640381053188674,0.4759358288770053,0.5073529411764706,0.0277682557186268,0.3157894736842105,0.0,0.0072518129532383,0.0097524381095273,0.0033056473790938,0.0,0.3255813953488373,0.5833333333333333,423,11,51,61,2,13012,12,57,142,1200000,52631.57894736842,2000000.0,500000.0,200000.0,,3,800000,-0.2,-0.3333333333333333
164705,Unknown,Raúl Silva,2024,4294,Brazil,BelÃ©m,Brazil,04-11-89,Centre-Back,Defender,Left,187.0,30-06-25,MadeinFootball,https://img.a.transfermarkt.technology/portrait/header/164705-1676967500.png?lm=1,PO1,Sporting Clube Farense,400000.0,5000000.0,35,120,134,2,8,10,7,10,7,16,8,10,16,12,6,15,11,19,13,17,12,9,10,9,15,8,14,12,14,11,12,10,10,14,16,12,11,11,15,15,20,10,11,10,1,1,3,2,1,3,2,3,1,1,3,14,12,15,11,8,11,6,2,1,1,20,1,1,1,1,1,1,1,1,1,1,1,84,20,7,347975206,5986,5986,5740,Mediterranean_Hispanic,120,0,0,3439.0,Unknown,19135096,2000000.0,1.0,10,169,11,1,0,3,191,2,0.5423392431860281,0.6085561497326203,0.5220588235294117,0.0033120672224115,0.0,0.0,0.0017504376094023,0.0247561890472618,0.0110836412122558,0.0,0.5581395348837206,0.7083333333333333,299,32,17,91,4,10849,9,59,258,200000,5357.142857142857,5000000.0,1000000.0,,50000.0,9,2800000,-0.5,-0.6923076923076923
164771,Jordan,Veretout,2024,1041,France,Ancenis,France,01-03-93,Central Midfield,Midfield,Right,177.0,30-06-26,VV Consulting,https://img.a.transfermarkt.technology/portrait/header/164771-1666815169.jpg?lm=1,FR1,Olympique Lyonnais,8000000.0,35000000.0,31,145,154,13,15,12,13,13,12,8,14,6,10,16,17,11,14,12,15,11,15,11,14,14,12,11,6,16,9,15,15,13,14,16,9,12,14,16,12,13,12,10,11,12,3,2,2,3,2,1,3,3,2,1,3,12,15,12,11,14,14,12,13,1,1,1,1,1,1,17,10,20,1,1,10,1,1,75,10,20,29933934,7250,6505,6505,Northern_European,145,5,0,106731.0,Unknown,85052016,10190000.0,5.0,34,66,36,3,1,7,143,1,0.6110082032283674,0.6903743315508021,0.7058823529411764,0.1030526058630349,0.0328947368421052,0.0,0.0397599399849962,0.1747936984246061,0.0565849051362537,0.5714285714285714,0.3255813953488373,0.5416666666666665,543,68,64,91,1,7295,6,26,33,7000000,195714.2857142857,35000000.0,8000000.0,1000000.0,4500000.0,6,18000000,-0.5333333333333333,-0.5333333333333333
164913,Soualiho,Meïté,2024,294,France,Paris,France,17-03-94,Central Midfield,Midfield,Right,187.0,30-06-26,Unknown,https://img.a.transfermarkt.technology/portrait/header/164913-1694781173.png?lm=1,PO1,Sport Lisboa e Benfica,3500000.0,13000000.0,30,130,137,8,10,13,7,13,8,13,12,9,12,14,9,13,14,13,14,14,14,12,13,13,14,13,8,13,13,14,11,11,11,16,14,15,11,14,16,10,10,12,8,11,3,3,1,1,2,1,2,3,1,4,2,12,15,8,10,11,15,13,13,1,1,1,1,1,1,18,1,20,1,1,14,1,1,82,12,20,1645874,6500,6500,5050,African_Caribbean,130,0,0,29020.0,Cremonese,85049379,6660000.0,5.0,34,1122,36,3,1,1,188,1,0.6103466525535857,0.53475935828877,0.5955882352941175,0.0280135225041931,0.0,0.0,0.0172543135783946,0.0647661915478869,0.0369732492569238,0.5714285714285714,0.5581395348837206,0.5,375,9,17,43,4,11154,3,8,22,2500000,70588.23529411765,13000000.0,2000000.0,400000.0,1500000.0,9,4050000,-0.2857142857142857,-0.16666666666666666
165007,Denis,Suárez,2024,1050,Spain,Salceda de Caselas,Spain,06-01-94,Attacking Midfield,Midfield,Right,176.0,30-06-26,Unknown,https://img.a.transfermarkt.technology/portrait/header/165007-1687272769.jpg?lm=1,ES1,Villarreal Club de FÃºtbol S.A.D.,1500000.0,18000000.0,30,148,156,13,14,15,12,16,13,7,13,9,7,16,12,11,16,9,16,9,14,12,17,13,12,15,8,14,9,16,14,13,14,13,10,12,13,12,11,11,8,16,8,14,1,3,2,1,3,2,2,1,1,3,2,12,13,8,10,11,13,14,13,1,1,1,1,1,1,1,15,17,7,18,20,12,10,66,12,20,11072215,7250,7250,6000,Mediterranean_Hispanic,146,1,0,88219.0,Unknown,67107819,4530000.0,5.0,89,1283,89,3,1,3,216,0,0.7095792537708389,0.6363636363636364,0.713235294117647,0.0851770990346724,0.006578947368421,0.0,0.0072518129532383,0.0897724431107777,0.0251395872107558,0.5714285714285714,0.3023255813953489,0.5,384,38,65,36,0,7051,15,105,137,1300000,25000.0,18000000.0,5000000.0,,8000000.0,8,8500000,-0.13333333333333333,-0.35
165467,Stole,Dimitrievski,2024,1049,Macedonia,Kumanovo,North Macedonia,25-12-93,Goalkeeper,Goalkeeper,Right,188.0,30-06-26,Promoesport,https://img.a.transfermarkt.technology/portrait/header/165467-1541150592.jpg?lm=1,ES1,Valencia Club de FÃºtbol S. A. D.,4000000.0,4000000.0,31,133,142,4,2,1,2,12,8,1,2,2,2,13,5,1,12,15,12,13,12,13,11,12,15,1,12,1,12,9,12,11,12,12,14,10,11,11,13,15,7,14,5,12,13,14,13,5,14,12,13,15,11,11,14,15,12,5,12,12,14,12,15,20,1,1,1,1,1,1,1,1,1,1,1,1,1,89,12,20,4259600,6645,6245,4645,Northern_European,131,56,0,12637.0,Unknown,47022611,750000.0,2.0,60,767,71,2,1,7,208,5,0.5766075681397195,0.4914438502673796,0.6029411764705883,0.0121938148351643,0.3684210526315789,0.0,0.0197549387346836,0.0197549387346836,0.0041390038612183,0.1428571428571428,0.581395348837209,0.5416666666666665,0,0,0,0,0,0,1,2,13,3000000,80000.0,4000000.0,1000000.0,100000.0,400000.0,5,2125000,-0.25,-0.25
165513,Berat,Djimsiti,2024,800,Switzerland,ZÃ¼rich,Albania,19-02-93,Centre-Back,Defender,Right,190.0,30-06-26,LITCHI AG,https://img.a.transfermarkt.technology/portrait/header/165513-1718627443.jpg?lm=1,IT1,Atalanta Bergamasca Calcio S.p.a.,10000000.0,22000000.0,31,142,145,4,7,8,5,10,4,15,4,5,16,11,4,16,11,13,15,17,13,13,10,13,15,6,11,7,14,16,13,11,11,13,16,14,13,14,17,13,12,12,6,12,1,1,3,3,3,4,3,3,2,1,1,13,14,5,14,7,15,12,15,1,14,20,14,1,1,1,1,1,1,1,1,1,1,83,10,20,12850716,7100,7000,5650,Mediterranean_Hispanic,139,48,1,28461.0,Unknown,98015432,9111392.0,2.0,92,1711,0,1,1,3,31,2,0.6765017200317545,0.5989304812834224,0.6617647058823528,0.027473742452494,0.3157894736842105,0.0131578947368421,0.0497624406101525,0.1097774443610902,0.0505924720131114,0.1428571428571428,0.6279069767441858,0.5416666666666665,538,22,14,84,1,7088,17,48,63,8000000,227142.85714285713,22000000.0,4000000.0,50000.0,1000000.0,6,1200000,-0.2,-0.2
165793,Takumi,Minamino,2024,162,Japan,"Izumisano, Osaka",Japan,16-01-95,Left Winger,Attack,Right,172.0,30-06-26,Sarcle Co. Ltd.,https://img.a.transfermarkt.technology/portrait/header/165793-1565700962.jpg?lm=1,FR1,Association sportive de Monaco Football Club,20000000.0,20000000.0,29,139,150,10,12,13,13,14,10,7,11,5,8,13,10,7,14,11,13,12,12,14,13,10,14,14,7,14,8,14,14,14,16,14,8,14,14,13,7,12,6,11,7,11,2,2,2,3,3,1,1,4,2,3,2,11,14,4,10,10,12,12,14,1,1,1,1,1,1,1,14,14,14,20,18,17,18,68,12,20,17034266,6950,7400,6250,10,130,42,17,89999.0,Unknown,45064891,8100000.0,3.0,54,683,56,0,1,0,24,7,0.7294257740142895,0.6631016042780749,0.5955882352941175,0.0868958977681688,0.2763157894736842,0.2236842105263157,0.0997749437359339,0.0997749437359339,0.044973471485319,0.2857142857142857,0.2093023255813952,0.4583333333333332,435,111,69,31,2,12002,8,32,44,15000000,506896.5517241379,20000000.0,5000000.0,300000.0,3000000.0,5,6500000,-0.25,0.25
165873,Federico,Barba,2024,1047,Italy,Roma,Italy,01-09-93,Centre-Back,Defender,Left,187.0,30-06-26,Team Raiola,https://img.a.transfermarkt.technology/portrait/header/165873-1725528561.jpg?lm=1,IT1,Calcio Como,1200000.0,2000000.0,31,120,132,5,12,12,6,12,5,14,7,10,12,13,6,12,13,13,13,10,12,12,11,12,12,6,10,12,14,14,13,12,12,13,13,12,13,12,12,13,8,11,8,8,1,2,2,1,2,3,3,3,2,3,2,8,14,8,12,10,14,10,13,1,17,20,1,1,1,1,1,1,1,1,1,1,1,77,20,10,1187554,6000,6000,4150,Mediterranean_Hispanic,119,0,0,16009.0,Unknown,43067335,1085714.286,7.0,52,1244,54,1,0,3,47,2,0.5441915850754168,0.4385026737967914,0.5147058823529411,0.0154498762561473,0.0,0.0,0.0057514378594648,0.0097524381095273,0.0060041350370843,0.8571428571428572,0.5581395348837206,0.5416666666666665,361,15,4,62,4,6540,10,31,50,1000000,31666.666666666668,2000000.0,500000.0,100000.0,500000.0,8,1700000,-0.16666666666666666,0.1111111111111111
165895,Matteo,Politano,2024,6195,Italy,Roma,Italy,03-08-93,Right Winger,Attack,Left,171.0,30-06-27,Unknown,https://img.a.transfermarkt.technology/portrait/header/165895-1692963030.jpg?lm=1,IT1,SocietÃ  Sportiva Calcio Napoli,13000000.0,30000000.0,31,148,153,16,15,13,13,15,14,8,16,5,6,14,14,7,14,7,14,11,15,12,13,14,14,14,10,15,7,14,13,15,16,12,7,14,14,13,9,12,4,14,7,14,3,3,2,2,2,3,4,3,3,2,3,13,14,2,11,14,15,14,10,1,1,1,1,6,9,1,10,1,14,15,15,20,16,65,20,10,25772795,7400,7250,6350,Mediterranean_Hispanic,144,7,3,78269.0,Unknown,43093382,10360000.0,5.0,52,1244,54,0,0,3,184,10,0.7095792537708389,0.6737967914438502,0.6985294117647058,0.0755692072378807,0.0460526315789473,0.0394736842105263,0.0647661915478869,0.1497874468617154,0.0575293758159948,0.5714285714285714,0.1860465116279068,0.5416666666666665,562,96,66,50,3,8009,15,31,58,10000000,301515.1515151515,30000000.0,7000000.0,150000.0,1500000.0,5,10200000,-0.23076923076923078,-0.3333333333333333
166086,Amar,Rahmanovic,2024,2696,Germany,Sindelfingen,Bosnia-Herzegovina,13-05-94,Attacking Midfield,Midfield,Left,191.0,30-06-25,BestTransfer,https://img.a.transfermarkt.technology/portrait/header/166086-1722144511.png?lm=1,RU1,PFK Krylya Sovetov Samara,2000000.0,2800000.0,30,120,140,11,11,12,12,12,11,8,14,2,12,13,6,8,13,13,12,10,13,13,13,13,12,13,9,12,9,14,14,12,11,11,9,13,12,11,11,13,9,12,8,13,3,3,2,1,4,3,1,1,1,3,3,14,12,9,10,13,12,12,13,1,1,1,1,1,1,1,1,17,1,14,20,12,1,83,20,13,4748618,6150,5280,4978,Mediterranean_Hispanic,117,5,0,27841.0,Unknown,62075209,562500.0,2.0,38,1372,10,3,0,3,149,0,0.4489282879068537,0.5270588235294117,0.4999999999999999,0.0268750597475683,0.0328947368421052,0.0,0.0097524381095273,0.0137534383595899,0.0030973082585627,0.1428571428571428,0.6511627906976742,0.5,334,62,44,95,1,10089,4,37,106,1500000,46774.1935483871,2800000.0,500000.0,300000.0,250000.0,9,475000,-0.4,-0.25
166237,Leandro,Paredes,2024,12,Argentina,San Justo,Argentina,29-06-94,Defensive Midfield,Midfield,Right,180.0,30-06-25,DCGLOBALSL,https://img.a.transfermarkt.technology/portrait/header/166237-1692881087.jpg?lm=1,IT1,Associazione Sportiva Roma,8000000.0,40000000.0,30,149,154,15,12,14,11,15,14,12,15,7,12,15,13,14,16,17,15,16,14,14,13,14,14,13,10,14,12,15,14,13,14,13,10,14,13,15,13,13,15,13,10,10,3,1,1,2,1,3,2,3,1,3,3,15,8,5,10,15,13,10,9,1,1,1,1,1,1,19,1,20,1,1,12,1,1,75,10,20,28214999,7450,7450,6750,Mediterranean_Hispanic,150,44,4,172603.0,Juventus,14024702,17875000.0,4.0,4,1301,4,3,1,3,29,4,0.7360412807621064,0.7165775401069518,0.7426470588235294,0.1666597464095936,0.2894736842105263,0.0526315789473684,0.0397599399849962,0.1997999499874969,0.0992805355704325,0.4285714285714285,0.3953488372093026,0.5,406,31,39,104,2,12344,19,82,99,5000000,145588.23529411765,40000000.0,10000000.0,4000000.0,3700000.0,9,33450000,-0.375,-0.375
166277,Roman,Zobnin,2024,232,Russia,Irkutsk,Russia,11-02-94,Central Midfield,Midfield,Right,182.0,30-06-25,Pavel Andreev,https://img.a.transfermarkt.technology/portrait/header/166277-1632577876.png?lm=1,RU1,FK Spartak Moskva,4500000.0,14000000.0,30,128,137,12,12,13,7,13,9,10,9,8,10,12,11,13,14,15,15,17,13,13,9,11,17,7,13,10,12,19,16,13,13,13,12,18,13,16,11,15,7,15,10,20,3,2,3,1,4,3,3,3,1,3,2,16,15,10,13,14,20,20,15,1,9,1,13,9,15,18,11,20,14,12,12,12,4,72,9,20,5395325,6500,6500,5254,Northern_European,123,41,0,46952.0,Unknown,58060513,3000000.0,1.0,78,660,81,3,1,7,82,1,0.6103466525535857,0.5565775401069518,0.5441176470588236,0.0453289713182703,0.2697368421052631,0.0,0.0222555638909727,0.0697674418604651,0.0166393510930859,0.0,0.4418604651162785,0.5,375,31,23,59,1,7036,13,54,163,3500000,130769.23076923077,14000000.0,5000000.0,,,1,1000000,-0.2222222222222222,-0.3
166601,Niklas,Süle,2024,16,Germany,Frankfurt am Main,Germany,03-09-95,Centre-Back,Defender,Right,195.0,30-06-26,Sports360 GmbH,https://img.a.transfermarkt.technology/portrait/header/166601-1709560223.jpg?lm=1,L1,Borussia Dortmund,15000000.0,60000000.0,29,154,162,4,12,12,8,12,5,15,12,11,15,13,10,16,12,11,14,15,14,14,12,13,15,11,11,11,15,12,12,12,10,17,17,12,16,13,18,14,8,16,8,12,2,2,1,2,2,2,2,3,1,1,2,6,12,13,9,13,9,10,12,1,10,20,17,8,12,12,1,10,1,1,1,1,1,99,12,20,42162119,7494,7494,6994,Northern_European,154,40,1,192307.0,Unknown,91107360,20000000.0,1.0,38,507,40,1,1,7,41,2,0.7418629267001853,0.7426737967914437,0.7720588235294117,0.1856862690190391,0.2631578947368421,0.0131578947368421,0.0747686921730432,0.2998249562390597,0.1110864190671963,0.0,0.7441860465116279,0.4583333333333332,422,22,14,38,1,8390,24,120,204,15000000,453787.8787878788,60000000.0,12000000.0,5500000.0,12000000.0,3,5700000,0.0,-0.3181818181818182
167105,Lukas,Lerager,2024,190,Denmark,Gladsaxe,Denmark,12-07-93,Central Midfield,Midfield,Right,188.0,31-12-25,People In Sport,https://img.a.transfermarkt.technology/portrait/header/167105-1699481305.jpg?lm=1,DK1,Football Club KÃ¸benhavn,3000000.0,6000000.0,31,131,135,5,10,10,12,12,8,14,14,6,13,13,6,14,13,15,15,15,13,13,11,13,14,6,11,13,13,15,17,12,12,12,14,15,12,17,14,11,12,14,6,12,1,3,3,4,2,3,3,2,2,1,2,16,15,10,16,15,15,13,10,1,1,1,1,1,1,15,1,20,1,1,1,1,1,80,8,20,3708789,6494,6094,4844,Northern_European,130,10,1,18821.0,Unknown,27054519,3150000.0,4.0,28,544,30,3,1,7,90,1,0.5566287377613125,0.5127272727272727,0.5955882352941175,0.0181651920081652,0.0657894736842105,0.0131578947368421,0.0147536884221055,0.0297574393598399,0.0174727075752104,0.4285714285714285,0.581395348837209,0.5416666666666665,464,45,29,84,0,11483,10,57,108,2500000,79838.70967741935,6000000.0,1000000.0,100000.0,250000.0,5,2650000,-0.16666666666666666,-0.16666666666666666
167329,Alassane,Plea,2024,18,France,Lille,France,10-03-93,Centre-Forward,Attack,Right,181.0,30-06-25,Unknown,https://img.a.transfermarkt.technology/portrait/header/167329-1627997314.jpg?lm=1,L1,Borussia Verein fÃ¼r LeibesÃ¼bungen 1900 MÃ¶nchengladbach,7000000.0,38000000.0,31,138,147,5,12,13,14,15,11,13,15,4,6,14,13,6,16,15,16,11,13,11,16,14,12,13,6,15,6,11,10,13,12,15,11,13,14,13,13,13,6,14,11,13,3,4,2,1,2,3,1,4,3,2,2,8,12,8,12,10,10,10,10,1,1,1,1,1,1,1,12,1,10,18,13,14,20,79,11,20,10312365,6893,6843,5893,African_Caribbean,137,1,0,67122.0,Unknown,85050636,11750000.0,2.0,34,834,36,0,1,1,42,3,0.6557290288436094,0.6249197860962566,0.6470588235294117,0.0648054715736761,0.006578947368421,0.0,0.0347586896724181,0.1897974493623406,0.0652518125503486,0.1428571428571428,0.418604651162791,0.5416666666666665,388,111,76,34,0,3854,16,102,138,6000000,164285.7142857143,38000000.0,8000000.0,,750000.0,2,5500000,-0.14285714285714285,-0.25
167722,Vitaliy,Buyalskyi,2024,338,Ukraine,"Kalynivka, Vinnytsya Oblast",Ukraine,06-01-93,Attacking Midfield,Midfield,Right,175.0,30-06-25,ProStar,https://img.a.transfermarkt.technology/portrait/header/167722-1726135167.png?lm=1,UKR1,Futbolniy Klub Dynamo Kyiv,5000000.0,8000000.0,31,129,135,11,11,12,11,12,10,10,11,7,9,13,14,12,12,9,12,15,13,9,13,12,15,13,13,17,10,15,16,13,13,14,9,13,13,14,9,10,10,13,11,9,4,1,2,2,3,3,3,2,1,4,1,13,8,6,16,11,16,15,12,1,1,1,1,1,1,11,13,17,10,10,20,11,12,68,12,20,5852398,5989,5989,3989,Northern_European,128,9,0,17000.0,Unknown,71042301,9111392.0,2.0,103,703,101,3,1,7,97,0,0.5427361735908971,0.421283422459893,0.5808823529411764,0.0164068029667624,0.0592105263157894,0.0,0.0247561890472618,0.0397599399849962,0.0505924720131114,0.1428571428571428,0.2790697674418605,0.5416666666666665,365,80,63,55,2,11902,21,59,69,4000000,152000.0,8000000.0,1000000.0,,400000.0,1,0,-0.2,-0.3333333333333333
167727,Andrea,Belotti,2024,1047,Italy,Calcinate,Italy,20-12-93,Centre-Forward,Attack,Right,181.0,30-06-26,Unknown,https://img.a.transfermarkt.technology/portrait/header/167727-1663581136.jpg?lm=1,IT1,Calcio Como,5000000.0,40000000.0,31,140,156,4,8,11,15,12,8,15,12,4,6,12,15,10,12,15,14,17,14,14,12,13,18,12,14,15,7,18,18,12,12,17,13,14,14,13,16,14,12,12,11,7,1,3,3,3,3,2,1,3,1,2,2,12,11,6,14,13,17,15,18,1,1,1,1,1,1,1,1,1,1,1,1,1,20,73,12,20,6909398,7000,7300,6350,Mediterranean_Hispanic,140,44,12,85385.0,Unknown,43066936,6133333.333,3.0,52,300,54,0,1,3,47,3,0.7161947605186557,0.6737967914438502,0.6691176470588234,0.0824405397028023,0.2894736842105263,0.1578947368421052,0.0247561890472618,0.1997999499874969,0.034047242051168,0.2857142857142857,0.418604651162791,0.5416666666666665,505,174,42,44,0,7409,17,53,77,2000000,55714.28571428572,40000000.0,8000000.0,400000.0,5000000.0,6,10850000,-0.6,-0.6666666666666666
167741,Mattia,Valoti,2024,2919,Italy,Vicenza,Italy,06-09-93,Central Midfield,Midfield,Right,187.0,30-06-25,GR Sports,https://img.a.transfermarkt.technology/portrait/header/167741-1663659383.jpg?lm=1,IT1,Associazione Calcio Monza,1500000.0,2500000.0,31,120,130,12,12,12,12,12,12,11,12,3,6,12,12,9,12,12,13,12,12,13,13,12,13,13,11,14,10,15,14,14,12,12,12,15,13,13,13,11,11,12,12,15,1,2,3,2,3,1,2,2,1,3,2,7,13,7,11,6,15,14,11,1,1,1,1,1,1,12,12,20,12,14,16,10,1,73,9,20,243108,6000,6000,4250,Northern_European,118,0,0,12499.0,Unknown,43050913,2875000.0,2.0,52,1582,54,3,1,7,28,1,0.5441915850754168,0.4491978609625668,0.5073529411764706,0.012060559652455,0.0,0.0,0.0072518129532383,0.0122530632658164,0.0159448873579821,0.1428571428571428,0.5581395348837206,0.5416666666666665,326,68,25,66,1,4609,12,25,35,1000000,31666.666666666668,2500000.0,500000.0,800000.0,450000.0,11,2200000,-0.3333333333333333,-0.3333333333333333
167798,Andrew,Hjulsager,2024,157,Denmark,Amager,Denmark,15-01-95,Attacking Midfield,Midfield,Right,175.0,30-06-25,Unknown,https://img.a.transfermarkt.technology/portrait/header/167798-1704873939.jpg?lm=1,BE1,Koninklijke Atletiek Associatie Gent,1000000.0,4000000.0,29,124,134,13,15,15,11,14,12,9,12,10,7,12,10,7,14,12,13,7,13,9,14,10,10,13,6,14,7,9,8,14,12,10,8,12,13,12,7,11,6,7,9,15,4,3,2,2,1,3,3,2,3,3,3,6,16,6,7,8,10,13,14,1,1,1,12,1,14,1,14,15,18,16,18,20,1,71,14,20,3562919,6004,5749,3512,Northern_European,121,0,0,10000.0,Unknown,27058391,9111392.0,2.0,28,59,30,3,1,7,120,0,0.5109817412013761,0.3702673796791443,0.5294117647058822,0.009647482104698,0.0,0.0,0.0047511877969492,0.0197549387346836,0.0505924720131114,0.1428571428571428,0.2790697674418605,0.4583333333333332,301,39,49,34,1,6575,10,92,139,800000,24137.931034482757,4000000.0,1000000.0,300000.0,600000.0,6,2100000,-0.3333333333333333,-0.5555555555555556
167799,Pierre-Emile,Højbjerg,2024,244,Denmark,KÃ¸benhavn,Denmark,05-08-95,Defensive Midfield,Midfield,Right,185.0,30-06-25,Unique Sports Group,https://img.a.transfermarkt.technology/portrait/header/167799-1629882773.jpg?lm=1,FR1,Olympique de Marseille,20000000.0,45000000.0,29,148,151,12,12,11,11,14,13,8,9,10,11,14,13,16,14,17,14,15,13,14,14,13,18,11,13,13,14,16,18,11,11,14,12,20,14,20,15,14,13,14,6,17,3,3,3,2,3,3,1,1,1,2,2,14,18,14,9,15,15,7,10,1,10,13,10,10,12,18,11,20,11,11,14,11,1,84,9,20,108817498,7400,7300,6250,Northern_European,146,58,5,115992.0,Unknown,27058392,15800000.0,2.0,28,778,30,3,1,7,144,4,0.7161947605186557,0.6631016042780749,0.713235294117647,0.1119951873635462,0.381578947368421,0.0657894736842105,0.0997749437359339,0.2248062015503876,0.0877524375677102,0.1428571428571428,0.5116279069767438,0.4583333333333332,463,32,33,75,2,6574,11,26,50,20000000,525657.8947368421,45000000.0,13000000.0,4000000.0,8000000.0,6,12000000,0.1111111111111111,-0.2857142857142857
168157,Leander,Dendoncker,2024,58,Belgium,Passendale,Belgium,15-04-95,Defensive Midfield,Midfield,Right,188.0,30-06-25,Wasserman,https://img.a.transfermarkt.technology/portrait/header/168157-1662059450.jpg?lm=1,BE1,Royal Sporting Club Anderlecht,7000000.0,32000000.0,29,135,147,9,9,11,8,11,10,16,11,10,13,14,10,14,11,14,15,14,12,15,11,14,12,10,12,12,13,15,15,13,13,14,15,12,12,14,12,16,12,14,8,13,1,3,2,1,2,2,1,2,1,3,1,15,14,12,10,11,14,11,19,1,1,15,1,1,1,18,1,20,1,1,1,1,1,76,9,20,31404762,6950,6600,6000,Northern_European,128,29,1,86994.0,Unknown,18057380,14400000.0,2.0,7,1128,8,3,1,7,175,4,0.6235776660492194,0.6363636363636364,0.5808823529411764,0.0839942178838111,0.1907894736842105,0.0131578947368421,0.0347586896724181,0.1597899474868717,0.0799744437345481,0.1428571428571428,0.581395348837209,0.4583333333333332,416,26,9,43,3,12013,12,37,43,6000000,151282.05128205128,32000000.0,6000000.0,500000.0,8000000.0,6,11250000,-0.14285714285714285,-0.45454545454545453
168989,Silvan,Widmer,2024,39,Switzerland,Aarau,Switzerland,05-03-93,Right-Back,Defender,Right,183.0,30-06-26,CAA Base Ltd,https://img.a.transfermarkt.technology/portrait/header/168989-1629202510.jpg?lm=1,L1,1. FuÃŸball- und Sportverein Mainz 05,2500000.0,9000000.0,31,136,140,4,12,11,9,12,3,12,9,17,12,12,7,13,12,13,13,14,12,12,11,12,16,11,15,14,12,15,17,14,12,13,11,18,15,16,12,16,12,15,9,13,3,3,2,2,3,2,3,1,2,3,1,16,13,7,15,16,18,12,12,1,10,16,20,10,18,1,8,1,10,1,1,1,1,79,11,20,8716940,6800,6900,5300,Northern_European,131,31,2,30684.0,Unknown,98010781,2583333.333,3.0,92,11,92,1,1,7,1,11,0.6632707065361206,0.5614973262032085,0.6029411764705883,0.0296203096348325,0.2039473684210526,0.0263157894736842,0.0122530632658164,0.0447611902975743,0.0143244719742215,0.2857142857142857,0.4651162790697669,0.5416666666666665,478,40,56,53,0,5886,20,79,154,1500000,42647.05882352941,9000000.0,2500000.0,400000.0,1400000.0,3,3850000,-0.5,-0.5714285714285714
169368,Ohi,Omoijuanfo,2024,206,Norway,Oslo,Norway,10-01-94,Centre-Forward,Attack,Right,188.0,30-06-25,Aneke/PMG ,https://img.a.transfermarkt.technology/portrait/header/169368-1553682375.jpg?lm=1,DK1,BrÃ¸ndby IdrÃ¦tsforening,1800000.0,2500000.0,30,126,133,5,8,11,14,12,7,12,11,5,8,11,13,7,11,12,14,13,15,12,12,13,12,14,10,15,9,15,13,13,13,14,14,13,13,11,13,12,14,13,5,14,1,1,1,1,2,3,1,3,2,2,2,15,14,8,11,15,14,14,12,1,1,1,1,1,1,1,1,1,1,17,14,15,20,75,9,20,2329133,6250,6250,4850,African_Caribbean,124,1,0,10082.0,Unknown,53059302,1225000.0,2.0,71,1096,73,0,1,1,45,3,0.5772691188145012,0.5133689839572192,0.5514705882352942,0.0097266627205107,0.006578947368421,0.0,0.0087521880470117,0.0122530632658164,0.0067779660546126,0.1428571428571428,0.581395348837209,0.5,430,167,39,35,0,8292,2,12,71,1500000,57291.666666666664,2500000.0,700000.0,300000.0,400000.0,6,925000,-0.16666666666666666,-0.4
169497,Juan,Cruz,2024,331,Spain,Madrid,Spain,28-07-92,Left-Back,Defender,Left,182.0,30-06-26,Roalza,https://img.a.transfermarkt.technology/portrait/header/169497-1598867290.jpg?lm=1,ES1,Club AtlÃ©tico Osasuna,2200000.0,2500000.0,32,122,132,10,13,11,7,9,10,12,10,12,13,12,5,13,11,12,13,14,9,13,10,11,6,8,8,14,14,14,16,13,14,11,12,12,13,14,11,14,13,9,11,15,3,3,1,3,3,2,3,2,3,4,1,14,11,4,7,9,11,10,10,1,20,19,1,18,1,14,16,10,1,9,1,1,1,79,20,7,756930,5800,5800,3050,Mediterranean_Hispanic,119,0,0,3030.0,Unknown,43077014,3000000.0,1.0,89,892,89,1,0,3,51,8,0.5177295580841492,0.320855614973262,0.5147058823529411,0.0029171297606138,0.0,0.0,0.010752688172043,0.0122530632658164,0.0166393510930859,0.0,0.4418604651162785,0.5833333333333333,388,8,11,72,4,6406,2,9,92,1800000,58333.333333333336,2500000.0,400000.0,75000.0,50000.0,6,2200000,-0.18181818181818182,-0.28
169681,Frederico,Venâncio,2024,2423,Portugal,SetÃºbal,Portugal,04-02-93,Centre-Back,Defender,Right,186.0,30-06-26,Unknown,https://img.a.transfermarkt.technology/portrait/header/169681-1547396267.png?lm=1,PO1,Clube Desportivo Santa Clara,700000.0,2000000.0,31,122,132,4,4,6,6,8,6,13,8,8,14,12,10,13,12,17,13,13,12,13,8,12,15,6,15,6,14,14,12,11,12,13,13,12,12,12,14,14,10,11,3,7,3,1,2,3,3,2,3,3,2,1,2,7,11,8,18,13,16,16,15,1,1,20,1,1,1,1,1,1,1,1,1,1,1,81,12,20,1636308,6100,5950,4000,Mediterranean_Hispanic,122,0,0,5836.0,Unknown,55038656,9111392.0,2.0,76,1363,79,1,1,3,57,2,0.5375760783275999,0.4224598930481283,0.536764705882353,0.0056266518090356,0.0,0.0,0.0032508127031757,0.0097524381095273,0.0505924720131114,0.1428571428571428,0.5348837209302322,0.5416666666666665,331,11,6,55,3,4941,3,9,20,700000,23076.923076923078,2000000.0,500000.0,,500000.0,4,0,0.0,-0.125
169880,Giovanni,Di Lorenzo,2024,6195,Italy,Castelnuovo di Garfagnana,Italy,04-08-93,Right-Back,Defender,Right,183.0,30-06-28,Unknown,https://img.a.transfermarkt.technology/portrait/header/169880-1661509008.jpg?lm=1,IT1,SocietÃ  Sportiva Calcio Napoli,15000000.0,25000000.0,31,152,155,4,13,11,11,12,3,14,12,11,14,13,10,16,11,14,13,15,14,13,11,13,15,6,11,14,13,15,15,15,13,15,13,18,17,17,14,16,10,12,6,14,2,2,2,2,3,3,2,2,1,4,3,14,15,7,14,14,17,13,11,1,11,16,20,10,17,1,8,1,15,1,1,1,1,83,9,20,36465002,7600,7750,6400,Mediterranean_Hispanic,148,21,2,81923.0,Unknown,43075156,3486666.667,3.0,52,330,54,1,1,3,184,11,0.7757343212490078,0.6791443850267379,0.7279411764705881,0.0790975727278784,0.1381578947368421,0.0263157894736842,0.0747686921730432,0.1247811952988247,0.0193431299036084,0.2857142857142857,0.4651162790697669,0.5416666666666665,546,29,55,84,0,7586,2,8,38,15000000,482258.06451612903,25000000.0,4000000.0,100000.0,250000.0,5,6350000,0.0,-0.3181818181818182
170472,Dimitri,Foulquier,2024,1049,France,Sarcelles,Guadeloupe,23-03-93,Right-Back,Defender,Right,183.0,30-06-25,ACE,https://img.a.transfermarkt.technology/portrait/header/170472-1447230887.jpg?lm=1,ES1,Valencia Club de FÃºtbol S. A. D.,2500000.0,4000000.0,31,135,138,9,13,12,9,12,6,9,9,11,13,11,7,12,12,11,12,14,13,13,11,13,14,11,7,13,13,12,13,16,13,14,11,15,15,14,14,13,10,13,7,16,2,1,3,3,3,1,3,4,3,3,2,12,13,5,13,10,14,15,15,1,18,1,20,14,15,1,10,1,12,9,1,10,1,77,10,20,8499721,6750,6750,4350,African_Caribbean,132,2,0,9000.0,Unknown,85045661,2250000.0,4.0,34,1345,43,1,1,1,208,11,0.6434241862926701,0.4598930481283422,0.6102941176470589,0.0086818648386888,0.0131578947368421,0.0,0.0122530632658164,0.0197549387346836,0.0124725686824634,0.4285714285714285,0.4651162790697669,0.5416666666666665,370,6,19,64,0,4947,10,36,63,2000000,54411.76470588235,4000000.0,1000000.0,200000.0,1500000.0,6,3000000,-0.2,-0.2
170481,Jean-Daniel,Akpa Akpro,2024,398,France,Toulouse,Cote d'Ivoire,11-10-92,Central Midfield,Midfield,Right,180.0,30-06-25,Unknown,https://img.a.transfermarkt.technology/portrait/header/170481-1598961837.jpg?lm=1,IT1,SocietÃ  Sportiva Lazio S.p.A.,1000000.0,3500000.0,32,127,135,7,11,13,12,12,7,12,11,6,13,12,7,14,13,14,15,16,13,13,12,12,16,13,10,14,13,15,15,13,13,14,11,17,13,14,12,13,16,13,5,15,2,3,3,1,3,4,3,3,3,1,2,20,15,7,14,12,18,15,17,1,11,1,11,11,12,12,7,20,11,1,11,10,8,71,9,20,2035139,6350,6800,5000,African_Caribbean,128,16,0,17787.0,Empoli Football Club,85053691,12700000.0,1.0,34,1512,24,3,1,1,185,1,0.6500396930404869,0.5294117647058822,0.5808823529411764,0.0171667437551117,0.1052631578947368,0.0,0.0047511877969492,0.0172543135783946,0.0705297369371371,0.0,0.3953488372093026,0.5833333333333333,295,10,18,70,1,3763,11,83,388,500000,3225.8064516129034,3500000.0,1250000.0,,1750000.0,5,3200000,-0.5,-0.5
170527,Timo,Werner,2024,148,Germany,Stuttgart,Germany,06-03-96,Left Winger,Attack,Right,180.0,30-06-25,Sports360 GmbH,https://img.a.transfermarkt.technology/portrait/header/170527-1663686137.jpg?lm=1,GB1,Tottenham Hotspur Football Club,17000000.0,80000000.0,28,154,161,6,9,12,12,11,7,13,10,4,6,11,17,8,12,16,13,11,13,12,12,11,12,11,6,16,5,15,18,18,14,17,11,15,17,16,12,15,5,12,3,12,1,3,3,3,2,2,1,2,3,1,2,8,16,8,13,10,13,8,14,1,1,1,1,1,1,1,15,1,12,18,10,13,20,75,13,20,56430002,7600,7800,7000,Northern_European,140,53,24,191781.0,Unknown,92051583,32000000.0,3.0,38,1432,40,0,1,7,202,7,0.7823498279968246,0.7433155080213903,0.6691176470588234,0.1851783543371182,0.3486842105263157,0.3157894736842105,0.0847711927981995,0.3998499624906226,0.1777549376371565,0.2857142857142857,0.3953488372093026,0.4166666666666665,508,211,93,26,0,9079,34,80,63,15000000,424242.42424242425,80000000.0,16000000.0,12000000.0,12000000.0,4,16000000,-0.11764705882352941,-0.11764705882352941
170544,Christophe,Hérelle,2024,44006,France,Nice,Martinique,22-08-92,Centre-Back,Defender,Right,191.0,30-06-26,Unknown,https://img.a.transfermarkt.technology/portrait/header/170544-1697463509.png?lm=1,TR1,Bodrumspor Spor Faaliyetleri Anonim ?irketi,1100000.0,9000000.0,32,120,130,5,10,8,6,11,5,14,10,5,15,12,6,14,12,14,14,15,12,13,8,13,14,5,10,10,14,14,14,11,13,15,14,15,12,14,14,12,10,12,6,12,1,1,3,2,1,3,3,2,2,2,4,9,14,8,12,10,12,10,10,1,1,20,15,1,13,13,1,1,1,1,1,1,1,75,6,20,1515316,6000,6450,3909,African_Caribbean,129,0,0,5749.0,Unknown,85076637,4500000.0,2.0,34,1041,63,1,1,1,39,2,0.6037311458057687,0.4127272727272726,0.588235294117647,0.0055426431068928,0.0,0.0,0.005251312828207,0.0447611902975743,0.0249729159143309,0.1428571428571428,0.6511627906976742,0.5833333333333333,297,4,2,52,5,1828,3,25,124,850000,26086.956521739132,9000000.0,2000000.0,,,5,3400000,-0.43333333333333335,-0.5277777777777778
170620,Vyacheslav,Karavaev,2024,964,Russia,Moskau,Russia,20-05-95,Right-Back,Defender,Right,175.0,30-06-26,Ivan Bakulin,https://img.a.transfermarkt.technology/portrait/header/170620-1721722730.png?lm=1,RU1,AO FK Zenit Sankt-Peterburg,5000000.0,7000000.0,29,129,134,10,12,11,12,12,9,10,11,12,13,13,10,13,13,13,15,14,13,13,11,12,15,13,11,13,12,14,13,14,11,12,11,13,15,14,12,12,8,12,7,13,1,3,1,1,3,2,2,2,1,2,1,14,13,7,15,15,15,12,13,1,13,10,20,10,14,7,1,5,11,1,1,1,1,64,10,20,6257211,6500,6500,5500,Northern_European,129,20,2,42131.0,Unknown,58076747,3500000.0,3.0,78,985,81,1,1,7,7,11,0.6103466525535857,0.5828877005347594,0.588235294117647,0.0406737304788399,0.131578947368421,0.0263157894736842,0.0247561890472618,0.0347586896724181,0.0194172060335009,0.2857142857142857,0.2790697674418605,0.4583333333333332,394,15,40,26,1,10244,7,46,212,5000000,171551.72413793104,7000000.0,1500000.0,100000.0,600000.0,7,5650000,0.0,0.0
170646,Ludwig,Augustinsson,2024,58,Sweden,Stockholm,Sweden,21-04-94,Left-Back,Defender,Left,181.0,30-06-27,Unknown,https://img.a.transfermarkt.technology/portrait/header/170646-1693900836.jpg?lm=1,BE1,Royal Sporting Club Anderlecht,4000000.0,12000000.0,30,134,141,15,16,10,8,12,14,8,12,10,12,13,10,14,13,10,14,10,15,14,12,15,15,8,8,12,13,15,14,13,12,12,10,16,13,14,12,16,6,16,5,6,2,2,2,2,1,2,1,3,2,2,3,12,16,3,13,13,18,14,16,1,20,1,1,20,1,1,13,1,1,13,1,1,1,74,20,8,8746776,6700,6700,5750,Northern_European,132,46,2,16706.0,Aston Villa,93024775,3766666.667,3.0,91,1426,91,1,0,7,175,8,0.6368086795448531,0.6096256684491979,0.6102941176470589,0.0161229114905557,0.3026315789473684,0.0263157894736842,0.0197549387346836,0.0597649412353088,0.0208987286702408,0.2857142857142857,0.418604651162791,0.5,388,14,68,43,0,11283,23,131,155,4000000,128333.33333333333,12000000.0,2500000.0,150000.0,700000.0,7,6050000,0.0,0.3333333333333333
170838,Salih,Uçan,2024,114,TÃ¼rkiye,Mugla,TÃ¼rkiye,06-01-94,Central Midfield,Midfield,Right,182.0,30-06-26,EMG Mundial,https://img.a.transfermarkt.technology/portrait/header/170838-1727357729.png?lm=1,TR1,Be?ikta? Jimnastik KulÃ¼bÃ¼,3600000.0,5500000.0,30,125,130,13,10,12,10,14,13,7,12,3,6,15,14,11,15,10,14,12,14,13,14,13,13,14,7,13,11,13,12,12,13,10,8,14,12,14,12,12,12,10,8,12,3,1,2,3,1,2,2,2,1,3,3,14,13,2,13,14,7,14,13,1,1,1,1,1,1,15,1,20,1,1,12,1,1,65,10,20,2808634,6200,6200,5000,Mediterranean_Hispanic,126,1,0,6912.0,Unknown,70058786,1550000.0,1.0,100,990,100,3,1,3,37,1,0.5706536120666843,0.5294117647058822,0.5661764705882353,0.0066656559872615,0.006578947368421,0.0,0.0177544386096524,0.0272568142035508,0.0085835717658823,0.0,0.4418604651162785,0.5,330,22,45,55,0,7291,32,80,49,3000000,77631.57894736843,5500000.0,1100000.0,1000000.0,5500000.0,9,4000000,-0.25,-0.4
170895,Garry,Rodrigues,2024,2381,Netherlands,Rotterdam,Cape Verde,27-11-90,Left Winger,Attack,Right,173.0,30-06-25,Unknown,https://img.a.transfermarkt.technology/portrait/header/170895-1726737854.png?lm=1,TR1,Sivasspor KulÃ¼bÃ¼,900000.0,9000000.0,34,120,135,10,12,13,12,13,11,8,11,4,7,12,12,7,13,8,12,9,11,9,13,11,12,14,7,14,7,11,12,15,15,13,8,11,14,12,8,12,9,12,15,13,2,3,1,2,1,3,1,3,3,3,1,12,13,10,8,12,14,10,12,1,1,1,1,1,6,1,16,1,16,20,8,19,10,70,8,20,252856,6000,6500,5000,African_Caribbean,118,41,7,23653.0,Unknown,860985,3090000.0,5.0,67,1253,17,0,1,1,183,7,0.6103466525535857,0.5294117647058822,0.5073529411764706,0.0228310546375217,0.2697368421052631,0.0921052631578947,0.0042510627656914,0.0447611902975743,0.0171393649823606,0.5714285714285714,0.2325581395348837,0.6666666666666665,400,80,75,44,2,12416,23,71,43,900000,24285.714285714286,9000000.0,1500000.0,,,10,4200000,-0.18181818181818182,-0.4
170929,Massadio,Haidara,2024,3911,France,Trappes,Mali,02-12-92,Left-Back,Defender,Left,179.0,30-06-25,HD,https://img.a.transfermarkt.technology/portrait/header/170929-1599767241.jpg?lm=1,FR1,Stade brestois 29,2000000.0,3000000.0,32,121,125,8,12,12,7,11,6,11,6,10,13,12,8,14,13,12,13,11,13,13,12,13,12,12,8,13,13,15,16,14,13,13,9,12,14,13,12,13,6,13,15,8,3,2,1,2,2,1,1,4,4,3,3,13,11,5,13,12,14,14,14,1,20,14,1,20,1,1,1,1,1,1,1,1,1,76,20,5,1399417,6047,6047,3597,African_Caribbean,122,13,1,7535.0,Unknown,85078879,2500000.0,1.0,34,1516,61,1,0,1,196,8,0.5504101614183646,0.3793582887700534,0.536764705882353,0.0072672355439853,0.0855263157894736,0.0131578947368421,0.0097524381095273,0.0147536884221055,0.0138614961526709,0.0,0.3720930232558141,0.5833333333333333,304,5,16,51,2,7501,19,226,446,1800000,48437.5,3000000.0,1000000.0,400000.0,2500000.0,3,1200000,-0.1,-0.28
170934,Mario,Lemina,2024,543,Gabon,Libreville,Gabon,01-09-93,Defensive Midfield,Midfield,Right,184.0,30-06-25,HD,https://img.a.transfermarkt.technology/portrait/header/170934-1667549900.jpg?lm=1,GB1,Wolverhampton Wanderers Football Club,10000000.0,15000000.0,31,130,147,9,9,13,11,13,8,12,12,10,12,14,9,14,13,14,13,15,12,11,13,10,15,14,12,12,10,13,15,13,13,15,13,14,13,15,16,14,12,14,12,13,2,2,1,3,3,2,2,3,2,2,3,14,15,8,10,13,14,12,9,1,1,1,10,1,10,18,1,20,10,1,7,7,1,85,10,20,6501730,6649,6649,5499,African_Caribbean,131,25,3,37499.0,Unknown,85104273,9510000.0,5.0,36,829,38,3,1,1,222,4,0.63006086266208,0.5827807486631016,0.6029411764705883,0.0362009913026852,0.1644736842105263,0.0394736842105263,0.0497624406101525,0.0747686921730432,0.0528070224172893,0.5714285714285714,0.4883720930232553,0.5416666666666665,356,18,10,58,2,8194,19,86,113,9000000,276562.5,15000000.0,2500000.0,,3000000.0,9,13000000,-0.1,-0.1
170953,Stéphane,Bahoken,2024,3205,France,Grasse,Cameroon,28-05-92,Centre-Forward,Attack,Right,185.0,30-06-25,ISF SPORTS,https://img.a.transfermarkt.technology/portrait/header/170953-1696332668.png?lm=1,TR1,Kayserispor KulÃ¼bÃ¼,800000.0,8000000.0,32,125,138,4,8,12,13,12,7,14,10,5,6,12,13,5,12,9,13,12,13,12,12,13,13,9,10,14,10,11,13,14,14,14,14,12,14,14,14,12,8,12,11,5,2,3,1,2,3,3,1,1,2,1,3,12,14,10,15,12,13,14,14,1,1,1,1,1,1,1,1,1,1,1,1,14,20,78,8,20,5875305,6350,6300,6000,African_Caribbean,128,22,4,19999.0,Unknown,85054562,9111392.0,2.0,34,556,15,0,1,1,118,3,0.5838846255623181,0.6363636363636364,0.5808823529411764,0.0193026891475241,0.1447368421052631,0.0526315789473684,0.0037509377344336,0.0397599399849962,0.0505924720131114,0.1428571428571428,0.5116279069767438,0.5833333333333333,342,67,19,40,1,5110,15,76,77,800000,17241.379310344826,8000000.0,2500000.0,,500000.0,5,3800000,-0.15789473684210525,-0.42857142857142855
170961,Thomas,Delaine,2024,667,France,Lens,France,24-03-92,Left-Back,Defender,Left,180.0,30-06-25,LÃ©andre Chouya,https://img.a.transfermarkt.technology/portrait/header/170961-1593970652.jpg?lm=1,FR1,Racing Club de Strasbourg Alsace,1000000.0,2000000.0,32,124,126,6,13,11,10,12,6,8,9,9,10,11,8,11,12,8,11,14,12,12,12,12,15,8,9,13,10,14,15,13,13,13,10,14,13,15,13,13,10,11,7,14,3,1,3,1,1,3,2,2,3,3,3,12,13,5,14,12,15,14,16,1,20,7,16,17,14,1,12,1,12,12,1,10,1,72,20,10,1901115,6200,6200,3768,Northern_European,117,0,0,9998.0,Unknown,85085647,600000.0,1.0,34,821,36,1,0,7,159,8,0.5706536120666843,0.3976470588235293,0.4999999999999999,0.009645550870166,0.0,0.0,0.0047511877969492,0.0097524381095273,0.0033056473790938,0.0,0.3953488372093026,0.5833333333333333,272,6,18,41,0,2371,14,39,49,800000,28571.428571428572,2000000.0,500000.0,,,2,1100000,-0.2,-0.3333333333333333
170986,Raphaël,Guerreiro,2024,27,France,Le Blanc-Mesnil,Portugal,22-12-93,Left-Back,Defender,Left,170.0,30-06-26,Wasserman,https://img.a.transfermarkt.technology/portrait/header/170986-1711745629.jpg?lm=1,L1,FC Bayern MÃ¼nchen,12000000.0,40000000.0,31,149,159,15,15,15,11,17,16,8,15,13,11,16,14,11,17,11,16,11,17,12,16,15,11,16,5,17,11,14,13,14,15,11,6,11,14,15,8,13,6,15,15,17,1,1,1,1,1,2,1,2,2,1,1,12,10,8,11,15,13,16,16,1,20,1,1,20,1,10,13,15,1,12,8,1,5,71,20,8,34898357,7600,7500,6250,Mediterranean_Hispanic,142,56,3,95825.0,Unknown,85045409,7250000.0,2.0,34,806,79,1,0,3,68,8,0.7426567875099233,0.6631016042780749,0.6838235294117647,0.0925215839599384,0.3684210526315789,0.0394736842105263,0.0597649412353088,0.1997999499874969,0.0402511180866135,0.1428571428571428,0.1627906976744184,0.5416666666666665,483,60,64,25,0,6825,40,138,95,10000000,280000.0,40000000.0,10000000.0,200000.0,3500000.0,3,8500000,-0.16666666666666666,-0.3333333333333333
171072,Sasa,Zdjelar,2024,2410,Yugoslavia (Republic),Belgrad,Serbia,20-03-95,Defensive Midfield,Midfield,Right,184.0,30-06-25,Unknown,https://img.a.transfermarkt.technology/portrait/header/171072-1659614721.png?lm=1,RU1,PFK CSKA Moskva,4000000.0,4000000.0,29,128,128,9,11,9,6,12,6,8,10,6,13,14,11,14,12,15,14,16,13,14,13,12,16,10,15,9,14,15,16,13,12,14,12,14,13,16,13,14,11,14,7,10,1,2,3,1,2,1,2,2,1,2,2,9,14,9,13,12,16,13,14,1,1,14,1,1,1,20,1,17,1,1,1,1,1,75,8,20,7330678,6150,6150,4650,Northern_European,130,3,0,33277.0,Unknown,62076386,500000.0,2.0,110,166,85,3,1,7,148,4,0.5640381053188674,0.4919786096256684,0.5955882352941175,0.0321241552055944,0.0197368421052631,0.0,0.0197549387346836,0.0197549387346836,0.0027500763910108,0.1428571428571428,0.4883720930232553,0.4583333333333332,403,8,24,75,1,11403,8,16,20,4000000,138888.88888888888,4000000.0,500000.0,750000.0,1000000.0,5,500000,0.0,0.0
171679,Matt,Doherty,2024,543,Ireland,Dublin,Ireland,16-01-92,Right-Back,Defender,Right,185.0,30-06-26,Gestifute,https://img.a.transfermarkt.technology/portrait/header/171679-1682598455.jpg?lm=1,GB1,Wolverhampton Wanderers Football Club,3000000.0,20000000.0,32,138,152,7,12,15,12,13,10,13,10,13,13,13,8,13,13,11,13,13,13,14,13,14,14,12,12,16,13,14,13,13,11,13,13,15,13,15,14,15,11,12,10,13,3,1,1,4,1,1,1,3,3,2,2,10,12,9,15,13,13,11,10,1,10,10,20,1,20,1,1,1,8,1,1,1,1,89,10,20,21514367,6898,7098,5798,Northern_European,137,29,1,86994.0,Unknown,52032335,8445000.0,2.0,49,433,52,1,1,7,222,11,0.6894681132574755,0.61475935828877,0.6470588235294117,0.0839942178838111,0.1907894736842105,0.0131578947368421,0.0147536884221055,0.0997749437359339,0.0468901913942053,0.1428571428571428,0.5116279069767438,0.5833333333333333,506,45,56,51,1,10431,10,30,92,2500000,81666.66666666667,20000000.0,4000000.0,,150000.0,4,8050000,-0.16666666666666666,-0.375
172015,Fernando,Pacheco,2024,714,Spain,Badajoz,Spain,18-05-92,Goalkeeper,Goalkeeper,Left,187.0,30-06-26,EMG Mundial,https://img.a.transfermarkt.technology/portrait/header/172015-1647529834.jpg?lm=1,ES1,Reial Club Deportiu Espanyol de Barcelona S.A.D.,2000000.0,18000000.0,32,143,145,3,3,3,1,12,6,8,2,1,3,13,3,3,12,8,13,13,12,14,11,12,13,5,11,1,13,14,13,10,14,9,12,11,12,10,14,11,8,13,12,12,12,13,14,10,15,14,14,16,15,14,14,11,12,7,14,11,14,13,13,20,1,1,1,1,1,1,1,1,1,1,1,1,1,81,20,10,15027338,7000,7000,5500,Mediterranean_Hispanic,140,0,0,19549.0,Unknown,67155103,2200000.0,1.0,89,123,89,2,0,3,170,5,0.6765017200317545,0.5828877005347594,0.6691176470588234,0.0188681613778199,0.0,0.0,0.0097524381095273,0.0897724431107777,0.0121947831884219,0.0,0.5581395348837206,0.5833333333333333,0,0,0,0,0,0,9,45,151,900000,15151.515151515152,18000000.0,4000000.0,,400000.0,5,3300000,-0.55,-0.64
173504,James,Tarkowski,2024,29,England,Manchester,England,19-11-92,Centre-Back,Defender,Right,185.0,30-06-26,Unknown,https://img.a.transfermarkt.technology/portrait/header/173504-1655979328.jpg?lm=1,GB1,Everton Football Club,13000000.0,28000000.0,32,138,150,3,6,10,8,13,4,16,6,7,15,14,10,15,12,13,15,14,14,15,10,12,13,10,13,8,14,16,15,14,10,13,14,14,14,13,13,14,10,12,9,8,3,1,4,2,3,2,1,1,2,3,3,12,15,5,7,13,7,11,12,1,1,20,10,1,1,9,1,1,1,1,1,1,1,77,9,20,53683875,7200,6900,6000,Northern_European,138,2,0,104393.0,Unknown,29055569,4000000.0,1.0,32,905,33,1,1,7,65,2,0.6632707065361206,0.6363636363636364,0.6544117647058822,0.1007949926951053,0.0131578947368421,0.0,0.0647661915478869,0.1397849462365591,0.0221950609739159,0.0,0.5116279069767438,0.5833333333333333,493,21,13,96,1,5913,8,30,78,10000000,398000.0,28000000.0,5000000.0,50000.0,,3,1800000,-0.23076923076923078,-0.23076923076923078
173859,Davide,Zappacosta,2024,800,Italy,Sora,Italy,11-06-92,Right Midfield,Midfield,Right,182.0,30-06-25,World Soccer Agency,https://img.a.transfermarkt.technology/portrait/header/173859-1661268432.jpg?lm=1,IT1,Atalanta Bergamasca Calcio S.p.a.,6000000.0,20000000.0,32,138,149,10,13,12,9,12,9,9,11,11,12,13,4,13,12,11,11,14,13,14,11,13,15,11,7,15,12,15,16,15,12,13,12,15,16,14,12,13,6,13,7,14,1,3,3,2,1,1,1,2,1,1,2,12,15,4,13,12,15,14,14,1,12,1,20,12,20,1,10,1,17,1,8,1,1,70,9,20,10006613,6900,6900,5650,Mediterranean_Hispanic,131,13,0,32115.0,Unknown,43061433,12100000.0,3.0,52,1396,54,3,1,3,31,9,0.6632707065361206,0.5989304812834224,0.6029411764705883,0.0310021079424916,0.0855263157894736,0.0,0.0297574393598399,0.0997749437359339,0.0671963110086391,0.2857142857142857,0.4418604651162785,0.5833333333333333,436,29,43,56,0,7714,24,123,180,6000000,174264.70588235295,20000000.0,3000000.0,75000.0,275000.0,8,14225000,0.0,0.0
173900,Hélder,Costa,2024,1465,Angola,Luanda,Angola,12-01-94,Right Winger,Attack,Left,179.0,30-06-25,MadeinFootball,https://img.a.transfermarkt.technology/portrait/header/173900-1687958907.JPG?lm=1,PO1,Grupo Desportivo Estoril Praia,1500000.0,15000000.0,30,127,145,12,12,15,11,14,11,6,10,2,4,11,13,4,15,9,11,10,12,10,11,9,13,16,7,13,5,10,13,16,15,11,7,12,16,14,8,12,10,12,9,12,2,2,1,1,2,1,3,2,2,2,3,13,14,5,12,11,12,15,14,1,1,1,1,1,1,1,13,1,12,20,10,19,9,77,20,8,3642479,6350,6350,5550,Mixed_Race,124,6,1,52196.0,Al-Ittihad Club Jeddah,55024865,16350000.0,2.0,3,868,3,0,0,4,109,10,0.590500132310135,0.588235294117647,0.5514705882352942,0.0503926682612226,0.0394736842105263,0.0131578947368421,0.0072518129532383,0.0747686921730432,0.0908080780021667,0.1428571428571428,0.3720930232558141,0.5,351,53,59,23,0,3258,4,58,172,900000,21428.571428571428,15000000.0,3000000.0,300000.0,800000.0,10,9800000,-0.55,-0.6785714285714286
174094,Morgan,Sanson,2024,417,France,Saint-Doulchard,France,18-08-94,Central Midfield,Midfield,Right,180.0,30-06-27,Unknown,https://img.a.transfermarkt.technology/portrait/header/174094-1674519367.jpg?lm=1,FR1,Olympique Gymnaste Club Nice CÃ´te d'Azur,8000000.0,28000000.0,30,136,145,12,13,14,11,15,13,8,13,5,8,15,10,11,14,13,14,12,14,12,15,13,14,14,10,13,10,16,15,14,14,15,8,14,14,14,12,10,8,11,14,11,1,3,1,2,2,2,3,3,2,2,2,7,15,9,16,14,15,14,15,1,1,1,1,1,1,13,13,20,13,13,17,13,1,73,8,20,21278174,6799,6949,5499,Northern_European,137,0,0,69595.0,Unknown,85046988,8125000.0,4.0,34,1272,36,3,1,7,142,1,0.6697539031489812,0.5827807486631016,0.6470588235294117,0.0671934430725168,0.0,0.0,0.0397599399849962,0.1397849462365591,0.0451123642323397,0.4285714285714285,0.3953488372093026,0.5,368,47,42,51,0,4765,17,101,214,7000000,207575.75757575757,28000000.0,5500000.0,500000.0,6500000.0,5,6000000,-0.125,0.0
174694,Rony,Lopes,2024,11282,Brazil,BelÃ©m,Portugal,28-12-95,Right Winger,Attack,Left,174.0,30-06-26,DV7 Management,https://img.a.transfermarkt.technology/portrait/header/174694-1672838605.jpg?lm=1,TR1,Alanyaspor,2200000.0,28000000.0,28,120,145,15,13,15,12,15,14,6,13,3,5,12,14,5,16,9,12,9,11,8,14,11,12,15,8,13,6,12,13,13,14,15,6,12,12,11,8,9,12,13,9,13,2,4,2,2,2,1,3,3,3,2,3,8,13,7,12,12,12,15,14,1,1,1,1,1,1,1,6,7,16,19,16,20,1,68,20,10,680249,6000,6250,5000,Mediterranean_Hispanic,119,2,0,42192.0,ESTAC Troyes,55038681,12666666.67,3.0,10,169,79,0,0,3,15,10,0.5772691188145012,0.5294117647058822,0.5147058823529411,0.0407326331320665,0.0131578947368421,0.0,0.010752688172043,0.1397849462365591,0.0703445466262951,0.2857142857142857,0.2558139534883721,0.4166666666666665,364,70,56,26,1,8762,6,50,96,2000000,53571.42857142857,28000000.0,12500000.0,2000000.0,9000000.0,9,25800000,-0.2,-0.2
174733,Omar,Colley,2024,1091,The Gambia,Lamin,The Gambia,24-10-92,Centre-Back,Defender,Left,191.0,30-06-25,Unknown,https://img.a.transfermarkt.technology/portrait/header/174733-1727966851.png?lm=1,GR1,Panthessalonikios Athlitikos Omilos Konstantinoupoliton,3000000.0,8000000.0,32,127,135,4,4,4,6,6,4,15,6,4,15,10,4,12,10,13,12,12,10,12,10,12,12,4,10,9,13,13,13,12,11,19,15,13,12,15,18,12,12,12,4,10,1,3,3,3,3,2,2,3,1,2,1,12,15,11,7,12,12,12,12,1,1,20,1,1,1,1,1,1,1,1,1,1,1,87,20,10,2523962,6350,6500,5200,African_Caribbean,123,38,0,33845.0,Unknown,13115373,4416666.667,3.0,96,794,96,1,0,1,153,2,0.6103466525535857,0.5508021390374331,0.5441176470588236,0.0326726258126876,0.25,0.0,0.0147536884221055,0.0397599399849962,0.0245099400927803,0.2857142857142857,0.6511627906976742,0.5833333333333333,414,28,2,74,4,9490,16,28,72,2500000,76666.66666666667,8000000.0,1500000.0,,,5,1800000,-0.2857142857142857,-0.32432432432432434
175179,Unknown,Luccas Claro,2024,7160,Brazil,RibeirÃ£o Preto,Brazil,02-10-91,Centre-Back,Defender,Right,180.0,30-06-25,Unknown,https://img.a.transfermarkt.technology/portrait/header/175179-1663352234.png?lm=1,TR1,EyÃ¼p Spor KulÃ¼bÃ¼,400000.0,2250000.0,33,120,135,8,10,10,9,11,10,14,9,12,14,11,9,14,11,13,12,12,13,12,11,11,12,8,14,10,15,14,13,13,12,13,13,14,12,13,14,13,12,10,9,10,2,1,2,2,4,3,1,3,4,2,1,13,12,9,13,13,15,8,10,1,7,20,7,1,1,7,1,1,1,1,1,1,1,83,7,20,3950668,6300,6300,4300,African_Caribbean,127,0,0,14999.0,Unknown,19096976,9111392.0,2.0,10,1227,11,1,1,1,66,2,0.5838846255623181,0.4545454545454545,0.5735294117647058,0.014474602817478,0.0,0.0,0.0017504376094023,0.0110027506876719,0.0505924720131114,0.1428571428571428,0.3953488372093026,0.625,408,17,9,67,0,7349,4,16,74,400000,10606.060606060606,2250000.0,1250000.0,,200000.0,3,750000,-0.1111111111111111,-0.2727272727272727
175449,Moi,Gómez,2024,331,Spain,Rojales,Spain,23-06-94,Left Winger,Attack,Right,176.0,30-06-27,InterStarDeporte,https://img.a.transfermarkt.technology/portrait/header/175449-1664970613.jpg?lm=1,ES1,Club AtlÃ©tico Osasuna,3500000.0,10000000.0,30,137,154,13,14,12,12,15,12,8,13,8,7,15,12,10,16,8,12,9,12,12,15,14,14,15,8,14,11,14,14,11,14,14,7,13,12,13,11,11,8,13,8,14,2,1,2,3,1,1,2,2,2,2,3,8,9,7,15,13,12,6,12,1,1,1,1,1,1,1,12,16,10,20,18,12,1,73,14,20,8924879,6850,6850,4450,Mediterranean_Hispanic,134,0,0,16866.0,Unknown,67142544,1550000.0,2.0,89,1243,89,0,1,3,51,7,0.6566551997883038,0.4705882352941176,0.625,0.0162774102531172,0.0,0.0,0.0172543135783946,0.0497624406101525,0.0085835717658823,0.1428571428571428,0.3023255813953489,0.5,470,38,51,47,0,5284,8,22,32,3000000,71428.57142857143,10000000.0,5000000.0,1500000.0,5000000.0,6,2000000,-0.14285714285714285,-0.4
175639,Jonathan,Clauss,2024,417,France,Strasbourg,France,25-09-92,Right-Back,Defender,Right,178.0,30-06-26,UTOPIA,https://img.a.transfermarkt.technology/portrait/header/175639-1666815234.jpg?lm=1,FR1,Olympique Gymnaste Club Nice CÃ´te d'Azur,7000000.0,15000000.0,32,143,148,12,15,14,10,13,13,6,12,13,13,14,8,13,13,14,11,14,12,12,13,13,15,10,8,13,12,13,14,16,14,12,9,15,16,14,11,15,12,14,6,9,1,1,2,2,1,3,2,2,2,1,2,10,13,9,11,13,12,10,12,1,12,1,20,12,20,1,12,1,16,1,1,1,1,67,8,20,22369159,7147,7147,4997,Mediterranean_Hispanic,134,4,0,46720.0,Unknown,85045209,6250000.0,2.0,34,1430,36,1,1,3,142,11,0.695951309870336,0.5290909090909091,0.625,0.0451049481125562,0.0263157894736842,0.0,0.0347586896724181,0.0747686921730432,0.0346954082057834,0.1428571428571428,0.3488372093023257,0.5833333333333333,384,44,68,30,2,3351,6,16,28,6000000,264772.7272727273,15000000.0,5000000.0,,,5,5525000,-0.5,-0.6
175722,Eric,Dier,2024,27,England,Cheltenham,England,15-01-94,Centre-Back,Defender,Right,191.0,30-06-25,Unknown,https://img.a.transfermarkt.technology/portrait/header/175722-1665608595.jpg?lm=1,L1,FC Bayern MÃ¼nchen,10000000.0,40000000.0,30,153,156,7,12,11,9,13,11,16,11,5,14,14,8,16,13,16,15,16,13,14,12,14,16,5,13,11,16,15,15,11,10,11,13,14,14,13,16,13,5,12,6,17,1,3,3,1,2,3,3,1,2,1,1,17,14,5,14,13,16,14,11,1,5,20,8,1,1,13,1,10,1,1,1,1,1,90,17,20,159332595,7642,7642,6342,Northern_European,153,45,3,104393.0,Unknown,55032265,5000000.0,1.0,32,350,33,1,1,7,68,2,0.7614448266737233,0.6729411764705882,0.7647058823529411,0.1007949926951053,0.2960526315789473,0.0394736842105263,0.0497624406101525,0.1997999499874969,0.0277507708547459,0.0,0.6511627906976742,0.5,460,16,18,60,1,11044,14,67,60,8000000,217647.0588235294,40000000.0,10000000.0,600000.0,5000000.0,2,1500000,-0.3333333333333333,-0.3333333333333333
175988,Anthony,Nwakaeme,2024,449,Nigeria,Lagos,Nigeria,21-03-89,Left Winger,Attack,Right,185.0,30-06-26,DW Sports Management,https://img.a.transfermarkt.technology/portrait/header/175988-1723800455.jpg?lm=1,TR1,Trabzonspor KulÃ¼bÃ¼,1300000.0,5500000.0,35,135,136,8,13,17,13,15,8,11,14,9,5,15,11,5,17,13,15,13,15,12,16,14,12,18,10,14,5,13,13,12,12,16,11,17,12,11,15,15,4,15,7,8,3,2,2,2,3,1,2,4,2,2,3,13,10,6,11,12,12,10,9,1,1,1,1,1,1,1,1,1,1,20,1,1,12,80,10,20,347975206,6650,4415,5353,African_Caribbean,135,1,0,57692.0,Unknown,57070194,9111392.0,2.0,69,789,70,0,1,1,204,7,0.3344800211696216,0.5671657754010695,0.6323529411764706,0.0556997007552092,0.006578947368421,0.0,0.0062515628907226,0.0272568142035508,0.0505924720131114,0.1428571428571428,0.5116279069767438,0.7083333333333333,476,139,99,27,1,11463,28,70,64,1000000,20000.0,5500000.0,2500000.0,,,7,3975000,-0.3333333333333333,-0.5
176139,Mattia,Bani,2024,252,Italy,Borgo San Lorenzo,Italy,10-12-93,Centre-Back,Defender,Right,188.0,30-06-26,Unknown,https://img.a.transfermarkt.technology/portrait/header/176139-1595917932.jpg?lm=1,IT1,Genoa Cricket and Football Club,2500000.0,3200000.0,31,126,133,6,10,8,8,11,7,15,8,10,13,12,8,14,12,14,14,13,12,13,9,13,12,6,10,8,13,14,13,11,12,13,14,15,13,13,15,11,12,13,7,12,4,1,4,3,3,1,1,2,1,3,2,11,13,8,12,12,14,16,12,1,1,20,10,1,1,1,1,1,1,1,1,1,1,79,7,20,2157482,6293,6393,5043,Mediterranean_Hispanic,126,0,0,17787.0,Unknown,43091093,2340583.333,6.0,52,228,54,1,1,3,104,2,0.5961894681132575,0.5340106951871657,0.5661764705882353,0.0171667437551117,0.0,0.0,0.0122530632658164,0.0157539384846211,0.01297582340065,0.7142857142857142,0.581395348837209,0.5416666666666665,366,13,3,85,3,4554,16,46,44,2000000,56451.6129032258,3200000.0,700000.0,75000.0,125000.0,7,1275000,-0.2,0.0
176485,Lucas,Piazón,2024,110302,Brazil,SÃ£o Paulo,Brazil,20-01-94,Attacking Midfield,Midfield,Right,182.0,30-06-25,Unknown,https://img.a.transfermarkt.technology/portrait/header/176485-1407140888.jpg?lm=1,PO1,Avs Futebol SAD,1200000.0,7500000.0,30,125,138,12,11,14,13,15,13,8,13,7,6,15,14,8,15,10,8,6,12,10,15,12,8,14,5,15,7,11,10,12,13,13,10,12,12,11,10,12,6,12,12,13,2,1,2,4,2,1,3,3,2,1,1,12,14,10,7,9,12,11,12,1,1,1,1,1,1,1,20,10,15,20,18,18,14,72,12,20,2335430,6407,6265,4904,Mediterranean_Hispanic,116,0,0,5822.0,BOT,19128545,7500000.0,1.0,10,1456,11,3,1,3,35,0,0.5792537708388462,0.5191443850267379,0.4926470588235294,0.0056131331673115,0.0,0.0,0.0057514378594648,0.0372593148287071,0.041640045556821,0.0,0.4418604651162785,0.5,316,51,42,26,2,8243,6,37,131,1000000,-224137.93103448275,7500000.0,2000000.0,7000000.0,7000000.0,13,9950000,-0.16666666666666666,-0.16666666666666666
177467,Gerard,Moreno,2024,1050,Spain,Santa PerpÃ¨tua de Mogoda,Spain,07-04-92,Centre-Forward,Attack,Left,180.0,30-06-27,YOU FIRST,https://img.a.transfermarkt.technology/portrait/header/177467-1726231623.jpg?lm=1,ES1,Villarreal Club de FÃºtbol S.A.D.,10000000.0,40000000.0,32,154,161,8,11,13,17,15,9,14,13,8,5,14,15,6,14,13,15,13,15,14,13,14,16,13,12,16,8,15,16,13,13,13,13,12,14,14,14,15,4,17,12,8,3,4,1,1,4,4,2,1,1,1,4,15,13,5,14,12,15,15,16,1,1,1,1,1,1,1,1,1,13,8,9,16,20,77,20,13,51480004,7700,7700,5000,Mediterranean_Hispanic,153,17,5,51243.0,Unknown,67115823,10750000.0,2.0,89,1328,89,0,0,3,216,3,0.7691188145011907,0.5294117647058822,0.7647058823529411,0.0494724350067158,0.1118421052631578,0.0657894736842105,0.0497624406101525,0.1997999499874969,0.0596961026695185,0.1428571428571428,0.3953488372093026,0.5833333333333333,471,184,64,48,0,6800,9,57,54,5000000,132352.9411764706,40000000.0,10000000.0,,,4,1000000,-0.5,-0.6666666666666666
177476,Nathan,Aké,2024,281,Netherlands,Den Haag,Netherlands,18-02-95,Centre-Back,Defender,Left,180.0,30-06-27,Wasserman,https://img.a.transfermarkt.technology/portrait/header/177476-1666733797.jpg?lm=1,GB1,Manchester City Football Club,40000000.0,42000000.0,29,153,164,2,10,13,8,14,6,15,10,10,15,14,3,15,14,12,15,14,15,15,13,13,15,6,14,5,15,14,16,16,14,13,12,14,15,15,15,13,10,13,8,15,4,1,1,1,1,3,3,1,4,3,3,16,14,10,12,12,15,11,8,1,17,20,1,10,1,17,1,10,1,1,1,1,1,75,20,10,43218521,7650,6815,6526,African_Caribbean,153,27,3,127591.0,Unknown,37025551,22966666.67,3.0,67,407,68,1,0,1,131,2,0.652024345064832,0.6926203208556149,0.7647058823529411,0.123195382031987,0.1776315789473684,0.0394736842105263,0.1997999499874969,0.2098024506126531,0.1275683583988444,0.2857142857142857,0.3953488372093026,0.4583333333333332,360,26,13,29,1,11287,17,82,78,35000000,1155172.4137931035,42000000.0,7000000.0,1500000.0,4500000.0,5,22000000,-0.125,-0.125
177547,Unknown,Matheus,2024,1075,Brazil,Belo Horizonte,Brazil,29-03-92,Goalkeeper,Goalkeeper,Right,190.0,30-06-27,Team of Future,https://img.a.transfermarkt.technology/portrait/header/177547-1591775250.png?lm=1,PO1,Sporting Clube de Braga,6000000.0,6000000.0,32,142,145,7,2,3,2,10,9,8,3,3,1,12,4,3,10,15,13,16,12,12,9,11,14,3,14,3,13,13,14,13,14,14,14,13,12,13,14,13,5,14,7,11,14,12,16,15,12,15,13,17,17,12,14,13,12,6,12,10,12,10,12,20,1,1,1,1,1,1,1,1,1,1,1,1,1,84,6,20,16409250,7100,6311,5634,Mediterranean_Hispanic,142,0,0,8950.0,Unknown,19158787,2400000.0,1.0,10,168,11,2,1,3,192,5,0.5853400370468378,0.5972192513368983,0.6838235294117647,0.0086335839753883,0.0,0.0,0.0297574393598399,0.0297574393598399,0.0133059251645879,0.0,0.6279069767441858,0.5833333333333333,0,0,0,0,0,0,3,39,230,5000000,165000.0,6000000.0,1000000.0,,,1,300000,-0.16666666666666666,-0.16666666666666666
177776,Unknown,César,2024,2503,Brazil,Rio de Janeiro,Brazil,27-01-92,Goalkeeper,Goalkeeper,Right,192.0,30-06-26,Unknown,https://img.a.transfermarkt.technology/portrait/header/177776-1543846059.jpg?lm=1,PO1,Boavista Futebol Clube,200000.0,900000.0,32,124,130,1,1,8,3,12,5,1,1,1,1,10,2,2,10,5,13,11,14,11,10,12,13,3,7,1,13,13,14,12,13,7,17,10,12,15,11,10,3,15,15,15,13,13,14,5,14,11,14,13,14,12,15,16,12,9,12,13,13,9,10,20,1,1,1,1,1,1,1,1,1,1,1,1,1,83,7,20,1187998,6200,6200,4202,Mediterranean_Hispanic,122,0,0,2950.0,Unknown,19124580,65000.0,1.0,10,1234,11,2,1,3,38,5,0.5706536120666843,0.4440641711229946,0.536764705882353,0.002839880379333,0.0,0.0,0.0007501875468867,0.0042510627656914,0.0003333425928498,0.0,0.6744186046511627,0.5833333333333333,0,0,0,0,0,0,1,32,290,300000,5357.142857142857,900000.0,400000.0,,150000.0,4,250000,2.0,2.0
177779,Janik,Haberer,2024,89,Germany,Wangen im AllgÃ¤u,Germany,02-04-94,Central Midfield,Midfield,Right,186.0,30-06-25,Unique Sports Group,https://img.a.transfermarkt.technology/portrait/header/177779-1692707721.jpg?lm=1,L1,1. FC Union Berlin,3000000.0,10000000.0,30,130,132,7,11,11,10,13,7,12,8,8,8,12,13,10,12,18,12,16,13,13,12,13,14,13,11,14,10,16,18,12,13,9,15,17,13,17,10,11,6,11,7,17,1,2,3,3,1,3,4,2,3,1,3,9,17,8,12,10,16,13,16,1,1,1,1,1,1,8,14,19,16,14,20,16,12,80,12,20,3270160,6250,6250,5750,Northern_European,126,0,0,19177.0,Unknown,92056736,9111392.0,2.0,38,1643,40,3,1,7,0,1,0.5772691188145012,0.6096256684491979,0.5661764705882353,0.0185089517548645,0.0,0.0,0.0147536884221055,0.0497624406101525,0.0505924720131114,0.1428571428571428,0.5348837209302322,0.5,422,52,31,60,0,5861,11,30,195,2500000,75000.0,10000000.0,3000000.0,75000.0,500000.0,5,2500000,-0.16666666666666666,-0.5
177847,Adnan,Januzaj,2024,472,Belgium,Brussel,Belgium,05-02-95,Right Winger,Attack,Left,186.0,30-06-25,Promoesport,https://img.a.transfermarkt.technology/portrait/header/177847-1685115304.png?lm=1,ES1,UniÃ³n Deportiva Las Palmas S.A.D.,2000000.0,15000000.0,29,143,155,16,13,17,13,15,15,5,15,3,6,15,13,6,17,10,11,8,13,11,16,13,10,17,11,13,8,8,11,15,16,15,9,11,14,12,9,10,5,14,12,15,2,1,1,2,2,3,1,3,2,2,1,18,15,11,10,12,11,7,13,1,1,1,1,1,1,1,18,12,16,17,13,20,10,75,20,11,22014169,7150,7150,6000,Northern_European,141,13,1,30072.0,Unknown,18054092,4437500.0,2.0,7,265,8,0,0,7,207,10,0.696348240275205,0.6363636363636364,0.6764705882352942,0.0290293518680348,0.0855263157894736,0.0131578947368421,0.0097524381095273,0.0747686921730432,0.024625684046779,0.1428571428571428,0.5348837209302322,0.4583333333333332,353,44,49,41,1,8229,16,67,86,1500000,-16666.666666666668,15000000.0,3000000.0,6000000.0,8000000.0,7,7000000,-0.25,-0.5
177907,Harry,Maguire,2024,985,England,Sheffield,England,05-03-93,Centre-Back,Defender,Right,194.0,30-06-25,Triple S Sports,https://img.a.transfermarkt.technology/portrait/header/177907-1663841733.jpg?lm=1,GB1,Manchester United Football Club,18000000.0,70000000.0,31,145,158,4,6,10,8,13,6,17,7,7,15,13,10,16,13,14,15,17,13,12,12,12,11,12,15,7,16,14,12,10,8,13,17,17,12,17,17,12,12,13,5,8,1,2,3,4,2,3,1,1,4,1,1,15,15,5,13,11,16,14,17,1,1,20,10,1,1,1,1,1,1,1,1,1,1,100,10,20,57546395,7250,7800,7000,Northern_European,143,46,7,231983.0,Unknown,28049740,34616666.67,3.0,32,1366,33,1,1,7,132,2,0.7823498279968246,0.7433155080213903,0.6911764705882353,0.2239980996652205,0.3026315789473684,0.0921052631578947,0.0897724431107777,0.3498374593648412,0.1922923785105142,0.2857142857142857,0.7209302325581395,0.5416666666666665,566,34,25,116,4,12533,11,57,57,15000000,427142.85714285716,70000000.0,14000000.0,50000.0,750000.0,5,30250000,-0.16666666666666666,-0.25
177960,Hamza,Barry,2024,443,The Gambia,Banjul,The Gambia,15-10-94,Central Midfield,Midfield,Right,175.0,30-06-25,Unknown,https://img.a.transfermarkt.technology/portrait/header/177960-1646079313.JPG?lm=1,DK1,Vejle Boldklub,400000.0,1500000.0,30,124,132,10,8,14,9,13,10,9,11,8,9,14,10,11,14,8,13,11,11,10,14,12,10,12,7,11,11,13,11,13,12,10,8,14,13,12,7,10,6,8,5,12,3,3,3,2,2,3,2,2,2,4,1,13,12,4,5,10,10,10,10,1,1,1,1,1,1,16,11,20,11,10,18,10,6,73,16,20,1158634,5800,5800,4750,African_Caribbean,118,13,0,1881.0,Unknown,13109649,250000.0,1.0,96,137,96,3,1,1,209,1,0.5177295580841492,0.5026737967914437,0.5073529411764706,0.0018076355219692,0.0855263157894736,0.0,0.0017504376094023,0.0072518129532383,0.0013611489208033,0.0,0.2790697674418605,0.5,313,28,35,66,0,8134,1,7,156,350000,-7894.736842105263,1500000.0,350000.0,,,4,550000,-0.125,0.16666666666666666
178313,Jean-Eudes,Aholou,2024,1420,Cote d'Ivoire,Yopougon,Cote d'Ivoire,20-03-94,Defensive Midfield,Midfield,Left,186.0,30-06-26,Unknown,https://img.a.transfermarkt.technology/portrait/header/178313-1525697526.jpg?lm=1,FR1,Angers Sporting Club de l'Ouest,800000.0,10000000.0,30,130,135,6,10,12,8,13,7,13,10,8,13,13,10,14,12,14,13,15,13,12,12,12,14,8,10,12,12,14,16,13,12,14,15,15,13,16,16,11,9,12,7,12,4,1,3,2,2,3,1,3,1,3,2,12,15,7,12,12,13,13,13,1,1,1,1,1,1,20,1,19,1,1,1,1,1,80,20,8,3126660,6496,6246,3996,African_Caribbean,130,2,0,18397.0,Unknown,13112746,5833333.333,3.0,23,1687,24,3,0,1,18,4,0.5767398782746759,0.4220320855614973,0.5955882352941175,0.0177557702873773,0.0131578947368421,0.0,0.0037509377344336,0.0497624406101525,0.032380529086919,0.2857142857142857,0.5348837209302322,0.5,284,20,9,45,2,2608,2,23,106,1500000,52380.95238095238,10000000.0,3000000.0,,,5,7900000,0.875,-0.25
178425,Dani,García,2024,683,Spain,Zumarraga,Spain,24-05-90,Central Midfield,Midfield,Right,180.0,30-06-25,RGFOOTBALL,https://img.a.transfermarkt.technology/portrait/header/178425-1728417881.png?lm=1,GR1,Olympiakos Syndesmos Filathlon Peiraios,1500000.0,6000000.0,34,141,152,11,10,10,8,14,10,13,10,6,15,13,9,15,13,15,13,15,14,14,11,14,13,13,15,11,15,18,17,12,13,13,10,13,13,13,14,12,13,12,8,10,4,2,2,3,3,3,3,1,3,3,2,17,13,8,15,13,15,15,14,1,1,1,1,1,1,20,1,19,1,1,10,1,1,82,11,20,20511447,7050,7050,5550,Mediterranean_Hispanic,141,0,0,24310.0,Unknown,67104797,9111392.0,2.0,89,1708,89,3,1,3,141,1,0.6831172267795713,0.588235294117647,0.6764705882352942,0.0234654651812898,0.0,0.0,0.0072518129532383,0.0297574393598399,0.0505924720131114,0.1428571428571428,0.3953488372093026,0.6666666666666665,508,4,13,164,1,5511,10,32,65,1200000,32142.85714285714,6000000.0,1200000.0,,,2,300000,-0.3333333333333333,-0.4
179184,Michy,Batshuayi,2024,141,Belgium,Brussel,Belgium,02-10-93,Centre-Forward,Attack,Right,185.0,30-06-27,Sport Cover,https://img.a.transfermarkt.technology/portrait/header/179184-1696447598.png?lm=1,TR1,Galatasaray Spor KulÃ¼bÃ¼,8000000.0,40000000.0,31,130,160,5,8,12,12,12,9,13,13,3,6,12,14,5,14,14,12,14,11,11,11,10,9,14,4,14,8,15,16,13,14,16,13,12,13,15,15,12,5,10,9,5,3,2,1,1,2,2,1,1,1,3,3,13,15,17,7,14,9,8,8,1,1,1,1,1,1,1,1,1,1,1,1,1,20,78,15,20,9947608,6700,7190,5742,African_Caribbean,130,45,25,96154.0,Unknown,18053710,16166666.67,3.0,7,265,8,0,1,1,102,3,0.7016406456734586,0.6087700534759358,0.5955882352941175,0.0928392720404555,0.2960526315789473,0.3289473684210526,0.0397599399849962,0.1997999499874969,0.0897895312092002,0.2857142857142857,0.5116279069767438,0.5416666666666665,496,193,44,46,2,15995,9,32,36,7000000,157954.54545454544,40000000.0,10000000.0,1500000.0,8000000.0,10,43000000,-0.17647058823529413,-0.06666666666666667
179643,Vladimír,Darida,2024,605,CSSR,Plze?,Czech Republic,08-08-90,Central Midfield,Midfield,Right,172.0,30-06-25,CHOVANECSPORT,https://img.a.transfermarkt.technology/portrait/header/179643-1657098719.jpg?lm=1,GR1,Aris Thessalonikis,800000.0,10000000.0,34,128,140,12,11,11,11,12,12,6,12,7,8,12,13,10,13,14,12,13,12,14,12,11,15,11,11,13,11,18,20,11,13,13,6,18,11,17,7,17,3,16,11,17,4,3,1,1,1,3,2,1,2,1,3,12,14,4,13,11,17,15,17,1,1,1,1,1,1,17,12,20,12,10,18,10,10,67,12,20,2135374,6500,7041,5992,Northern_European,120,76,8,47913.0,Unknown,25019899,3900000.0,2.0,14,1155,28,3,1,7,20,1,0.6819264355649642,0.6355080213903743,0.5220588235294117,0.0462569295109051,0.5,0.1052631578947368,0.0037509377344336,0.0497624406101525,0.0216394899858329,0.1428571428571428,0.2093023255813952,0.6666666666666665,449,61,65,75,3,9667,23,80,91,700000,17142.85714285714,10000000.0,3000000.0,,,3,2500000,-0.2222222222222222,-0.3
179860,Andraz,Sporar,2024,265,Slovenia,Ljubljana,Slovenia,27-02-94,Centre-Forward,Attack,Right,186.0,30-06-26,AR Sport Management,https://img.a.transfermarkt.technology/portrait/header/179860-1719928232.jpg?lm=1,GR1,Panathinaikos Athlitikos Omilos,3500000.0,5500000.0,30,125,135,7,9,12,13,13,10,13,11,6,4,10,14,6,12,11,13,12,13,11,12,13,13,15,5,14,7,11,10,13,12,14,12,13,14,13,14,12,9,14,12,7,3,1,1,1,3,3,3,2,1,1,2,12,15,15,16,13,14,12,10,1,1,1,1,1,1,1,1,1,1,1,6,7,20,82,12,20,5444999,6500,6600,5000,Northern_European,125,39,5,23653.0,Unknown,62083377,3475000.0,4.0,87,850,87,0,1,7,150,3,0.6235776660492194,0.5294117647058822,0.5588235294117647,0.0228310546375217,0.256578947368421,0.0657894736842105,0.0172543135783946,0.0272568142035508,0.0192783132864801,0.4285714285714285,0.5348837209302322,0.5,436,180,56,39,0,13015,20,117,191,2500000,77586.20689655172,5500000.0,1000000.0,250000.0,800000.0,8,5500000,-0.375,-0.5
181118,Tomasz,Kedziora,2024,1091,Poland,SulechÃ³w,Poland,11-06-94,Centre-Back,Defender,Right,184.0,30-06-26,Fabryka Futbolu,https://img.a.transfermarkt.technology/portrait/header/181118-1727966811.png?lm=1,GR1,Panthessalonikios Athlitikos Omilos Konstantinoupoliton,2500000.0,5000000.0,30,126,130,9,12,9,8,10,5,13,7,12,11,12,14,14,11,14,12,16,11,14,12,11,11,8,14,12,12,14,15,13,13,14,13,14,13,15,14,12,13,13,3,11,1,1,1,4,2,4,3,3,1,2,4,13,12,3,16,12,13,13,11,1,13,14,20,4,17,1,1,1,7,1,1,1,1,77,8,20,5129262,6307,6267,3767,Northern_European,126,26,1,6399.0,Unknown,96026801,950000.0,2.0,75,1434,78,1,1,7,153,2,0.5795183911087589,0.3975401069518716,0.5661764705882353,0.0061702943297988,0.1710526315789473,0.0131578947368421,0.0122530632658164,0.0247561890472618,0.0052501458373843,0.1428571428571428,0.4883720930232553,0.5,447,22,34,71,2,18594,7,74,172,2500000,85714.28571428571,5000000.0,1000000.0,150000.0,1000000.0,4,2500000,0.0,0.0
181136,Piotr,Zieli?Ski,2024,46,Poland,Z?bkowice ?l?skie,Poland,20-05-94,Central Midfield,Midfield,Right,180.0,30-06-28,BMG-SPORT,https://img.a.transfermarkt.technology/portrait/header/181136-1692962961.jpg?lm=1,IT1,Football Club Internazionale Milano S.p.A.,22000000.0,50000000.0,30,155,159,14,14,13,14,17,12,7,15,4,7,17,14,7,16,10,15,11,12,9,16,14,11,15,10,14,10,15,12,13,14,12,9,16,14,14,10,14,7,11,6,15,2,3,2,3,3,1,2,3,1,2,2,13,13,13,14,13,15,14,12,1,1,1,1,1,1,14,13,20,12,11,20,10,1,69,17,20,50943751,7750,7700,6750,Northern_European,149,72,9,124615.0,Unknown,43093171,8050000.0,2.0,75,1691,78,3,1,7,89,1,0.7691188145011907,0.7165775401069518,0.7352941176470587,0.1203217050483436,0.4736842105263157,0.1184210526315789,0.1097774443610902,0.2498124531132783,0.0446956859912775,0.1428571428571428,0.3953488372093026,0.5,504,68,57,48,0,7579,15,28,35,18000000,527941.1764705882,50000000.0,10000000.0,300000.0,2500000.0,6,6250000,-0.18181818181818182,-0.4
181375,Sébastien,Haller,2024,1244,France,Ris-Orangis,Cote d'Ivoire,22-06-94,Centre-Forward,Attack,Right,190.0,30-06-25,management 360,https://img.a.transfermarkt.technology/portrait/header/181375-1709560699.jpg?lm=1,ES1,Club Deportivo LeganÃ©s S.A.D.,10000000.0,45000000.0,30,141,145,6,9,10,15,12,7,14,9,4,7,11,17,6,13,12,15,16,15,15,12,15,12,15,10,12,7,14,15,12,11,16,17,16,13,16,18,15,6,15,6,5,1,2,1,2,3,1,3,2,2,1,1,14,16,6,13,13,11,14,16,1,1,1,1,1,1,1,1,1,1,1,10,1,20,82,10,20,25127735,7000,6900,6100,Mixed_Race,139,15,4,210959.0,Unknown,85051578,23250000.0,5.0,34,1236,24,0,1,4,54,3,0.6632707065361206,0.6470588235294117,0.6617647058823528,0.2036969622646428,0.0986842105263157,0.0526315789473684,0.0497624406101525,0.2248062015503876,0.1291424761798938,0.5714285714285714,0.6279069767441858,0.5,410,167,61,30,1,8830,16,72,167,3000000,78378.37837837837,45000000.0,9000000.0,750000.0,1250000.0,7,14700000,-0.7,-0.8333333333333334
181378,Gaëtan,Laborde,2024,417,France,Mont-de-Marsan,France,03-05-94,Centre-Forward,Attack,Left,181.0,30-06-26,Unknown,https://img.a.transfermarkt.technology/portrait/header/181378-1596553589.jpg?lm=1,FR1,Olympique Gymnaste Club Nice CÃ´te d'Azur,8000000.0,18000000.0,30,140,145,5,13,13,15,13,10,17,14,5,4,13,12,4,12,13,14,14,13,14,13,12,15,11,8,15,11,17,18,13,13,13,15,15,13,16,14,14,8,14,5,14,2,3,1,4,4,3,3,1,3,2,1,10,14,7,15,8,16,12,15,1,1,1,1,1,1,1,1,1,1,13,10,15,20,78,20,8,13890406,7000,7000,4250,Northern_European,142,0,0,40917.0,Unknown,85075725,11000000.0,3.0,34,970,36,0,0,7,142,3,0.6765017200317545,0.4491978609625668,0.6838235294117647,0.0395014711179047,0.0,0.0,0.0397599399849962,0.0897724431107777,0.0610850301397261,0.2857142857142857,0.418604651162791,0.5,425,135,46,28,1,7645,3,20,85,5000000,160714.2857142857,18000000.0,5000000.0,,600000.0,5,6300000,-0.5,-0.6666666666666666
181380,Arthur,Masuaku,2024,114,France,Lille,DR Congo,07-11-93,Left-Back,Defender,Left,179.0,30-06-25,Sport Cover,https://img.a.transfermarkt.technology/portrait/header/181380-1696075631.png?lm=1,TR1,Be?ikta? Jimnastik KulÃ¼bÃ¼,4000000.0,10000000.0,31,131,140,12,14,14,7,14,10,9,13,13,11,12,9,11,15,9,12,10,12,11,12,12,12,15,8,13,12,12,12,15,15,13,9,16,15,15,11,12,10,14,10,14,2,3,2,1,3,4,2,1,2,1,1,16,16,14,12,16,13,11,11,1,19,1,1,20,1,1,16,1,1,10,1,1,1,70,20,5,7950524,6546,6546,5346,African_Caribbean,130,11,1,46397.0,BeÅŸiktaÅŸ A.Åž.,85074537,3133333.333,3.0,34,834,29,1,0,1,37,8,0.6164329187615771,0.5664171122994652,0.5955882352941175,0.0447930537356352,0.0723684210526315,0.0131578947368421,0.0197549387346836,0.0497624406101525,0.017380112408678,0.2857142857142857,0.3720930232558141,0.5416666666666665,330,8,37,58,3,8682,19,92,98,3500000,109677.41935483871,10000000.0,2000000.0,,500000.0,3,1500000,-0.16666666666666666,-0.3
181382,Abdoulaye,Touré,2024,738,France,Nantes,Guinea,03-03-94,Defensive Midfield,Midfield,Right,188.0,30-06-25,Unknown,https://img.a.transfermarkt.technology/portrait/header/181382-1485420758.jpg?lm=1,FR1,Le Havre Athletic Club,3000000.0,10000000.0,30,120,134,4,7,12,10,10,10,12,11,5,13,12,13,14,11,13,12,13,13,13,10,12,16,10,11,12,13,14,14,12,12,14,14,15,12,13,16,12,12,11,9,8,2,3,2,2,3,1,3,3,1,2,2,13,15,8,15,12,14,14,14,1,1,1,1,1,1,20,1,20,1,1,1,1,1,84,8,20,2490431,6300,6450,5100,African_Caribbean,120,0,0,18249.0,Unknown,85075621,3500000.0,1.0,34,1014,44,3,1,1,126,4,0.6037311458057687,0.5401069518716577,0.5220588235294117,0.0176128589320079,0.0,0.0,0.0147536884221055,0.0497624406101525,0.0194172060335009,0.0,0.581395348837209,0.5,267,17,12,23,3,4075,6,39,124,3000000,105555.55555555556,10000000.0,2000000.0,,150000.0,6,1800000,0.0,0.5
181579,James,Ward-Prowse,2024,703,England,Portsmouth,England,01-11-94,Central Midfield,Midfield,Right,177.0,30-06-25,CAA Stellar,https://img.a.transfermarkt.technology/portrait/header/181579-1684751045.jpg?lm=1,GB1,Nottingham Forest Football Club,22000000.0,38000000.0,30,152,155,20,18,10,12,13,20,7,11,6,9,15,12,13,15,15,13,13,14,13,16,14,17,11,18,13,13,17,19,12,13,14,7,20,11,20,12,17,11,13,6,14,2,3,3,3,1,3,3,3,2,3,1,11,14,4,18,12,17,14,13,1,1,1,12,1,12,18,10,20,14,10,14,14,1,66,10,20,61090523,7600,7600,6450,Northern_European,150,11,2,115992.0,Unknown,29076100,34800000.0,1.0,32,1173,33,3,1,7,140,1,0.755887801005557,0.6844919786096256,0.7426470588235294,0.1119951873635462,0.0723684210526315,0.0263157894736842,0.1097774443610902,0.1897974493623406,0.1933109253034806,0.0,0.3255813953488373,0.5,486,64,65,53,2,8732,4,35,71,16000000,469117.64705882355,38000000.0,8000000.0,2000000.0,9000000.0,3,8450000,-0.4666666666666667,-0.5789473684210527
181767,Unknown,Marquinhos,2024,583,Brazil,SÃ£o Paulo,Brazil,14-05-94,Centre-Back,Defender,Right,183.0,30-06-28,Bertolucci Sports,https://img.a.transfermarkt.technology/portrait/header/181767-1672303747.jpg?lm=1,FR1,Paris Saint-Germain Football Club,50000000.0,75000000.0,30,164,165,4,11,10,8,14,4,15,10,7,16,14,8,16,14,14,17,15,17,17,13,16,17,10,15,8,16,17,15,13,13,16,13,15,14,16,14,15,8,15,8,15,1,1,3,1,3,3,3,1,1,1,3,15,16,7,15,14,18,15,16,1,1,20,14,1,1,16,1,1,1,1,1,1,1,75,10,20,191688462,8195,8595,7645,Mixed_Race,164,69,4,276164.0,Unknown,19163495,18550000.0,2.0,10,1456,11,1,1,4,154,2,0.887536385287113,0.8122994652406417,0.8455882352941175,0.2666600360947734,0.4539473684210526,0.0526315789473684,0.2498124531132783,0.3748437109277319,0.1030306397399927,0.1428571428571428,0.4651162790697669,0.5,514,38,13,41,2,15712,29,79,47,40000000,1207575.7575757576,75000000.0,13000000.0,10000000.0,25000000.0,2,14250000,-0.2,-0.3333333333333333
181778,Unknown,Emerson,2024,379,Brazil,Santos,Italy,03-08-94,Left-Back,Defender,Left,176.0,30-06-26,PS Sports,https://img.a.transfermarkt.technology/portrait/header/181778-1660636930.jpg?lm=1,GB1,West Ham United Football Club,12000000.0,30000000.0,30,139,158,12,14,14,7,15,10,9,14,10,12,12,4,14,14,11,13,12,12,12,12,11,14,14,8,15,12,13,14,16,15,15,9,13,15,14,13,13,11,9,5,13,2,3,1,1,2,2,2,3,1,2,1,8,12,9,13,10,14,13,12,1,20,1,15,15,12,1,14,10,10,1,1,1,1,77,20,10,37578710,7150,7250,5750,Mixed_Race,136,27,0,110192.0,Unknown,19158043,12466666.67,3.0,10,1340,54,1,0,4,220,8,0.7095792537708389,0.6096256684491979,0.6397058823529411,0.1063946072206928,0.1776315789473684,0.0,0.0597649412353088,0.1497874468617154,0.0692334046501291,0.2857142857142857,0.3023255813953489,0.5,303,13,16,41,2,9119,10,50,158,12000000,395000.0,30000000.0,6000000.0,,400000.0,9,12450000,0.0,0.0
181783,Cláudio,Winck,2024,10484,Brazil,PortÃ£o,Brazil,15-04-94,Right-Back,Defender,Right,184.0,30-06-25,GOAL CLUB,https://img.a.transfermarkt.technology/portrait/header/181783-1727699056.jpg?lm=1,TR1,Kas?mpa?a Spor KulÃ¼bÃ¼,700000.0,1000000.0,30,122,130,10,10,13,10,12,13,9,13,13,12,11,14,14,13,15,13,14,12,14,11,10,12,14,11,12,10,14,15,13,12,10,9,13,14,14,12,14,14,12,13,14,3,2,1,2,4,3,1,1,1,1,2,12,13,8,10,12,11,12,10,1,1,1,15,1,20,1,1,13,14,1,1,13,1,77,7,20,742614,6092,5892,4094,Northern_European,121,0,0,3499.0,Unknown,19159360,9111392.0,2.0,10,1175,11,1,1,7,117,11,0.5299020905001324,0.4325133689839571,0.5294117647058822,0.0033700042583721,0.0,0.0,0.0032508127031757,0.0047511877969492,0.0505924720131114,0.1428571428571428,0.4883720930232553,0.5,265,32,23,68,4,5257,6,27,56,700000,16000.0,1000000.0,200000.0,,750000.0,7,550000,0.0,0.16666666666666666
182201,Ally,Samatta,2024,1091,Tanzania,Dar es Salam,Tanzania,23-12-92,Centre-Forward,Attack,Right,183.0,30-06-25,1863,https://img.a.transfermarkt.technology/portrait/header/182201-1727967720.png?lm=1,GR1,Panthessalonikios Athlitikos Omilos Konstantinoupoliton,1500000.0,12000000.0,32,120,132,12,12,12,12,14,10,11,11,6,5,12,15,6,11,18,12,15,8,12,11,12,12,14,6,14,5,12,14,14,14,13,12,14,15,13,12,11,10,11,8,11,2,2,2,2,1,1,1,3,3,2,3,10,18,7,10,8,10,10,8,1,1,1,1,1,1,1,1,1,1,16,14,14,20,78,7,20,2347774,6000,6747,4753,African_Caribbean,116,68,22,88141.0,K Racing Club Genk,13102011,4342500.0,4.0,94,403,94,0,1,1,153,3,0.643027255887801,0.502994652406417,0.4926470588235294,0.0851017808879237,0.4473684210526315,0.2894736842105263,0.0072518129532383,0.0597649412353088,0.0240978916081002,0.4285714285714285,0.4651162790697669,0.5833333333333333,415,126,41,32,1,14488,8,25,83,1000000,28571.428571428572,12000000.0,2500000.0,,,6,5500000,-0.4444444444444444,-0.6
182323,Lucas,Lima,2024,6890,Brazil,EstaÃ§Ã£o (RS),Brazil,10-10-91,Left-Back,Defender,Right,179.0,30-06-25,Un1que Football,https://img.a.transfermarkt.technology/portrait/header/182323-1695642485.png?lm=1,TR1,?stanbul Ba?ak?ehir Futbol KulÃ¼bÃ¼,1000000.0,7500000.0,33,135,155,13,7,10,10,15,3,13,10,4,15,15,11,17,13,15,18,18,15,14,12,13,19,11,14,13,15,16,16,9,9,14,10,17,9,10,12,14,11,15,10,12,3,2,1,1,2,3,1,1,1,4,2,19,17,6,19,17,20,13,16,1,1,11,1,1,1,20,1,14,1,1,10,1,1,73,11,20,861432,6900,6900,6250,Mediterranean_Hispanic,134,22,0,22277.0,Unknown,8833577,3550000.0,2.0,10,477,11,1,1,3,4,8,0.6632707065361206,0.6631016042780749,0.625,0.021502365279493,0.1447368421052631,0.0,0.0047511877969492,0.0372593148287071,0.0196949915275424,0.1428571428571428,0.3720930232558141,0.625,445,18,39,63,2,7055,2,3,10,900000,21212.121212121212,7500000.0,1500000.0,,200000.0,7,1600000,-0.1,-0.3076923076923077
182581,Tonny,Vilhena,2024,265,Netherlands,Maassluis,Netherlands,03-01-95,Central Midfield,Midfield,Left,175.0,30-06-27,Team of Future,https://img.a.transfermarkt.technology/portrait/header/182581-1707301588.jpg?lm=1,GR1,Panathinaikos Athlitikos Omilos,2500000.0,14000000.0,29,131,141,11,11,13,11,14,12,7,15,7,7,13,8,12,13,14,14,13,13,12,13,11,10,14,9,14,11,9,14,13,14,15,8,17,13,15,12,13,7,13,7,13,1,1,1,2,3,2,4,1,2,3,2,8,15,13,9,8,10,13,18,1,1,1,1,10,1,18,14,20,1,11,14,11,1,75,20,14,5675138,6550,6500,5900,African_Caribbean,131,15,0,20999.0,U.S. Salernitana 1919,168335,4833333.333,3.0,67,888,68,3,0,1,150,1,0.6103466525535857,0.6256684491978609,0.6029411764705883,0.0202683064135333,0.0986842105263157,0.0,0.0122530632658164,0.0697674418604651,0.026824819206089,0.2857142857142857,0.2790697674418605,0.4583333333333332,455,64,45,67,1,12468,8,15,36,2000000,60937.5,14000000.0,3000000.0,3500000.0,4000000.0,5,4950000,-0.3333333333333333,-0.42857142857142855
182618,Tiemoué,Bakayoko,2024,1091,France,Paris,France,17-08-94,Defensive Midfield,Midfield,Right,189.0,30-06-25,Unknown,https://img.a.transfermarkt.technology/portrait/header/182618-1727967288.png?lm=1,GR1,Panthessalonikios Athlitikos Omilos Konstantinoupoliton,2000000.0,40000000.0,30,132,145,5,7,12,8,11,6,14,10,12,14,12,11,16,12,17,12,16,11,12,12,11,14,8,10,12,14,15,14,13,12,16,14,14,14,13,16,10,15,12,10,9,1,3,3,3,1,2,2,2,3,2,2,11,14,11,9,11,9,11,10,1,1,1,1,1,1,20,1,20,1,1,1,1,1,77,11,20,9748428,6599,7149,6249,African_Caribbean,130,1,0,112499.0,AC Milan,85119867,24000000.0,2.0,34,1122,36,3,1,1,153,4,0.6962159301402487,0.6629946524064171,0.5955882352941175,0.108622286253376,0.006578947368421,0.0,0.0097524381095273,0.1997999499874969,0.1333092585905164,0.1428571428571428,0.6046511627906974,0.5,323,15,10,48,2,7408,11,66,92,1500000,35714.28571428572,40000000.0,6500000.0,,5000000.0,8,25750000,-0.25,-0.25
182710,João,Teixeira,2024,2424,Portugal,Seixal,Portugal,06-02-94,Attacking Midfield,Midfield,Right,178.0,30-06-25,MadeinFootball,https://img.a.transfermarkt.technology/portrait/header/182710-1537969065.png?lm=1,PO1,Gil Vicente Futebol Clube,800000.0,1000000.0,30,124,128,12,12,14,11,14,12,5,13,4,8,14,11,10,15,14,12,10,13,12,14,11,13,14,11,13,11,12,13,12,14,13,7,12,13,12,8,10,8,12,7,8,2,3,3,1,1,1,3,4,3,3,4,12,11,6,13,11,11,8,11,1,1,1,1,1,1,14,12,20,5,18,20,12,1,70,12,20,1125588,6196,6196,4696,Mediterranean_Hispanic,122,0,0,2500.0,Unknown,55024870,9111392.0,2.0,76,1359,79,3,1,3,106,0,0.570124371526859,0.496898395721925,0.536764705882353,0.0024053526096289,0.0,0.0,0.0037509377344336,0.0047511877969492,0.0505924720131114,0.1428571428571428,0.3488372093023257,0.5,309,32,37,62,4,4298,7,54,125,400000,13636.363636363636,1000000.0,400000.0,,300000.0,9,1400000,-0.5,-0.5
182722,Bruno,Varela,2024,2420,Portugal,Lisboa,Cape Verde,04-11-94,Goalkeeper,Goalkeeper,Right,191.0,30-06-26,Footunited,https://img.a.transfermarkt.technology/portrait/header/182722-1537345329.jpg?lm=1,PO1,VitÃ³ria Sport Clube,4000000.0,8000000.0,30,131,138,3,1,2,1,10,6,4,2,2,3,10,2,1,9,12,13,14,11,14,12,12,15,3,7,2,13,12,14,12,14,12,13,13,12,11,13,12,13,11,13,9,14,9,15,13,13,13,14,16,12,14,12,20,14,8,16,8,15,5,8,20,1,1,1,1,1,1,1,1,1,1,1,1,1,85,8,20,2557168,6535,6535,5485,Mixed_Race,132,0,0,4750.0,Unknown,55027991,100000.0,1.0,76,843,17,2,1,4,217,5,0.6149775072770575,0.581283422459893,0.6102941176470589,0.0045779914581496,0.0,0.0,0.0197549387346836,0.0397599399849962,0.0005277924386788,0.0,0.6511627906976742,0.5,0,0,0,0,0,0,8,76,54,4000000,128571.42857142857,8000000.0,3000000.0,400000.0,1500000.0,6,4400000,0.0,0.0
182875,Jean-Charles,Castelletto,2024,995,France,Clamart,Cameroon,26-01-95,Centre-Back,Defender,Right,186.0,30-06-28,BTFM,https://img.a.transfermarkt.technology/portrait/header/182875-1704213298.jpg?lm=1,FR1,Football Club de Nantes,3500000.0,5000000.0,29,126,130,4,10,10,5,11,5,15,7,7,14,11,6,13,12,13,13,15,13,12,10,12,12,6,12,10,12,13,13,12,13,14,15,13,13,14,14,12,12,7,8,13,2,3,1,2,2,3,3,3,3,1,2,9,13,6,10,10,12,10,19,1,12,20,15,1,13,10,1,1,1,1,1,1,1,76,8,20,3712524,6300,6300,3773,African_Caribbean,126,11,0,11947.0,Unknown,85068487,800000.0,1.0,34,367,15,1,1,1,93,2,0.5838846255623181,0.3981818181818181,0.5661764705882353,0.0115275389216179,0.0723684210526315,0.0,0.0172543135783946,0.0247561890472618,0.0044167893552598,0.0,0.5348837209302322,0.4583333333333332,357,13,4,56,4,5072,8,8,19,3500000,139583.33333333334,5000000.0,1000000.0,200000.0,800000.0,5,600000,0.0,0.0
182877,Anthony,Martial,2024,2441,France,Massy,France,05-12-95,Centre-Forward,Attack,Right,181.0,30-06-27,USFA Management,https://img.a.transfermarkt.technology/portrait/header/182877-1728416288.png?lm=1,GR1,Athlitiki Enosi Konstantinoupoleos,9000000.0,65000000.0,29,145,170,5,8,16,15,16,8,11,12,2,5,14,15,4,16,5,13,10,15,11,9,13,8,17,6,13,5,14,10,15,16,15,9,15,16,16,13,8,8,13,13,10,3,3,3,2,3,3,3,3,3,1,3,16,14,12,12,10,8,11,12,1,1,1,1,1,1,1,12,1,10,16,1,14,20,76,12,20,41757025,7500,7200,6750,African_Caribbean,143,30,2,289979.0,Unknown,85086702,32500000.0,2.0,34,925,36,0,1,1,34,3,0.702963747023022,0.7165775401069518,0.6911764705882353,0.2800000386246906,0.1973684210526315,0.0263157894736842,0.0447611902975743,0.3248312078019504,0.1805327925775716,0.1428571428571428,0.418604651162791,0.4583333333333332,422,115,57,19,1,11220,25,101,127,9000000,138888.88888888888,65000000.0,12000000.0,5000000.0,32000000.0,4,23000000,-0.1,-0.4
182891,Thomas,Didillon-Hödl,2024,403,France,SÃ©clin,France,28-11-95,Goalkeeper,Goalkeeper,Left,193.0,30-06-26,PUM,https://img.a.transfermarkt.technology/portrait/header/182891-1706020673.jpg?lm=1,NL1,Willem II,500000.0,5000000.0,29,123,135,4,2,3,3,8,8,1,2,1,3,10,2,2,8,10,13,14,13,13,10,12,12,2,13,2,13,12,11,11,13,15,16,15,11,13,14,14,7,11,8,1,11,12,12,9,12,11,12,14,13,7,12,11,14,6,13,12,12,8,18,20,1,1,1,1,1,1,1,1,1,1,1,1,1,84,20,10,1465397,5989,5989,3939,Northern_European,123,0,0,14999.0,AS Monaco,85093462,1750000.0,2.0,34,1461,36,2,0,7,221,5,0.5427361735908971,0.4159358288770053,0.5441176470588236,0.014474602817478,0.0,0.0,0.0022505626406601,0.0247561890472618,0.0096947137420483,0.1428571428571428,0.6976744186046511,0.4583333333333332,0,0,0,0,0,0,2,6,121,950000,28125.0,5000000.0,1000000.0,250000.0,2000000.0,9,3100000,0.9,0.5833333333333334
182894,Jean-Philippe,Gbamin,2024,995,Cote d'Ivoire,San-PÃ©dro,Cote d'Ivoire,25-09-95,Defensive Midfield,Midfield,Right,186.0,30-06-25,Bernard Collignon,https://img.a.transfermarkt.technology/portrait/header/182894-1705317996.png?lm=1,FR1,Football Club de Nantes,2500000.0,30000000.0,29,130,140,6,10,12,8,11,6,12,11,14,14,13,7,17,11,16,11,14,13,11,10,12,13,7,11,9,12,13,15,12,11,14,14,18,14,15,15,15,12,14,16,15,1,1,3,1,1,3,3,2,1,1,1,13,15,8,12,12,14,15,15,1,10,15,13,6,10,20,1,17,1,1,1,1,1,90,10,20,18142372,6545,6745,4995,African_Caribbean,126,11,0,86994.0,Trabzonspor A.Åž.,29114927,15000000.0,2.0,23,1311,24,3,1,1,93,4,0.6427626356178884,0.5288770053475935,0.5661764705882353,0.0839942178838111,0.0723684210526315,0.0,0.0122530632658164,0.1497874468617154,0.0833078696630462,0.1428571428571428,0.5348837209302322,0.4583333333333332,282,11,10,27,2,5119,17,145,310,2000000,54545.454545454544,30000000.0,5500000.0,2000000.0,2500000.0,7,3300000,-0.2,-0.3333333333333333
182904,Clément,Lenglet,2024,13,France,Beauvais,France,17-06-95,Centre-Back,Defender,Left,186.0,30-06-25,Wasserman,https://img.a.transfermarkt.technology/portrait/header/182904-1599988301.jpg?lm=1,ES1,Club AtlÃ©tico de Madrid S.A.D.,10000000.0,60000000.0,29,144,154,9,10,11,8,13,9,15,8,10,15,14,8,15,13,12,15,12,13,13,12,13,14,10,12,10,15,15,14,12,13,13,15,13,14,15,14,14,9,13,10,9,2,3,3,2,2,1,1,3,3,2,1,13,14,8,12,12,15,15,9,1,12,20,1,1,1,1,1,1,1,1,1,1,1,81,20,8,15657934,7242,7492,6492,Northern_European,145,15,1,110583.0,Tottenham Hotspur,85078880,20650000.0,2.0,34,161,36,1,0,7,52,2,0.7415983064302726,0.6889839572192513,0.7058823529411764,0.1067721635717024,0.0986842105263157,0.0131578947368421,0.0497624406101525,0.2998249562390597,0.1146976304897358,0.1428571428571428,0.5348837209302322,0.4583333333333332,399,16,10,84,2,9105,8,13,24,7500000,229687.5,60000000.0,15000000.0,150000.0,2500000.0,6,20650000,-0.25,-0.0625
182906,Mike,Maignan,2024,5,French Guiana,Cayenne,France,03-07-95,Goalkeeper,Goalkeeper,Right,191.0,30-06-26,ESN,https://img.a.transfermarkt.technology/portrait/header/182906-1681459155.jpg?lm=1,IT1,Associazione Calcio Milan,38000000.0,45000000.0,29,161,166,1,1,6,1,12,1,6,10,5,1,13,9,5,12,8,15,14,15,16,13,14,15,6,15,1,15,15,12,8,16,14,15,17,11,14,15,17,5,14,6,1,13,15,16,13,15,16,14,17,7,9,14,15,18,5,15,15,16,12,12,20,1,1,1,1,1,1,1,1,1,1,1,1,1,89,9,20,157734860,8050,7250,6100,African_Caribbean,163,4,0,69037.0,Unknown,85094520,8700000.0,2.0,35,338,36,2,1,1,27,5,0.7095792537708389,0.6470588235294117,0.838235294117647,0.0666546286380837,0.0263157894736842,0.0,0.1897974493623406,0.2248062015503876,0.048306897413817,0.1428571428571428,0.6511627906976742,0.4583333333333332,0,0,0,0,0,0,10,76,129,35000000,1120967.7419354839,45000000.0,5000000.0,250000.0,1000000.0,2,750000,-0.07894736842105263,-0.2222222222222222
182913,Adrien,Rabiot,2024,244,France,Saint-Maurice,France,03-04-95,Central Midfield,Midfield,Left,188.0,30-06-26,Unknown,https://img.a.transfermarkt.technology/portrait/header/182913-1681462009.jpg?lm=1,FR1,Olympique de Marseille,30000000.0,50000000.0,29,147,157,11,14,13,9,16,9,13,14,7,11,16,12,15,15,9,13,9,13,10,11,12,10,12,6,14,16,15,15,12,12,15,14,15,16,18,17,11,13,15,10,15,2,3,3,3,2,3,3,2,2,2,4,10,10,14,12,12,12,10,10,1,9,7,1,12,1,18,18,20,1,1,10,1,1,71,20,8,16952440,7350,7500,7250,Northern_European,146,29,2,172499.0,Unknown,85086031,9111392.0,2.0,34,1276,36,3,0,7,144,1,0.7426567875099233,0.7700534759358288,0.713235294117647,0.1665593222139286,0.1907894736842105,0.0263157894736842,0.1497874468617154,0.2498124531132783,0.0505924720131114,0.1428571428571428,0.581395348837209,0.4583333333333332,475,53,34,68,0,10699,20,47,50,25000000,745454.5454545454,50000000.0,15000000.0,3500000.0,10000000.0,4,10000000,-0.2857142857142857,-0.375
182923,Stefano,Denswil,2024,449,Netherlands,Zaandam,Suriname,07-05-93,Centre-Back,Defender,Left,188.0,30-06-25,NR X,https://img.a.transfermarkt.technology/portrait/header/182923-1723802444.jpg?lm=1,TR1,Trabzonspor KulÃ¼bÃ¼,2600000.0,6000000.0,31,125,130,11,9,11,6,12,11,14,6,10,14,13,12,14,13,15,12,14,11,12,12,13,12,9,14,8,11,14,12,13,11,14,13,14,11,13,14,12,11,11,2,7,2,3,3,1,2,3,3,2,3,3,3,10,13,9,8,11,13,12,10,1,15,20,1,1,1,1,1,1,1,1,1,1,1,81,20,9,3084975,6138,6238,4141,African_Caribbean,125,0,0,68910.0,Unknown,37018392,3600000.0,2.0,67,1692,90,1,0,1,204,2,0.5756813971950252,0.4375401069518716,0.5588235294117647,0.0665319952453005,0.0,0.0,0.0127531882970742,0.0297574393598399,0.0199727770215839,0.1428571428571428,0.581395348837209,0.5416666666666665,449,22,13,66,2,15372,16,42,37,2100000,60294.117647058825,6000000.0,1200000.0,,2500000.0,5,1750000,-0.25,-0.34375
182932,Davy,Klaassen,2024,610,Netherlands,Hilversum,Netherlands,21-02-93,Central Midfield,Midfield,Right,179.0,30-06-25,Unknown,https://img.a.transfermarkt.technology/portrait/header/182932-1726562366.jpg?lm=1,NL1,AFC Ajax Amsterdam,4000000.0,22000000.0,31,141,143,8,11,11,14,14,8,13,12,5,7,12,14,11,13,17,17,13,13,16,14,15,18,13,14,16,12,18,18,11,13,14,10,17,12,16,12,16,7,15,7,11,1,2,2,2,2,2,1,2,3,2,3,10,13,4,14,13,18,11,16,1,1,1,1,1,1,14,1,20,1,1,18,1,10,75,11,20,17313750,7000,7000,6400,Northern_European,140,35,9,34999.0,Unknown,37018393,17400000.0,3.0,67,627,68,3,1,7,6,1,0.6765017200317545,0.6791443850267379,0.6691176470588234,0.0337869481376622,0.2302631578947368,0.1184210526315789,0.0197549387346836,0.1097774443610902,0.0966415733770382,0.2857142857142857,0.3720930232558141,0.5416666666666665,508,127,67,60,0,10388,18,115,246,4000000,125806.45161290323,22000000.0,7000000.0,750000.0,3500000.0,6,7000000,0.0,-0.2
183120,Nikola,Storm,2024,354,Belgium,Knokke,Belgium,30-09-94,Left Winger,Attack,Left,178.0,30-06-26,SportPlus,https://img.a.transfermarkt.technology/portrait/header/183120-1705503875.jpg?lm=1,BE1,Yellow-Red Koninklijke Voetbalclub Mechelen,2000000.0,4500000.0,30,122,125,13,14,11,9,12,9,8,10,8,7,12,7,7,12,8,12,15,10,14,10,12,14,12,8,14,9,11,13,15,13,8,8,12,15,12,8,12,13,10,12,12,1,3,2,3,1,3,1,2,3,2,3,13,14,6,10,10,12,10,8,1,1,1,12,1,14,1,14,1,14,20,16,16,14,69,20,8,1785165,5918,5918,5012,Northern_European,115,0,0,4999.0,Unknown,18059923,250000.0,1.0,7,737,8,0,0,7,223,7,0.5333421540089971,0.5306951871657754,0.4852941176470588,0.0048184301573859,0.0,0.0,0.0097524381095273,0.0222555638909727,0.0013611489208033,0.0,0.3488372093023257,0.5,340,63,62,15,1,8121,8,34,108,2000000,67857.14285714286,4500000.0,1500000.0,100000.0,1200000.0,4,600000,0.0,0.0
183288,Luke,Shaw,2024,985,England,London,England,12-07-95,Left-Back,Defender,Left,178.0,30-06-27,CAA Stellar,https://img.a.transfermarkt.technology/portrait/header/183288-1668500175.jpg?lm=1,GB1,Manchester United Football Club,28000000.0,42000000.0,29,147,162,15,14,14,8,15,13,12,6,12,14,14,8,13,14,10,13,12,14,13,13,14,10,10,9,15,14,14,12,15,15,15,13,11,15,15,14,13,12,13,12,15,2,1,3,2,1,4,1,2,1,3,1,15,15,6,12,10,12,13,16,1,20,13,1,16,1,1,1,1,1,1,1,1,1,75,20,8,27532418,7100,7900,6500,Northern_European,149,21,2,197186.0,Unknown,29076105,37500000.0,1.0,32,858,33,1,0,7,132,8,0.7955808414924583,0.6898395721925134,0.7352941176470587,0.190397515659898,0.1381578947368421,0.0263157894736842,0.1397849462365591,0.2098024506126531,0.2083113419817217,0.0,0.3488372093023257,0.4583333333333332,353,4,31,78,0,10421,29,345,289,20000000,500000.0,42000000.0,8000000.0,13000000.0,21000000.0,1,9000000,-0.375,-0.47368421052631576
183318,Jamaal,Lascelles,2024,762,England,Derby,England,11-11-93,Centre-Back,Defender,Right,188.0,30-06-25,Unique Sports Group,https://img.a.transfermarkt.technology/portrait/header/183318-1696454186.jpg?lm=1,GB1,Newcastle United Football Club,7000000.0,18000000.0,31,125,148,3,4,8,5,10,3,15,3,3,14,10,3,15,10,15,13,15,11,11,4,12,14,4,17,8,12,15,15,11,10,11,15,16,13,14,16,13,9,16,5,10,1,3,3,2,1,3,3,2,3,3,1,13,13,5,13,13,15,12,13,1,1,20,1,1,1,1,1,1,1,1,1,1,1,89,13,20,4769912,6250,6250,5250,Northern_European,123,0,0,63795.0,Unknown,28059634,5000000.0,1.0,32,410,33,1,1,7,137,2,0.5772691188145012,0.5561497326203209,0.5441176470588236,0.0615928629296634,0.0,0.0,0.0347586896724181,0.0897724431107777,0.0277507708547459,0.0,0.581395348837209,0.5416666666666665,328,20,5,61,1,4437,18,111,353,6000000,205172.41379310345,18000000.0,3500000.0,500000.0,3000000.0,1,1000000,-0.14285714285714285,-0.14285714285714285
183321,Kevin,Mbabu,2024,865,Switzerland,ChÃªne-Bougeries,Switzerland,19-04-95,Right-Back,Defender,Right,184.0,30-06-26,Unknown,https://img.a.transfermarkt.technology/portrait/header/183321-1657202547.jpg?lm=1,DK1,Fodbold Club Midtjylland,4000000.0,14000000.0,29,134,140,4,11,14,7,11,4,11,7,18,11,11,7,15,12,16,11,15,11,10,11,11,16,11,7,12,11,12,15,15,12,13,12,13,17,16,13,12,12,11,12,9,2,3,2,1,2,1,2,1,3,2,2,13,14,16,10,12,8,10,9,1,12,12,20,10,18,1,1,1,12,1,1,1,1,80,11,20,26756565,6700,7000,5750,Mixed_Race,126,22,0,81194.0,Unknown,98029336,3955000.0,4.0,92,361,92,1,1,4,86,11,0.6765017200317545,0.6096256684491979,0.5661764705882353,0.0783936377409577,0.1447368421052631,0.0,0.0197549387346836,0.0697674418604651,0.0219450540292785,0.4285714285714285,0.4883720930232553,0.4583333333333332,309,11,28,72,1,6451,16,118,174,4000000,151923.07692307694,14000000.0,3000000.0,,250000.0,7,6550000,0.0,0.14285714285714285
183383,Pieter,Gerkens,2024,157,Belgium,Bilzen,Belgium,17-02-95,Attacking Midfield,Midfield,Right,179.0,30-06-27,SportPlus,https://img.a.transfermarkt.technology/portrait/header/183383-1671479324.jpg?lm=1,BE1,Koninklijke Atletiek Associatie Gent,1500000.0,3500000.0,29,125,127,10,10,12,11,8,12,12,12,6,12,11,7,10,11,12,16,13,14,15,15,15,14,14,14,16,14,15,15,11,10,6,12,15,12,13,7,15,10,12,6,19,4,1,1,1,4,3,2,3,1,2,3,8,12,8,18,12,12,11,20,1,1,1,1,1,13,19,13,20,13,15,19,15,12,64,6,20,4473227,6253,6203,5502,Northern_European,112,0,0,12499.0,Unknown,18054953,1100000.0,2.0,7,192,8,3,1,7,120,0,0.5710505424715533,0.5831016042780748,0.463235294117647,0.012060559652455,0.0,0.0,0.0072518129532383,0.0172543135783946,0.0060835023195088,0.1428571428571428,0.3720930232558141,0.4583333333333332,347,46,34,27,0,10577,6,46,214,1500000,50000.0,3500000.0,500000.0,500000.0,1000000.0,4,2400000,0.0,-0.16666666666666666
184528,Emil,Krafth,2024,762,Sweden,Ljungby,Sweden,02-08-94,Right-Back,Defender,Right,184.0,30-06-25,Unknown,https://img.a.transfermarkt.technology/portrait/header/184528-1674210829.jpg?lm=1,GB1,Newcastle United Football Club,2500000.0,5000000.0,30,129,129,8,13,11,7,11,9,12,10,10,12,12,7,13,13,11,13,13,12,12,14,12,13,8,8,12,13,13,14,14,13,15,12,12,15,14,13,13,8,11,11,9,3,4,1,3,1,2,3,3,2,2,2,10,12,2,12,13,16,14,15,1,8,14,20,8,18,1,1,1,12,1,1,5,1,83,8,20,2114704,6450,6300,5250,Northern_European,128,42,0,40597.0,Unknown,93031462,2633333.333,3.0,91,851,91,1,1,7,137,11,0.5838846255623181,0.5561497326203209,0.5808823529411764,0.0391924735927818,0.2763157894736842,0.0,0.0122530632658164,0.0247561890472618,0.014602257468263,0.2857142857142857,0.4883720930232553,0.5,299,6,15,23,2,6240,9,103,343,2500000,78448.27586206897,5000000.0,1000000.0,250000.0,900000.0,4,3125000,0.0,0.0
184573,Victor,Lindelöf,2024,985,Sweden,VÃ¤sterÃ¥s,Sweden,17-07-94,Centre-Back,Defender,Right,187.0,30-06-25,Unknown,https://img.a.transfermarkt.technology/portrait/header/184573-1695244778.jpg?lm=1,GB1,Manchester United Football Club,15000000.0,35000000.0,30,143,150,3,10,12,7,14,4,13,5,11,15,14,12,15,14,10,14,10,13,14,12,14,12,7,10,8,15,14,13,13,12,14,14,16,13,16,13,11,8,15,5,15,3,1,1,1,1,3,3,2,2,4,1,14,16,6,18,13,17,15,16,1,5,20,14,1,13,10,1,3,1,1,1,1,1,80,13,20,36018563,7143,6993,6493,Northern_European,143,52,3,197186.0,Unknown,93023425,19030000.0,2.0,91,1638,91,1,1,7,132,2,0.6755755490870601,0.6890909090909091,0.6911764705882353,0.190397515659898,0.3421052631578947,0.0394736842105263,0.0747686921730432,0.1747936984246061,0.1056973804827911,0.1428571428571428,0.5581395348837206,0.5,477,9,12,55,2,9826,13,56,58,10000000,330833.3333333333,35000000.0,7000000.0,150000.0,1500000.0,3,3650000,-0.3333333333333333,-0.4444444444444444
184816,Unknown,Ahmed Hassan,2024,2425,Egypt,Kairo,Egypt,05-03-93,Centre-Forward,Attack,Right,191.0,30-06-25,Unknown,https://img.a.transfermarkt.technology/portrait/header/184816-1669802583.png?lm=1,PO1,Rio Ave Futebol Clube,1200000.0,5000000.0,31,120,135,8,8,12,14,12,8,15,10,6,7,11,13,7,12,10,13,14,12,13,12,12,12,11,7,14,8,15,12,9,9,13,16,12,11,14,15,12,6,12,10,6,1,2,3,3,1,1,3,1,3,3,1,13,11,6,12,12,14,16,16,1,1,1,1,1,1,1,1,1,1,1,1,1,20,85,12,20,1234200,6100,6250,5050,North_African__Middle_Eastern,120,27,5,13010.0,Alanyaspor,12041043,1350000.0,2.0,31,699,32,0,1,6,171,3,0.5772691188145012,0.53475935828877,0.5220588235294117,0.0125539900753857,0.1776315789473684,0.0657894736842105,0.0057514378594648,0.0247561890472618,0.0074724297897163,0.1428571428571428,0.6511627906976742,0.5416666666666665,395,129,32,40,2,11999,23,90,141,900000,26515.151515151516,5000000.0,750000.0,50000.0,1500000.0,10,2800000,-0.25,-0.4375
184892,Florian,Thauvin,2024,410,France,OrlÃ©ans,France,26-01-93,Right Winger,Attack,Left,181.0,30-06-25,Unknown,https://img.a.transfermarkt.technology/portrait/header/184892-1675246062.jpg?lm=1,IT1,Udinese Calcio,3000000.0,50000000.0,31,144,154,9,14,16,13,16,13,9,14,4,3,15,13,3,15,11,14,13,14,11,15,12,14,16,9,15,6,14,13,15,15,13,8,14,15,14,9,14,7,12,6,13,3,3,3,2,3,3,1,2,3,2,3,10,15,8,14,11,15,14,12,1,1,1,1,1,1,1,13,10,14,16,15,20,10,70,20,10,11540039,7192,6894,6265,Mediterranean_Hispanic,144,10,1,97053.0,Unknown,85046587,11212500.0,4.0,34,1092,36,0,0,3,205,10,0.6624768457263827,0.6647058823529411,0.6985294117647058,0.0937073619625977,0.0657894736842105,0.0131578947368421,0.0147536884221055,0.2498124531132783,0.0622656184894024,0.4285714285714285,0.418604651162791,0.5416666666666665,459,118,83,47,5,7787,16,71,177,5000000,118292.68292682926,50000000.0,11000000.0,150000.0,14000000.0,9,16500000,0.6666666666666666,0.6666666666666666
184894,Alfred,Duncan,2024,607,Ghana,Accra,Ghana,10-03-93,Central Midfield,Midfield,Left,178.0,30-06-26,Unknown,https://img.a.transfermarkt.technology/portrait/header/184894-1663591729.jpg?lm=1,IT1,Venezia Football Club,4000000.0,18000000.0,31,134,145,12,11,13,8,13,11,10,12,9,13,13,10,13,12,14,13,15,12,14,12,13,15,11,9,14,14,16,16,12,12,15,10,15,14,14,15,14,12,14,9,12,4,2,3,2,2,2,3,2,3,3,2,13,13,4,13,11,15,15,11,1,1,1,1,1,10,18,1,20,10,1,12,1,1,78,20,9,6841445,6700,6800,5500,African_Caribbean,132,9,0,46346.0,Unknown,43084308,7866666.667,3.0,39,20,41,3,0,1,210,1,0.6500396930404869,0.5828877005347594,0.6102941176470589,0.0447438072550687,0.0592105263157894,0.0,0.0197549387346836,0.0897724431107777,0.0436771391816439,0.2857142857142857,0.3488372093023257,0.5416666666666665,408,22,32,54,2,6028,17,74,81,2500000,70000.0,18000000.0,3500000.0,150000.0,5000000.0,8,13000000,-0.375,-0.4444444444444444
185077,Vincenzo,Grifo,2024,60,Germany,Pforzheim,Italy,07-04-93,Left Winger,Attack,Right,180.0,Unknown,ROOF,https://img.a.transfermarkt.technology/portrait/header/185077-1658413230.jpg?lm=1,L1,Sport-Club Freiburg,9000000.0,12000000.0,31,140,144,18,16,13,13,16,17,6,16,8,7,14,13,7,15,11,12,8,14,10,17,14,11,16,13,13,7,14,14,13,15,11,9,11,12,14,9,13,4,12,7,14,1,1,3,2,2,2,3,2,2,4,2,10,15,13,7,12,10,11,9,1,1,1,1,1,1,1,20,12,15,20,18,15,8,80,8,20,9615877,6847,7047,5497,Mediterranean_Hispanic,138,6,2,19230.0,Unknown,91105243,4875000.0,4.0,38,1140,54,0,1,3,189,7,0.6827202963747023,0.582566844919786,0.6544117647058822,0.018560129469963,0.0394736842105263,0.0263157894736842,0.0447611902975743,0.0597649412353088,0.0270563071196422,0.4285714285714285,0.3953488372093026,0.5416666666666665,425,116,112,24,2,7198,11,40,57,7500000,226515.15151515152,12000000.0,3000000.0,,400000.0,7,5600000,-0.16666666666666666,-0.375
185245,Jhon,Córdoba,2024,16704,Colombia,Istmina,Colombia,11-05-93,Centre-Forward,Attack,Right,188.0,30-06-25,Promoesport,https://img.a.transfermarkt.technology/portrait/header/185245-1721724504.png?lm=1,RU1,FK Krasnodar,14000000.0,17000000.0,31,134,139,6,8,12,12,12,7,13,8,5,6,11,11,8,11,18,13,17,9,13,11,11,17,13,8,14,7,16,17,14,13,18,15,12,16,16,16,11,9,11,5,5,2,1,2,2,2,2,3,3,1,2,4,13,15,10,8,11,12,9,7,1,1,1,1,1,1,1,1,1,1,7,10,10,20,85,12,20,11691675,6750,6150,5250,African_Caribbean,133,0,0,29999.0,Unknown,76018954,12066000.0,5.0,20,668,20,0,1,1,78,3,0.5640381053188674,0.5561497326203209,0.6176470588235294,0.0289588618076162,0.0,0.0,0.0697674418604651,0.0847711927981995,0.0670074168726909,0.5714285714285714,0.581395348837209,0.5416666666666665,388,132,47,69,4,4957,17,79,150,14000000,347368.4210526316,17000000.0,3000000.0,800000.0,1000000.0,7,11450000,0.0,0.16666666666666666
185966,Unknown,Rodinei,2024,683,Brazil,TatuÃ­,Brazil,29-01-92,Right-Back,Defender,Right,177.0,30-06-27,R13 Fussball,https://img.a.transfermarkt.technology/portrait/header/185966-1728417668.png?lm=1,GR1,Olympiakos Syndesmos Filathlon Peiraios,1500000.0,2000000.0,32,126,132,10,14,12,10,11,8,6,9,12,13,12,9,13,12,11,12,12,12,11,11,10,14,12,11,12,12,11,12,14,13,12,8,13,13,16,12,12,6,12,6,11,1,2,3,3,1,3,3,3,1,1,1,12,12,4,10,12,15,7,12,1,1,1,20,1,17,1,1,1,16,1,1,13,1,78,10,20,286044,6300,6300,3250,African_Caribbean,118,0,0,8945.0,Unknown,19161089,941000.0,1.0,10,1472,11,1,1,1,141,11,0.5838846255623181,0.3422459893048128,0.5073529411764706,0.0086287558890583,0.0,0.0,0.0072518129532383,0.0097524381095273,0.0052001444484569,0.0,0.3255813953488373,0.5833333333333333,458,18,54,60,2,16516,3,3,12,1300000,27272.727272727272,2000000.0,400000.0,,,5,600000,-0.13333333333333333,-0.13333333333333333
186186,Bobby,De Cordova-Reid,2024,1003,England,Bristol,Jamaica,02-02-93,Right Winger,Attack,Right,170.0,30-06-27,Straight Ace Sports,https://img.a.transfermarkt.technology/portrait/header/186186-1657802404.jpg?lm=1,GB1,Leicester City Football Club,5000000.0,10000000.0,31,128,133,10,12,14,14,13,10,8,11,5,8,14,11,7,13,10,14,9,11,14,13,12,14,13,8,13,9,14,14,14,13,12,5,12,14,14,7,10,5,12,8,15,3,3,1,3,2,2,1,4,2,2,2,13,12,6,12,12,15,12,14,1,1,1,1,1,12,1,1,1,1,12,20,16,18,68,11,20,4854754,6396,6396,4746,African_Caribbean,125,16,2,34798.0,Unknown,28058544,10125000.0,2.0,32,259,55,0,1,1,127,10,0.5965863985181264,0.5022459893048128,0.5588235294117647,0.0335928590671944,0.1052631578947368,0.0263157894736842,0.0247561890472618,0.0497624406101525,0.0562237839939998,0.1428571428571428,0.1627906976744184,0.5416666666666665,461,71,52,53,0,4814,5,10,24,5000000,204166.66666666666,10000000.0,2000000.0,100000.0,150000.0,3,7000000,0.0,-0.16666666666666666
186368,Valentino,Lazaro,2024,416,Austria,Graz,Austria,24-03-96,Left Midfield,Midfield,Right,181.0,30-06-27,Unique Sports Group,https://img.a.transfermarkt.technology/portrait/header/186368-1692819728.jpg?lm=1,IT1,Torino Calcio,3500000.0,19000000.0,28,131,138,13,13,14,9,14,11,9,11,9,10,13,10,12,15,13,12,8,11,9,12,10,10,15,7,13,9,11,13,15,15,12,9,13,14,13,10,12,6,11,11,17,3,1,2,3,2,3,3,2,3,1,2,9,14,10,12,11,13,14,14,1,5,1,19,11,19,1,13,10,20,8,10,14,8,76,10,20,2720891,6550,7200,5400,Mixed_Race,125,36,3,43845.0,Torino,16067510,9076500.0,4.0,6,557,7,3,1,4,201,6,0.702963747023022,0.5721925133689839,0.5588235294117647,0.0423287984727797,0.2368421052631578,0.0394736842105263,0.0172543135783946,0.0947736934233558,0.0503986221839495,0.4285714285714285,0.418604651162791,0.4166666666666665,379,25,56,49,1,8373,18,146,85,3500000,100000.0,19000000.0,5000000.0,1750000.0,3000000.0,6,10500000,0.0,-0.2222222222222222
186590,John,Stones,2024,281,England,Barnsley,England,28-05-94,Centre-Back,Defender,Right,188.0,30-06-26,Wasserman,https://img.a.transfermarkt.technology/portrait/header/186590-1684764261.jpg?lm=1,GB1,Manchester City Football Club,38000000.0,60000000.0,30,161,170,5,8,13,8,14,5,14,5,8,13,16,12,16,15,13,15,16,17,15,14,14,13,12,13,14,16,16,17,14,13,12,16,16,15,16,15,16,8,14,9,10,1,3,2,1,2,2,1,2,2,1,3,10,18,7,15,12,15,13,16,1,1,20,10,1,1,12,1,1,1,1,1,1,1,72,12,20,128950907,8050,8050,7500,Northern_European,161,58,3,231983.0,Unknown,28060397,29550000.0,2.0,32,145,33,1,1,7,131,2,0.8154273617359089,0.7967914438502673,0.8235294117647058,0.2239980996652205,0.381578947368421,0.0394736842105263,0.1897974493623406,0.2998249562390597,0.164143448429123,0.1428571428571428,0.581395348837209,0.5,411,21,10,17,2,11324,20,129,67,32000000,887500.0,60000000.0,15000000.0,3500000.0,10000000.0,3,10450000,-0.15789473684210525,-0.15789473684210525
186704,Kristoffer,Peterson,2024,385,Sweden,GÃ¶teborg,Sweden,28-11-94,Left Winger,Attack,Right,185.0,30-06-26,Unknown,https://img.a.transfermarkt.technology/portrait/header/186704-1657114129.jpg?lm=1,NL1,Fortuna Sittardia Combinatie,600000.0,3500000.0,30,120,124,7,12,14,10,12,13,11,14,4,5,12,10,4,13,8,10,12,12,12,11,11,13,14,7,10,6,10,12,14,14,11,12,13,15,12,12,9,7,12,8,9,1,2,3,3,2,2,3,1,3,2,3,12,15,6,12,9,14,10,8,1,1,1,1,1,1,1,13,12,13,20,12,17,14,76,10,20,1058909,6000,6150,4250,Northern_European,118,1,0,7671.0,Unknown,93024468,500000.0,2.0,91,582,91,0,1,7,94,7,0.5640381053188674,0.4491978609625668,0.5073529411764706,0.0073985594921625,0.006578947368421,0.0,0.0027506876719179,0.0172543135783946,0.0027500763910108,0.1428571428571428,0.5116279069767438,0.5,344,68,44,26,2,7352,6,10,36,600000,14583.333333333334,3500000.0,1500000.0,,750000.0,8,2550000,0.0,0.0
187105,Mike,Van Der Hoorn,2024,200,Netherlands,Almere,Netherlands,15-10-92,Centre-Back,Defender,Right,190.0,30-06-26,V4S,https://img.a.transfermarkt.technology/portrait/header/187105-1723460912.jpg?lm=1,NL1,Football Club Utrecht,1200000.0,3500000.0,32,126,133,5,9,9,8,10,4,15,7,9,13,13,6,15,10,13,14,15,11,14,10,13,13,8,12,8,14,13,12,12,9,11,15,16,12,13,15,16,13,10,5,8,2,3,1,1,3,2,3,1,4,1,3,18,12,5,15,14,16,10,14,1,1,20,6,1,1,1,1,1,1,1,1,1,1,82,8,20,4454997,6000,6000,4000,Northern_European,126,0,0,4999.0,Unknown,37027601,2150000.0,3.0,67,50,68,1,1,7,92,2,0.5441915850754168,0.4224598930481283,0.5661764705882353,0.0048184301573859,0.0,0.0,0.0057514378594648,0.0172543135783946,0.0119169976943803,0.2857142857142857,0.6279069767441858,0.5833333333333333,401,27,12,44,1,8358,9,29,63,1200000,37096.77419354839,3500000.0,1000000.0,50000.0,3000000.0,4,2100000,0.0,0.2
187245,Mitchell,Dijks,2024,385,Netherlands,Purmerend,Netherlands,09-02-93,Left-Back,Defender,Left,194.0,30-06-26,ESA,https://img.a.transfermarkt.technology/portrait/header/187245-1595941226.jpg?lm=1,NL1,Fortuna Sittardia Combinatie,850000.0,5000000.0,31,125,137,4,11,12,3,13,6,10,5,14,12,13,5,13,13,15,12,14,12,12,12,12,14,11,11,14,11,16,16,13,11,15,12,12,15,13,17,14,14,12,15,8,3,3,2,2,3,2,2,1,3,1,1,18,11,13,11,17,8,10,7,1,20,8,1,20,1,1,14,1,1,1,1,1,1,90,20,7,3838641,6250,6250,5000,Northern_European,123,0,0,8000.0,Unknown,37025511,9111392.0,2.0,67,1194,68,1,0,7,94,8,0.5772691188145012,0.5294117647058822,0.5441176470588236,0.0077162475726795,0.0,0.0,0.0040010002500625,0.0247561890472618,0.0505924720131114,0.1428571428571428,0.7209302325581395,0.5416666666666665,341,3,17,50,4,6592,32,117,140,850000,25000.0,5000000.0,1250000.0,,500000.0,7,1650000,0.0,0.0
187492,Julian,Brandt,2024,16,Germany,Bremen,Germany,02-05-96,Attacking Midfield,Midfield,Right,185.0,30-06-26,Unknown,https://img.a.transfermarkt.technology/portrait/header/187492-1709560849.jpg?lm=1,L1,Borussia Dortmund,40000000.0,50000000.0,28,146,158,11,12,16,12,18,13,6,14,7,5,16,11,8,17,9,14,7,11,10,16,10,10,16,6,13,8,11,11,13,15,12,12,15,15,12,10,9,4,12,4,14,3,1,3,3,3,3,1,1,3,2,1,6,8,4,12,10,11,17,20,1,1,1,1,1,1,1,20,17,15,20,18,15,10,83,14,20,34293861,7398,7398,6748,Northern_European,136,38,3,134156.0,Unknown,91119265,12750000.0,2.0,38,253,40,3,1,7,41,0,0.7291611537443768,0.7163636363636363,0.6397058823529411,0.1295346593833375,0.25,0.0394736842105263,0.1997999499874969,0.2498124531132783,0.0708075224311786,0.1428571428571428,0.5116279069767438,0.4166666666666665,528,122,138,11,0,8115,16,49,32,35000000,1112903.2258064516,50000000.0,10000000.0,5000000.0,20000000.0,1,0,-0.125,-0.125
187587,Ante,Rebi?,2024,1005,Croatia,Split,Croatia,21-09-93,Left Winger,Attack,Right,185.0,30-06-25,LIAN Sports Group,https://img.a.transfermarkt.technology/portrait/header/187587-1596115623.jpg?lm=1,IT1,Unione Sportiva Lecce,2200000.0,40000000.0,31,147,156,6,13,13,14,12,7,15,13,5,6,13,10,9,13,18,14,17,12,11,12,11,14,13,11,16,8,14,12,15,14,16,13,12,16,13,14,12,12,15,15,14,2,1,2,2,3,3,3,1,2,2,3,15,14,16,10,16,13,7,7,1,1,1,1,1,1,1,10,1,8,20,14,11,18,78,14,20,16807193,7350,6043,6949,Northern_European,142,42,3,86345.0,Unknown,24023726,5233333.333,3.0,24,1409,25,0,1,7,206,7,0.5498809208785393,0.7378609625668449,0.6838235294117647,0.0833675322781711,0.2763157894736842,0.0394736842105263,0.010752688172043,0.1997999499874969,0.029047103158421,0.2857142857142857,0.5116279069767438,0.5416666666666665,356,75,40,79,6,7722,38,144,131,1500000,31578.947368421053,40000000.0,10000000.0,650000.0,4000000.0,7,16300000,-0.3181818181818182,-0.6428571428571429
187718,Clinton,Mata,2024,1041,Belgium,Verviers,Angola,07-11-92,Right-Back,Defender,Right,180.0,30-06-26,Trois Akademie,https://img.a.transfermarkt.technology/portrait/header/187718-1616529648.jpg?lm=1,FR1,Olympique Lyonnais,4000000.0,10000000.0,32,132,140,7,12,12,8,11,8,10,9,13,15,13,12,13,12,14,12,15,11,15,10,12,15,14,14,14,14,14,14,13,12,13,10,15,14,16,14,15,12,14,6,12,1,3,1,2,2,2,2,2,2,2,4,14,14,8,14,14,14,12,10,1,1,16,20,1,17,1,1,1,15,1,1,14,1,72,7,20,10097999,6600,6600,5000,African_Caribbean,131,8,0,40000.0,Unknown,18070768,3250000.0,2.0,7,1579,3,1,1,1,143,11,0.6235776660492194,0.5294117647058822,0.6029411764705883,0.0386160000849743,0.0526315789473684,0.0,0.0197549387346836,0.0497624406101525,0.0180282785632934,0.1428571428571428,0.3953488372093026,0.5833333333333333,444,9,34,75,1,11144,8,33,102,4000000,128225.80645161291,10000000.0,2000000.0,,150000.0,4,1700000,0.0,0.0
188077,Ryan,Christie,2024,989,Scotland,Inverness,Scotland,22-02-95,Central Midfield,Midfield,Left,178.0,30-06-27,PLG,https://img.a.transfermarkt.technology/portrait/header/188077-1697450633.jpg?lm=1,GB1,Association Football Club Bournemouth,12000000.0,12000000.0,29,139,150,11,12,14,13,14,12,5,14,1,5,13,11,7,15,10,15,7,13,11,16,13,12,16,8,16,9,12,15,14,14,13,9,15,14,14,11,15,6,14,6,10,2,4,3,2,2,1,1,3,3,4,1,10,14,8,14,10,14,14,13,1,1,1,1,1,1,1,15,16,15,16,20,20,9,74,20,10,38141386,6949,7099,5999,Northern_European,137,31,4,40597.0,Unknown,61042900,1790000.0,2.0,82,658,83,3,0,7,22,1,0.6896004233924319,0.6362566844919786,0.6470588235294117,0.0391924735927818,0.2039473684210526,0.0526315789473684,0.0597649412353088,0.0597649412353088,0.0099169421372815,0.1428571428571428,0.3488372093023257,0.4583333333333332,428,75,88,48,1,9084,9,40,86,12000000,570238.0952380953,12000000.0,2000000.0,50000.0,600000.0,3,2150000,0.0,0.0
188180,Benjamin,Verbic,2024,265,Slovenia,Celje,Slovenia,27-11-93,Left Winger,Attack,Right,183.0,30-06-25,AR Sport Management,https://img.a.transfermarkt.technology/portrait/header/188180-1716317284.jpg?lm=1,GR1,Panathinaikos Athlitikos Omilos,1800000.0,7000000.0,31,125,135,12,10,14,13,14,14,12,14,9,5,13,10,6,15,12,10,13,14,10,13,11,12,14,7,13,7,11,13,13,11,13,9,12,13,12,11,12,12,13,12,12,4,3,3,3,3,3,3,1,2,4,1,14,12,6,14,13,13,10,8,1,1,1,1,1,1,1,18,10,13,20,15,14,15,70,12,20,4083749,6250,6750,4000,Northern_European,120,43,5,20105.0,Unknown,62085786,9111392.0,2.0,87,340,87,0,1,7,150,7,0.6434241862926701,0.4224598930481283,0.5220588235294117,0.019405044577721,0.2828947368421052,0.0657894736842105,0.0087521880470117,0.0347586896724181,0.0505924720131114,0.1428571428571428,0.4651162790697669,0.5416666666666665,419,102,52,80,4,14077,12,62,135,1200000,36290.32258064516,7000000.0,1500000.0,150000.0,500000.0,4,3350000,-0.4,-0.52
188888,Sheraldo,Becker,2024,681,Netherlands,Amsterdam,Suriname,09-02-95,Left Winger,Attack,Right,180.0,30-06-26,Sports360 GmbH,https://img.a.transfermarkt.technology/portrait/header/188888-1692707512.jpg?lm=1,ES1,Real Sociedad de FÃºtbol S.A.D.,10000000.0,17000000.0,29,140,140,6,13,13,13,13,10,8,9,5,6,12,9,7,14,14,11,13,12,12,12,11,13,14,7,13,6,13,14,17,13,12,11,14,17,13,11,11,6,12,12,11,3,3,2,2,3,3,2,2,3,3,3,15,16,10,8,13,14,9,8,1,1,1,1,1,1,1,10,1,17,16,10,20,18,78,8,20,12378126,6994,6218,5334,African_Caribbean,131,5,2,28766.0,Unknown,37027194,1600000.0,2.0,67,64,90,0,1,1,168,7,0.5730351944958983,0.5651336898395721,0.6029411764705883,0.0277682557186268,0.0328947368421052,0.0263157894736842,0.0497624406101525,0.0847711927981995,0.0088613572599238,0.1428571428571428,0.3953488372093026,0.4583333333333332,376,53,64,34,1,9284,19,77,76,6000000,206034.4827586207,17000000.0,5000000.0,,700000.0,5,2400000,-0.4,-0.5
189340,Gianluca,Di Chiara,2024,130,Italy,Palermo,Italy,26-12-93,Left-Back,Defender,Left,186.0,30-06-25,Unknown,https://img.a.transfermarkt.technology/portrait/header/189340-1613734678.jpg?lm=1,IT1,Parma Calcio 1913,700000.0,2000000.0,30,120,124,13,12,13,7,12,11,6,11,12,14,13,4,13,12,11,11,12,11,11,11,12,14,11,10,13,13,13,12,14,13,12,12,15,14,13,12,14,13,13,5,12,1,3,1,3,2,3,2,3,2,2,1,13,14,5,16,12,16,12,12,1,20,12,1,19,1,1,15,1,1,1,1,1,1,78,20,6,1121579,6000,6000,4250,Mediterranean_Hispanic,118,0,0,4790.0,Unknown,43079191,968000.0,5.0,52,1111,54,1,0,3,155,8,0.5441915850754168,0.4491978609625668,0.5073529411764706,0.00461661614879,0.0,0.0,0.0032508127031757,0.0097524381095273,0.0053501486152393,0.5714285714285714,0.5348837209302322,0.5,377,8,28,77,3,4901,4,22,52,500000,15000.0,2000000.0,500000.0,100000.0,175000.0,12,1875000,-0.2857142857142857,-0.3333333333333333
189439,Maximiliano,Moreira,2024,2672,Uruguay,Maldonado,Uruguay,11-06-94,Left-Back,Defender,Right,173.0,30-06-25,Unknown,https://img.a.transfermarkt.technology/portrait/header/189439-1660579349.png?lm=1,GR1,APO Levadiakos Football Club,350000.0,400000.0,30,134,136,12,12,15,12,14,11,11,12,5,8,14,12,6,16,8,13,14,14,13,13,11,18,15,12,17,8,14,13,14,16,12,10,12,13,13,13,11,9,15,9,14,2,2,3,3,3,1,1,1,2,2,3,19,15,8,15,12,14,14,12,1,1,1,1,1,1,1,12,16,12,13,20,17,1,75,9,20,3733214,6750,6750,6023,Mediterranean_Hispanic,135,11,0,19991.0,Unknown,14061320,9111392.0,2.0,106,900,103,1,1,3,8,8,0.6434241862926701,0.6388235294117647,0.6323529411764706,0.019294964209396,0.0723684210526315,0.0,0.0015003750937734,0.0017504376094023,0.0505924720131114,0.1428571428571428,0.2325581395348837,0.5,217,5,7,38,5,4434,7,40,154,350000,8823.529411764706,400000.0,50000.0,,150000.0,5,0,0.0,0.0
190185,Unknown,Marcelo,2024,979,Brazil,Rio de Janeiro,Brazil,27-07-89,Centre-Back,Defender,Right,185.0,30-06-25,ADRIANO SPORTS,https://img.a.transfermarkt.technology/portrait/header/190185-1705662897.png?lm=1,PO1,Moreirense Futebol Clube,100000.0,3000000.0,35,131,139,4,6,8,7,10,6,14,5,6,15,12,8,15,12,15,13,16,12,11,12,13,15,7,16,8,16,14,14,12,12,14,13,15,12,13,13,14,11,13,13,8,2,1,1,1,1,2,1,1,2,1,2,8,14,6,13,11,16,13,12,1,1,20,1,1,1,8,1,1,1,1,1,1,1,74,8,20,2574817,6550,5779,5025,Mediterranean_Hispanic,131,0,0,26919.0,Unknown,19080674,440000.0,1.0,10,1234,11,1,1,3,134,2,0.5149510452500662,0.5320855614973261,0.6029411764705883,0.0259847606283078,0.0,0.0,0.0002500625156289,0.0147536884221055,0.002416733798161,0.0,0.5116279069767438,0.7083333333333333,387,14,5,93,2,5218,3,26,221,100000,-3703.703703703704,3000000.0,2000000.0,,,6,3100000,0.0,-0.5
190222,Sander,Van De Streek,2024,589,Netherlands,Barneveld,Netherlands,24-03-93,Attacking Midfield,Midfield,Right,180.0,30-06-25,Grand Stand,https://img.a.transfermarkt.technology/portrait/header/190222-1726737081.jpg?lm=1,TR1,Antalyaspor,1100000.0,3000000.0,31,128,129,9,10,11,12,14,9,14,12,5,5,12,8,8,13,14,14,12,14,14,13,16,14,12,6,15,8,14,15,11,13,13,13,12,12,15,11,15,10,11,7,13,2,3,1,2,1,1,1,3,1,1,1,10,13,4,14,11,15,12,14,1,1,1,1,1,1,1,12,16,12,13,20,14,14,74,11,20,4589998,6200,6200,4600,Northern_European,127,0,0,3000.0,Unknown,37027437,600000.0,1.0,67,144,68,3,1,7,19,0,0.5706536120666843,0.4866310160427807,0.5735294117647058,0.0028881612426335,0.0,0.0,0.005251312828207,0.0147536884221055,0.0033056473790938,0.0,0.3953488372093026,0.5416666666666665,436,114,46,38,2,6112,14,30,35,1000000,29545.454545454544,3000000.0,600000.0,,125000.0,3,675000,-0.23076923076923078,-0.2857142857142857
190280,Patrik,Carlgren,2024,995,Sweden,Falun,Sweden,08-01-92,Goalkeeper,Goalkeeper,Right,189.0,30-06-26,Unknown,https://img.a.transfermarkt.technology/portrait/header/190280-1726237403.jpg?lm=1,FR1,Football Club de Nantes,800000.0,1200000.0,32,127,130,3,2,2,1,5,5,3,1,3,2,9,4,2,5,10,13,16,13,11,10,13,13,3,12,2,12,12,12,10,13,12,14,10,10,10,11,11,10,14,5,13,12,13,13,13,15,12,16,15,16,15,10,9,13,11,9,14,12,8,8,20,1,1,1,1,1,1,1,1,1,1,1,1,1,84,3,20,2046309,6350,5800,4000,Northern_European,124,1,0,2320.0,Unknown,93015023,9111392.0,2.0,91,482,91,2,1,7,93,5,0.5177295580841492,0.4224598930481283,0.5514705882352942,0.0022315415017472,0.006578947368421,0.0,0.0037509377344336,0.0057514378594648,0.0505924720131114,0.1428571428571428,0.6046511627906974,0.5833333333333333,0,0,0,0,0,0,2,11,58,800000,30400.0,1200000.0,400000.0,,40000.0,5,760000,0.0,0.0
190284,Maximilian,Eggestein,2024,60,Germany,Hannover,Germany,08-12-96,Central Midfield,Midfield,Right,181.0,Unknown,ROOF,https://img.a.transfermarkt.technology/portrait/header/190284-1723189965.jpg?lm=1,L1,Sport-Club Freiburg,10000000.0,30000000.0,28,140,148,10,12,10,11,15,10,7,13,6,11,14,15,12,15,12,15,9,14,13,13,13,11,10,12,14,12,17,18,10,12,13,10,16,11,17,11,14,8,12,4,13,3,2,3,1,3,1,2,2,2,2,1,8,12,4,15,14,17,13,15,1,1,1,1,1,1,18,11,20,11,11,15,11,1,77,12,20,10388646,6900,6900,5250,Northern_European,137,0,0,14499.0,Unknown,91126294,9111392.0,2.0,38,596,40,3,1,7,189,1,0.6632707065361206,0.5561497326203209,0.6470588235294117,0.0139917941844734,0.0,0.0,0.0497624406101525,0.1497874468617154,0.0505924720131114,0.1428571428571428,0.418604651162791,0.4166666666666665,463,54,45,59,0,7315,3,3,11,10000000,354464.28571428574,30000000.0,7000000.0,450000.0,2000000.0,2,50000,0.0,0.0
190289,Gerrit,Holtmann,2024,80,Germany,Bremerhaven,Philippines,25-03-95,Left Winger,Attack,Left,185.0,30-06-25,Sports360 GmbH,https://img.a.transfermarkt.technology/portrait/header/190289-1721851662.jpg?lm=1,L1,Verein fÃ¼r LeibesÃ¼bungen Bochum 1848 FuÃŸballgemeinschaft,700000.0,4500000.0,29,126,129,10,11,13,11,12,9,5,12,10,8,10,9,10,13,14,9,10,8,10,9,8,11,15,5,12,8,10,14,17,14,10,10,13,17,12,8,12,6,11,9,16,2,1,3,1,3,1,1,2,1,2,2,9,14,6,8,10,12,13,15,1,10,1,1,16,1,1,20,1,14,20,12,14,10,77,20,8,2515303,6297,6297,4797,Mediterranean_Hispanic,108,2,1,9588.0,Unknown,91147351,3000000.0,1.0,38,254,77,0,0,3,212,7,0.583487695157449,0.5077005347593583,0.4338235294117646,0.0092496477911022,0.0131578947368421,0.0131578947368421,0.0032508127031757,0.0222555638909727,0.0166393510930859,0.0,0.5116279069767438,0.4583333333333332,280,42,33,15,1,5856,22,72,120,700000,21093.75,4500000.0,1000000.0,,600000.0,7,3100000,-0.3,-0.65
190338,Anthony,Briançon,2024,618,France,Avignon,France,28-11-94,Centre-Back,Defender,Right,185.0,30-06-26,E CASTAGNINO,https://img.a.transfermarkt.technology/portrait/header/190338-1727722993.jpg?lm=1,FR1,Association sportive de Saint-Ã‰tienne Loire,1000000.0,5000000.0,30,123,135,6,9,8,7,12,7,13,8,8,15,13,8,13,12,14,13,15,12,13,10,12,13,13,15,8,13,13,12,12,11,13,12,15,12,12,13,11,11,14,11,14,3,3,1,2,2,3,2,1,1,3,2,14,12,6,15,13,14,16,14,1,1,20,1,1,1,16,1,15,1,1,1,1,1,79,10,20,3237852,6150,6150,3902,Northern_European,123,0,0,12397.0,Unknown,48032750,9111392.0,2.0,34,111,36,1,1,7,25,2,0.5640381053188674,0.4119786096256684,0.5441176470588236,0.011962066691322,0.0,0.0,0.0047511877969492,0.0247561890472618,0.0505924720131114,0.1428571428571428,0.5116279069767438,0.5,271,20,4,45,4,1335,12,67,128,800000,23913.043478260868,5000000.0,1000000.0,,300000.0,1,0,-0.4666666666666667,-0.4666666666666667
190393,Corentin,Tolisso,2024,1041,France,Tarare,France,03-08-94,Central Midfield,Midfield,Right,181.0,30-06-27,E CASTAGNINO,https://img.a.transfermarkt.technology/portrait/header/190393-1672830594.jpg?lm=1,FR1,Olympique Lyonnais,5000000.0,45000000.0,30,143,145,12,10,10,14,13,8,15,16,8,12,14,12,12,14,16,13,15,13,12,14,12,16,12,12,16,12,15,16,12,12,15,13,9,13,15,14,13,11,14,17,16,1,2,4,1,3,1,1,1,4,1,1,8,12,12,15,12,15,10,10,1,12,1,13,10,10,20,12,19,13,11,15,11,1,81,10,20,26111602,7150,7100,6650,African_Caribbean,137,28,2,95889.0,Unknown,29114971,41500000.0,1.0,34,1471,36,3,1,1,143,1,0.6897327335273882,0.7058823529411764,0.6470588235294117,0.092583383464963,0.1842105263157894,0.0263157894736842,0.0247561890472618,0.2248062015503876,0.2305341815050418,0.0,0.418604651162791,0.5,373,59,41,31,2,10316,33,153,191,7000000,216666.66666666666,45000000.0,8000000.0,,7500000.0,2,14000000,0.4,0.4
190442,Alan,Ruiz,2024,2431,Argentina,La Plata,Argentina,19-08-93,Attacking Midfield,Midfield,Left,183.0,30-06-26,SoccerSoul,https://img.a.transfermarkt.technology/portrait/header/190442-1478085307.jpg?lm=1,PO1,Club Football Estrela da Amadora,800000.0,7000000.0,31,120,137,13,14,15,12,15,14,8,15,5,6,15,12,7,16,10,10,9,15,10,15,13,9,17,6,13,6,12,7,12,13,14,10,13,12,11,11,7,7,14,6,13,3,1,1,1,2,2,3,2,4,3,2,16,14,18,4,13,4,4,5,1,1,1,1,1,1,1,1,10,1,10,20,10,13,70,20,8,596602,5997,5997,2997,Mediterranean_Hispanic,120,0,0,2054.0,Unknown,14035484,4840000.0,1.0,4,784,4,3,0,3,55,0,0.5437946546705478,0.315187165775401,0.5220588235294117,0.0019746873089888,0.0,0.0,0.0037509377344336,0.0347586896724181,0.0268618572738131,0.0,0.4651162790697669,0.5416666666666665,369,41,35,92,3,14430,6,15,51,500000,10416.666666666666,7000000.0,2000000.0,,1000000.0,10,6325000,-0.375,-0.375
191056,Brice,Samba,2024,826,Congo,Linzolo,France,25-04-94,Goalkeeper,Goalkeeper,Left,187.0,30-06-28,Sport Cover,https://img.a.transfermarkt.technology/portrait/header/191056-1602242038.jpg?lm=1,FR1,Racing Club de Lens,15000000.0,15000000.0,30,130,131,4,2,1,6,10,6,2,11,1,2,12,8,1,10,8,12,14,13,13,11,11,12,6,9,3,12,13,8,10,14,15,15,15,10,14,15,11,8,10,5,1,14,12,12,12,13,13,14,15,8,10,11,11,13,6,10,12,10,15,15,20,1,1,1,1,1,1,1,1,1,1,1,1,1,90,20,9,9787271,6490,6490,3791,African_Caribbean,128,0,0,19999.0,Unknown,85073883,2500000.0,3.0,21,842,36,2,0,1,158,5,0.6090235512040222,0.4001069518716577,0.5808823529411764,0.0193026891475241,0.0,0.0,0.0747686921730432,0.0747686921730432,0.0138614961526709,0.2857142857142857,0.5581395348837206,0.5,0,0,0,0,0,0,1,1,11,15000000,415277.77777777775,15000000.0,800000.0,600000.0,800000.0,6,3950000,0.0,0.0
191217,Héctor,Bellerín,2024,150,Spain,Badalona,Spain,19-03-95,Right-Back,Defender,Right,178.0,30-06-28,Goal Management,https://img.a.transfermarkt.technology/portrait/header/191217-1676903202.jpg?lm=1,ES1,Real Betis BalompiÃ© S.A.D.,4000000.0,40000000.0,29,143,162,7,12,13,9,12,5,10,10,12,12,11,8,14,13,12,14,15,13,13,10,14,13,12,12,14,12,15,15,16,14,15,9,16,16,15,10,14,8,14,8,14,2,1,2,1,1,2,3,2,3,3,1,15,14,5,14,14,14,15,15,1,1,1,20,1,19,1,1,1,10,1,1,8,1,74,10,20,9034927,7100,7100,6750,Mediterranean_Hispanic,139,4,0,86994.0,Unknown,28066082,750000.0,2.0,89,124,89,1,1,3,164,11,0.6897327335273882,0.7165775401069518,0.6617647058823528,0.0839942178838111,0.0263157894736842,0.0,0.0197549387346836,0.1997999499874969,0.0041390038612183,0.1428571428571428,0.3488372093023257,0.4583333333333332,376,15,42,44,2,10531,10,76,241,3000000,87096.7741935484,40000000.0,8000000.0,500000.0,13000000.0,6,19200000,-0.25,-0.5714285714285714
191391,Yusuf,Erdo?An,2024,2293,TÃ¼rkiye,Isparta,TÃ¼rkiye,07-08-92,Left Winger,Attack,Left,171.0,30-06-26,Foot & Ball,https://img.a.transfermarkt.technology/portrait/header/191391-1727458656.png?lm=1,TR1,Konyaspor,500000.0,6250000.0,32,120,130,10,11,13,11,12,5,3,11,6,3,10,7,7,14,16,12,14,13,10,11,9,15,15,3,13,7,9,13,16,15,9,7,15,15,12,10,11,13,14,11,12,3,1,1,2,2,1,3,1,3,1,1,12,15,6,15,10,12,7,10,1,8,1,1,12,1,1,16,1,16,18,1,20,1,68,20,9,517553,5994,5994,3994,Mediterranean_Hispanic,114,0,0,12408.0,Unknown,70047807,750000.0,2.0,100,665,100,0,0,3,125,7,0.5433977242656788,0.4218181818181817,0.4779411764705882,0.0119726884812481,0.0,0.0,0.0022505626406601,0.0310077519379845,0.0041390038612183,0.1428571428571428,0.1860465116279068,0.5833333333333333,439,62,49,64,1,5705,21,75,88,500000,10294.117647058823,6250000.0,1250000.0,,900000.0,7,2950000,0.0,0.0
191422,Mahmoud,Dahoud,2024,24,Syria,AmÃ»dÃª?,Syria,01-01-96,Central Midfield,Midfield,Right,178.0,30-06-26,Unknown,https://img.a.transfermarkt.technology/portrait/header/191422-1726605307.jpg?lm=1,L1,Eintracht Frankfurt FuÃŸball AG,6000000.0,18000000.0,28,140,150,9,11,16,10,16,9,6,11,5,9,17,10,10,16,14,13,11,16,10,16,10,12,14,10,12,10,16,16,13,17,11,8,13,13,14,8,11,6,12,13,9,3,3,2,1,2,4,3,4,3,2,3,7,15,13,11,9,13,14,17,1,1,1,1,1,1,20,1,18,1,1,12,1,1,68,12,20,12957411,7093,7093,5743,North_African__Middle_Eastern,128,2,0,76660.0,Unknown,92063787,12000000.0,1.0,93,65,93,3,1,6,63,1,0.6888065625826938,0.6088770053475935,0.5808823529411764,0.0740155290568719,0.0131578947368421,0.0,0.0297574393598399,0.0897724431107777,0.0666407400205561,0.0,0.3488372093023257,0.4166666666666665,341,25,49,47,1,8650,23,187,124,5000000,141176.4705882353,18000000.0,6000000.0,600000.0,15000000.0,4,9000000,-0.16666666666666666,-0.6428571428571429
191614,Unknown,Fred,2024,36,Brazil,Belo Horizonte,Brazil,05-03-93,Central Midfield,Midfield,Left,169.0,30-06-27,Energy Sports,https://img.a.transfermarkt.technology/portrait/header/191614-1728391871.JPG?lm=1,TR1,FenerbahÃ§e Spor KulÃ¼bÃ¼,15000000.0,50000000.0,31,144,149,10,10,13,9,13,10,8,7,6,13,14,9,14,14,15,15,15,10,11,11,11,14,12,8,14,13,17,17,16,16,14,7,15,15,18,13,10,12,14,3,12,2,4,1,2,2,1,3,1,3,3,2,15,14,12,12,10,15,12,13,1,1,1,1,1,1,16,10,20,1,10,12,1,1,64,20,12,25476425,7200,6900,6000,African_Caribbean,142,19,0,150789.0,Unknown,19159362,27913333.33,3.0,10,168,11,3,0,1,84,1,0.6632707065361206,0.6363636363636364,0.6838235294117647,0.1455957713688687,0.125,0.0,0.0747686921730432,0.2498124531132783,0.1550506032389788,0.2857142857142857,0.13953488372093,0.5416666666666665,488,44,57,112,1,13414,7,31,39,13000000,367142.85714285716,50000000.0,10000000.0,,11000000.0,3,24000000,-0.23529411764705882,-0.3157894736842105
191891,Arkadiusz,Milik,2024,506,Poland,Tychy,Poland,28-02-94,Centre-Forward,Attack,Left,186.0,30-06-26,CAA Stellar,https://img.a.transfermarkt.technology/portrait/header/191891-1661518258.jpg?lm=1,IT1,Juventus Football Club,6000000.0,40000000.0,30,151,160,10,10,12,16,15,15,15,14,4,4,13,15,6,16,10,17,14,14,14,11,15,13,14,11,15,4,15,16,14,14,16,14,12,13,13,15,13,10,13,14,11,1,1,2,1,3,2,3,3,3,3,3,11,16,9,9,13,10,12,15,1,1,1,1,1,1,1,1,1,1,1,12,1,20,80,20,10,53670146,7550,7850,6800,Northern_European,152,62,16,75941.0,Juventus,96026541,9079166.667,6.0,75,1538,78,0,0,7,116,3,0.7889653347446415,0.7219251336898395,0.7573529411764706,0.0733212502426113,0.4078947368421052,0.2105263157894736,0.0297574393598399,0.1997999499874969,0.0504134374121503,0.7142857142857142,0.5348837209302322,0.5,402,161,39,41,2,8374,25,187,208,4000000,104285.71428571429,40000000.0,8000000.0,2500000.0,5000000.0,5,16500000,-0.3333333333333333,-0.42857142857142855
192009,Unai,López,2024,367,Spain,Donostia-San SebastiÃ¡n,Spain,30-10-95,Central Midfield,Midfield,Right,170.0,30-06-26,IDUB GLOBAL,https://img.a.transfermarkt.technology/portrait/header/192009-1726662500.jpg?lm=1,ES1,Rayo Vallecano de Madrid S.A.D.,3000000.0,12000000.0,29,130,151,12,13,13,12,15,11,7,9,8,7,15,13,8,15,13,15,13,13,13,14,12,12,14,12,14,13,15,14,12,12,13,8,12,12,12,11,13,7,12,12,16,1,2,3,3,1,3,1,2,1,1,3,13,14,8,11,10,10,10,17,1,1,1,1,1,1,12,12,20,14,12,18,14,1,67,12,20,3383932,6500,6500,5000,Mediterranean_Hispanic,128,0,0,9724.0,Unknown,67145056,9111392.0,2.0,89,423,89,3,1,3,163,1,0.6103466525535857,0.5294117647058822,0.5808823529411764,0.0093809717392794,0.0,0.0,0.0147536884221055,0.0597649412353088,0.0505924720131114,0.1428571428571428,0.1627906976744184,0.4583333333333332,356,20,22,70,1,2521,4,6,11,2800000,89655.1724137931,12000000.0,7000000.0,500000.0,1500000.0,7,1600000,-0.06666666666666667,-0.2
192080,Nick,Pope,2024,762,England,Soham,England,19-04-92,Goalkeeper,Goalkeeper,Right,198.0,30-06-26,CAA Stellar,https://img.a.transfermarkt.technology/portrait/header/192080-1663841362.jpg?lm=1,GB1,Newcastle United Football Club,16000000.0,20000000.0,32,140,155,1,2,3,3,7,2,3,1,1,2,10,3,3,7,8,15,13,9,14,6,12,14,4,8,2,15,15,15,8,13,12,18,10,9,10,13,16,8,10,1,2,17,16,15,2,16,8,16,15,13,12,11,10,13,2,8,13,14,10,12,20,1,1,1,1,1,1,1,1,1,1,1,1,1,78,13,20,45389195,7194,7144,5994,Northern_European,138,8,0,115992.0,Unknown,29083750,6400000.0,2.0,32,1391,33,2,1,7,137,5,0.695554379465467,0.6357219251336897,0.6544117647058822,0.1119951873635462,0.0526315789473684,0.0,0.0797699424856214,0.0997749437359339,0.0355287646879079,0.1428571428571428,0.8139534883720931,0.5833333333333333,0,0,0,0,0,0,8,91,163,14000000,536538.4615384615,20000000.0,4000000.0,,,2,3550000,-0.125,-0.3
192279,Kepa,Arrizabalaga,2024,989,Spain,Ondarroa,Spain,03-10-94,Goalkeeper,Goalkeeper,Right,188.0,31-05-25,AC Talent,https://img.a.transfermarkt.technology/portrait/header/192279-1661855851.jpg?lm=1,GB1,Association Football Club Bournemouth,12000000.0,60000000.0,30,144,160,4,1,2,3,11,7,1,3,3,3,11,6,1,11,8,14,12,14,15,11,12,13,2,10,5,12,13,12,9,15,12,14,12,12,12,11,13,8,12,8,15,14,13,14,5,16,15,15,16,15,13,13,13,15,7,17,13,15,14,16,20,1,1,1,1,1,1,1,1,1,1,1,1,1,90,10,20,14353977,7000,7250,6500,Mediterranean_Hispanic,141,11,0,170000.0,Unknown,67157624,80000000.0,1.0,89,1086,89,2,1,3,22,5,0.7095792537708389,0.6898395721925134,0.6764705882352942,0.1641462446661716,0.0723684210526315,0.0,0.0597649412353088,0.2998249562390597,0.4444290119169976,0.0,0.581395348837209,0.5,0,0,0,0,0,0,8,47,60,11000000,338709.67741935485,60000000.0,20000000.0,,1000000.0,8,24000000,-0.08333333333333333,-0.45
192565,Leroy,Sané,2024,27,Germany,Essen,Germany,11-01-96,Right Winger,Attack,Left,183.0,30-06-25,11WINS,https://img.a.transfermarkt.technology/portrait/header/192565-1694587968.jpg?lm=1,L1,FC Bayern MÃ¼nchen,60000000.0,100000000.0,28,165,175,14,14,18,14,15,16,7,17,3,7,14,11,8,17,13,15,10,14,12,15,14,11,16,4,15,8,11,9,17,16,14,10,15,18,13,11,12,4,14,6,12,2,2,2,4,3,2,1,1,2,4,3,11,16,13,10,12,11,9,7,1,1,1,1,12,12,1,15,10,15,20,17,18,10,80,20,9,96400267,8247,8247,7997,Mixed_Race,160,45,11,326026.0,Unknown,91138280,50500000.0,2.0,38,475,40,0,0,4,68,10,0.8414924583223076,0.849946524064171,0.8161764705882353,0.3148076442125246,0.2960526315789473,0.1447368421052631,0.2998249562390597,0.4998749687421855,0.280535570432512,0.1428571428571428,0.4651162790697669,0.4166666666666665,480,128,122,43,0,12950,23,118,218,45000000,1396875.0,100000000.0,20000000.0,500000.0,30000000.0,3,12500000,-0.35714285714285715,-0.4375
192616,Ulisses,Garcia,2024,244,Portugal,Almada,Switzerland,11-01-96,Left-Back,Defender,Left,182.0,30-06-28,Unknown,https://img.a.transfermarkt.technology/portrait/header/192616-1700236348.jpg?lm=1,FR1,Olympique de Marseille,4000000.0,4000000.0,28,123,127,8,12,13,9,12,7,9,10,14,11,12,8,12,13,15,13,14,12,12,10,12,14,13,8,11,11,12,14,13,11,13,12,16,14,13,14,11,12,12,8,16,1,2,2,1,3,2,1,1,2,2,1,15,16,9,8,11,13,12,10,1,20,10,1,20,1,12,14,12,1,14,1,1,1,82,20,10,2446725,6128,6178,3742,African_Caribbean,118,4,0,13706.0,Unknown,98030499,1800000.0,3.0,76,46,92,1,0,1,144,8,0.5677427890976449,0.3948663101604278,0.5073529411764706,0.0132260596925281,0.0263157894736842,0.0,0.0197549387346836,0.0197549387346836,0.0099724992360898,0.2857142857142857,0.4418604651162785,0.4166666666666665,324,17,43,52,1,9060,12,44,68,4000000,131666.66666666666,4000000.0,1000000.0,50000.0,1000000.0,5,1950000,0.0,0.3333333333333333
192635,Nico,Elvedi,2024,18,Switzerland,ZÃ¼rich,Switzerland,30-09-96,Centre-Back,Defender,Right,189.0,30-06-27,Gol International,https://img.a.transfermarkt.technology/portrait/header/192635-1691249306.jpg?lm=1,L1,Borussia Verein fÃ¼r LeibesÃ¼bungen 1900 MÃ¶nchengladbach,10000000.0,35000000.0,28,137,145,4,8,8,7,12,4,14,6,8,14,14,7,13,12,13,13,13,14,14,12,13,12,7,11,10,14,16,12,13,11,15,15,13,15,14,13,13,10,12,10,17,3,2,3,2,1,4,3,1,3,2,3,12,15,4,12,16,14,14,18,1,15,20,17,12,14,12,1,10,1,1,1,1,1,84,14,20,11670804,6994,7294,5994,Northern_European,137,38,1,57533.0,Unknown,98033057,4000000.0,1.0,92,1711,92,1,1,7,42,2,0.7154008997089177,0.6357219251336897,0.6470588235294117,0.0555461676099138,0.25,0.0131578947368421,0.0497624406101525,0.1747936984246061,0.0221950609739159,0.0,0.6046511627906974,0.4166666666666665,399,22,14,41,1,5746,24,43,54,8000000,233823.5294117647,35000000.0,7000000.0,4000000.0,7000000.0,1,2500000,-0.2,-0.42857142857142855
192638,Nicolas,Haas,2024,749,Switzerland,Sursee,Switzerland,23-01-96,Central Midfield,Midfield,Right,178.0,30-06-25,Wasserman,https://img.a.transfermarkt.technology/portrait/header/192638-1725530159.jpg?lm=1,IT1,Empoli Football Club S.r.l.,700000.0,3500000.0,28,125,131,10,11,10,9,12,12,11,10,6,10,13,10,13,14,13,13,14,12,13,13,13,14,12,10,12,13,15,14,12,13,13,10,12,13,15,11,15,11,12,12,12,2,1,2,2,1,2,2,4,1,1,1,13,13,12,9,14,15,13,14,1,1,1,1,1,1,14,6,20,6,1,15,1,1,74,10,20,2574089,6250,5900,5100,Northern_European,125,0,0,28461.0,Unknown,98033333,2300000.0,1.0,92,1438,92,3,1,7,64,1,0.530960571579783,0.5401069518716577,0.5588235294117647,0.027473742452494,0.0,0.0,0.0032508127031757,0.0172543135783946,0.0127503541765049,0.0,0.3488372093023257,0.4166666666666665,320,30,32,50,0,4720,5,49,169,700000,22222.222222222223,3500000.0,600000.0,,1500000.0,6,1300000,0.0,-0.5333333333333333
192735,Stanislav,Lobotka,2024,6195,Slovakia,Tren?Ã­n,Slovakia,25-11-94,Defensive Midfield,Midfield,Right,168.0,30-06-27,FairSport,https://img.a.transfermarkt.technology/portrait/header/192735-1661509021.jpg?lm=1,IT1,SocietÃ  Sportiva Calcio Napoli,28000000.0,40000000.0,30,150,155,4,11,14,6,17,4,5,9,5,12,16,8,17,17,13,14,15,17,15,14,15,15,12,10,9,14,17,15,13,15,16,7,15,12,15,10,15,5,11,12,11,1,2,2,3,3,3,3,3,3,3,1,13,14,3,15,13,15,16,16,1,1,1,1,1,1,20,1,18,1,1,14,1,1,64,13,20,30058676,7500,7500,6250,Northern_European,150,40,3,49230.0,Unknown,63012964,9500000.0,3.0,86,1519,86,3,1,7,184,4,0.7426567875099233,0.6631016042780749,0.7426470588235294,0.0475286474502393,0.2631578947368421,0.0394736842105263,0.1397849462365591,0.1997999499874969,0.052751465318481,0.2857142857142857,0.1162790697674416,0.5,453,8,17,36,1,6343,13,44,39,28000000,777083.3333333334,40000000.0,5000000.0,200000.0,600000.0,5,8150000,0.0,-0.2
192765,Ben,Davies,2024,148,Wales,Neath,Wales,24-04-93,Centre-Back,Defender,Left,181.0,30-06-25,CAA Stellar,https://img.a.transfermarkt.technology/portrait/header/192765-1668520095.jpg?lm=1,GB1,Tottenham Hotspur Football Club,10000000.0,25000000.0,31,144,145,11,12,12,8,13,13,15,7,11,13,14,10,15,13,13,15,18,13,11,12,14,15,9,12,13,15,15,16,12,13,13,12,14,13,16,14,14,6,10,9,15,1,1,3,2,2,3,3,2,2,3,1,14,13,4,13,12,15,14,17,1,20,18,1,15,1,1,1,1,1,1,1,1,1,76,20,8,67881263,7200,7500,5900,Northern_European,143,74,1,104393.0,Unknown,28049754,12650000.0,1.0,109,1023,106,1,0,7,202,2,0.7426567875099233,0.6256684491978609,0.6911764705882353,0.1007949926951053,0.4868421052631578,0.0131578947368421,0.0497624406101525,0.1247811952988247,0.0702519514430956,0.0,0.418604651162791,0.5416666666666665,443,12,26,54,0,12957,19,115,90,8000000,242187.5,25000000.0,5000000.0,,5500000.0,1,4500000,-0.2,-0.4666666666666667
193004,Waldemar,Anton,2024,16,Uzbekistan,Almalyk,Germany,20-07-96,Centre-Back,Defender,Right,189.0,30-06-28,AKA Global GmbH,https://img.a.transfermarkt.technology/portrait/header/193004-1723922551.jpg?lm=1,L1,Borussia Dortmund,24000000.0,24000000.0,28,132,137,5,9,9,8,11,5,14,8,10,13,12,7,14,11,12,15,14,13,12,12,13,13,7,13,8,15,16,12,11,11,13,15,16,13,14,13,15,9,14,4,16,1,2,3,1,1,3,2,3,4,2,2,10,15,2,15,14,17,15,17,1,10,20,12,8,8,15,1,10,1,1,1,1,1,84,10,20,4522165,6500,6450,5000,Northern_European,131,0,0,23972.0,Unknown,91137493,13250000.0,2.0,107,47,40,1,1,7,41,2,0.6037311458057687,0.5294117647058822,0.6029411764705883,0.0231390865453787,0.0,0.0,0.1197799449862465,0.1197799449862465,0.0735853773715936,0.1428571428571428,0.6046511627906974,0.4166666666666665,378,20,16,62,3,4909,15,25,32,24000000,770967.7419354839,24000000.0,3500000.0,100000.0,2500000.0,2,5500000,0.2,1.4
193033,Tim,Kleindienst,2024,18,Germany,JÃ¼terbog,Germany,31-08-95,Centre-Forward,Attack,Right,194.0,30-06-28,Robert Schneider,https://img.a.transfermarkt.technology/portrait/header/193033-1722945738.jpg?lm=1,L1,Borussia Verein fÃ¼r LeibesÃ¼bungen 1900 MÃ¶nchengladbach,8000000.0,8000000.0,29,124,127,6,8,11,12,10,7,14,8,6,7,10,11,8,10,16,12,14,11,12,10,11,14,10,10,13,8,15,12,11,10,14,18,14,12,14,16,14,8,14,14,8,3,3,2,1,3,2,2,2,2,1,2,10,15,6,10,12,14,10,12,1,1,1,1,1,1,1,12,1,12,12,1,12,20,82,16,20,3550775,6251,6251,5000,Northern_European,120,0,0,14999.0,Unknown,92065436,3450000.0,5.0,38,697,40,0,1,7,42,3,0.5774014289494576,0.5294117647058822,0.5220588235294117,0.014474602817478,0.0,0.0,0.0397599399849962,0.0397599399849962,0.0191394205394594,0.5714285714285714,0.7209302325581395,0.4583333333333332,362,139,44,73,0,4208,18,86,190,12000000,383870.96774193546,12000000.0,500000.0,150000.0,400000.0,8,4150000,1.0,1.4
193082,Alejandro,Grimaldo,2024,15,Spain,Valencia,Spain,20-09-95,Left-Back,Defender,Right,171.0,30-06-27,Wasserman,https://img.a.transfermarkt.technology/portrait/header/193082-1689710805.jpg?lm=1,L1,Bayer 04 Leverkusen FuÃŸball,45000000.0,45000000.0,29,70,-75,4,1,2,3,5,6,1,1,3,1,8,2,2,4,5,7,14,4,8,5,12,15,1,9,1,4,6,5,12,11,6,10,13,8,5,8,20,9,11,9,9,12,10,8,5,12,11,8,12,10,12,6,8,12,3,13,11,11,10,18,20,1,1,1,1,1,1,1,1,1,1,1,1,1,0,3,20,4183999,3500,3500,1000,Mediterranean_Hispanic,67,0,0,269.0,Unknown,2000147031,2100000.0,1.0,89,1556,89,1,1,3,36,8,0.2134162476845726,0.1016042780748663,0.1323529411764705,0.0002510604891623,0.0,0.0,0.2248062015503876,0.2248062015503876,0.0116392122003388,0.0,0.1860465116279068,0.4583333333333332,479,49,108,53,0,12470,16,173,325,40000000,1209090.9090909092,45000000.0,7000000.0,2000000.0,2000000.0,3,11400000,-0.1111111111111111,0.14285714285714285
193098,Álex,Moreno,2024,703,Spain,Vilafranca Del PenedÃ¨s,Spain,08-06-93,Left-Back,Defender,Left,179.0,31-05-25,Gol International,https://img.a.transfermarkt.technology/portrait/header/193098-1667289023.jpg?lm=1,GB1,Nottingham Forest Football Club,13000000.0,20000000.0,31,141,145,10,13,15,10,13,8,7,10,12,12,12,10,14,14,9,12,13,11,10,11,10,12,14,9,14,13,13,15,15,15,12,9,14,16,14,12,13,9,12,9,12,1,2,1,3,4,3,1,3,1,2,3,12,13,10,11,10,13,10,13,1,20,1,1,20,1,1,18,1,1,17,1,1,1,68,20,8,7042625,6650,6650,4650,Mediterranean_Hispanic,127,0,0,14057.0,Unknown,67153373,11600000.0,2.0,89,1592,89,1,0,3,140,8,0.6301931727970362,0.4919786096256684,0.5735294117647058,0.0135649913528973,0.0,0.0,0.0647661915478869,0.0997749437359339,0.0644184560682241,0.1428571428571428,0.3720930232558141,0.5416666666666665,417,24,32,42,1,4224,11,30,119,11000000,327272.7272727273,20000000.0,5000000.0,,800000.0,6,12200000,-0.15384615384615385,0.1
193116,John,Mcginn,2024,405,Scotland,Glasgow,Scotland,18-10-94,Central Midfield,Midfield,Left,178.0,30-06-27,Unknown,https://img.a.transfermarkt.technology/portrait/header/193116-1689172405.jpg?lm=1,GB1,Aston Villa Football Club,30000000.0,32000000.0,30,143,150,11,13,14,13,13,10,9,15,9,10,14,10,14,15,15,13,14,13,11,14,10,16,13,10,13,13,16,17,13,13,14,9,15,14,17,15,13,14,13,5,10,3,1,3,1,4,4,3,2,2,1,1,12,13,4,8,13,16,15,15,1,1,1,1,1,1,18,1,20,1,1,17,1,1,77,20,10,39999750,7150,7150,6000,Northern_European,142,48,13,81194.0,Unknown,61043070,2130000.0,2.0,82,545,83,3,0,7,30,1,0.696348240275205,0.6363636363636364,0.6838235294117647,0.0783936377409577,0.3157894736842105,0.1710526315789473,0.1497874468617154,0.1597899474868717,0.0118058834967637,0.1428571428571428,0.3488372093023257,0.5,499,49,72,105,2,7274,9,50,168,23000000,912000.0,32000000.0,7000000.0,300000.0,,2,550000,-0.23333333333333334,-0.23333333333333334
193256,Gauthier,Gallon,2024,273,France,Nice,France,23-04-93,Goalkeeper,Goalkeeper,Right,187.0,30-06-27,Kemari,https://img.a.transfermarkt.technology/portrait/header/193256-1583139111.jpg?lm=1,FR1,Stade Rennais Football Club,1200000.0,2500000.0,31,125,128,7,2,3,3,10,9,2,3,2,1,11,2,2,10,12,12,15,12,13,10,11,11,8,10,1,11,13,10,9,12,14,12,13,9,13,14,12,7,1,7,1,11,13,15,10,13,15,13,15,13,8,12,7,13,8,15,8,13,10,11,20,1,1,1,1,1,1,1,1,1,1,1,1,1,79,6,20,2252769,6245,6245,3495,Northern_European,123,0,0,4499.0,Unknown,29114950,9111392.0,2.0,34,1041,36,2,1,7,195,5,0.5766075681397195,0.3684491978609625,0.5441176470588236,0.0043356215243813,0.0,0.0,0.0057514378594648,0.0122530632658164,0.0505924720131114,0.1428571428571428,0.5581395348837206,0.5416666666666665,0,0,0,0,0,0,0,0,0,1000000,45238.09523809524,2500000.0,500000.0,,50000.0,4,1150000,-0.16666666666666666,-0.3333333333333333
193319,Luís,Silva,2024,110302,Portugal,Matosinhos,Portugal,29-09-92,Central Midfield,Midfield,Right,185.0,30-06-25,Unknown,https://img.a.transfermarkt.technology/portrait/header/193319-1508857067.jpg?lm=1,PO1,Avs Futebol SAD,150000.0,1500000.0,32,125,136,10,10,12,7,14,12,10,14,8,13,15,13,14,13,12,15,13,12,11,14,14,13,11,13,10,14,15,14,10,11,11,11,12,10,10,10,11,9,12,12,15,3,1,2,2,1,2,3,3,1,2,2,11,10,4,13,12,15,12,11,1,1,11,9,1,10,20,1,19,1,1,1,1,1,80,10,20,2081792,6185,6185,4960,Northern_European,125,0,0,15654.0,Unknown,19152917,9111392.0,2.0,76,929,79,3,1,7,35,1,0.5686689600423392,0.5251336898395721,0.5588235294117647,0.015107082126714,0.0,0.0,0.0005001250312578,0.0072518129532383,0.0505924720131114,0.1428571428571428,0.5116279069767438,0.5833333333333333,413,34,16,133,8,5403,0,0,0,200000,-11538.461538461539,1500000.0,400000.0,,750000.0,11,2000000,0.3333333333333333,0.3333333333333333
193469,Björn,Engels,2024,1096,Belgium,Kaprijke,Belgium,15-09-94,Centre-Back,Defender,Right,195.0,30-06-26,SportPlus,https://img.a.transfermarkt.technology/portrait/header/193469-1705658592.jpg?lm=1,BE1,Royal Antwerp Football Club,250000.0,12000000.0,30,124,126,8,8,8,8,12,9,15,10,12,13,13,11,14,12,13,12,15,12,13,12,11,12,11,14,7,13,14,12,10,9,15,16,12,11,14,15,14,9,11,15,9,1,2,3,3,3,1,1,2,1,2,3,10,13,10,14,10,13,12,9,1,1,20,1,1,1,10,1,1,1,1,1,1,1,83,8,20,3462749,6150,6200,5250,Northern_European,124,0,0,14250.0,Unknown,18059845,5000000.0,4.0,7,708,8,1,1,7,173,2,0.5706536120666843,0.5561497326203209,0.5514705882352942,0.0137513554852371,0.0,0.0,0.0010002500625156,0.0597649412353088,0.0277507708547459,0.4285714285714285,0.7441860465116279,0.5,196,19,8,23,3,6335,13,295,566,200000,2777.777777777778,12000000.0,3000000.0,300000.0,3500000.0,4,5000000,-0.5,-0.7142857142857143
193592,Kristoffer,Olsson,2024,865,Sweden,Vrinnevi,Sweden,30-06-95,Central Midfield,Midfield,Right,180.0,30-06-26,Nordic Sky,https://img.a.transfermarkt.technology/portrait/header/193592-1574609450.png?lm=1,DK1,Fodbold Club Midtjylland,2500000.0,4500000.0,29,130,135,12,14,13,9,14,14,10,9,11,11,14,11,11,14,11,13,10,15,15,14,14,12,13,12,12,13,13,13,12,14,10,8,13,13,13,8,13,8,13,7,11,2,2,1,3,1,1,1,1,3,3,3,10,14,10,5,13,12,12,11,1,1,1,1,1,1,18,9,20,12,1,14,1,1,69,12,20,5878125,6250,6250,5000,Northern_European,131,40,0,21999.0,Football Club Midtjylland,93031737,2275000.0,6.0,91,1632,91,3,1,7,86,1,0.5772691188145012,0.5294117647058822,0.6029411764705883,0.0212339236795425,0.2631578947368421,0.0,0.0122530632658164,0.0222555638909727,0.0126114614294841,0.7142857142857142,0.3953488372093026,0.4583333333333332,376,26,55,76,0,10971,8,83,341,2000000,76000.0,4500000.0,800000.0,,700000.0,4,3800000,-0.2,-0.2
193867,Liam,Henderson,2024,749,Scotland,Livingston,Scotland,25-04-96,Central Midfield,Midfield,Right,183.0,30-06-25,ES,https://img.a.transfermarkt.technology/portrait/header/193867-1661523222.jpg?lm=1,IT1,Empoli Football Club S.r.l.,1400000.0,3000000.0,28,128,134,11,11,10,9,13,12,7,14,5,9,14,9,11,13,14,12,14,13,13,13,14,15,11,11,14,11,14,14,12,12,13,11,15,12,16,13,13,11,13,7,13,2,2,2,1,1,2,1,1,1,3,1,15,12,6,12,12,15,11,8,1,1,1,1,1,1,1,10,20,10,10,19,10,1,67,10,20,3468584,6400,5800,5000,Northern_European,128,0,0,28461.0,Unknown,61058564,740000.0,3.0,82,846,83,3,1,7,64,1,0.5177295580841492,0.5294117647058822,0.5808823529411764,0.027473742452494,0.0,0.0,0.0067516879219804,0.0147536884221055,0.00408344676241,0.2857142857142857,0.4651162790697669,0.4166666666666665,342,27,51,57,2,5559,0,0,0,1400000,55000.0,3000000.0,500000.0,300000.0,600000.0,9,2350000,0.0,-0.2222222222222222
193900,Marius,Wolf,2024,167,Germany,Coburg,Germany,27-05-95,Right-Back,Defender,Right,188.0,30-06-27,ROGON,https://img.a.transfermarkt.technology/portrait/header/193900-1723533785.jpg?lm=1,L1,FC Augsburg 1907,3000000.0,10000000.0,29,142,143,10,12,12,12,11,9,9,12,12,10,11,13,10,11,17,11,16,11,11,11,11,17,13,12,11,10,14,17,15,10,10,12,16,15,17,12,13,6,14,8,17,4,1,4,4,2,3,1,1,1,1,1,7,16,12,6,11,15,11,13,1,8,1,15,12,18,1,14,1,20,16,1,20,8,81,10,20,10872297,6850,6850,4500,Northern_European,124,0,0,67077.0,Unknown,91124151,2333333.333,3.0,38,372,40,1,1,7,67,11,0.6566551997883038,0.4759358288770053,0.5514705882352942,0.0647620187967057,0.0,0.0,0.0147536884221055,0.0497624406101525,0.012935544504014,0.2857142857142857,0.581395348837209,0.4583333333333332,379,38,47,35,1,6339,29,67,96,3000000,101724.13793103448,10000000.0,2000000.0,50000.0,1000000.0,9,5050000,0.0,-0.5384615384615384
195246,Pascal,Stenzel,2024,79,Germany,BÃ¼nde,Germany,20-03-96,Right-Back,Defender,Right,183.0,30-06-26,Unique Sports Group,https://img.a.transfermarkt.technology/portrait/header/195246-1657181494.jpg?lm=1,L1,Verein fÃ¼r Bewegungsspiele Stuttgart 1893,2500000.0,6500000.0,28,125,129,6,10,10,5,12,8,12,8,12,12,13,11,12,13,11,13,14,13,13,11,13,15,6,12,10,13,18,13,11,11,12,12,16,12,15,10,13,8,13,5,15,2,3,3,3,3,1,3,1,1,1,2,10,14,5,10,12,15,13,13,1,1,18,20,1,17,17,1,15,12,1,1,1,1,74,9,20,2911999,6250,6250,4750,Northern_European,118,0,0,17260.0,Unknown,92065838,2650000.0,2.0,38,290,40,1,1,7,211,11,0.5772691188145012,0.5026737967914437,0.5073529411764706,0.0166578634559248,0.0,0.0,0.0122530632658164,0.032258064516129,0.0146948526347954,0.1428571428571428,0.4651162790697669,0.4166666666666665,310,22,25,47,0,6591,11,21,43,2500000,80000.0,6500000.0,2000000.0,100000.0,2000000.0,3,1300000,0.0,0.0
195488,Paulo,Gazzaniga,2024,12321,Argentina,Murphy,Argentina,02-01-92,Goalkeeper,Goalkeeper,Right,195.0,30-06-27,LGT Football,https://img.a.transfermarkt.technology/portrait/header/195488-1544621003.jpg?lm=1,ES1,Girona FÃºtbol Club S. A. D.,4000000.0,4000000.0,32,128,142,3,1,3,1,8,5,6,1,3,1,10,2,1,13,9,12,13,10,12,14,12,13,6,6,4,12,11,12,8,15,11,17,11,7,12,13,14,9,12,8,1,15,12,12,5,13,16,13,16,12,7,13,18,8,4,11,13,14,13,14,20,1,1,1,1,1,1,1,1,1,1,1,1,1,90,9,20,3658538,6400,6100,4750,Mediterranean_Hispanic,127,1,0,28998.0,Girona,67136579,3150000.0,1.0,4,994,4,2,1,3,107,5,0.5574225985710506,0.5026737967914437,0.5735294117647058,0.0279922789243409,0.006578947368421,0.0,0.0197549387346836,0.0197549387346836,0.0174727075752104,0.0,0.7441860465116279,0.5833333333333333,0,0,0,0,0,0,1,2,20,3500000,18518.51851851852,4000000.0,1500000.0,,3000000.0,5,1500000,-0.125,-0.125
195633,Charlie,Taylor,2024,180,England,York,England,18-09-93,Left-Back,Defender,Left,183.0,30-06-26,InterLex Sport,https://img.a.transfermarkt.technology/portrait/header/195633-1700671881.jpg?lm=1,GB1,Southampton Football Club,3000000.0,7000000.0,31,132,144,12,15,12,9,14,11,11,9,10,13,12,5,15,12,10,12,13,11,13,7,13,14,11,8,13,15,14,14,14,13,13,11,17,13,15,13,15,4,13,7,16,1,2,3,3,2,2,4,3,2,1,2,15,15,6,11,15,12,17,10,1,20,17,8,17,1,8,14,1,1,8,1,1,1,70,20,7,14590135,6593,6593,5243,Northern_European,131,0,0,28708.0,Unknown,28059140,9111392.0,2.0,32,1688,33,1,0,7,186,8,0.622651495104525,0.5554010695187165,0.6029411764705883,0.0277122499171983,0.0,0.0,0.0147536884221055,0.0347586896724181,0.0505924720131114,0.1428571428571428,0.4651162790697669,0.5416666666666665,393,4,32,40,0,6412,9,30,63,2800000,120652.17391304347,7000000.0,2000000.0,,100000.0,3,275000,-0.06666666666666667,-0.06666666666666667
195736,Florian,Grillitsch,2024,533,Austria,Neunkirchen,Austria,07-08-95,Defensive Midfield,Midfield,Right,187.0,30-06-26,YOU FIRST,https://img.a.transfermarkt.technology/portrait/header/195736-1691269821.jpg?lm=1,L1,TSG 1899 Hoffenheim FuÃŸball-Spielbetriebs GmbH,6500000.0,25000000.0,29,144,147,12,13,11,11,15,12,12,11,6,12,15,11,13,14,13,15,12,16,14,15,13,8,12,12,12,14,15,13,11,12,13,14,13,15,14,11,14,6,13,7,17,4,3,1,1,2,2,1,1,3,1,4,13,16,6,8,15,13,12,18,1,1,16,1,1,1,20,12,19,12,12,15,12,10,77,10,20,17267579,7100,7100,5000,Northern_European,138,33,1,40000.0,Unknown,16096614,9111392.0,2.0,6,1030,7,3,1,7,199,4,0.6897327335273882,0.5294117647058822,0.6544117647058822,0.0386160000849743,0.2171052631578947,0.0131578947368421,0.032258064516129,0.1247811952988247,0.0505924720131114,0.1428571428571428,0.5581395348837206,0.4583333333333332,376,77,56,66,1,4447,40,85,55,3500000,107812.5,25000000.0,6000000.0,75000.0,4000000.0,5,6600000,-0.46153846153846156,-0.46153846153846156
195778,Alexander,Nübel,2024,79,Germany,Paderborn,Germany,30-09-96,Goalkeeper,Goalkeeper,Right,193.0,30-06-26,Siebert & Backs,https://img.a.transfermarkt.technology/portrait/header/195778-1691998861.jpg?lm=1,L1,Verein fÃ¼r Bewegungsspiele Stuttgart 1893,12000000.0,16000000.0,28,137,155,4,1,2,2,11,8,7,3,2,1,12,3,1,11,13,13,13,15,12,9,12,12,2,11,1,10,15,12,13,15,12,15,14,11,10,13,12,8,15,5,13,14,15,9,12,11,14,15,16,17,10,14,11,16,15,6,13,15,7,11,20,1,1,1,1,1,1,1,1,1,1,1,1,1,88,14,20,3576621,6840,6740,5240,Northern_European,137,0,0,105768.0,AS Monaco,92071707,600000.0,1.0,38,1109,40,2,1,7,211,5,0.6421010849431067,0.5550802139037433,0.6470588235294117,0.102122716435868,0.0,0.0,0.0597649412353088,0.0797699424856214,0.0033056473790938,0.0,0.6976744186046511,0.4166666666666665,0,0,0,0,0,0,6,16,43,12000000,457692.3076923077,16000000.0,4000000.0,100000.0,300000.0,4,3600000,0.0,0.2
196231,Marvin,Friedrich,2024,18,Germany,Kassel,Germany,13-12-95,Centre-Back,Defender,Right,193.0,30-06-26,ROOF,https://img.a.transfermarkt.technology/portrait/header/196231-1662966392.jpg?lm=1,L1,Borussia Verein fÃ¼r LeibesÃ¼bungen 1900 MÃ¶nchengladbach,3500000.0,10000000.0,29,132,142,4,8,8,7,11,4,16,7,6,14,12,7,14,11,14,13,16,12,13,11,12,14,8,14,10,14,13,13,11,8,15,17,13,13,12,16,12,11,14,8,9,2,3,1,3,1,3,3,1,3,2,2,8,13,5,10,12,15,11,10,1,10,20,14,1,1,1,1,1,1,1,1,1,1,83,11,20,4741001,6590,6590,5490,Northern_European,131,0,0,47944.0,Unknown,92067018,2060000.0,5.0,38,712,40,1,1,7,42,2,0.622254564699656,0.5818181818181818,0.6029411764705883,0.0462868636461514,0.0,0.0,0.0172543135783946,0.0497624406101525,0.0114169838051056,0.5714285714285714,0.6976744186046511,0.4583333333333332,381,22,17,43,0,6330,10,28,113,3500000,121428.57142857143,10000000.0,3000000.0,500000.0,1000000.0,4,2350000,0.0,0.0
196357,Jonathan,Tah,2024,15,Germany,Hamburg,Germany,11-02-96,Centre-Back,Defender,Right,195.0,30-06-25,Gol International,https://img.a.transfermarkt.technology/portrait/header/196357-1695367765.jpg?lm=1,L1,Bayer 04 Leverkusen FuÃŸball,30000000.0,40000000.0,28,142,153,5,10,9,6,13,5,11,5,12,15,12,8,15,12,12,13,12,14,12,10,13,12,7,11,6,13,15,13,13,11,16,17,14,13,13,18,14,6,13,9,8,1,2,4,1,1,4,1,3,1,3,3,8,13,8,13,13,14,15,15,1,1,20,12,1,8,1,1,1,1,1,1,1,1,94,12,20,18869764,7100,7100,6250,Mixed_Race,139,16,0,67122.0,Unknown,91119700,9500000.0,1.0,38,594,40,1,1,4,36,2,0.6897327335273882,0.6631016042780749,0.6617647058823528,0.0648054715736761,0.1052631578947368,0.0,0.1497874468617154,0.1997999499874969,0.052751465318481,0.0,0.7441860465116279,0.4166666666666665,496,20,16,61,2,11368,20,60,81,30000000,867647.0588235294,40000000.0,8000000.0,4000000.0,22000000.0,3,7500000,0.0,0.2
196792,Julian,Weigl,2024,18,Germany,Bad Aibling,Germany,08-09-95,Defensive Midfield,Midfield,Right,186.0,30-06-28,Sports360 GmbH,https://img.a.transfermarkt.technology/portrait/header/196792-1662965628.jpg?lm=1,L1,Borussia Verein fÃ¼r LeibesÃ¼bungen 1900 MÃ¶nchengladbach,6000000.0,30000000.0,29,142,150,5,7,11,8,16,6,12,10,5,12,17,7,14,16,14,16,12,18,16,15,15,13,11,8,10,16,17,13,11,12,16,12,16,12,16,11,16,12,12,6,10,2,1,4,2,3,3,2,1,1,2,2,8,12,10,12,13,16,14,15,1,1,14,1,1,1,20,1,19,1,1,10,1,1,80,8,20,15988499,7100,7100,6200,Northern_European,142,6,0,76711.0,Borussia MÃ¶nchengladbach,91124144,9893333.333,3.0,38,117,40,3,1,7,42,4,0.6897327335273882,0.6577540106951871,0.6838235294117647,0.0740647755374384,0.0394736842105263,0.0,0.0297574393598399,0.1497874468617154,0.0549367112030889,0.2857142857142857,0.5348837209302322,0.4583333333333332,486,17,15,107,0,8234,19,36,99,6000000,175000.0,30000000.0,7000000.0,800000.0,18000000.0,4,12700000,0.0,-0.4
196793,Maximilian,Wittek,2024,80,Germany,Freising,Germany,21-08-95,Left-Back,Defender,Left,173.0,30-06-26,Sports360 GmbH,https://img.a.transfermarkt.technology/portrait/header/196793-1721851854.jpg?lm=1,L1,Verein fÃ¼r LeibesÃ¼bungen Bochum 1848 FuÃŸballgemeinschaft,2000000.0,2500000.0,29,122,126,14,14,10,8,12,13,8,13,15,10,13,10,11,14,17,10,14,11,10,12,11,14,13,7,12,9,14,17,14,14,10,7,13,13,15,7,14,14,11,12,14,1,3,3,1,2,2,1,2,2,3,2,8,12,9,14,10,13,11,11,1,20,1,12,20,1,10,14,1,12,14,1,12,1,66,20,8,3512208,5995,5995,3800,Northern_European,112,0,0,4999.0,Unknown,91124147,750000.0,1.0,38,512,40,1,0,7,212,8,0.5435300344006351,0.4010695187165775,0.463235294117647,0.0048184301573859,0.0,0.0,0.0097524381095273,0.0122530632658164,0.0041390038612183,0.0,0.2325581395348837,0.4583333333333332,388,27,48,99,2,4007,16,40,71,2000000,72222.22222222222,2500000.0,500000.0,200000.0,900000.0,4,150000,0.0,0.0
196829,Timon,Wellenreuther,2024,234,Germany,Karlsruhe,Germany,03-12-95,Goalkeeper,Goalkeeper,Right,188.0,30-06-27,Unknown,https://img.a.transfermarkt.technology/portrait/header/196829-1686056014.jpg?lm=1,NL1,Feyenoord Rotterdam,7000000.0,7000000.0,29,122,126,3,1,3,2,10,5,7,2,9,1,10,10,2,10,8,12,14,14,11,9,11,15,6,10,10,11,13,13,14,11,14,14,15,12,13,12,13,6,14,3,11,12,12,13,10,13,13,14,14,16,13,15,12,16,10,10,13,14,10,10,20,1,1,1,1,1,1,1,1,1,1,1,1,1,80,5,20,5737500,6400,5500,5000,Northern_European,122,0,0,6999.0,Feyenoord Rotterdam,92067270,1000000.0,1.0,38,710,40,2,1,7,85,5,0.4780365175972479,0.5294117647058822,0.536764705882353,0.0067496646894043,0.0,0.0,0.0347586896724181,0.0347586896724181,0.0055279313314258,0.0,0.581395348837209,0.4583333333333332,0,0,0,0,0,0,6,21,33,6000000,203448.27586206896,7000000.0,1000000.0,100000.0,700000.0,7,400000,-0.14285714285714285,1.0
196948,Andreas,Christensen,2024,131,Denmark,LillerÃ¸d,Denmark,10-04-96,Centre-Back,Defender,Right,187.0,30-06-26,KIN Partners,https://img.a.transfermarkt.technology/portrait/header/196948-1668183241.jpg?lm=1,ES1,Futbol Club Barcelona,40000000.0,40000000.0,28,155,165,5,10,11,9,14,5,15,8,12,15,14,9,14,13,7,17,8,16,16,10,17,11,7,9,10,16,15,13,12,14,12,14,14,15,13,10,15,6,15,4,15,1,1,2,4,2,1,1,2,2,2,3,16,15,5,10,14,13,16,18,1,1,20,14,1,10,16,1,16,1,1,1,1,1,78,10,20,42075000,7750,8200,6250,Northern_European,151,56,2,230768.0,Unknown,27066387,9111392.0,2.0,28,835,30,1,1,7,96,2,0.8352738819793597,0.6631016042780749,0.75,0.2228248746870193,0.3684210526315789,0.0263157894736842,0.1997999499874969,0.1997999499874969,0.0505924720131114,0.1428571428571428,0.5581395348837206,0.4166666666666665,384,17,13,27,1,12093,27,94,149,20000000,696428.5714285715,40000000.0,10000000.0,750000.0,16000000.0,4,22750000,-0.5,-0.5
197122,Unai,García,2024,331,Spain,Esquiroz,Spain,03-02-92,Centre-Back,Defender,Right,186.0,30-06-25,Global Ases,https://img.a.transfermarkt.technology/portrait/header/197122-1490623673.jpg?lm=1,ES1,Club AtlÃ©tico Osasuna,1200000.0,2500000.0,32,129,137,7,8,7,7,9,6,14,8,11,14,9,8,13,9,12,15,15,13,14,8,14,5,7,8,7,14,14,15,12,11,13,15,13,12,13,13,15,11,3,12,15,2,1,1,3,2,2,1,1,2,1,1,18,10,5,11,11,9,12,16,1,14,20,6,1,1,1,1,1,1,1,1,1,1,76,9,20,2833955,6400,6400,4200,Mediterranean_Hispanic,128,0,0,8662.0,Unknown,67149678,9111392.0,2.0,89,474,89,1,1,3,51,2,0.5971156390579518,0.4438502673796791,0.5808823529411764,0.0083554862027776,0.0,0.0,0.0057514378594648,0.0122530632658164,0.0505924720131114,0.1428571428571428,0.5348837209302322,0.5833333333333333,271,18,3,50,1,3427,9,43,215,1000000,36000.0,2500000.0,1000000.0,,,2,400000,-0.16666666666666666,-0.3333333333333333
197471,Roberto,Gagliardini,2024,2919,Italy,Bergamo,Italy,07-04-94,Central Midfield,Midfield,Right,188.0,30-06-25,GR Sports,https://img.a.transfermarkt.technology/portrait/header/197471-1641817964.jpg?lm=1,IT1,Associazione Calcio Monza,3000000.0,20000000.0,30,139,150,4,9,10,12,13,7,13,12,11,12,14,7,15,13,14,15,15,14,16,12,13,16,9,10,15,14,18,16,13,12,16,13,15,13,15,16,12,12,11,9,11,2,3,3,3,3,1,3,3,3,2,1,15,14,8,14,12,20,14,13,1,1,1,1,1,1,15,8,20,8,7,9,7,1,77,9,20,3794011,6950,6750,5950,Mediterranean_Hispanic,141,7,0,53462.0,Unknown,43081390,20500000.0,1.0,52,176,54,3,1,3,28,1,0.6434241862926701,0.6310160427807486,0.6764705882352942,0.0516151397199903,0.0460526315789473,0.0,0.0147536884221055,0.0997749437359339,0.1138642740076113,0.0,0.581395348837209,0.5,334,24,15,55,0,7395,15,73,130,2000000,62903.22580645161,20000000.0,3000000.0,,800000.0,8,8100000,-0.3333333333333333,-0.5
197473,Alberto,Grassi,2024,749,Italy,Lumezzane,Italy,07-03-95,Defensive Midfield,Midfield,Right,183.0,30-06-26,Unknown,https://img.a.transfermarkt.technology/portrait/header/197473-1695031303.jpg?lm=1,IT1,Empoli Football Club S.r.l.,1800000.0,7000000.0,29,123,130,8,10,10,7,11,5,11,10,7,11,12,11,15,13,12,13,15,12,12,13,13,15,14,9,14,13,14,14,12,12,14,11,13,13,13,12,14,13,14,18,14,2,2,3,3,3,3,3,1,2,3,3,12,15,7,14,13,15,14,12,1,1,1,5,1,10,17,1,20,10,1,1,1,1,75,12,20,2256349,6150,6150,4950,Mediterranean_Hispanic,122,0,0,32018.0,Empoli Football Club,43081383,8225000.0,2.0,52,874,54,3,1,3,64,4,0.5640381053188674,0.5240641711229946,0.536764705882353,0.0309084430676888,0.0,0.0,0.0087521880470117,0.0347586896724181,0.0456679352204227,0.1428571428571428,0.4651162790697669,0.4583333333333332,264,10,6,46,3,4694,20,126,159,1800000,57758.620689655174,7000000.0,1500000.0,100000.0,2000000.0,7,4500000,0.0,0.0
197642,Chuba,Akpom,2024,610,England,London,England,09-10-95,Centre-Forward,Attack,Right,183.0,30-06-28,Unknown,https://img.a.transfermarkt.technology/portrait/header/197642-1678463529.jpg?lm=1,NL1,AFC Ajax Amsterdam,12000000.0,12000000.0,29,120,125,6,9,10,11,10,7,10,8,4,7,10,10,7,12,12,11,14,12,10,10,10,13,13,8,14,6,13,14,17,14,15,13,14,16,14,14,12,8,14,6,8,1,3,3,3,3,3,1,2,2,2,2,12,15,3,9,12,15,15,16,1,1,1,1,1,1,1,1,1,1,6,10,7,20,81,8,20,2280772,6000,5900,3018,African_Caribbean,117,0,0,28998.0,Unknown,28084927,6273333.333,3.0,32,858,33,0,1,1,6,3,0.530960571579783,0.3174331550802138,0.4999999999999999,0.0279922789243409,0.0,0.0,0.0597649412353088,0.0597649412353088,0.0348250414344842,0.2857142857142857,0.4651162790697669,0.4583333333333332,438,139,33,31,0,15128,5,28,102,8000000,287037.037037037,12000000.0,2000000.0,,1000000.0,10,950000,-0.3333333333333333,-0.3333333333333333
197747,Alessio,Romagnoli,2024,398,Italy,Anzio,Italy,12-01-95,Centre-Back,Defender,Left,185.0,30-06-27,Team Raiola,https://img.a.transfermarkt.technology/portrait/header/197747-1650543426.jpg?lm=1,IT1,SocietÃ  Sportiva Lazio S.p.A.,15000000.0,50000000.0,29,145,150,5,5,8,8,12,4,15,5,13,16,14,12,15,13,14,13,13,15,13,12,13,15,5,13,8,15,15,14,12,12,15,15,14,13,16,14,14,13,14,11,9,1,2,1,3,3,1,1,3,1,3,2,19,15,4,14,14,17,15,13,1,10,20,1,1,1,1,1,1,1,1,1,1,1,78,20,11,17020269,7250,6900,6750,Mediterranean_Hispanic,144,12,2,106922.0,Unknown,43093395,25000000.0,1.0,52,76,54,1,0,3,185,2,0.6632707065361206,0.7165775401069518,0.6985294117647058,0.1032370387608426,0.0789473684210526,0.0263157894736842,0.0747686921730432,0.2498124531132783,0.1388649684713464,0.0,0.5116279069767438,0.4583333333333332,417,18,7,86,3,8552,25,112,88,12000000,322297.2972972973,50000000.0,9000000.0,900000.0,18000000.0,4,10500000,-0.2,-0.2
197838,Jamie,Vardy,2024,1003,England,Sheffield,England,11-01-87,Centre-Forward,Attack,Right,179.0,30-06-25,Wasserman,https://img.a.transfermarkt.technology/portrait/header/197838-1683031278.jpg?lm=1,GB1,Leicester City Football Club,1000000.0,20000000.0,37,153,163,7,12,12,17,14,7,12,12,5,3,12,17,12,15,17,15,17,15,16,14,13,17,12,13,16,5,16,16,17,12,12,11,16,15,16,13,14,17,14,13,10,1,3,3,3,2,1,2,2,3,2,3,8,16,14,18,15,16,10,7,1,1,1,1,1,1,1,1,1,1,12,10,12,20,72,10,20,347975206,7650,7400,6500,Northern_European,152,26,7,185587.0,Unknown,90008752,476000.0,3.0,32,1366,33,0,1,7,127,3,0.7294257740142895,0.6898395721925134,0.7573529411764706,0.1791973209914572,0.1710526315789473,0.0921052631578947,0.0047511877969492,0.0997749437359339,0.0026167393538709,0.2857142857142857,0.3720930232558141,0.7916666666666665,532,235,86,55,3,4690,16,50,60,1000000,29032.25806451613,20000000.0,6000000.0,,,1,900000,0.0,0.0
197929,Ivan,Provedel,2024,398,Italy,Pordenone,Italy,17-03-94,Goalkeeper,Goalkeeper,Right,194.0,30-06-27,Unknown,https://img.a.transfermarkt.technology/portrait/header/197929-1695160944.jpg?lm=1,IT1,SocietÃ  Sportiva Lazio S.p.A.,14000000.0,14000000.0,30,144,150,3,3,2,2,9,1,1,1,2,1,11,1,3,10,6,13,12,12,13,13,13,16,3,10,7,14,15,15,12,14,12,15,13,12,12,12,15,3,13,4,1,13,13,14,4,15,16,14,17,11,13,13,12,16,10,18,14,17,14,15,20,1,1,1,1,1,1,1,1,1,1,1,1,1,84,8,20,11469091,7200,7200,4500,Mediterranean_Hispanic,143,0,0,35577.0,Unknown,43094150,1875000.0,2.0,52,1168,54,2,1,3,185,5,0.702963747023022,0.4759358288770053,0.6911764705882353,0.0343450749174155,0.0,0.0,0.0697674418604651,0.0697674418604651,0.0103891774771521,0.1428571428571428,0.7209302325581395,0.5,0,0,0,0,0,0,7,42,123,14000000,435937.5,14000000.0,800000.0,75000.0,450000.0,9,2725000,0.0,0.0
198006,Rafa,Soares,2024,3329,Portugal,Marco de Canaveses,Portugal,09-05-95,Left-Back,Defender,Left,177.0,30-06-26,Unknown,https://img.a.transfermarkt.technology/portrait/header/198006-1694780939.png?lm=1,PO1,Futebol Clube de FamalicÃ£o,1200000.0,3500000.0,29,120,135,13,14,9,9,13,13,8,12,11,8,13,11,12,14,10,12,11,13,13,13,13,12,10,13,11,11,10,10,11,12,13,9,12,11,12,11,13,10,13,6,12,3,3,2,3,3,2,1,1,1,3,2,9,10,6,14,12,15,11,12,1,20,1,1,19,1,1,16,1,1,10,1,1,1,71,20,9,1402893,5749,6619,2787,Mediterranean_Hispanic,110,0,0,11352.0,Unknown,55038684,1500000.0,1.0,76,914,79,1,0,3,99,8,0.6260915586133898,0.2927272727272726,0.4485294117647059,0.0109529966483424,0.0,0.0,0.0057514378594648,0.0172543135783946,0.0083057862718408,0.0,0.3255813953488373,0.4583333333333332,323,18,46,38,1,8815,7,23,68,1200000,30434.782608695652,3500000.0,600000.0,500000.0,1000000.0,8,3550000,0.0,-0.2
198008,André,Silva,2024,23826,Portugal,Baguim do Monte,Portugal,06-11-95,Centre-Forward,Attack,Right,185.0,30-06-26,Roc Nation Sports,https://img.a.transfermarkt.technology/portrait/header/198008-1724336978.jpg?lm=1,L1,RasenBallsport Leipzig,6000000.0,45000000.0,29,148,154,7,11,12,16,14,7,14,9,5,6,13,14,8,13,13,17,14,14,15,12,14,12,14,7,17,8,15,15,12,14,13,13,16,13,15,13,14,7,12,6,9,2,3,1,2,2,3,3,1,3,3,1,8,15,10,13,11,16,12,9,1,1,1,1,1,1,1,10,1,9,10,12,9,20,84,13,20,24627377,7050,7050,6750,Mediterranean_Hispanic,146,51,19,79999.0,Unknown,55041694,21333333.33,3.0,76,127,79,0,1,3,162,3,0.6831172267795713,0.7165775401069518,0.713235294117647,0.0772397251080767,0.3355263157894737,0.25,0.0297574393598399,0.2248062015503876,0.1184940322231172,0.2857142857142857,0.5116279069767438,0.4583333333333332,439,149,56,38,0,10018,14,97,373,5000000,138709.67741935485,45000000.0,13000000.0,700000.0,10000000.0,7,24000000,-0.16666666666666666,-0.3333333333333333
198116,Federico,Dimarco,2024,46,Italy,Milano,Italy,10-11-97,Left-Back,Defender,Left,175.0,30-06-27,Roc Nation Sports,https://img.a.transfermarkt.technology/portrait/header/198116-1725531769.jpg?lm=1,IT1,Football Club Internazionale Milano S.p.A.,50000000.0,50000000.0,27,145,154,16,16,11,11,13,15,11,17,7,13,14,13,14,14,12,14,15,13,14,12,13,15,15,10,13,13,15,16,14,14,14,10,14,14,13,11,14,7,13,8,13,4,1,2,1,2,1,1,1,3,3,2,12,14,6,14,12,16,13,13,1,20,19,1,19,1,1,17,1,1,1,1,1,1,75,20,8,13917489,7250,7250,6200,Northern_European,142,4,0,56923.0,Unknown,43143488,4455000.0,2.0,52,952,54,1,0,7,89,8,0.7095792537708389,0.6577540106951871,0.6838235294117647,0.0549571410776481,0.0263157894736842,0.0,0.2498124531132783,0.2498124531132783,0.0247229089696936,0.1428571428571428,0.2790697674418605,0.375,306,28,48,28,0,7538,9,69,117,60000000,2137500.0,60000000.0,1000000.0,1300000.0,3500000.0,7,6400000,0.2,0.2
198516,Harry,Toffolo,2024,703,England,Welwyn Garden City,England,19-08-95,Left-Back,Defender,Left,183.0,30-06-25,Wasserman,https://img.a.transfermarkt.technology/portrait/header/198516-1645696821.jpg?lm=1,GB1,Nottingham Forest Football Club,5000000.0,5000000.0,29,120,130,12,13,11,12,13,14,12,10,10,11,12,7,12,12,11,12,11,12,11,13,13,12,7,9,12,12,13,12,13,12,11,10,14,12,15,11,14,6,9,7,12,1,1,3,1,3,2,2,2,2,1,3,11,10,3,11,11,14,10,11,1,20,1,1,19,1,1,14,1,1,1,1,1,1,71,20,8,1832428,6000,6000,3500,Northern_European,118,0,0,40597.0,Unknown,29079834,2400000.0,1.0,32,1654,33,1,0,7,140,8,0.5441915850754168,0.3689839572192513,0.5073529411764706,0.0391924735927818,0.0,0.0,0.0247561890472618,0.0247561890472618,0.0133059251645879,0.0,0.4651162790697669,0.4583333333333332,385,17,46,38,1,8289,1,3,13,5000000,285294.1176470588,5000000.0,200000.0,,250000.0,4,1850000,0.0,0.0
198709,Cédric,Hountondji,2024,1420,France,Toulouse,Benin,19-01-94,Centre-Back,Defender,Right,194.0,30-06-26,One Team Management,https://img.a.transfermarkt.technology/portrait/header/198709-1625741459.jpg?lm=1,FR1,Angers Sporting Club de l'Ouest,1800000.0,3000000.0,30,124,125,3,5,6,5,8,5,14,7,5,13,12,6,15,10,11,13,13,10,14,7,13,11,6,8,8,14,12,12,13,12,16,17,15,12,13,15,12,12,12,5,8,2,3,3,2,2,1,1,1,2,1,3,12,13,6,10,12,10,15,15,1,1,20,1,1,1,12,1,1,1,1,1,1,1,85,5,20,1993216,6040,6040,3690,African_Caribbean,123,17,0,7363.0,Unknown,85048646,2000000.0,1.0,34,1512,9,1,1,1,18,2,0.5494839904736702,0.3893048128342246,0.5441176470588236,0.0071011493742317,0.1118421052631578,0.0,0.0087521880470117,0.0147536884221055,0.0110836412122558,0.0,0.7209302325581395,0.5,292,6,5,34,1,2196,6,68,267,1500000,51923.07692307692,3000000.0,1000000.0,,1500000.0,7,450000,-0.16666666666666666,-0.16666666666666666
199248,Bryan,Cristante,2024,12,Italy,San Vito al Tagliamento,Italy,03-03-95,Defensive Midfield,Midfield,Right,186.0,30-06-27,GR Sports,https://img.a.transfermarkt.technology/portrait/header/199248-1724827920.jpg?lm=1,IT1,Associazione Sportiva Roma,20000000.0,25000000.0,29,145,150,8,11,12,12,14,8,17,16,8,12,16,12,15,14,6,13,15,16,10,13,15,14,8,14,14,13,19,16,8,9,16,16,17,12,16,15,15,12,11,5,11,1,1,4,3,2,1,1,1,3,1,2,7,15,3,15,14,19,18,18,1,1,15,1,1,1,20,1,20,1,1,10,1,1,82,12,20,50047696,7250,7600,6250,Mediterranean_Hispanic,145,27,2,64038.0,Unknown,43091113,12233333.33,3.0,52,1310,54,3,1,3,29,4,0.755887801005557,0.6631016042780749,0.7058823529411764,0.0618275079253037,0.1776315789473684,0.0263157894736842,0.0997749437359339,0.1247811952988247,0.067937072307564,0.2857142857142857,0.5348837209302322,0.4583333333333332,468,40,28,90,3,8345,13,65,80,12000000,360606.0606060606,25000000.0,8000000.0,3000000.0,3500000.0,6,5500000,-0.4,-0.4
199258,Andrea,Petagna,2024,2919,Italy,Trieste,Italy,30-06-95,Centre-Forward,Attack,Left,190.0,30-06-26,GR Sports,https://img.a.transfermarkt.technology/portrait/header/199258-1660297353.jpg?lm=1,IT1,Associazione Calcio Monza,3800000.0,20000000.0,29,132,145,3,8,12,13,12,6,16,11,4,5,13,14,9,14,13,13,16,12,13,14,12,13,12,11,13,7,18,15,12,11,18,15,15,13,12,18,12,9,10,8,8,1,1,2,1,3,2,3,3,1,4,2,12,14,5,12,10,16,15,14,1,1,1,1,1,1,1,1,1,1,1,1,1,20,85,20,10,2375105,6600,6600,5850,Mediterranean_Hispanic,131,1,0,64038.0,Brianza,43091160,9900000.0,4.0,52,1523,54,0,0,3,28,3,0.6235776660492194,0.6203208556149732,0.6029411764705883,0.0618275079253037,0.006578947368421,0.0,0.018754688672168,0.0997749437359339,0.054973749270813,0.4285714285714285,0.6279069767441858,0.4583333333333332,397,84,40,44,2,7754,18,80,58,2000000,58333.333333333336,20000000.0,3500000.0,800000.0,600000.0,10,10800000,-0.47368421052631576,-0.6923076923076923
199316,Abdülkerim,Bardakc?,2024,141,TÃ¼rkiye,Konya,TÃ¼rkiye,07-09-94,Centre-Back,Defender,Left,185.0,30-06-25,GPA Turkey,https://img.a.transfermarkt.technology/portrait/header/199316-1671036661.png?lm=1,TR1,Galatasaray Spor KulÃ¼bÃ¼,7500000.0,10000000.0,30,120,130,8,10,12,8,12,6,13,9,7,13,13,7,13,12,15,13,14,14,11,12,12,13,10,10,9,12,12,13,12,12,14,13,14,13,12,14,13,10,12,7,9,1,3,3,4,2,2,4,3,1,1,1,11,12,10,12,10,12,10,12,1,14,20,1,1,1,10,1,1,1,1,1,1,1,81,20,10,1291275,6000,6000,4009,Mediterranean_Hispanic,122,0,0,30132.0,Unknown,70062993,9111392.0,2.0,100,744,100,1,0,3,102,2,0.5441915850754168,0.4234224598930481,0.536764705882353,0.0290872889039954,0.0,0.0,0.0372593148287071,0.0497624406101525,0.0505924720131114,0.1428571428571428,0.5116279069767438,0.5,385,34,16,81,1,6971,11,27,27,7500000,217647.0588235294,10000000.0,1500000.0,100000.0,1000000.0,7,3525000,-0.16666666666666666,-0.25
199321,Rubén,Blanco,2024,244,Spain,Mos,Spain,25-07-95,Goalkeeper,Goalkeeper,Right,188.0,30-06-26,Media Base Sports,https://img.a.transfermarkt.technology/portrait/header/199321-1676905860.jpg?lm=1,FR1,Olympique de Marseille,2000000.0,10000000.0,29,135,156,4,3,2,1,11,8,1,3,1,2,13,4,3,7,9,13,12,15,11,7,12,6,7,8,1,15,13,11,13,15,11,14,11,11,13,11,7,5,12,14,15,13,10,14,7,14,12,14,16,14,13,11,11,13,5,13,13,10,12,16,20,1,1,1,1,1,1,1,1,1,1,1,1,1,80,12,20,5343053,6700,6700,5400,Mediterranean_Hispanic,132,0,0,14410.0,Olympique de Marseille,67156610,1500000.0,1.0,89,983,89,2,1,3,144,5,0.6368086795448531,0.5721925133689839,0.6102941176470589,0.0139058542477986,0.0,0.0,0.0097524381095273,0.0497624406101525,0.0083057862718408,0.0,0.581395348837209,0.4583333333333332,0,0,0,0,0,0,13,96,123,1500000,43333.333333333336,10000000.0,2000000.0,300000.0,1000000.0,2,0,-0.25,-0.4
199527,Jacob,Murphy,2024,762,England,London,England,24-02-95,Right Winger,Attack,Right,179.0,30-06-27,Unknown,https://img.a.transfermarkt.technology/portrait/header/199527-1674210561.jpg?lm=1,GB1,Newcastle United Football Club,15000000.0,15000000.0,29,126,132,5,13,14,11,13,13,4,11,5,7,11,5,11,13,9,13,11,11,11,12,6,12,13,6,12,13,11,15,15,14,13,7,13,15,11,10,11,3,7,5,10,4,3,2,2,3,1,3,3,1,1,2,8,11,1,12,11,12,11,15,1,1,1,14,1,20,1,10,1,15,16,1,19,1,74,11,20,4832549,6300,6300,4850,African_Caribbean,111,0,0,40597.0,Unknown,29079830,11300000.0,1.0,32,858,33,0,1,1,137,10,0.5838846255623181,0.5133689839572192,0.4558823529411764,0.0391924735927818,0.0,0.0,0.0747686921730432,0.0747686921730432,0.0627517431039751,0.0,0.3720930232558141,0.4583333333333332,0,0,0,0,0,0,2,21,94,14000000,534615.3846153846,15000000.0,1500000.0,100000.0,200000.0,5,7550000,-0.06666666666666667,-0.06666666666666667
199704,Yunis,Abdelhamid,2024,618,France,Montpellier,Morocco,28-09-87,Centre-Back,Defender,Left,190.0,30-06-25,PSC,https://img.a.transfermarkt.technology/portrait/header/199704-1727723225.jpg?lm=1,FR1,Association sportive de Saint-Ã‰tienne Loire,600000.0,2500000.0,37,131,131,3,10,4,5,12,4,14,6,5,15,12,7,14,8,15,14,16,12,15,9,13,15,8,12,8,14,13,14,11,11,15,16,16,12,15,16,15,12,11,5,5,3,1,2,3,2,2,2,1,2,1,3,9,14,7,13,12,15,13,12,1,1,20,1,1,1,1,1,1,1,1,1,1,1,83,20,5,347975206,6550,6550,3907,North_African__Middle_Eastern,131,10,0,18410.0,Unknown,85122308,9111392.0,2.0,34,978,67,1,0,6,25,2,0.6169621593014025,0.4125133689839572,0.6029411764705883,0.0177683233118354,0.0657894736842105,0.0,0.0027506876719179,0.0122530632658164,0.0505924720131114,0.1428571428571428,0.6279069767441858,0.7916666666666665,461,25,3,58,3,4125,2,4,15,500000,8000.0,2500000.0,1000000.0,,,4,1000000,-0.16666666666666666,-0.2857142857142857
199733,Danilo,Cataldi,2024,430,Italy,Roma,Italy,06-08-94,Defensive Midfield,Midfield,Right,180.0,30-06-25,GR Sports,https://img.a.transfermarkt.technology/portrait/header/199733-1661513736.jpg?lm=1,IT1,Associazione Calcio Fiorentina,5500000.0,10000000.0,30,139,145,14,5,11,13,14,16,4,16,4,12,13,12,14,14,14,14,13,14,13,14,13,16,13,14,13,14,16,14,12,12,12,10,15,13,12,12,13,15,14,10,13,3,2,2,3,3,2,3,2,3,3,2,10,16,6,16,13,16,13,12,1,1,1,1,1,1,20,1,18,1,1,11,1,1,70,14,20,9586470,6950,6700,5000,Mediterranean_Hispanic,139,0,0,49807.0,Unknown,43093936,9111392.0,2.0,52,1244,54,3,1,3,26,4,0.6368086795448531,0.5294117647058822,0.6617647058823528,0.0480858086127266,0.0,0.0,0.0272568142035508,0.0497624406101525,0.0505924720131114,0.1428571428571428,0.3953488372093026,0.5,397,32,21,89,3,10069,16,67,47,4000000,133620.6896551724,10000000.0,2500000.0,300000.0,7000000.0,6,5200000,-0.2727272727272727,-0.5
199953,Caleb,Ekuban,2024,252,Italy,Villafranca di Verona,Ghana,23-03-94,Centre-Forward,Attack,Right,182.0,30-06-26,GB1,https://img.a.transfermarkt.technology/portrait/header/199953-1707213734.jpg?lm=1,IT1,Genoa Cricket and Football Club,1500000.0,7000000.0,30,125,137,5,10,13,12,12,5,13,8,3,5,13,12,6,13,14,10,10,12,12,12,11,11,10,10,12,7,14,13,15,14,13,13,15,15,13,14,11,6,12,9,14,3,2,2,1,3,1,3,3,1,4,2,11,12,3,8,6,15,15,7,1,1,1,1,1,1,1,1,1,1,11,16,15,20,82,10,20,2709567,6250,6000,5200,African_Caribbean,122,13,3,29230.0,Unknown,43068478,1386666.667,3.0,52,1599,41,0,1,1,104,3,0.5441915850754168,0.5508021390374331,0.536764705882353,0.0282163021300551,0.0855263157894736,0.0394736842105263,0.0072518129532383,0.0347586896724181,0.0076761391538653,0.2857142857142857,0.4418604651162785,0.5,393,81,40,28,0,5599,23,123,152,1500000,48333.333333333336,7000000.0,2000000.0,,200000.0,8,2875000,0.0,0.5
199976,Marco,Sportiello,2024,5,Italy,Desio,Italy,10-05-92,Goalkeeper,Goalkeeper,Right,192.0,30-06-27,GR Sports,https://img.a.transfermarkt.technology/portrait/header/199976-1661351013.jpg?lm=1,IT1,Associazione Calcio Milan,1500000.0,10000000.0,32,130,140,5,2,3,2,8,7,5,1,1,3,7,5,3,8,10,14,12,14,12,8,12,13,3,13,5,13,13,13,10,14,13,15,13,10,14,13,13,5,14,5,13,14,15,13,8,13,13,15,15,14,13,12,11,15,5,12,12,13,11,10,20,1,1,1,1,1,1,1,1,1,1,1,1,1,87,7,20,2245552,6450,6450,5000,Mediterranean_Hispanic,130,0,0,21346.0,Unknown,43058979,9111392.0,2.0,52,411,54,2,1,3,27,5,0.6037311458057687,0.5294117647058822,0.5955882352941175,0.0206033756048385,0.0,0.0,0.0072518129532383,0.0497624406101525,0.0505924720131114,0.1428571428571428,0.6744186046511627,0.5833333333333333,0,0,0,0,0,0,11,37,89,1500000,39062.5,10000000.0,2000000.0,,350000.0,6,4650000,0.0,0.0
200056,Elseid,Hysaj,2024,398,Albania,ShkodÃ«r,Albania,02-02-94,Right-Back,Defender,Right,182.0,30-06-26,Unknown,https://img.a.transfermarkt.technology/portrait/header/200056-1661350737.jpg?lm=1,IT1,SocietÃ  Sportiva Lazio S.p.A.,2500000.0,25000000.0,30,136,145,8,12,12,8,12,8,11,8,9,13,12,8,14,12,13,15,14,10,10,12,10,13,8,12,15,13,15,14,14,14,14,11,16,15,17,13,11,6,13,6,15,3,2,2,2,2,3,3,1,3,3,3,15,14,7,13,12,14,13,13,1,16,10,20,15,15,1,9,1,10,1,1,1,1,70,11,20,7103724,6800,7450,5746,Mediterranean_Hispanic,133,71,2,71154.0,Unknown,43083951,2525000.0,2.0,0,1368,0,1,1,3,185,11,0.7360412807621064,0.6091978609625668,0.6176470588235294,0.0686988403902252,0.4671052631578947,0.0263157894736842,0.0122530632658164,0.1247811952988247,0.0140003888996916,0.1428571428571428,0.4418604651162785,0.5,478,5,16,57,4,7034,14,34,26,2000000,59090.90909090909,25000000.0,5000000.0,900000.0,3800000.0,2,6000000,-0.2,-0.5
201737,Christopher,Jullien,2024,969,France,Lagny-sur-Marne,France,22-03-93,Centre-Back,Defender,Right,196.0,30-06-25,Classico,https://img.a.transfermarkt.technology/portrait/header/201737-1702665335.JPG?lm=1,FR1,Montpellier HÃ©rault Sport Club,2500000.0,6500000.0,31,125,135,4,7,6,11,10,4,14,7,10,15,12,5,12,10,14,13,14,11,11,10,11,11,5,14,6,12,14,12,13,12,13,17,15,14,14,13,14,12,13,10,10,1,3,1,2,3,3,1,3,1,2,1,7,14,10,12,7,10,14,14,1,1,20,1,1,1,1,1,1,1,1,1,1,1,88,8,20,2454812,6250,6250,4500,Mixed_Race,123,0,0,14999.0,Unknown,85051582,3933333.333,3.0,34,788,36,1,1,4,133,2,0.5772691188145012,0.4759358288770053,0.5441176470588236,0.014474602817478,0.0,0.0,0.0122530632658164,0.032258064516129,0.021824680313342,0.2857142857142857,0.7674418604651163,0.5416666666666665,336,37,19,59,2,4384,9,112,366,2000000,66666.66666666667,6500000.0,1300000.0,,800000.0,6,3450000,-0.2,-0.3333333333333333
202228,Milos,Veljkovic,2024,86,Switzerland,Basel,Serbia,26-09-95,Centre-Back,Defender,Right,188.0,30-06-25,LIAN Sports Group,https://img.a.transfermarkt.technology/portrait/header/202228-1694527030.jpg?lm=1,L1,Sportverein Werder Bremen von 1899,4500000.0,12000000.0,29,130,137,5,7,8,6,12,6,11,7,8,14,12,7,13,11,7,15,12,15,16,9,14,12,6,11,6,16,17,10,10,10,13,14,11,12,13,14,16,6,15,9,14,3,2,1,3,2,2,3,2,1,1,2,16,16,10,8,14,13,15,18,1,1,20,1,1,1,16,1,14,1,1,1,1,1,85,10,20,4111059,6500,6500,5000,Northern_European,128,20,0,21924.0,Unknown,28070894,330000.0,1.0,92,152,85,1,1,7,194,2,0.6103466525535857,0.5294117647058822,0.5808823529411764,0.0211615023845918,0.131578947368421,0.0,0.0222555638909727,0.0597649412353088,0.0018056057112697,0.0,0.581395348837209,0.4583333333333332,311,9,14,36,0,6015,32,106,88,4500000,170000.0,12000000.0,2000000.0,,500000.0,1,250000,0.0,0.0
202278,Flavien,Tait,2024,152,France,Longjumeau,France,02-02-93,Central Midfield,Midfield,Right,176.0,30-06-26,Unknown,https://img.a.transfermarkt.technology/portrait/header/202278-1727718933.png?lm=1,TR1,Samsunspor,1000000.0,9000000.0,31,133,135,11,12,13,9,13,10,7,13,5,10,15,10,10,13,7,13,14,13,14,15,13,13,12,10,14,13,14,14,13,14,13,8,14,13,15,12,12,9,11,10,14,3,2,1,2,1,3,2,3,3,1,3,12,12,7,14,12,14,8,13,1,1,1,1,1,1,1,12,18,10,20,14,14,1,70,9,20,7999608,6650,6650,3809,Northern_European,132,0,0,27598.0,Unknown,85121618,4650000.0,2.0,34,861,36,3,1,7,180,1,0.6301931727970362,0.4020320855614973,0.6102941176470589,0.026640414751928,0.0,0.0,0.0047511877969492,0.0447611902975743,0.0258062723964554,0.1428571428571428,0.3023255813953489,0.5416666666666665,335,33,46,27,1,4642,9,26,47,900000,26666.666666666668,9000000.0,2000000.0,,250000.0,3,3900001,-0.55,-0.7
202591,Benjamin,Henrichs,2024,23826,Germany,Bocholt,Germany,23-02-97,Right-Back,Defender,Right,185.0,30-06-28,CN Sports,https://img.a.transfermarkt.technology/portrait/header/202591-1715858341.jpg?lm=1,L1,RasenBallsport Leipzig,20000000.0,20000000.0,27,134,141,7,13,13,7,13,9,11,9,13,12,14,11,13,14,11,12,12,13,12,12,12,14,11,10,14,11,14,14,13,14,14,12,12,14,15,14,12,8,14,10,18,1,3,3,3,3,3,3,1,1,2,3,12,14,8,14,14,15,13,13,1,17,11,20,12,14,14,10,14,12,8,8,10,1,79,12,20,7814751,6700,6700,5250,Mixed_Race,134,7,0,47944.0,Unknown,91132680,17500000.0,2.0,38,210,40,1,1,4,162,11,0.6368086795448531,0.5561497326203209,0.625,0.0462868636461514,0.0460526315789473,0.0,0.0997749437359339,0.0997749437359339,0.0971971443651212,0.1428571428571428,0.5116279069767438,0.375,393,29,48,67,1,9961,15,67,192,17000000,648076.9230769231,20000000.0,5000000.0,250000.0,12000000.0,2,4000000,-0.15,-0.15
202788,Robin,Pröpper,2024,124,Netherlands,Arnhem,Netherlands,23-09-93,Centre-Back,Defender,Right,190.0,Unknown,V4S,https://img.a.transfermarkt.technology/portrait/header/202788-1629789110.jpg?lm=1,SC1,Rangers Football Club,3000000.0,3000000.0,31,122,123,9,7,12,8,11,10,15,11,10,13,12,8,12,9,15,11,12,13,11,10,12,12,5,16,10,13,12,14,11,12,12,13,13,12,13,12,13,10,13,10,12,4,2,2,1,3,1,1,3,4,1,1,13,11,4,13,14,14,10,6,1,1,20,10,1,1,12,1,1,1,1,1,1,1,80,12,20,3737520,5999,5999,4499,Northern_European,121,0,0,2199.0,Unknown,168288,9111392.0,2.0,67,91,68,1,1,7,161,2,0.5440592749404605,0.4758288770053475,0.5294117647058822,0.0021147018125601,0.0,0.0,0.0147536884221055,0.0147536884221055,0.0505924720131114,0.1428571428571428,0.6279069767441858,0.5416666666666665,414,32,17,82,2,7629,10,50,288,2500000,84482.75862068965,3000000.0,500000.0,50000.0,150000.0,3,750000,-0.16666666666666666,0.0
202886,Ruben,Loftus-Cheek,2024,5,England,London,England,23-01-96,Central Midfield,Midfield,Right,191.0,30-06-27,CAA Stellar,https://img.a.transfermarkt.technology/portrait/header/202886-1692879593.jpg?lm=1,IT1,Associazione Calcio Milan,25000000.0,30000000.0,28,148,162,7,10,14,13,15,5,12,10,5,9,15,10,10,15,14,14,12,17,11,14,15,13,11,12,15,14,15,14,15,11,16,14,13,14,11,16,11,10,13,14,11,3,3,4,1,1,3,1,3,4,3,3,15,15,3,13,14,15,15,16,1,1,1,1,1,10,15,10,20,10,10,19,12,11,86,13,20,37685715,7400,6700,6500,African_Caribbean,145,10,0,173988.0,Unknown,28068727,18500000.0,1.0,32,858,33,3,1,1,27,1,0.6368086795448531,0.6898395721925134,0.7058823529411764,0.1679971263230163,0.0657894736842105,0.0,0.1247811952988247,0.1497874468617154,0.1027528542459512,0.0,0.6511627906976742,0.4166666666666665,336,29,30,22,0,10866,22,128,281,20000000,763461.5384615385,30000000.0,6000000.0,,5000000.0,6,8350000,-0.2,-0.2
203026,Danny,Ward,2024,1003,Wales,Wrexham,Wales,22-06-93,Goalkeeper,Goalkeeper,Right,191.0,30-06-25,CAA Stellar,https://img.a.transfermarkt.technology/portrait/header/203026-1668070552.jpg?lm=1,GB1,Leicester City Football Club,1800000.0,10000000.0,31,129,145,3,3,1,1,10,7,1,3,1,1,11,2,1,10,12,13,13,13,13,10,12,14,1,10,1,12,12,11,12,12,12,12,13,11,13,13,13,14,16,8,13,13,14,13,6,14,13,11,13,13,9,13,10,13,8,14,15,16,12,16,20,1,1,1,1,1,1,1,1,1,1,1,1,1,88,8,20,5131270,6450,6850,5000,Northern_European,125,26,0,40597.0,Unknown,29058892,7062500.0,2.0,109,1676,106,2,1,7,127,5,0.6566551997883038,0.5294117647058822,0.5588235294117647,0.0391924735927818,0.1710526315789473,0.0,0.0087521880470117,0.0497624406101525,0.0392094224839578,0.1428571428571428,0.6511627906976742,0.5416666666666665,0,0,0,0,0,0,3,33,78,1500000,46296.2962962963,10000000.0,2000000.0,,,5,9250000,-0.16666666666666666,-0.5714285714285714
203074,Ivan,Petryak,2024,6992,Ukraine,"Smila, Cherkasy Oblast",Ukraine,13-03-94,Left Winger,Attack,Right,171.0,30-06-25,ProStar,https://img.a.transfermarkt.technology/portrait/header/203074-1690180116.png?lm=1,UKR1,ZAO FK Chornomorets Odessa,500000.0,2000000.0,30,120,125,12,12,13,11,13,12,6,11,7,6,13,9,9,13,15,10,6,11,10,12,9,16,12,9,12,12,15,12,14,14,9,6,13,14,12,7,9,7,9,11,13,1,2,2,4,3,4,4,2,1,1,2,14,12,7,5,8,14,13,8,1,1,1,4,1,5,1,14,4,13,20,10,17,10,63,15,20,1661402,5750,5750,3500,Northern_European,119,5,0,4941.0,Unknown,71049139,1350000.0,2.0,103,1385,101,0,1,7,224,7,0.5111140513363324,0.3689839572192513,0.5147058823529411,0.0047624243559574,0.0328947368421052,0.0,0.0022505626406601,0.0097524381095273,0.0074724297897163,0.1428571428571428,0.1860465116279068,0.5,325,48,56,40,1,7789,3,47,364,400000,4166.666666666667,2000000.0,500000.0,,400000.0,6,800000,-0.3333333333333333,-0.5
203348,Chancel,Mbemba,2024,244,Zaire,Kinshasa,DR Congo,08-08-94,Centre-Back,Defender,Right,182.0,30-06-25,Unknown,https://img.a.transfermarkt.technology/portrait/header/203348-1666814922.jpg?lm=1,FR1,Olympique de Marseille,8000000.0,20000000.0,30,142,145,4,9,11,6,12,4,15,10,4,15,12,7,13,12,11,14,16,11,14,11,13,15,10,13,11,12,16,16,15,13,16,13,14,15,15,14,14,8,16,13,14,1,3,1,3,2,1,2,3,2,1,2,14,14,5,9,17,16,13,16,1,10,20,15,1,13,13,1,1,1,1,1,1,1,80,12,20,21552434,7100,7100,5650,African_Caribbean,142,66,4,52999.0,Unknown,18057323,8330000.0,2.0,111,729,29,1,1,1,144,2,0.6897327335273882,0.5989304812834224,0.6838235294117647,0.051168058925828,0.4342105263157894,0.0526315789473684,0.0397599399849962,0.0997749437359339,0.0462512847579099,0.1428571428571428,0.4418604651162785,0.5,371,32,6,41,2,10320,9,32,62,5000000,140625.0,20000000.0,7000000.0,,8000000.0,3,3500000,-0.6666666666666666,-0.6666666666666666
203357,Ryan,Thomas,2024,1269,New Zealand,Te Puke,New Zealand,20-12-94,Central Midfield,Midfield,Right,174.0,30-06-25,Unknown,https://img.a.transfermarkt.technology/portrait/header/203357-1724750728.jpg?lm=1,NL1,Prins Hendrik Ende Desespereert Nimmer Combinatie Zwolle,900000.0,3000000.0,30,129,135,11,11,14,6,14,8,10,10,7,7,15,13,5,16,10,14,8,13,12,12,13,15,9,8,16,11,14,16,13,15,13,9,9,13,14,9,12,7,7,18,19,1,1,1,4,3,2,3,3,1,3,2,16,12,4,10,11,9,13,13,1,1,1,12,1,12,14,12,17,13,12,20,12,13,64,10,20,-1,6450,5801,5000,Northern_European,128,19,3,32655.0,Unknown,37047951,2750000.0,1.0,68,1475,69,3,1,7,156,1,0.5178618682191056,0.5294117647058822,0.5808823529411764,0.0315235412661366,0.125,0.0394736842105263,0.0042510627656914,0.0147536884221055,0.0152504236228784,0.0,0.2558139534883721,0.5,246,20,38,23,1,7214,17,141,446,600000,19166.666666666668,3000000.0,700000.0,150000.0,1500000.0,4,1350000,-0.3333333333333333,-0.4
203394,Andreas,Pereira,2024,931,Belgium,Duffel,Brazil,01-01-96,Attacking Midfield,Midfield,Right,178.0,30-06-26,Bertolucci Sports,https://img.a.transfermarkt.technology/portrait/header/203394-1659355525.jpg?lm=1,GB1,Fulham Football Club,20000000.0,20000000.0,28,138,145,15,13,14,12,15,14,6,15,2,8,15,14,13,15,13,11,11,11,10,15,10,18,15,10,13,12,14,16,14,14,10,7,16,14,13,7,11,6,14,3,12,3,3,2,3,4,2,4,4,1,3,2,11,17,10,13,9,15,10,14,1,1,1,1,1,1,1,14,20,13,16,18,15,1,71,14,20,14418146,6500,6500,6000,Mediterranean_Hispanic,134,1,0,57996.0,Unknown,28085588,4825000.0,2.0,7,435,11,3,1,3,95,0,0.6103466525535857,0.6363636363636364,0.625,0.055993248404076,0.006578947368421,0.0,0.0997749437359339,0.0997749437359339,0.0267785216256007,0.1428571428571428,0.3488372093023257,0.4166666666666665,387,40,46,78,1,9248,5,20,43,20000000,696428.5714285715,20000000.0,4000000.0,,3000000.0,7,11500000,0.0,0.0
203412,Andreas,Cornelius,2024,190,Denmark,Copenhagen,Denmark,16-03-93,Centre-Forward,Attack,Left,193.0,30-06-27,Players Promotion ,https://img.a.transfermarkt.technology/portrait/header/203412-1668183778.jpg?lm=1,DK1,Football Club KÃ¸benhavn,1000000.0,12000000.0,31,132,150,6,7,12,14,12,7,15,12,5,5,12,10,7,12,13,14,14,13,12,12,12,14,8,9,12,6,15,16,11,10,16,17,16,13,14,18,11,15,13,15,6,1,1,2,1,3,3,3,1,1,2,3,7,13,6,14,12,12,7,11,1,1,1,1,1,1,1,1,1,1,1,1,1,20,91,20,11,6142255,6650,6750,5000,Northern_European,130,41,9,30920.0,Unknown,27024589,6286666.667,6.0,28,382,30,0,0,7,90,3,0.6434241862926701,0.5294117647058822,0.5955882352941175,0.0298481953096106,0.2697368421052631,0.1184210526315789,0.0047511877969492,0.0597649412353088,0.0348991175699325,0.7142857142857142,0.6976744186046511,0.5416666666666665,417,110,39,49,1,11186,23,121,133,900000,20000.0,12000000.0,3500000.0,,4500000.0,7,9500000,-0.1,-0.4
203460,Jack,Grealish,2024,281,England,Birmingham,England,10-09-95,Left Winger,Attack,Right,180.0,30-06-27,CAA Stellar,https://img.a.transfermarkt.technology/portrait/header/203460-1676499047.jpg?lm=1,GB1,Manchester City Football Club,55000000.0,100000000.0,29,166,175,13,16,17,14,15,11,11,13,3,6,14,12,9,16,11,13,14,14,11,16,13,14,16,12,13,11,14,15,15,15,14,7,15,15,14,14,14,13,14,12,9,3,1,1,1,3,2,2,4,3,1,1,12,16,12,15,16,13,6,10,1,1,1,1,1,1,1,18,14,16,20,20,16,12,82,15,20,288514966,8350,7900,7500,Northern_European,158,23,1,313178.0,Unknown,28067800,9111392.0,2.0,32,199,33,0,1,7,131,7,0.7955808414924583,0.7967914438502673,0.8014705882352942,0.3024013935788383,0.1513157894736842,0.0131578947368421,0.274818704676169,0.4998749687421855,0.0505924720131114,0.1428571428571428,0.3953488372093026,0.4583333333333332,444,59,80,63,0,11252,13,95,84,45000000,1546551.7241379311,100000000.0,20000000.0,250000.0,4500000.0,3,35850000,-0.25,-0.35714285714285715
203507,Adrien,Hunou,2024,1420,France,Ã‰vry,France,19-01-94,Centre-Forward,Attack,Right,179.0,30-06-25,Unknown,https://img.a.transfermarkt.technology/portrait/header/203507-1630778579.png?lm=1,FR1,Angers Sporting Club de l'Ouest,700000.0,6000000.0,30,127,134,8,11,12,14,13,11,14,11,6,8,13,10,10,14,10,17,13,11,12,14,12,14,14,10,12,12,13,14,13,14,12,11,12,13,13,12,11,12,12,11,13,3,1,3,2,1,2,2,2,3,2,1,16,12,7,14,13,14,15,15,1,1,1,1,1,1,1,8,10,12,12,18,14,20,70,8,20,3914500,6348,6348,4098,Northern_European,127,0,0,12329.0,Unknown,85103859,2385000.0,2.0,34,1724,36,0,1,7,18,3,0.5902355120402223,0.4329411764705882,0.5735294117647058,0.0118964047172334,0.0,0.0,0.0032508127031757,0.0297574393598399,0.0132225895163754,0.1428571428571428,0.3720930232558141,0.5,338,69,15,16,0,5750,1,14,100,500000,12068.965517241379,6000000.0,1500000.0,,600000.0,4,1150000,-0.2857142857142857,-0.5
203746,Ruben,Aguilar,2024,826,France,Grenoble,France,26-04-93,Right-Back,Defender,Right,172.0,30-06-26,One Team Football ,https://img.a.transfermarkt.technology/portrait/header/203746-1614090581.jpg?lm=1,FR1,Racing Club de Lens,5000000.0,12000000.0,31,134,141,6,14,13,7,13,7,9,8,12,12,13,8,13,13,14,14,15,14,13,12,13,16,10,8,14,12,15,15,14,13,14,7,16,14,16,12,14,12,13,10,11,2,4,3,1,1,1,3,3,2,2,2,15,14,6,14,13,15,12,10,1,12,1,20,10,15,1,1,1,13,1,1,1,1,71,10,20,10130269,6700,6700,4750,Mediterranean_Hispanic,133,1,0,28013.0,Unknown,85046582,5750000.0,2.0,34,562,36,1,1,3,158,11,0.6368086795448531,0.5026737967914437,0.6176470588235294,0.0270411459173219,0.006578947368421,0.0,0.0247561890472618,0.0597649412353088,0.0319175532653684,0.1428571428571428,0.2093023255813952,0.5416666666666665,326,6,26,45,3,4329,13,40,89,4000000,138461.53846153847,12000000.0,3000000.0,,,3,2600000,-0.2,-0.3333333333333333
203853,Oleksandr,Zinchenko,2024,11,Ukraine,"Radomyshl, Zhytomyr Oblast",Ukraine,15-12-96,Left-Back,Defender,Left,175.0,30-06-26,UniqueFA,https://img.a.transfermarkt.technology/portrait/header/203853-1688658681.jpg?lm=1,GB1,Arsenal Football Club,35000000.0,42000000.0,28,156,160,12,12,13,10,13,13,12,12,9,11,13,9,12,14,13,15,15,16,14,14,14,18,13,9,15,11,16,16,13,13,14,10,13,14,15,10,14,11,14,8,18,3,3,2,3,3,3,4,3,2,1,2,18,15,3,13,14,13,13,13,1,20,1,8,19,8,15,15,16,16,15,16,16,7,61,20,12,219941228,7800,7800,6750,Northern_European,140,52,8,139190.0,Unknown,71081391,18625000.0,2.0,103,1202,101,1,0,7,21,8,0.7823498279968246,0.7165775401069518,0.6691176470588234,0.1343955767004278,0.3421052631578947,0.1052631578947368,0.1747936984246061,0.2098024506126531,0.103447317981055,0.1428571428571428,0.2790697674418605,0.4166666666666665,274,7,35,20,0,7847,31,131,104,30000000,973333.3333333334,42000000.0,6000000.0,650000.0,4500000.0,4,7500000,-0.21052631578947367,-0.2857142857142857
203938,Branco,Van Den Boomen,2024,610,Netherlands,Veldhoven,Netherlands,21-07-95,Central Midfield,Midfield,Right,188.0,30-06-27,Forza Sports Group,https://img.a.transfermarkt.technology/portrait/header/203938-1682946572.jpg?lm=1,NL1,AFC Ajax Amsterdam,6000000.0,12000000.0,29,127,130,16,12,10,12,14,16,9,14,4,10,15,15,11,14,14,12,15,13,13,14,14,17,12,12,13,12,15,13,12,12,12,14,15,11,13,12,14,8,12,5,9,2,1,2,2,1,2,3,2,3,3,2,11,15,8,7,9,15,8,12,1,1,1,1,1,1,14,1,20,1,1,15,1,1,75,7,20,2818248,6350,6350,3751,Northern_European,129,0,0,12137.0,Unknown,37039831,337500.0,2.0,67,1568,68,3,1,7,6,1,0.590500132310135,0.3958288770053475,0.588235294117647,0.0117110062021597,0.0,0.0,0.0297574393598399,0.0597649412353088,0.0018472735353759,0.1428571428571428,0.581395348837209,0.4583333333333332,403,63,89,57,1,6685,4,25,99,6000000,185156.25,12000000.0,3000000.0,75000.0,750000.0,7,3775000,0.0,-0.3333333333333333
204069,Milan,Skriniar,2024,583,Slovakia,Å½iar nad Hronom,Slovakia,11-02-95,Centre-Back,Defender,Right,188.0,30-06-28,Unknown,https://img.a.transfermarkt.technology/portrait/header/204069-1598256813.jpg?lm=1,FR1,Paris Saint-Germain Football Club,20000000.0,65000000.0,29,161,168,4,7,9,10,10,4,17,6,11,18,12,10,17,11,17,16,17,12,13,9,13,18,6,14,10,14,16,16,14,11,16,16,18,15,16,18,15,12,14,3,11,1,3,1,2,3,3,2,4,4,1,2,14,16,5,16,14,19,12,11,1,5,20,12,1,1,10,1,5,1,1,1,1,1,82,9,20,48719002,8050,8050,7750,Northern_European,159,54,3,106922.0,Unknown,63013145,19600000.0,2.0,86,1728,86,1,1,7,154,2,0.8154273617359089,0.8235294117647058,0.8088235294117647,0.1032370387608426,0.3552631578947368,0.0394736842105263,0.0997749437359339,0.3248312078019504,0.1088641351148642,0.1428571428571428,0.581395348837209,0.4583333333333332,428,25,8,60,2,8848,7,51,84,15000000,415277.77777777775,65000000.0,12000000.0,75000.0,600000.0,5,13025000,-0.5,-0.6666666666666666
204103,Adama,Traoré,2024,931,Spain,L'Hospitalet de Llobregat,Spain,25-01-96,Right Winger,Attack,Right,178.0,30-06-25,Gestifute,https://img.a.transfermarkt.technology/portrait/header/204103-1685622835.jpg?lm=1,GB1,Fulham Football Club,9000000.0,40000000.0,28,146,154,7,13,18,10,12,8,10,13,7,7,11,9,7,12,12,9,11,10,8,10,6,14,18,5,9,10,9,10,20,15,15,14,12,20,10,17,9,11,10,6,11,2,3,2,2,1,1,1,2,1,1,4,11,14,11,10,12,11,10,11,1,1,1,1,1,13,1,16,1,18,16,10,20,13,72,10,20,39437190,7300,7450,6250,African_Caribbean,136,9,0,49876.0,Unknown,67174729,12750000.0,3.0,89,779,89,0,1,1,95,10,0.7360412807621064,0.6631016042780749,0.6397058823529411,0.0481524362040812,0.0592105263157894,0.0,0.0447611902975743,0.1997999499874969,0.0708075224311786,0.2857142857142857,0.3488372093023257,0.4166666666666665,418,35,64,38,3,6591,14,60,92,10000000,326666.6666666667,40000000.0,8000000.0,5000000.0,7000000.0,7,25000000,0.1111111111111111,0.1111111111111111
204176,Taylan,Antalyal?,2024,44006,TÃ¼rkiye,Mugla,TÃ¼rkiye,08-01-95,Central Midfield,Midfield,Right,180.0,30-06-25,GPA Turkey,https://img.a.transfermarkt.technology/portrait/header/204176-1695411521.png?lm=1,TR1,Bodrumspor Spor Faaliyetleri Anonim ?irketi,1600000.0,6000000.0,29,120,130,11,11,10,9,13,10,8,10,5,9,13,12,12,13,12,13,13,13,13,12,12,14,12,8,11,10,15,15,12,12,13,9,14,12,15,12,14,8,10,7,14,1,2,3,3,1,3,2,3,1,2,1,15,12,7,16,14,17,14,14,1,1,5,1,1,1,18,1,20,1,1,12,1,10,75,12,20,1590182,6050,6050,4100,Mediterranean_Hispanic,120,9,0,7089.0,MKE AnkaragÃ¼cÃ¼,70075966,500000.0,1.0,100,990,100,3,1,3,39,1,0.5508070918232336,0.4331550802139037,0.5220588235294117,0.0068365702433452,0.0592105263157894,0.0,0.0077519379844961,0.0297574393598399,0.0027500763910108,0.0,0.3953488372093026,0.4583333333333332,338,21,28,47,1,5359,15,40,69,1200000,32857.142857142855,6000000.0,900001.0,200000.0,700000.0,6,1400000,-0.25,-0.25
204189,Okan,Kocuk,2024,152,TÃ¼rkiye,Bursa,TÃ¼rkiye,27-07-95,Goalkeeper,Goalkeeper,Right,187.0,30-06-26,FutureBall,https://img.a.transfermarkt.technology/portrait/header/204189-1727715476.png?lm=1,TR1,Samsunspor,1500000.0,1500000.0,29,120,130,3,1,1,2,12,7,8,3,1,3,13,2,2,12,8,12,9,12,14,10,12,12,6,8,4,13,9,10,11,14,11,14,13,11,10,11,12,12,12,10,15,11,10,10,4,13,16,15,15,12,5,11,8,13,7,10,9,14,14,12,20,1,1,1,1,1,1,1,1,1,1,1,1,1,75,10,20,1330405,6000,6000,4000,Northern_European,121,0,0,4692.0,Unknown,70063195,9111392.0,2.0,100,280,100,2,1,7,180,5,0.5441915850754168,0.4224598930481283,0.5294117647058822,0.0045219856567211,0.0,0.0,0.0072518129532383,0.0072518129532383,0.0505924720131114,0.1428571428571428,0.5581395348837206,0.4583333333333332,0,0,0,0,0,0,3,14,71,1700000,48529.41176470588,1700000.0,300000.0,50000.0,400000.0,9,1050000,0.7,1.125
204201,Emre,Ta?Demir,2024,2832,TÃ¼rkiye,Ankara,TÃ¼rkiye,08-08-95,Left-Back,Defender,Left,176.0,30-06-25,MAC Management,https://img.a.transfermarkt.technology/portrait/header/204201-1725459574.jpg?lm=1,TR1,Gaziantep Futbol KulÃ¼bÃ¼ A.?.,150000.0,3000000.0,29,95,-75,11,12,13,10,13,11,6,12,4,2,14,9,2,15,7,8,7,11,9,14,11,14,16,6,8,3,13,12,13,14,11,6,14,12,8,6,12,6,12,9,12,1,3,3,1,2,1,3,3,2,3,1,16,12,3,12,13,11,11,17,1,1,1,1,1,1,10,14,20,14,14,18,14,10,67,20,8,21720000,4999,5243,3246,Mediterranean_Hispanic,86,0,0,6139.0,Unknown,70121920,700000.0,1.0,100,71,100,1,0,3,103,8,0.4440328129134692,0.3418181818181818,0.2720588235294117,0.0059192338406364,0.0,0.0,0.0005001250312578,0.0147536884221055,0.0038612183671768,0.0,0.3023255813953489,0.4583333333333332,191,13,21,21,0,7574,35,195,214,150000,2941.176470588235,3000000.0,750000.0,175000.0,3000000.0,9,1625000,0.2,0.2
205006,Rick,Karsdorp,2024,383,Netherlands,Schoonhoven,Netherlands,11-02-95,Right-Back,Defender,Right,184.0,30-06-25,SEG,https://img.a.transfermarkt.technology/portrait/header/205006-1630497867.jpg?lm=1,NL1,Eindhovense Voetbalvereniging Philips Sport Vereniging,5000000.0,15000000.0,29,142,147,6,11,11,5,14,6,8,6,15,11,14,5,12,13,15,14,15,15,14,13,12,17,11,7,17,11,13,16,14,13,14,9,18,18,17,12,15,11,12,7,13,2,3,2,3,1,3,3,3,1,2,2,10,14,11,12,11,15,14,10,1,1,10,20,1,18,1,1,1,14,1,1,1,1,80,8,20,33809621,7100,6500,5750,Northern_European,134,3,0,78269.0,Unknown,37039938,16000000.0,1.0,67,1351,68,1,1,7,62,11,0.6103466525535857,0.6096256684491979,0.625,0.0755692072378807,0.0197368421052631,0.0,0.0247561890472618,0.0747686921730432,0.0888635795438762,0.0,0.4883720930232553,0.4583333333333332,356,12,42,34,2,9863,24,143,204,5000000,170689.6551724138,15000000.0,4000000.0,,3500000.0,4,200000,0.0,-0.2857142857142857
205562,Thomas,Lemar,2024,13,Guadeloupe,Baie-Mahault,France,12-11-95,Attacking Midfield,Midfield,Left,171.0,30-06-27,Kemari,https://img.a.transfermarkt.technology/portrait/header/205562-1686662075.jpg?lm=1,ES1,Club AtlÃ©tico de Madrid S.A.D.,10000000.0,70000000.0,29,149,165,16,15,15,12,15,16,6,13,2,7,16,14,6,16,9,12,10,13,12,15,12,15,16,10,14,8,14,15,15,16,11,7,13,14,13,9,13,5,15,12,16,3,2,1,1,1,3,3,2,3,2,3,19,15,3,16,15,16,18,16,1,10,1,1,18,1,1,19,17,13,20,18,14,1,58,20,8,11379621,7300,7450,6750,Mixed_Race,141,27,4,124516.0,Unknown,85093001,38000000.0,2.0,41,129,36,3,0,4,52,0,0.7360412807621064,0.7165775401069518,0.6764705882352942,0.1202261089390087,0.1776315789473684,0.0526315789473684,0.0497624406101525,0.3498374593648412,0.2110891969221367,0.1428571428571428,0.1860465116279068,0.4583333333333332,400,37,58,25,0,7938,24,151,244,5000000,131081.0810810811,70000000.0,10000000.0,750000.0,14000000.0,2,7750000,-0.5,-0.5833333333333334
205760,Alexander,Jeremejeff,2024,265,Sweden,Kungsbacka,Sweden,12-10-93,Centre-Forward,Attack,Right,192.0,31-12-25,TIAgency,https://img.a.transfermarkt.technology/portrait/header/205760-1490190967.jpg?lm=1,GR1,Panathinaikos Athlitikos Omilos,1500000.0,2200000.0,31,126,128,7,10,11,15,13,8,14,10,7,7,14,16,7,12,12,14,12,14,14,12,15,13,11,9,12,8,11,12,11,8,15,14,10,12,13,15,14,10,14,6,7,2,3,2,2,3,2,2,1,3,3,2,7,13,5,11,13,14,11,9,1,1,1,1,1,1,1,1,1,1,1,1,1,20,75,11,20,1549928,6300,5900,3500,Northern_European,126,1,0,3261.0,Unknown,93038087,542500.0,4.0,91,770,91,0,1,7,150,3,0.530960571579783,0.3689839572192513,0.5661764705882353,0.0031401873490619,0.006578947368421,0.0,0.0072518129532383,0.010752688172043,0.0029861940609461,0.4285714285714285,0.6744186046511627,0.5416666666666665,346,131,54,36,2,10583,6,10,31,1300000,46428.57142857143,2200000.0,500000.0,0.0,75000.0,8,1425000,-0.13333333333333333,0.08333333333333333
205927,Dominik,Livakovic,2024,36,Croatia,Zadar,Croatia,09-01-95,Goalkeeper,Goalkeeper,Right,188.0,30-06-28,Unknown,https://img.a.transfermarkt.technology/portrait/header/205927-1728392573.JPG?lm=1,TR1,FenerbahÃ§e Spor KulÃ¼bÃ¼,11000000.0,15000000.0,29,143,144,4,3,3,3,8,7,7,2,3,3,13,4,2,7,4,14,11,14,15,10,14,13,8,14,1,14,14,10,11,15,12,14,13,10,11,13,14,3,11,4,12,14,10,9,4,13,12,19,18,9,16,15,7,13,2,18,14,18,18,19,20,1,1,1,1,1,1,1,1,1,1,1,1,1,79,8,20,13899601,7400,7200,6500,Northern_European,141,31,0,15384.0,Unknown,24025298,3637500.0,2.0,24,1695,25,2,1,7,84,5,0.702963747023022,0.6898395721925134,0.6764705882352942,0.0148463654648916,0.2039473684210526,0.0,0.0547636909227306,0.0747686921730432,0.020181116142115,0.1428571428571428,0.581395348837209,0.4583333333333332,0,0,0,0,0,0,2,13,40,11000000,361666.6666666667,15000000.0,5000000.0,250000.0,800000.0,2,0,0.0,-0.08333333333333333
205938,Mario,Pasalic,2024,800,Germany,Mainz,Croatia,09-02-95,Central Midfield,Midfield,Right,188.0,30-06-25,TTMA,https://img.a.transfermarkt.technology/portrait/header/205938-1716240830.jpg?lm=1,IT1,Atalanta Bergamasca Calcio S.p.a.,13000000.0,28000000.0,29,147,152,8,10,12,16,14,7,12,14,4,8,14,9,11,14,13,17,12,13,10,13,13,13,11,11,18,9,14,14,13,14,14,14,13,13,13,12,14,12,12,8,14,3,1,2,2,2,2,1,2,1,3,3,15,16,6,17,13,17,14,15,1,1,1,1,1,1,12,1,20,1,1,20,1,1,82,17,20,20490768,7350,7150,5900,Northern_European,142,40,7,35577.0,Unknown,24021244,8500000.0,2.0,38,894,25,3,1,7,31,1,0.696348240275205,0.6256684491978609,0.6838235294117647,0.0343450749174155,0.2631578947368421,0.0921052631578947,0.0647661915478869,0.1397849462365591,0.047195755437651,0.1428571428571428,0.581395348837209,0.4583333333333332,447,89,45,48,0,6935,5,33,161,13000000,428571.4285714286,28000000.0,5000000.0,1000000.0,5000000.0,7,4000000,0.0,0.0
206040,Raúl,Jiménez,2024,931,Mexico,Tepeji del RÃ­o de Ocampo,Mexico,05-05-91,Centre-Forward,Attack,Right,187.0,30-06-25,Unknown,https://img.a.transfermarkt.technology/portrait/header/206040-1668454631.jpg?lm=1,GB1,Fulham Football Club,5000000.0,50000000.0,33,150,155,6,11,14,15,12,8,16,13,6,8,13,20,9,14,17,13,16,15,14,11,12,16,9,8,15,10,15,18,14,12,14,15,14,14,14,13,13,8,11,9,12,1,2,3,1,3,2,3,4,1,3,1,10,10,6,14,13,17,14,15,1,1,1,1,1,1,1,1,1,1,10,13,13,20,76,13,20,347975206,7600,7250,6500,Mediterranean_Hispanic,149,96,30,115992.0,Unknown,51013463,19225000.0,4.0,63,1484,64,0,1,3,95,3,0.7095792537708389,0.6898395721925134,0.7352941176470587,0.1119951873635462,0.631578947368421,0.3947368421052631,0.0247561890472618,0.2498124531132783,0.106780743909553,0.4285714285714285,0.5581395348837206,0.625,518,165,58,48,2,17700,11,85,149,5000000,133333.33333333334,50000000.0,10000000.0,,,4,13000000,0.0,-0.16666666666666666
206050,Paulo,Dybala,2024,12,Argentina,Laguna Larga,Argentina,15-11-93,Second Striker,Attack,Left,177.0,30-06-25,Unknown,https://img.a.transfermarkt.technology/portrait/header/206050-1725530843.jpg?lm=1,IT1,Associazione Sportiva Roma,20000000.0,110000000.0,31,160,177,16,15,18,15,18,17,13,17,4,4,17,16,4,19,9,16,10,12,11,17,14,13,17,11,14,4,14,12,14,18,18,7,10,12,12,12,13,5,11,16,13,1,2,3,3,3,3,3,2,3,1,3,14,14,12,9,9,11,13,15,1,1,1,1,1,1,1,1,1,1,12,20,15,20,79,20,10,20000000,8000,8404,7750,Mediterranean_Hispanic,158,34,3,160192.0,Unknown,14044150,26450000.0,2.0,4,791,4,0,0,3,29,12,0.8622651495104525,0.8235294117647058,0.8014705882352942,0.1546754705211533,0.2236842105263157,0.0394736842105263,0.0997749437359339,0.549887471867967,0.1469207477985499,0.1428571428571428,0.3255813953488373,0.5416666666666665,533,193,85,44,0,7492,34,115,81,8000000,150000.0,110000000.0,18000000.0,7000000.0,6500000.0,3,15000000,-0.6,-0.68
206225,Isaac,Hayden,2024,762,England,Chelmsford,England,22-03-95,Defensive Midfield,Midfield,Right,187.0,30-06-26,Unique Sports Group,https://img.a.transfermarkt.technology/portrait/header/206225-1680273024.jpg?lm=1,GB1,Newcastle United Football Club,1800000.0,10000000.0,29,126,140,5,10,11,7,12,5,11,10,7,13,12,8,14,12,14,15,15,14,12,10,13,15,8,12,12,14,15,15,12,11,12,13,16,12,15,12,15,10,14,11,12,3,2,2,3,3,1,4,1,2,4,2,9,12,6,16,13,18,15,14,1,1,13,13,1,1,20,1,20,1,1,1,1,1,79,12,20,8802182,6297,6297,5147,African_Caribbean,125,0,0,57996.0,Norwich City,28067790,2900000.0,1.0,32,349,33,3,1,1,137,4,0.583487695157449,0.5451336898395721,0.5588235294117647,0.055993248404076,0.0,0.0,0.0087521880470117,0.0497624406101525,0.0160837801050029,0.0,0.5581395348837206,0.4583333333333332,282,10,16,65,4,7499,12,107,114,1500000,48076.92307692308,10000000.0,2000000.0,,250000.0,5,4800000,-0.16666666666666666,-0.5
206386,Tin,Jedvaj,2024,265,Croatia,Zagreb,Croatia,28-11-95,Centre-Back,Defender,Right,185.0,30-06-27,Unknown,https://img.a.transfermarkt.technology/portrait/header/206386-1630619815.png?lm=1,GR1,Panathinaikos Athlitikos Omilos,2500000.0,9000000.0,29,123,136,7,8,9,9,12,8,11,9,15,14,12,8,13,12,10,15,15,11,12,9,13,15,9,10,12,12,9,14,12,11,14,13,14,14,13,12,11,13,12,10,15,2,1,2,1,1,2,3,3,1,4,3,14,12,13,8,12,12,8,10,1,12,20,16,9,13,9,1,7,1,1,1,1,1,79,9,20,5894221,6243,6779,5584,Northern_European,123,26,2,23972.0,Unknown,24026928,4125000.0,4.0,24,1697,25,1,1,7,150,2,0.6472611802064038,0.5918716577540106,0.5441176470588236,0.0231390865453787,0.1710526315789473,0.0263157894736842,0.0122530632658164,0.0447611902975743,0.0228895247090196,0.4285714285714285,0.5116279069767438,0.4583333333333332,289,14,8,65,1,9426,16,98,103,2700000,67241.37931034483,9000000.0,2000000.0,6500000.0,6500000.0,7,9750000,0.08,0.08
206542,Robin,Quaison,2024,605,Sweden,Stockholm,Sweden,09-10-93,Centre-Forward,Attack,Right,183.0,30-06-26,Universal Twenty Two,https://img.a.transfermarkt.technology/portrait/header/206542-1685660298.jpg?lm=1,GR1,Aris Thessalonikis,2500000.0,13000000.0,31,137,142,11,12,13,11,12,11,9,13,6,8,13,10,10,12,16,12,15,10,12,14,10,16,14,9,15,7,12,16,14,12,16,11,15,16,14,15,11,6,13,6,17,2,3,2,3,2,1,1,2,2,2,3,13,15,5,10,13,14,12,10,1,1,1,1,1,1,1,16,15,13,16,20,13,18,77,9,20,9826942,6850,6850,5750,Mixed_Race,128,42,12,14999.0,Unknown,68015337,2250000.0,2.0,91,1426,91,0,1,4,20,3,0.6566551997883038,0.6096256684491979,0.5808823529411764,0.014474602817478,0.2763157894736842,0.1578947368421052,0.0122530632658164,0.0647661915478869,0.0124725686824634,0.1428571428571428,0.4651162790697669,0.5416666666666665,354,75,25,35,1,4735,6,20,36,2000000,65000.0,13000000.0,2500000.0,750000.0,2000000.0,4,2100000,-0.2857142857142857,-0.5
206717,Eduard,Sobol,2024,667,Ukraine,"Vilnyansk, Zaporizhya Oblast",Ukraine,20-04-95,Left-Back,Defender,Left,186.0,30-06-26,ProStar,https://img.a.transfermarkt.technology/portrait/header/206717-1714036997.png?lm=1,FR1,Racing Club de Strasbourg Alsace,1500000.0,4000000.0,29,121,135,12,13,11,9,10,14,11,9,12,13,11,13,13,11,11,10,11,12,14,12,11,13,10,12,13,12,14,13,14,14,12,11,12,13,14,11,11,13,13,8,13,2,3,2,3,2,3,1,1,1,1,1,12,12,2,16,9,12,11,12,1,20,1,1,17,1,1,17,1,1,13,1,1,1,73,20,7,1051875,6000,6000,3012,Northern_European,121,26,0,7499.0,Unknown,71050075,3000000.0,2.0,103,1610,101,1,0,7,159,8,0.5441915850754168,0.3167914438502673,0.5294117647058822,0.0072324733224089,0.1710526315789473,0.0,0.0072518129532383,0.0197549387346836,0.0166393510930859,0.1428571428571428,0.5348837209302322,0.4583333333333332,334,9,27,52,0,9999,5,13,58,1200000,33333.333333333336,4000000.0,800000.0,1000000.0,900000.0,11,4050000,-0.2,-0.4
206746,Kenny,Tete,2024,931,Netherlands,Amsterdam,Netherlands,09-10-95,Right-Back,Defender,Right,180.0,30-06-25,Sports Invest UK ltd,https://img.a.transfermarkt.technology/portrait/header/206746-1599577236.jpg?lm=1,GB1,Fulham Football Club,15000000.0,15000000.0,29,137,138,7,16,10,7,12,7,12,10,12,14,12,7,15,12,13,13,15,12,11,10,13,14,9,8,11,14,14,15,15,11,14,12,14,14,15,14,12,10,14,8,13,2,2,3,3,2,1,3,1,3,2,1,12,12,10,12,11,12,4,8,1,11,14,20,11,19,1,1,1,1,1,1,1,1,71,10,20,28764795,6842,6842,5242,African_Caribbean,135,13,0,40597.0,Unknown,37039829,3600000.0,2.0,67,64,68,1,1,1,95,11,0.6555967187086531,0.5552941176470588,0.6323529411764706,0.0391924735927818,0.0855263157894736,0.0,0.0747686921730432,0.0747686921730432,0.0199727770215839,0.1428571428571428,0.3953488372093026,0.4583333333333332,332,11,25,53,0,7596,21,114,106,15000000,533928.5714285715,15000000.0,2000000.0,250000.0,6500000.0,3,4600000,0.0,0.0
206843,Andrija,Zivkovic,2024,1091,Yugoslavia (Republic),NiÅ¡,Serbia,11-07-96,Right Winger,Attack,Left,169.0,30-06-27,Unknown,https://img.a.transfermarkt.technology/portrait/header/206843-1727967539.png?lm=1,GR1,Panthessalonikios Athlitikos Omilos Konstantinoupoliton,8000000.0,18000000.0,28,130,145,15,15,15,12,15,13,6,12,10,6,15,11,7,16,13,10,9,15,10,16,14,9,16,11,12,8,13,11,12,14,13,6,11,12,10,8,10,9,15,10,10,1,2,1,3,1,2,2,1,2,1,2,12,9,12,8,10,7,10,7,1,1,1,1,1,1,1,16,10,16,19,16,20,7,62,20,14,6527465,6499,6799,4499,Northern_European,129,26,1,30749.0,Unknown,62082823,9111392.0,2.0,110,1048,85,0,0,7,153,10,0.6499073829055305,0.4758288770053475,0.588235294117647,0.0296830747571231,0.1710526315789473,0.0131578947368421,0.0397599399849962,0.0897724431107777,0.0505924720131114,0.1428571428571428,0.13953488372093,0.4166666666666665,404,84,83,61,1,14732,14,80,115,8000000,214285.7142857143,18000000.0,6000000.0,4000000.0,7000000.0,2,0,0.0,0.14285714285714285
206888,Georgiy,Bushchan,2024,338,Ukraine,Odesa,Ukraine,31-05-94,Goalkeeper,Goalkeeper,Right,196.0,30-06-26,ProStar,https://img.a.transfermarkt.technology/portrait/header/206888-1726134596.png?lm=1,UKR1,Futbolniy Klub Dynamo Kyiv,7000000.0,10000000.0,30,132,135,4,3,1,2,8,5,10,3,3,3,11,4,2,8,10,11,12,13,14,12,12,13,3,10,2,12,12,14,9,13,15,16,16,8,11,12,13,8,13,10,16,15,14,13,5,12,15,12,15,11,15,14,18,6,4,15,14,11,11,15,20,1,1,1,1,1,1,1,1,1,1,1,1,1,93,12,20,8861221,6449,6449,4471,Northern_European,130,16,0,17000.0,Unknown,71049105,9111392.0,2.0,103,1071,101,2,1,7,97,5,0.6035988356708124,0.4728342245989304,0.5955882352941175,0.0164068029667624,0.1052631578947368,0.0,0.0347586896724181,0.0497624406101525,0.0505924720131114,0.1428571428571428,0.7674418604651163,0.5,0,0,0,0,0,0,7,60,172,7000000,276000.0,10000000.0,2000000.0,,200000.0,4,100000,0.0,0.0
206912,Jimmy,Cabot,2024,826,France,ChambÃ©ry,France,18-04-94,Right Midfield,Midfield,Right,164.0,30-06-26,AMS CONSULTING,https://img.a.transfermarkt.technology/portrait/header/206912-1704795705.jpg?lm=1,FR1,Racing Club de Lens,2500000.0,5000000.0,30,129,134,13,12,14,10,13,10,5,10,4,11,13,10,10,14,7,12,11,12,11,12,11,15,15,8,13,10,11,13,14,15,8,2,14,14,15,6,12,7,10,7,12,1,3,4,1,2,1,3,4,1,1,3,10,12,9,13,11,13,10,10,1,1,1,1,1,20,1,15,1,20,15,1,17,10,64,10,20,5634640,6450,6450,3500,Northern_European,115,0,0,14310.0,Unknown,167580,1900000.0,2.0,34,345,36,3,1,7,158,9,0.6037311458057687,0.3689839572192513,0.4852941176470588,0.0138092925211977,0.0,0.0,0.0122530632658164,0.0247561890472618,0.0105280702241728,0.1428571428571428,0.0232558139534884,0.5,274,26,32,24,1,6120,5,113,569,0,-3571.4285714285716,5000000.0,2000000.0,,500000.0,4,4200000,-1.0,-1.0
206947,Kévin,Rodrigues,2024,10484,France,Bayonne,Portugal,05-03-94,Left-Back,Defender,Left,170.0,30-06-25,4YOURDREAM,https://img.a.transfermarkt.technology/portrait/header/206947-1727695143.jpg?lm=1,TR1,Kas?mpa?a Spor KulÃ¼bÃ¼,1600000.0,5000000.0,30,125,135,13,13,13,11,13,13,6,13,8,12,13,11,12,14,13,13,13,12,13,12,12,10,13,11,12,13,15,13,14,14,15,6,13,14,13,9,13,11,13,7,8,2,1,1,3,3,1,2,1,1,1,1,13,12,8,12,10,14,13,13,1,20,1,1,16,1,1,14,1,1,12,1,1,1,64,20,8,5467595,6238,6488,4238,Northern_European,125,3,0,14999.0,Unknown,85119246,9111392.0,2.0,34,157,79,1,0,7,117,8,0.6087589309341096,0.4479144385026737,0.5588235294117647,0.014474602817478,0.0197368421052631,0.0,0.0077519379844961,0.0247561890472618,0.0505924720131114,0.1428571428571428,0.1627906976744184,0.5,246,12,23,42,1,3474,14,52,141,1500000,44642.857142857145,5000000.0,2000000.0,,250000.0,8,4250000,-0.16666666666666666,-0.25
207014,Will,Hughes,2024,873,England,Weybridge,England,17-04-95,Central Midfield,Midfield,Left,185.0,30-06-25,Two Touch Agency,https://img.a.transfermarkt.technology/portrait/header/207014-1700672424.jpg?lm=1,GB1,Crystal Palace Football Club,9000000.0,18000000.0,29,130,155,11,10,12,9,13,12,9,10,6,13,13,11,14,13,16,14,15,14,13,13,13,15,11,12,11,13,15,17,10,14,13,13,13,11,14,12,13,15,12,10,15,2,2,1,1,3,1,1,3,2,1,4,13,14,3,10,13,16,10,13,1,1,1,1,1,1,20,11,20,15,1,11,11,1,74,20,9,8978346,6499,6499,5599,Northern_European,130,0,0,57996.0,Unknown,29086005,8050000.0,2.0,32,1660,33,3,0,7,58,1,0.6102143424186293,0.5934759358288769,0.5955882352941175,0.055993248404076,0.0,0.0,0.0447611902975743,0.0897724431107777,0.0446956859912775,0.1428571428571428,0.5116279069767438,0.4583333333333332,418,22,35,79,0,5729,12,102,237,9000000,277777.77777777775,18000000.0,3500000.0,7000000.0,7000000.0,2,3000000,0.0,0.0
207015,Vincent,Janssen,2024,1096,Netherlands,Heesch,Netherlands,15-06-94,Centre-Forward,Attack,Left,185.0,30-06-26,YOU FIRST,https://img.a.transfermarkt.technology/portrait/header/207015-1659086968.jpg?lm=1,BE1,Royal Antwerp Football Club,8000000.0,14000000.0,30,130,145,5,6,11,13,14,12,14,11,5,4,12,15,4,12,15,12,14,11,12,12,13,16,13,8,15,8,14,14,11,12,15,12,11,12,13,16,12,5,12,11,6,1,2,3,1,2,2,1,3,3,2,3,12,14,6,12,14,17,10,13,1,1,1,1,1,1,1,1,1,1,1,12,1,20,88,20,16,9899999,6500,6450,5500,Northern_European,128,18,7,49999.0,Unknown,37018783,9250000.0,4.0,67,604,68,0,0,7,173,3,0.6037311458057687,0.5828877005347594,0.5808823529411764,0.0482712071278004,0.1184210526315789,0.0921052631578947,0.0397599399849962,0.0697674418604651,0.0513625378482735,0.4285714285714285,0.5116279069767438,0.5,423,156,51,77,3,13497,14,116,293,8000000,257258.06451612903,14000000.0,2000000.0,,400000.0,6,12100000,0.0,-0.1111111111111111
207877,Ruslan,Malinovskyi,2024,252,Ukraine,Zhytomyr,Ukraine,04-05-93,Attacking Midfield,Midfield,Left,181.0,30-06-27,ProStar,https://img.a.transfermarkt.technology/portrait/header/207877-1663583019.jpg?lm=1,IT1,Genoa Cricket and Football Club,8000000.0,30000000.0,31,146,155,17,14,15,12,16,17,4,19,4,6,15,14,11,17,15,12,12,13,12,14,13,14,16,8,13,6,11,15,14,15,16,9,16,12,11,15,13,12,13,6,12,2,2,3,4,3,3,2,4,2,2,2,15,14,6,14,13,16,14,11,1,1,1,1,1,1,11,1,18,1,10,20,10,14,79,20,12,20240319,7300,7050,6300,Northern_European,145,49,7,24615.0,Unknown,71048716,8150000.0,4.0,103,1706,101,3,0,7,104,0,0.6831172267795713,0.6684491978609625,0.7058823529411764,0.0237599784474226,0.3223684210526316,0.0921052631578947,0.0397599399849962,0.1497874468617154,0.0452512569793605,0.4285714285714285,0.418604651162791,0.5416666666666665,419,82,72,86,2,11771,12,86,246,3500000,113333.33333333333,30000000.0,10000000.0,,200000.0,5,9800000,-0.5625,-0.65
207917,Alberto,Moreno,2024,1047,Spain,Sevilla,Spain,05-07-92,Left-Back,Defender,Left,171.0,30-06-25,Unknown,https://img.a.transfermarkt.technology/portrait/header/207917-1687268193.jpg?lm=1,IT1,Calcio Como,1800000.0,15000000.0,32,140,150,8,14,13,5,14,9,8,12,9,13,14,9,15,14,14,13,15,13,11,14,12,14,12,7,14,12,15,17,14,15,15,8,15,15,17,12,13,9,14,12,9,3,3,1,3,2,3,2,1,1,1,3,14,13,7,14,13,15,14,13,1,18,1,1,20,1,1,16,1,1,10,1,8,1,65,20,5,15033524,7000,7000,6050,Mediterranean_Hispanic,141,4,0,23429.0,Unknown,67150301,18000000.0,1.0,89,1364,89,1,0,3,47,8,0.6765017200317545,0.641711229946524,0.6764705882352942,0.0226147563699357,0.0263157894736842,0.0,0.0087521880470117,0.0747686921730432,0.0999749993055362,0.0,0.1860465116279068,0.5833333333333333,395,21,26,68,1,6852,11,107,195,1800000,50000.0,15000000.0,3000000.0,,2500000.0,4,1900000,0.0,-0.1
208166,Bartlomiej,Dragowski,2024,265,Poland,Bia?ystok,Poland,19-08-97,Goalkeeper,Goalkeeper,Right,191.0,30-06-28,Mariusz Kulesza,https://img.a.transfermarkt.technology/portrait/header/208166-1663686932.jpg?lm=1,GR1,Panathinaikos Athlitikos Omilos,3000000.0,16000000.0,27,130,139,4,2,3,1,9,6,10,3,3,2,10,3,1,9,12,13,14,10,10,8,13,15,2,12,3,13,8,11,12,12,14,17,13,11,14,13,11,5,8,11,14,13,14,12,12,14,10,12,17,8,13,12,11,13,12,12,12,15,11,8,20,1,1,1,1,1,1,1,1,1,1,1,1,1,74,9,20,3073665,6500,6500,5500,Northern_European,128,2,0,28461.0,Unknown,96052559,2150000.0,3.0,75,185,78,2,1,7,150,5,0.6103466525535857,0.5828877005347594,0.5808823529411764,0.027473742452494,0.0131578947368421,0.0,0.0147536884221055,0.0797699424856214,0.0119169976943803,0.2857142857142857,0.6511627906976742,0.375,0,0,0,0,0,0,14,55,71,3000000,98333.33333333333,16000000.0,3000000.0,3200000.0,2000000.0,5,14800000,0.2,0.25
208172,Mateusz,Wieteska,2024,1390,Poland,Warszawa,Poland,11-02-97,Centre-Back,Defender,Right,187.0,30-06-27,UNIDOS,https://img.a.transfermarkt.technology/portrait/header/208172-1668091600.jpg?lm=1,IT1,Cagliari Calcio,3000000.0,4000000.0,27,122,126,7,10,9,8,12,8,15,8,12,14,12,12,14,10,14,12,13,12,10,11,13,13,11,14,11,13,12,12,11,9,13,14,13,11,13,14,11,8,12,5,10,1,1,2,4,2,1,4,1,3,2,3,12,13,3,12,11,14,12,13,1,7,20,14,1,1,13,1,1,1,1,1,1,1,77,9,20,2200238,6100,6100,3500,Northern_European,123,1,0,7937.0,Unknown,96059426,2141666.667,3.0,75,1646,78,1,1,7,46,2,0.5574225985710506,0.3689839572192513,0.5441176470588236,0.007655413684921,0.006578947368421,0.0,0.0147536884221055,0.0197549387346836,0.011870700113892,0.2857142857142857,0.5581395348837206,0.375,312,25,15,59,1,8326,1,3,23,2200000,76785.71428571429,4000000.0,800000.0,125000.0,500000.0,8,3525000,-0.26666666666666666,-0.37142857142857144
208552,Siebe,Schrijvers,2024,2727,Belgium,Peer,Belgium,18-07-96,Central Midfield,Midfield,Right,179.0,30-06-27,SportPlus,https://img.a.transfermarkt.technology/portrait/header/208552-1713336899.png?lm=1,BE1,Oud-Heverlee Leuven,2000000.0,7500000.0,28,122,140,9,13,13,12,12,12,11,13,10,3,14,12,5,12,6,14,14,14,14,15,14,9,15,8,12,5,14,12,13,12,7,6,10,14,10,8,13,5,11,14,3,3,1,3,3,1,2,2,1,3,2,2,12,11,3,13,8,15,16,18,1,1,1,1,1,1,1,1,16,1,19,20,17,17,65,8,20,537020,5600,5600,4950,Northern_European,115,0,0,11999.0,Unknown,18054954,2350000.0,2.0,7,1133,8,3,1,7,146,1,0.4912675310928817,0.5240641711229946,0.4852941176470588,0.0115777510194504,0.0,0.0,0.0097524381095273,0.0372593148287071,0.0130281396705464,0.1428571428571428,0.3720930232558141,0.4166666666666665,385,56,50,50,0,9024,4,23,231,1500000,46666.666666666664,7500000.0,2000000.0,1500000.0,3500000.0,4,2500000,-0.25,-0.25
208690,George,Pu?Ca?,2024,44006,Romania,Marghita,Romania,08-04-96,Centre-Forward,Attack,Right,188.0,30-06-27,Wasserman,https://img.a.transfermarkt.technology/portrait/header/208690-1716545812.jpg?lm=1,TR1,Bodrumspor Spor Faaliyetleri Anonim ?irketi,1500000.0,6000000.0,28,120,125,8,9,11,13,11,12,15,12,8,3,10,16,7,11,16,10,16,10,11,8,9,15,10,8,13,8,10,15,15,12,13,13,12,13,12,15,8,9,13,8,10,1,3,1,2,4,3,3,1,3,2,2,14,14,8,13,15,18,12,17,1,1,1,1,1,1,1,1,1,1,16,10,1,20,77,11,20,3689484,6000,6000,5000,Mediterranean_Hispanic,118,30,8,17399.0,Genoa CFC,57108725,3533333.333,3.0,77,915,80,0,1,3,39,3,0.5441915850754168,0.5294117647058822,0.5073529411764706,0.0167920842559001,0.1973684210526315,0.1052631578947368,0.0072518129532383,0.0297574393598399,0.01960239636101,0.2857142857142857,0.581395348837209,0.4166666666666665,355,105,17,31,0,8259,6,55,73,1300000,44444.444444444445,6000000.0,1200000.0,1000000.0,1000000.0,9,6700000,-0.13333333333333333,-0.35
209212,Solly,March,2024,1237,England,Eastbourne,England,20-07-94,Right Winger,Attack,Left,180.0,30-06-26,Unknown,https://img.a.transfermarkt.technology/portrait/header/209212-1682348330.jpeg?lm=1,GB1,Brighton and Hove Albion Football Club,15000000.0,22000000.0,30,138,141,13,13,14,9,13,13,8,13,4,8,13,10,10,14,9,12,10,13,14,12,14,14,13,8,12,13,15,14,14,13,13,10,12,14,14,9,15,6,15,12,17,2,4,2,1,1,2,3,2,3,3,4,9,13,5,12,14,18,8,13,1,11,1,11,17,17,1,17,11,17,15,14,20,1,73,20,8,47210232,6897,6897,5247,Northern_European,131,0,0,52196.0,Unknown,29090530,5000.0,1.0,32,444,33,0,0,7,44,10,0.6628737761312516,0.5558288770053476,0.6029411764705883,0.0503926682612226,0.0,0.0,0.0747686921730432,0.1097774443610902,0.0,0.0,0.3953488372093026,0.5,299,28,29,17,0,4504,13,103,430,10000000,354464.28571428574,22000000.0,5000000.0,,150000.0,0,0,-0.4444444444444444,-0.5454545454545454
210178,Pablo,Marí,2024,2919,Spain,Almussafes,Spain,31-08-93,Centre-Back,Defender,Left,193.0,30-06-25,AC Talent,https://img.a.transfermarkt.technology/portrait/header/210178-1663659195.jpg?lm=1,IT1,Associazione Calcio Monza,3500000.0,7000000.0,31,133,145,5,5,7,5,13,4,15,8,9,15,14,7,15,13,15,12,15,11,12,14,11,12,7,13,7,13,14,14,12,12,13,17,11,13,13,16,14,14,11,10,9,3,2,1,1,2,1,3,1,2,4,1,13,13,9,11,12,12,9,9,1,9,20,1,1,1,11,1,1,1,1,1,1,1,87,20,8,7516251,6650,6650,5750,Mediterranean_Hispanic,132,0,0,57996.0,Brianza,67157583,3525000.0,4.0,89,51,89,1,0,3,28,2,0.6301931727970362,0.6096256684491979,0.6102941176470589,0.055993248404076,0.0,0.0,0.0172543135783946,0.0347586896724181,0.0195560987805216,0.4285714285714285,0.6976744186046511,0.5416666666666665,404,21,2,91,2,5308,10,67,172,3500000,120000.0,7000000.0,2000000.0,,,7,5300000,0.0,-0.3
210689,Vladyslav,Kabaev,2024,338,Ukraine,Odesa,Ukraine,01-09-95,Left Winger,Attack,Left,177.0,30-06-26,ProStar,https://img.a.transfermarkt.technology/portrait/header/210689-1726135463.png?lm=1,UKR1,Futbolniy Klub Dynamo Kyiv,3000000.0,3000000.0,29,121,121,8,11,12,12,12,9,10,12,5,8,13,11,12,12,13,11,13,12,10,12,12,4,15,11,15,10,11,13,12,12,14,9,12,12,11,12,11,9,8,5,11,3,1,2,1,3,1,2,1,1,1,2,4,12,7,15,11,12,13,8,1,1,1,1,1,1,1,18,14,10,20,19,14,15,66,20,12,1196307,5500,5500,2500,Northern_European,113,0,0,3455.0,Unknown,71049691,675000.0,2.0,103,1071,101,0,0,7,97,7,0.4780365175972479,0.2620320855614972,0.4705882352941176,0.0033275170986677,0.0,0.0,0.0147536884221055,0.0147536884221055,0.0037223256201561,0.1428571428571428,0.3255813953488373,0.4583333333333332,272,20,25,44,0,7138,6,21,47,4000000,162500.0,4000000.0,300000.0,,400000.0,2,0,1.2222222222222223,1.6666666666666667
210747,Willian,Arão,2024,265,Brazil,SÃ£o Paulo,Brazil,12-03-92,Defensive Midfield,Midfield,Right,181.0,30-06-25,Brazil Football,https://img.a.transfermarkt.technology/portrait/header/210747-1666617919.png?lm=1,GR1,Panathinaikos Athlitikos Omilos,2500000.0,7000000.0,32,130,137,12,10,11,11,14,9,16,12,3,14,15,12,13,12,13,12,16,15,12,12,12,13,13,13,13,14,14,13,13,12,13,13,12,13,14,14,14,10,13,10,15,3,3,1,1,1,2,1,3,2,1,4,15,11,6,6,11,8,9,11,1,1,14,1,1,1,20,1,18,1,1,1,1,1,77,8,20,7248753,6450,6400,4800,African_Caribbean,131,1,0,48076.0,Unknown,19073567,2750000.0,2.0,10,1456,11,3,1,1,150,4,0.5971156390579518,0.5080213903743315,0.6029411764705883,0.0464143251252647,0.006578947368421,0.0,0.0122530632658164,0.0347586896724181,0.0152504236228784,0.1428571428571428,0.418604651162791,0.5833333333333333,564,43,35,72,3,18850,3,6,17,2000000,63793.10344827586,7000000.0,2500000.0,,400000.0,6,4000000,-0.2,-0.3333333333333333
211251,Darwin,Machís,2024,366,Venezuela,Tucupita,Venezuela,07-02-93,Left Winger,Attack,Right,171.0,30-06-26,YOU FIRST,https://img.a.transfermarkt.technology/portrait/header/211251-1719836851.jpg?lm=1,ES1,Real Valladolid Club de FÃºtbol S.A.D.,2000000.0,10000000.0,31,131,136,9,10,14,13,10,11,10,13,4,4,10,12,4,11,8,11,11,11,10,11,11,18,13,8,13,7,9,12,16,14,13,7,14,16,13,10,12,7,12,5,5,2,3,2,2,3,3,2,1,1,2,1,12,16,10,14,14,18,15,10,1,13,1,1,14,1,1,16,1,16,20,11,17,15,72,9,20,4393609,6532,6586,5491,Mixed_Race,117,36,9,14277.0,Unknown,86017618,4250000.0,2.0,108,1531,105,0,1,4,169,7,0.6217253241598306,0.5819251336898396,0.4999999999999999,0.0137774271514194,0.2368421052631578,0.1184210526315789,0.0097524381095273,0.0497624406101525,0.0235839884441234,0.1428571428571428,0.1860465116279068,0.5416666666666665,401,87,47,57,3,6491,4,22,93,1200000,17948.71794871795,10000000.0,2500000.0,,300000.0,14,6200000,-0.4,-0.52
211325,Badou,Ndiaye,2024,2832,Senegal,Dakar,Senegal,27-10-90,Central Midfield,Midfield,Right,180.0,30-06-26,Unknown,https://img.a.transfermarkt.technology/portrait/header/211325-1728296431.jpg?lm=1,TR1,Gaziantep Futbol KulÃ¼bÃ¼ A.?.,500000.0,15000000.0,34,130,140,7,10,14,10,13,8,10,11,8,12,13,12,13,13,14,12,17,12,13,12,13,14,13,12,14,11,15,17,13,13,13,10,12,13,15,14,12,14,12,9,15,2,2,2,3,3,2,1,3,3,3,2,16,16,10,12,12,17,15,16,1,1,1,1,1,1,16,1,20,1,1,14,1,1,76,9,20,347975206,6550,6000,5200,African_Caribbean,131,31,2,25000.0,Unknown,53075287,7950000.0,3.0,83,402,84,3,1,1,103,1,0.5441915850754168,0.5508021390374331,0.6029411764705883,0.0241317410948361,0.2039473684210526,0.0263157894736842,0.0022505626406601,0.0747686921730432,0.0441401150031945,0.2857142857142857,0.3953488372093026,0.6666666666666665,425,74,59,84,2,7033,11,34,48,450000,12068.965517241379,15000000.0,3500000.0,,,12,20000000,-0.35714285714285715,-0.55
211637,Kiki,Kouyaté,2024,969,Mali,Bamako,Mali,15-04-97,Centre-Back,Defender,Right,192.0,30-06-26,Mondo Victory,https://img.a.transfermarkt.technology/portrait/header/211637-1702665133.JPG?lm=1,FR1,Montpellier HÃ©rault Sport Club,5000000.0,6000000.0,27,121,135,5,7,6,9,9,5,15,6,6,14,10,8,12,8,14,12,14,11,11,10,11,12,7,10,7,12,12,13,12,12,12,16,16,13,13,15,11,10,13,8,5,3,3,1,3,3,1,1,2,2,3,1,13,13,6,8,12,12,13,10,1,1,20,15,1,14,10,1,1,1,1,1,1,1,78,10,20,2396926,6047,6047,3750,African_Caribbean,118,21,0,8477.0,Unknown,13186668,2662500.0,4.0,61,133,61,1,1,1,133,2,0.5504101614183646,0.3957219251336898,0.5073529411764706,0.0081768470085659,0.1381578947368421,0.0,0.0247561890472618,0.0297574393598399,0.0147642990083057,0.4285714285714285,0.6744186046511627,0.375,212,11,3,50,4,2631,7,27,100,3500000,173750.0,6000000.0,1500000.0,,350000.0,3,3000000,-0.3,-0.3
211727,Artem,Timofeev,2024,932,Russia,Saratov,Russia,12-01-94,Defensive Midfield,Midfield,Right,185.0,30-06-25,Pavel Andreev,https://img.a.transfermarkt.technology/portrait/header/211727-1721715816.png?lm=1,RU1,"?????????? ???? ""?????????"" ??????",2500000.0,2800000.0,30,120,120,7,6,11,6,12,9,13,8,9,12,12,8,12,12,15,15,15,13,13,9,12,12,5,8,11,13,16,16,11,11,12,11,12,13,16,11,14,14,10,14,10,1,3,3,1,3,1,2,2,3,2,4,10,9,3,10,11,10,11,19,1,1,7,1,1,1,20,1,19,1,1,10,1,1,74,12,20,2501202,5749,5749,3249,Northern_European,118,0,0,14999.0,Unknown,58085234,800000.0,1.0,78,1344,81,3,1,7,3,4,0.5109817412013761,0.342139037433155,0.5073529411764706,0.014474602817478,0.0,0.0,0.0122530632658164,0.0137534383595899,0.0044167893552598,0.0,0.5116279069767438,0.5,292,21,16,60,1,6575,2,42,229,2000000,81250.0,2800000.0,500000.0,50000.0,,5,1350000,-0.2,-0.2
212229,Halil,Akbunar,2024,7160,TÃ¼rkiye,Izmir,TÃ¼rkiye,09-11-93,Right Winger,Attack,Left,170.0,30-06-26,Unknown,https://img.a.transfermarkt.technology/portrait/header/212229-1599995155.jpeg?lm=1,TR1,EyÃ¼p Spor KulÃ¼bÃ¼,1200000.0,4800000.0,31,125,135,13,12,15,10,12,9,5,13,2,5,12,8,7,11,14,10,15,12,13,10,10,13,14,12,10,6,13,15,17,17,7,13,15,14,12,7,12,5,12,8,12,2,2,3,2,2,1,3,2,1,1,1,2,15,8,13,5,13,12,15,1,6,1,1,1,1,1,15,1,15,20,1,16,1,61,20,8,1932723,5500,6250,5000,Mediterranean_Hispanic,121,2,0,7499.0,Unknown,70065879,1100000.0,2.0,100,682,100,0,0,3,66,10,0.5772691188145012,0.5294117647058822,0.5294117647058822,0.0072324733224089,0.0131578947368421,0.0,0.0057514378594648,0.0237559389847461,0.0060835023195088,0.1428571428571428,0.1627906976744184,0.5416666666666665,432,63,73,51,5,4394,6,16,22,1000000,27142.85714285714,4800000.0,800000.0,100000.0,450000.0,6,1850000,-0.2857142857142857,-0.4117647058823529
212723,Djibril,Sow,2024,368,Switzerland,ZÃ¼rich,Switzerland,06-02-97,Central Midfield,Midfield,Right,184.0,30-06-28,Signature - ISCM AG,https://img.a.transfermarkt.technology/portrait/header/212723-1663065652.jpg?lm=1,ES1,Sevilla FÃºtbol Club S.A.D.,9000000.0,22000000.0,27,137,144,8,10,13,9,13,8,9,12,7,10,14,10,12,14,15,12,10,13,11,14,13,12,10,9,14,11,13,16,13,13,12,12,17,17,16,12,12,8,11,7,12,2,2,2,3,2,3,2,1,1,1,1,9,16,5,12,10,15,14,17,1,1,1,1,1,1,16,10,20,10,10,14,10,1,76,11,20,11846703,7000,6750,6250,Mixed_Race,135,30,0,41665.0,Unknown,98034373,6875000.0,4.0,92,1711,92,3,1,4,181,1,0.6434241862926701,0.6631016042780749,0.6323529411764706,0.0402237528328796,0.1973684210526315,0.0,0.0447611902975743,0.1097774443610902,0.0381677268813022,0.4285714285714285,0.4883720930232553,0.375,374,24,36,55,0,5690,19,99,89,7500000,256896.55172413794,22000000.0,6000000.0,1000000.0,1500000.0,5,7900000,-0.16666666666666666,-0.5833333333333334
212804,Florian,Tardieu,2024,618,France,Istres,France,22-04-92,Central Midfield,Midfield,Right,181.0,30-06-26,AGJ SP MGMT,https://img.a.transfermarkt.technology/portrait/header/212804-1727722208.jpg?lm=1,FR1,Association sportive de Saint-Ã‰tienne Loire,1000000.0,3000000.0,32,125,130,12,11,11,10,14,12,12,12,6,12,15,14,11,12,13,13,14,12,13,12,13,14,9,13,9,13,15,17,10,11,13,12,14,10,15,12,12,13,13,7,6,1,1,1,3,1,1,2,3,1,3,1,11,13,7,14,13,12,12,11,1,1,1,1,1,1,20,1,19,1,1,1,1,1,72,10,20,2845242,6249,6249,3499,Mediterranean_Hispanic,124,0,0,4999.0,Unknown,85116899,9111392.0,2.0,34,669,36,3,1,3,25,1,0.5771368086795449,0.3688770053475935,0.5514705882352942,0.0048184301573859,0.0,0.0,0.0047511877969492,0.0147536884221055,0.0505924720131114,0.1428571428571428,0.418604651162791,0.5833333333333333,402,29,22,81,4,3501,4,27,112,700000,21551.724137931036,3000000.0,500000.0,,400000.0,5,900000,-0.3,-0.4166666666666667
212832,Dimitrios,Pelkas,2024,6890,Greece,Giannitsa,Greece,26-10-93,Attacking Midfield,Midfield,Right,175.0,30-06-26,ROGON,https://img.a.transfermarkt.technology/portrait/header/212832-1695642814.png?lm=1,TR1,?stanbul Ba?ak?ehir Futbol KulÃ¼bÃ¼,2000000.0,7000000.0,31,125,130,13,12,15,10,15,12,4,14,5,6,15,10,5,15,10,13,5,15,9,15,11,17,16,9,14,6,14,12,14,16,10,8,12,13,11,8,9,8,10,5,10,1,2,3,2,1,2,2,2,4,3,3,13,14,8,15,12,15,13,14,1,1,1,1,1,1,1,14,12,14,19,20,18,8,68,8,20,4139040,6400,6500,5000,Mediterranean_Hispanic,122,26,1,38462.0,Hull City,36058048,2200000.0,1.0,40,538,42,3,1,3,4,0,0.6103466525535857,0.5294117647058822,0.536764705882353,0.0371308807298521,0.1710526315789473,0.0131578947368421,0.0097524381095273,0.0347586896724181,0.0121947831884219,0.0,0.2790697674418605,0.5416666666666665,394,81,60,85,2,11226,21,91,57,1800000,43055.555555555555,7000000.0,2000000.0,400000.0,,5,1250000,-0.1,-0.21739130434782608
212847,Adam,Webster,2024,1237,England,West Wittering,England,04-01-95,Centre-Back,Defender,Right,190.0,30-06-26,Unknown,https://img.a.transfermarkt.technology/portrait/header/212847-1681737411.jpg?lm=1,GB1,Brighton and Hove Albion Football Club,15000000.0,25000000.0,29,142,144,5,6,13,6,13,5,14,7,6,14,14,7,15,13,12,14,13,14,13,13,13,14,7,14,8,14,13,14,13,11,10,15,13,15,14,13,14,8,15,13,10,3,2,2,3,3,2,2,1,2,1,2,12,12,3,13,12,13,11,13,1,1,20,11,1,1,1,1,1,1,1,1,1,1,77,17,20,40294485,7095,7095,5495,Northern_European,142,0,0,63795.0,Unknown,29080394,9111392.0,2.0,32,1658,33,1,1,7,44,2,0.6890711828526065,0.5823529411764705,0.6838235294117647,0.0615928629296634,0.0,0.0,0.0747686921730432,0.1247811952988247,0.0505924720131114,0.1428571428571428,0.6279069767441858,0.4583333333333332,356,17,12,36,1,4423,24,122,108,12000000,497916.6666666667,25000000.0,5000000.0,,,4,9950000,-0.4,-0.4
212862,Álex,Remiro,2024,681,Spain,Cascante,Spain,24-03-95,Goalkeeper,Goalkeeper,Right,191.0,30-06-27,Feel Winner,https://img.a.transfermarkt.technology/portrait/header/212862-1694594210.jpg?lm=1,ES1,Real Sociedad de FÃºtbol S.A.D.,25000000.0,25000000.0,29,150,153,5,2,1,2,11,9,2,3,3,1,17,2,2,16,7,12,12,12,12,12,13,12,5,12,1,13,13,13,13,14,12,15,13,13,11,12,14,6,12,4,16,14,15,13,8,15,15,13,16,14,11,13,11,11,5,14,10,16,14,14,20,1,1,1,1,1,1,1,1,1,1,1,1,1,80,10,20,40551639,7493,7493,5493,Mediterranean_Hispanic,147,0,0,42342.0,Unknown,67183918,9111392.0,2.0,89,325,89,2,1,3,168,5,0.7417306165652289,0.582139037433155,0.7205882352941175,0.0408774757219678,0.0,0.0,0.1247811952988247,0.1247811952988247,0.0505924720131114,0.1428571428571428,0.6511627906976742,0.4583333333333332,0,0,0,0,0,0,2,7,31,25000000,953846.1538461539,25000000.0,3000000.0,200000.0,1000000.0,6,7800000,0.0,0.0
213260,Rubén,García,2024,331,Spain,XÃ tiva,Spain,14-07-93,Right Winger,Attack,Left,172.0,30-06-26,Unknown,https://img.a.transfermarkt.technology/portrait/header/213260-1583310204.jpg?lm=1,ES1,Club AtlÃ©tico Osasuna,2500000.0,10000000.0,31,138,150,14,15,14,12,14,14,9,13,4,5,14,13,9,15,11,12,14,13,13,15,14,15,16,7,14,6,14,13,14,14,12,5,12,13,13,11,13,8,12,11,12,1,2,3,1,2,2,2,1,1,1,2,13,14,7,14,13,14,14,10,1,1,1,1,1,1,1,15,15,15,18,20,18,8,72,20,10,7730057,6950,6950,4900,Mediterranean_Hispanic,134,0,0,18853.0,Unknown,67155012,3500000.0,1.0,89,1680,89,0,0,3,51,10,0.6698862132839376,0.5187165775401069,0.625,0.0181960917606775,0.0,0.0,0.0122530632658164,0.0497624406101525,0.0194172060335009,0.0,0.2093023255813952,0.5416666666666665,439,45,51,45,0,3522,15,37,46,2000000,46875.0,10000000.0,2000000.0,,5000000.0,2,800000,-0.2,-0.3333333333333333
213510,Unknown,Jota,2024,982,Portugal,Funchal,Portugal,07-03-93,Attacking Midfield,Midfield,Right,173.0,30-06-25,Wealth Sports,https://img.a.transfermarkt.technology/portrait/header/213510-1534846680.jpg?lm=1,PO1,Clube Desportivo Nacional,75000.0,800000.0,31,140,153,12,14,17,14,15,11,7,14,6,6,13,12,10,16,11,11,10,13,9,14,11,11,18,10,13,7,10,13,14,16,10,8,13,14,11,8,17,7,13,13,6,3,2,2,3,2,1,3,1,2,3,1,16,14,3,16,14,12,10,12,1,1,1,1,1,1,1,15,1,14,20,12,18,1,62,16,20,23253443,7000,6600,3510,Mediterranean_Hispanic,139,0,0,24358.0,Unknown,83111421,9111392.0,2.0,76,518,79,3,1,3,56,0,0.6235776660492194,0.3700534759358288,0.6617647058823528,0.0235118148100582,0.0,0.0,0.0001250312578144,0.0037509377344336,0.0505924720131114,0.1428571428571428,0.2325581395348837,0.5416666666666665,252,7,11,41,5,8064,1,4,32,75000,-1000.0,800000.0,275000.0,100000.0,800000.0,3,125000,0.0,-0.4
213670,Lucas,Torró,2024,331,Spain,Cocentaina,Spain,19-07-94,Defensive Midfield,Midfield,Right,190.0,30-06-27,Unknown,https://img.a.transfermarkt.technology/portrait/header/213670-1533115480.jpg?lm=1,ES1,Club AtlÃ©tico Osasuna,4000000.0,8000000.0,30,130,135,6,8,10,7,13,6,16,9,10,12,13,9,15,12,10,16,17,13,15,9,12,15,6,13,8,16,17,13,10,13,14,16,15,10,14,15,15,13,15,7,9,3,1,3,1,3,1,2,1,2,1,2,12,14,8,12,13,16,10,16,1,1,12,1,1,1,20,1,20,1,1,10,1,1,77,10,20,2506616,6250,6250,4150,Mediterranean_Hispanic,129,0,0,6775.0,Unknown,67158501,1837500.0,4.0,89,373,89,3,1,3,51,4,0.5772691188145012,0.4385026737967914,0.588235294117647,0.0065333664218183,0.0,0.0,0.0197549387346836,0.0397599399849962,0.010180838356621,0.4285714285714285,0.6279069767441858,0.5,315,12,8,74,0,4346,13,53,92,3500000,113793.10344827586,8000000.0,2500000.0,,,4,2900000,-0.125,-0.5625
214532,Pierrick,Capelle,2024,1420,France,Lesquin,France,15-04-87,Central Midfield,Midfield,Left,181.0,30-06-25,FAIR SPORT MNG,https://img.a.transfermarkt.technology/portrait/header/214532-1595883152.jpg?lm=1,FR1,Angers Sporting Club de l'Ouest,250000.0,2000000.0,37,124,128,10,11,12,9,13,11,9,14,6,11,12,10,11,12,10,11,14,12,12,12,12,14,12,10,14,12,15,15,13,14,12,10,16,13,14,12,12,10,15,7,14,4,3,2,2,2,3,1,3,1,3,2,11,12,6,12,13,14,15,15,1,13,1,1,12,1,1,20,16,1,17,13,1,1,73,20,10,198196,6200,6200,3750,Northern_European,124,0,0,9198.0,Unknown,85098947,9111392.0,2.0,34,824,36,3,0,7,18,1,0.5706536120666843,0.3957219251336898,0.5514705882352942,0.0088730570573586,0.0,0.0,0.0010002500625156,0.0097524381095273,0.0505924720131114,0.1428571428571428,0.418604651162791,0.7916666666666665,427,42,23,52,2,3496,2,27,185,200000,2083.3333333333335,2000000.0,800000.0,,,1,400000,-0.2,-0.2
215099,Daley,Sinkgraven,2024,472,Netherlands,Assen,Netherlands,04-07-95,Left-Back,Defender,Left,179.0,30-06-25,V4S,https://img.a.transfermarkt.technology/portrait/header/215099-1658913308.jpg?lm=1,ES1,UniÃ³n Deportiva Las Palmas S.A.D.,1000000.0,9000000.0,29,128,132,12,13,13,6,14,12,9,8,7,9,14,8,10,15,10,10,7,12,9,13,12,11,12,12,14,8,16,13,13,14,12,10,13,13,13,9,11,5,11,14,17,3,4,1,2,3,1,1,2,3,2,3,12,14,7,9,8,13,15,11,1,18,3,1,19,1,10,17,20,1,16,16,1,1,70,20,10,2414311,6400,5756,5001,Northern_European,116,0,0,28747.0,Unknown,37041911,6000000.0,2.0,67,101,68,1,0,7,207,8,0.5119079121460705,0.52951871657754,0.4926470588235294,0.0277499089905726,0.0,0.0,0.0047511877969492,0.0447611902975743,0.0333064807355759,0.1428571428571428,0.3720930232558141,0.4583333333333332,264,9,27,25,1,9713,17,126,372,700000,20312.5,9000000.0,2500000.0,100000.0,3500000.0,3,4500000,-0.3,-0.5333333333333333
215114,Thomas,Foket,2024,58,Belgium,Brussel,Belgium,25-09-94,Right-Back,Defender,Right,177.0,30-06-27,Quadrans,https://img.a.transfermarkt.technology/portrait/header/215114-1639672934.png?lm=1,BE1,Royal Sporting Club Anderlecht,6000000.0,7000000.0,30,124,131,11,14,11,8,11,9,8,9,8,12,10,8,12,12,8,12,14,13,14,10,12,14,10,8,10,14,15,14,14,12,12,8,15,14,15,12,12,5,11,8,8,3,3,1,1,3,3,1,3,2,2,3,15,14,1,14,12,10,10,12,1,1,1,20,1,19,1,1,1,15,1,1,13,1,74,8,20,1773332,6200,6350,5000,Northern_European,121,10,1,13808.0,Unknown,18060678,3500000.0,1.0,7,265,8,1,1,7,175,11,0.590500132310135,0.5294117647058822,0.5294117647058822,0.013324552653661,0.0657894736842105,0.0131578947368421,0.0297574393598399,0.0347586896724181,0.0194172060335009,0.0,0.3255813953488373,0.5,427,5,28,58,1,11120,5,38,130,4000000,120312.5,7000000.0,2000000.0,600000.0,2500000.0,4,3700000,-0.3333333333333333,-0.42857142857142855
215122,Ivo,Rodrigues,2024,8024,Portugal,Baguim do Monte,Portugal,30-03-95,Right Winger,Attack,Right,180.0,30-06-26,Universal Twenty Two,https://img.a.transfermarkt.technology/portrait/header/215122-1716230209.png?lm=1,PO1,Futebol Clube de Arouca,1300000.0,2000000.0,29,125,130,12,14,13,14,13,13,9,14,7,7,13,12,8,14,8,12,12,11,11,13,9,15,13,7,13,7,12,14,14,13,12,9,12,14,13,7,13,6,7,10,10,3,3,1,3,2,3,1,1,3,1,3,8,13,11,13,11,10,10,11,1,1,1,1,1,1,1,12,1,12,20,13,18,15,70,9,20,2672998,6250,6250,4750,Mediterranean_Hispanic,123,0,0,3149.0,Unknown,55062071,9111392.0,2.0,76,127,79,0,1,3,98,10,0.5772691188145012,0.5026737967914437,0.5441176470588236,0.0030320382152689,0.0,0.0,0.0062515628907226,0.0097524381095273,0.0505924720131114,0.1428571428571428,0.3953488372093026,0.4583333333333332,344,44,47,84,1,4530,5,16,28,1000000,16666.666666666668,2000000.0,500000.0,600000.0,1500000.0,9,3450000,-0.23076923076923078,-0.23076923076923078
215592,Haris,Hajradinovic,2024,10484,Macedonia,Prilep,Bosnia-Herzegovina,18-02-94,Attacking Midfield,Midfield,Left,178.0,30-06-26,Unknown,https://img.a.transfermarkt.technology/portrait/header/215592-1727699365.jpg?lm=1,TR1,Kas?mpa?a Spor KulÃ¼bÃ¼,2500000.0,3300000.0,30,120,130,12,14,13,12,15,13,6,13,6,5,17,16,11,16,13,13,9,13,10,16,12,12,16,8,12,7,14,12,11,12,11,7,13,11,13,10,13,13,13,7,12,3,2,1,3,2,3,3,1,2,2,4,12,11,10,10,10,13,8,7,1,8,1,1,12,1,12,14,18,12,14,20,12,7,70,20,8,2812109,5950,5338,4741,Northern_European,121,5,1,6787.0,Unknown,21020532,9111392.0,2.0,60,1186,10,3,0,7,117,0,0.4566022757343212,0.5017112299465241,0.5294117647058822,0.0065449538290104,0.0328947368421052,0.0131578947368421,0.0122530632658164,0.0162540635158789,0.0505924720131114,0.1428571428571428,0.3488372093023257,0.5,402,66,75,63,2,4602,3,10,20,2000000,59375.0,3300000.0,600000.0,100000.0,375000.0,6,1050000,-0.25925925925925924,-0.2
215599,Lukas,Klostermann,2024,23826,Germany,Gevelsberg,Germany,03-06-96,Centre-Back,Defender,Right,189.0,30-06-28,EMG Mundial,https://img.a.transfermarkt.technology/portrait/header/215599-1724337278.jpg?lm=1,L1,RasenBallsport Leipzig,8000000.0,38000000.0,28,137,142,5,10,8,9,10,6,12,6,15,12,11,7,13,11,12,14,16,10,12,9,11,15,7,11,14,11,13,14,13,9,15,15,16,18,17,15,13,10,15,7,16,1,2,1,1,1,1,2,3,2,1,3,12,16,6,7,13,13,15,17,1,16,15,20,14,18,1,8,1,10,8,1,10,1,88,11,20,13628164,7000,7000,5250,Northern_European,126,18,0,95889.0,Unknown,91134708,1000000.0,1.0,38,537,40,1,1,7,162,2,0.6765017200317545,0.5561497326203209,0.5661764705882353,0.092583383464963,0.1184210526315789,0.0,0.0397599399849962,0.1897974493623406,0.0055279313314258,0.0,0.6046511627906974,0.4166666666666665,383,21,15,20,0,8117,20,114,193,8000000,239393.9393939394,38000000.0,7000000.0,500000.0,3000000.0,1,0,0.0,0.0
215864,Mijat,Gacinovic,2024,2441,Yugoslavia (Republic),Novi Sad,Serbia,08-02-95,Attacking Midfield,Midfield,Right,175.0,30-06-26,Unknown,https://img.a.transfermarkt.technology/portrait/header/215864-1728415885.png?lm=1,GR1,Athlitiki Enosi Konstantinoupoleos,3000000.0,11000000.0,29,125,130,10,12,15,8,15,9,9,11,6,8,12,11,8,14,13,12,10,10,12,12,11,13,15,10,14,8,15,15,15,15,9,8,13,13,13,6,12,8,13,11,16,4,1,1,2,4,4,3,1,2,3,1,13,15,7,11,11,15,10,11,1,1,1,1,1,1,1,14,17,14,17,20,14,1,67,10,20,2969999,6000,6850,5000,Mediterranean_Hispanic,120,23,2,23653.0,Unknown,62096212,1625000.0,4.0,110,1058,85,3,1,3,34,0,0.6566551997883038,0.5294117647058822,0.5220588235294117,0.0228310546375217,0.1513157894736842,0.0263157894736842,0.0147536884221055,0.0547636909227306,0.0090002500069446,0.4285714285714285,0.2790697674418605,0.4583333333333332,362,40,39,61,0,8859,29,57,32,2500000,90000.0,11000000.0,2000000.0,400000.0,1750000.0,4,2050000,-0.16666666666666666,-0.2857142857142857
215876,Ricardo,Pereira,2024,1003,Portugal,Lisboa,Portugal,06-10-93,Right-Back,Defender,Right,175.0,30-06-26,Gestifute,https://img.a.transfermarkt.technology/portrait/header/215876-1720192308.jpg?lm=1,GB1,Leicester City Football Club,8000000.0,40000000.0,31,142,165,9,14,14,11,12,8,6,12,7,12,12,12,16,14,11,14,13,13,12,13,13,15,13,7,14,14,15,16,15,13,13,9,10,14,13,10,14,9,12,16,16,3,1,3,4,1,3,4,1,1,3,1,12,15,6,13,14,15,15,12,1,13,1,20,12,17,1,1,1,13,12,1,18,7,70,10,20,26028545,7100,7100,5750,African_Caribbean,133,7,0,139190.0,Unknown,55062009,9111392.0,2.0,76,843,79,1,1,1,127,11,0.6897327335273882,0.6096256684491979,0.6176470588235294,0.1343955767004278,0.0460526315789473,0.0,0.0397599399849962,0.1997999499874969,0.0505924720131114,0.1428571428571428,0.2790697674418605,0.5416666666666665,365,27,37,63,0,9946,8,99,311,7000000,230000.0,40000000.0,8000000.0,300000.0,4000000.0,5,5700000,-0.125,-0.2222222222222222
215977,Adrien,Thomasson,2024,826,France,Bourg-Saint-Maurice,France,10-12-93,Attacking Midfield,Midfield,Right,175.0,30-06-26,One Team Football ,https://img.a.transfermarkt.technology/portrait/header/215977-1673538425.jpg?lm=1,FR1,Racing Club de Lens,5000000.0,9000000.0,31,132,134,12,12,13,12,12,10,12,13,12,10,13,11,11,13,11,12,12,12,9,14,12,14,12,11,14,11,13,17,15,13,12,9,15,14,14,13,12,14,12,13,12,1,1,1,2,2,1,2,3,2,1,2,12,13,7,14,12,11,9,13,1,1,1,1,1,1,13,18,20,12,12,13,14,1,72,8,20,5770998,6600,6600,4268,Northern_European,129,0,0,13798.0,Unknown,85128018,2350000.0,2.0,34,233,36,3,1,7,158,0,0.6235776660492194,0.4511229946524063,0.588235294117647,0.0133148964810009,0.0,0.0,0.0247561890472618,0.0447611902975743,0.0130281396705464,0.1428571428571428,0.2790697674418605,0.5416666666666665,406,63,49,56,3,3987,7,16,46,5000000,194000.0,9000000.0,3000000.0,,,3,1250000,0.0,-0.16666666666666666
216179,Stefano,Sensi,2024,2919,Italy,Urbino,Italy,05-08-95,Central Midfield,Midfield,Right,168.0,30-06-25,GR Sports,https://img.a.transfermarkt.technology/portrait/header/216179-1692962617.jpg?lm=1,IT1,Associazione Calcio Monza,3000000.0,30000000.0,29,137,150,11,13,12,11,16,16,4,13,5,6,16,12,10,16,11,15,11,15,12,15,15,15,16,11,13,13,16,12,13,16,10,4,7,13,10,7,11,8,15,20,11,2,3,2,2,1,1,2,3,1,2,3,12,15,9,12,15,16,15,13,1,1,1,1,1,1,18,1,20,1,1,16,1,1,63,12,20,4423330,6846,6746,6246,Mediterranean_Hispanic,136,9,3,71154.0,Brianza,43109319,15125000.0,2.0,52,1550,54,3,1,3,28,1,0.6428949457528447,0.6626737967914438,0.6397058823529411,0.0686988403902252,0.0592105263157894,0.0394736842105263,0.0147536884221055,0.1497874468617154,0.0840023333981499,0.1428571428571428,0.1162790697674416,0.4583333333333332,304,34,20,59,2,4651,28,128,69,1500000,45967.74193548387,30000000.0,6000000.0,450000.0,4000000.0,8,22600000,-0.5,-0.625
216240,Lucas,Olaza,2024,16704,Uruguay,Montevideo,Uruguay,21-07-94,Left-Back,Defender,Left,173.0,30-06-25,Sport Business,https://img.a.transfermarkt.technology/portrait/header/216240-1692083558.png?lm=1,RU1,FK Krasnodar,3000000.0,6000000.0,30,122,135,13,15,11,10,11,15,9,13,15,13,12,13,13,12,11,14,12,13,13,11,13,11,10,11,13,11,12,12,14,13,12,10,15,13,13,10,12,12,12,8,11,2,3,3,1,3,2,2,1,2,3,3,14,12,5,8,9,11,14,8,1,20,1,1,16,1,1,12,1,1,1,1,1,1,68,20,6,1412938,6100,6100,3250,Mediterranean_Hispanic,123,0,0,4790.0,Unknown,78048502,1960000.0,4.0,106,975,103,1,0,3,78,8,0.5574225985710506,0.3422459893048128,0.5441176470588236,0.00461661614879,0.0,0.0,0.0147536884221055,0.0297574393598399,0.0108614128170226,0.4285714285714285,0.2325581395348837,0.5,301,23,24,56,1,5689,9,33,96,3500000,130769.23076923077,6000000.0,2000000.0,150000.0,500000.0,10,3100000,0.16666666666666666,0.16666666666666666
216443,Riechedly,Bazoer,2024,2293,Netherlands,Utrecht,Curacao,12-10-96,Centre-Back,Defender,Right,184.0,30-06-26,Irchandly Bazoer,https://img.a.transfermarkt.technology/portrait/header/216443-1727457389.png?lm=1,TR1,Konyaspor,3800000.0,15000000.0,28,133,145,8,9,13,10,13,14,12,13,8,11,14,11,12,15,17,12,16,13,10,14,10,12,13,9,14,11,14,15,13,13,15,12,16,13,13,14,11,8,11,7,16,3,2,1,2,3,2,2,3,1,2,1,12,18,18,7,10,7,10,8,1,1,18,1,1,1,19,1,20,1,1,12,1,1,74,12,20,9169874,6500,6500,6000,African_Caribbean,132,6,0,10000.0,Unknown,37041762,6750000.0,2.0,67,1551,26,1,1,1,125,2,0.6103466525535857,0.6363636363636364,0.6102941176470589,0.009647482104698,0.0394736842105263,0.0,0.018754688672168,0.0747686921730432,0.0374732631461985,0.1428571428571428,0.4883720930232553,0.4166666666666665,363,23,24,70,3,10199,26,71,54,3500000,97857.14285714286,15000000.0,3000000.0,3500000.0,10000000.0,6,5050000,-0.125,-0.125
216569,Jérémie,Boga,2024,417,France,Marseille,Cote d'Ivoire,03-01-97,Left Winger,Attack,Right,172.0,30-06-27,LIAN Sports Group,https://img.a.transfermarkt.technology/portrait/header/216569-1661509174.jpg?lm=1,FR1,Olympique Gymnaste Club Nice CÃ´te d'Azur,15000000.0,25000000.0,27,137,145,10,11,19,12,15,12,6,14,4,4,14,11,5,17,8,10,8,12,6,12,10,13,18,7,14,3,9,9,16,17,12,4,13,16,11,11,10,8,12,12,14,1,3,2,1,2,3,1,1,3,1,4,13,15,7,11,10,13,10,14,1,1,1,1,1,1,1,14,1,8,20,18,13,14,72,9,20,20850322,6847,6847,5747,African_Caribbean,129,10,1,53462.0,Unknown,28084880,16333333.33,3.0,34,919,24,0,1,1,142,7,0.6562582693834348,0.6093048128342246,0.588235294117647,0.0516151397199903,0.0657894736842105,0.0131578947368421,0.0747686921730432,0.1247811952988247,0.0907154828189671,0.2857142857142857,0.2093023255813952,0.375,347,51,37,1,0,7970,15,72,92,15000000,608695.6521739131,25000000.0,4000000.0,1000000.0,2500000.0,5,3000000,0.0,0.0
216599,Domen,Crnigoj,2024,607,Slovenia,Koper,Slovenia,18-11-95,Central Midfield,Midfield,Right,188.0,30-06-26,AR Sport Management,https://img.a.transfermarkt.technology/portrait/header/216599-1725528301.jpg?lm=1,IT1,Venezia Football Club,900000.0,2000000.0,29,122,130,7,12,13,12,13,7,12,13,4,10,13,10,12,14,15,13,15,12,13,12,13,16,16,9,14,11,14,13,13,12,12,12,14,12,13,13,14,14,11,10,12,3,3,4,3,3,1,1,1,2,2,3,15,15,10,14,10,14,14,12,1,1,1,1,1,1,1,1,20,17,1,15,13,1,73,9,20,2743013,6100,6500,4800,Northern_European,123,24,3,5994.0,Unknown,62123347,9111392.0,2.0,87,746,87,3,1,7,210,1,0.6103466525535857,0.5080213903743315,0.5441176470588236,0.0057792193370651,0.1578947368421052,0.0394736842105263,0.0042510627656914,0.0097524381095273,0.0505924720131114,0.1428571428571428,0.581395348837209,0.4583333333333332,363,21,26,57,0,4908,16,82,81,900000,27419.354838709678,2000000.0,500000.0,400000.0,750000.0,5,550000,0.0,-0.25
216603,?Rfan Can,Kahveci,2024,36,TÃ¼rkiye,Corum,TÃ¼rkiye,15-07-95,Right Winger,Attack,Left,180.0,30-06-25,DW Sports Management,https://img.a.transfermarkt.technology/portrait/header/216603-1728391961.JPG?lm=1,TR1,FenerbahÃ§e Spor KulÃ¼bÃ¼,10000000.0,11500000.0,29,135,145,16,17,16,12,15,17,12,17,5,3,16,12,8,17,8,12,11,17,10,14,12,12,15,10,12,8,11,9,11,10,14,9,12,13,12,11,5,11,12,14,11,3,2,2,2,3,1,3,1,3,4,3,16,14,7,10,14,10,7,10,1,4,4,1,4,1,16,5,16,5,10,20,18,1,71,20,9,11365142,6785,6785,6393,Mediterranean_Hispanic,126,21,1,26588.0,Unknown,70075229,4305000.0,2.0,100,387,100,0,0,3,84,10,0.6480550410161419,0.6783957219251336,0.5661764705882353,0.0256651413132587,0.1381578947368421,0.0131578947368421,0.0497624406101525,0.0572643160790197,0.023889552487569,0.1428571428571428,0.3953488372093026,0.4583333333333332,424,66,60,70,4,8384,25,86,38,9500000,277941.17647058825,11500000.0,2000000.0,,2000000.0,4,2450000,-0.05,0.05555555555555555
216662,Deniz,Türüç,2024,6890,Netherlands,Enschede,TÃ¼rkiye,29-01-93,Right Winger,Attack,Left,177.0,30-06-26,OER-SPORTS,https://img.a.transfermarkt.technology/portrait/header/216662-1695643570.png?lm=1,TR1,?stanbul Ba?ak?ehir Futbol KulÃ¼bÃ¼,1700000.0,6000000.0,31,125,135,13,15,14,12,15,16,5,14,6,8,14,14,8,15,10,11,10,14,10,14,11,12,16,6,11,8,12,12,11,13,13,8,14,12,13,12,12,11,15,7,14,2,3,1,2,1,3,3,2,1,2,2,20,15,8,10,14,13,10,13,1,10,1,1,10,1,1,15,20,15,15,18,15,1,77,20,10,4460771,6300,6300,5010,Mediterranean_Hispanic,119,11,2,12612.0,Unknown,168236,1600000.0,2.0,67,465,100,0,0,3,4,10,0.5838846255623181,0.5304812834224598,0.5147058823529411,0.012169674403514,0.0723684210526315,0.0263157894736842,0.0082520630157539,0.0297574393598399,0.0088613572599238,0.1428571428571428,0.3255813953488373,0.5416666666666665,478,70,69,98,3,6636,12,31,68,1500000,40277.77777777778,6000000.0,2000000.0,,300000.0,3,4200000,-0.11764705882352941,-0.2857142857142857
216870,Nacho,Vidal,2024,331,Spain,El Campello,Spain,24-01-95,Right-Back,Defender,Right,180.0,30-06-25,Promoesport,https://img.a.transfermarkt.technology/portrait/header/216870-1510233362.jpg?lm=1,ES1,Club AtlÃ©tico Osasuna,2000000.0,5000000.0,29,127,138,8,13,12,8,10,7,9,8,13,11,11,10,13,12,11,13,13,12,14,10,11,12,12,11,14,13,14,14,14,13,11,10,13,14,15,11,14,12,11,8,13,3,2,2,1,2,4,3,3,1,3,3,17,11,5,14,12,12,12,16,1,1,12,20,1,19,1,1,1,13,1,1,1,1,0,11,20,2624031,6400,6400,4400,Mediterranean_Hispanic,124,0,0,8662.0,Unknown,67184889,9111392.0,2.0,89,452,89,1,1,3,51,11,0.5971156390579518,0.4652406417112299,0.5514705882352942,0.0083554862027776,0.0,0.0,0.0097524381095273,0.0247561890472618,0.0505924720131114,0.1428571428571428,0.3953488372093026,0.4583333333333332,281,9,9,56,0,3810,5,25,61,1500000,54545.454545454544,5000000.0,2000000.0,,,4,2700000,-0.25,-0.4
217033,Aleksey,Sutormin,2024,1083,Russia,Moskau,Russia,10-01-94,Right Winger,Attack,Right,188.0,30-06-25,Unknown,https://img.a.transfermarkt.technology/portrait/header/217033-1721723881.png?lm=1,RU1,FK Rostov,1500000.0,3500000.0,30,126,128,11,10,10,13,11,11,13,12,8,6,13,12,13,12,9,12,9,11,13,11,11,16,10,6,12,11,13,13,14,12,13,13,10,13,13,12,14,5,10,5,14,1,1,2,1,2,4,4,3,4,1,2,19,12,3,12,12,8,10,18,1,1,1,15,7,18,1,14,8,20,14,14,17,10,79,13,20,2349576,6000,6000,3750,Northern_European,119,3,1,29489.0,Unknown,58085174,2500000.0,2.0,78,985,81,0,1,7,81,10,0.5441915850754168,0.3957219251336898,0.5147058823529411,0.0284663970019515,0.0197368421052631,0.0131578947368421,0.0072518129532383,0.0172543135783946,0.0138614961526709,0.1428571428571428,0.581395348837209,0.5,358,68,31,44,0,7325,0,0,0,1200000,47000.0,3500000.0,600000.0,25000.0,,5,1425000,0.0,-0.2
217111,Hakim,Ziyech,2024,141,Netherlands,Dronten,Morocco,19-03-93,Right Winger,Attack,Left,180.0,30-06-25,HZ INTERNATIONAL,https://img.a.transfermarkt.technology/portrait/header/217111-1701255091.png?lm=1,TR1,Galatasaray Spor KulÃ¼bÃ¼,7000000.0,50000000.0,31,150,160,14,14,15,10,16,16,10,14,7,6,15,13,6,16,13,17,13,13,10,17,9,14,17,11,14,6,12,12,14,16,12,10,15,13,15,9,11,10,14,6,15,3,1,3,2,2,1,1,1,1,3,4,14,14,12,14,14,15,15,12,1,1,1,1,1,1,1,17,19,17,17,20,19,13,68,20,13,41548240,7490,7490,6490,North_African__Middle_Eastern,144,40,17,115992.0,Unknown,37040604,18166666.67,3.0,67,432,67,0,0,6,102,10,0.7413336861603599,0.6887700534759358,0.6985294117647058,0.1119951873635462,0.2631578947368421,0.2236842105263157,0.0347586896724181,0.2498124531132783,0.1009009509708603,0.2857142857142857,0.3953488372093026,0.5416666666666665,488,133,141,58,0,11430,25,84,48,5000000,132432.43243243243,50000000.0,10000000.0,,2500000.0,4,3000000,-0.4444444444444444,-0.5833333333333334
217115,Neal,Maupay,2024,244,France,Versailles,France,14-08-96,Centre-Forward,Attack,Right,171.0,30-06-25,TTMA,https://img.a.transfermarkt.technology/portrait/header/217115-1700737951.jpg?lm=1,FR1,Olympique de Marseille,12000000.0,22000000.0,28,133,145,6,10,11,14,14,7,13,13,5,7,13,13,9,14,17,14,17,12,14,14,12,15,13,11,15,9,14,16,14,14,15,8,15,13,15,14,14,14,11,7,8,2,1,1,3,3,2,3,2,1,3,2,14,13,5,14,13,12,5,8,1,1,1,1,1,1,1,1,1,1,1,1,1,20,69,10,20,34262112,6800,6700,5400,Mediterranean_Hispanic,135,0,0,57996.0,Unknown,85120748,7490000.0,4.0,34,1578,36,0,1,3,144,3,0.6368086795448531,0.5721925133689839,0.6323529411764706,0.055993248404076,0.0,0.0,0.0597649412353088,0.1097774443610902,0.0415844884580127,0.4285714285714285,0.1860465116279068,0.4166666666666665,393,106,36,55,2,5935,6,76,245,12000000,366666.6666666667,22000000.0,4500000.0,2000000.0,2000000.0,7,9500000,0.0,0.2
217863,Unknown,Guilherme,2024,2293,Brazil,Porto Alegre,Brazil,01-04-90,Left-Back,Defender,Right,180.0,30-06-25,Jose Renato Martinez,https://img.a.transfermarkt.technology/portrait/header/217863-1727457675.png?lm=1,TR1,Konyaspor,650000.0,2200000.0,34,130,135,8,12,12,10,12,10,13,13,8,13,14,9,13,13,14,14,16,15,12,13,12,15,8,13,12,14,17,16,11,12,13,10,15,11,15,12,12,12,13,7,10,1,3,3,2,1,2,3,2,1,3,3,11,12,12,9,14,15,9,12,1,1,1,1,1,1,20,1,19,1,1,1,1,1,77,9,20,8581463,6483,6486,3986,Mediterranean_Hispanic,130,0,0,57533.0,Unknown,19105719,100000.0,1.0,10,1171,11,1,1,3,125,8,0.6084943106641969,0.4209625668449197,0.5955882352941175,0.0555461676099138,0.0,0.0,0.0030007501875468,0.010752688172043,0.0005277924386788,0.0,0.3953488372093026,0.6666666666666665,467,16,78,51,1,6788,3,9,17,650000,13888.888888888889,2200000.0,900000.0,,,7,2525000,-0.07142857142857142,-0.35
217879,Patrik,Hrosovsky,2024,1184,CSSR,Bojnice,Slovakia,22-04-92,Central Midfield,Midfield,Right,173.0,30-06-25,SPOCS Global Sports,https://img.a.transfermarkt.technology/portrait/header/217879-1714038111.png?lm=1,BE1,Koninklijke Racing Club Genk,3500000.0,6500000.0,32,126,140,10,11,13,13,13,12,5,13,6,9,14,16,5,14,12,13,13,14,14,12,15,14,15,8,11,13,11,14,12,14,12,7,6,14,13,12,12,12,10,12,14,2,1,2,1,1,1,1,1,2,2,2,7,10,5,13,13,12,9,11,1,1,1,1,1,1,20,1,19,1,1,1,1,1,67,10,20,2078505,6000,6550,5000,Northern_European,121,44,0,29999.0,Unknown,25034467,5200000.0,1.0,14,218,86,3,1,7,122,1,0.6169621593014025,0.5294117647058822,0.5294117647058822,0.0289588618076162,0.2894736842105263,0.0,0.0172543135783946,0.032258064516129,0.0288619128309119,0.0,0.2325581395348837,0.5833333333333333,496,39,43,47,0,13276,1,1,7,3000000,90625.0,6500000.0,1000000.0,,150000.0,3,950000,-0.14285714285714285,-0.3333333333333333
220635,Martin,Ádám,2024,6676,Hungary,Szeged,Hungary,06-11-94,Centre-Forward,Attack,Left,191.0,30-06-26,YUNiK Management,https://img.a.transfermarkt.technology/portrait/header/220635-1727786936.jpg?lm=1,GR1,A.G.S Asteras Tripolis,700000.0,1000000.0,30,121,129,6,8,10,14,13,9,16,13,4,8,11,15,8,14,11,12,13,14,13,13,14,12,7,12,13,9,12,12,9,8,12,17,10,9,12,18,8,9,8,8,12,2,3,2,3,1,1,3,3,3,2,1,8,11,5,8,10,12,12,10,1,1,1,1,1,1,1,1,10,1,1,15,1,20,91,20,12,1103222,5849,5415,2505,Northern_European,124,6,0,4190.0,Unknown,38034947,9111392.0,2.0,45,1444,47,0,0,7,5,3,0.4667901561259593,0.262566844919786,0.5514705882352942,0.0040372457891845,0.0394736842105263,0.0,0.0032508127031757,0.0047511877969492,0.0505924720131114,0.1428571428571428,0.6511627906976742,0.5,343,110,42,69,0,6355,1,2,14,600000,27380.95238095238,1000000.0,200000.0,25000.0,100000.0,5,400000,-0.25,-0.4
220656,László,Kleinheisler,2024,265,Hungary,Kazincbarcika,Hungary,08-04-94,Attacking Midfield,Midfield,Right,173.0,30-06-26,Vladan Filipovic,https://img.a.transfermarkt.technology/portrait/header/220656-1663607341.jpg?lm=1,GR1,Panathinaikos Athlitikos Omilos,1200000.0,3000000.0,30,127,129,12,11,13,12,13,12,7,14,8,10,12,10,9,14,17,11,16,11,11,12,10,17,14,10,13,8,13,16,14,14,16,7,15,13,12,11,12,10,14,4,15,3,1,2,1,3,2,2,3,3,2,3,11,16,10,13,13,10,10,7,1,1,1,1,1,1,1,16,16,16,16,20,16,10,70,11,20,1555092,6193,6193,5043,Northern_European,124,42,3,6711.0,Unknown,38034285,500000.0,3.0,45,718,47,3,1,7,150,0,0.5697274411219899,0.5340106951871657,0.5514705882352942,0.0064715669167937,0.2763157894736842,0.0394736842105263,0.0057514378594648,0.0147536884221055,0.0027500763910108,0.2857142857142857,0.2325581395348837,0.5,331,39,39,37,0,10149,6,36,173,1000000,33620.68965517241,3000000.0,500000.0,25000.0,150000.0,9,1250000,-0.3333333333333333,-0.3333333333333333
220793,Douglas,Santos,2024,964,Brazil,JoÃ£o Pessoa,Brazil,22-03-94,Left-Back,Defender,Left,176.0,30-06-27,Roc Nation Sports,https://img.a.transfermarkt.technology/portrait/header/220793-1721722607.png?lm=1,RU1,AO FK Zenit Sankt-Peterburg,12000000.0,18000000.0,30,144,144,14,14,13,11,14,14,8,14,14,11,14,12,13,14,11,14,10,16,13,13,15,14,11,13,10,13,14,12,14,15,12,9,14,12,14,10,17,12,13,7,8,3,2,3,3,2,1,1,1,1,1,2,7,13,9,12,12,12,9,10,1,20,16,13,18,1,17,13,13,1,11,1,1,1,70,20,9,24010022,7255,7251,5511,Mixed_Race,137,1,0,52681.0,Unknown,19187721,5620000.0,5.0,10,692,11,1,0,4,7,8,0.7097115639057952,0.5840641711229946,0.6470588235294117,0.0508609926352371,0.006578947368421,0.0,0.0597649412353088,0.0897724431107777,0.0311953109808605,0.5714285714285714,0.3023255813953489,0.5,432,15,51,43,0,10426,5,12,24,10000000,320967.7419354839,18000000.0,3000000.0,400000.0,3000000.0,5,4000000,-0.16666666666666666,-0.3333333333333333
220878,Issiaga,Sylla,2024,969,Guinea,Conakry,Guinea,01-01-94,Left-Back,Defender,Left,180.0,30-06-25,P.P.M.,https://img.a.transfermarkt.technology/portrait/header/220878-1702665492.JPG?lm=1,FR1,Montpellier HÃ©rault Sport Club,2500000.0,3500000.0,30,122,130,9,10,12,10,11,9,14,9,13,13,11,7,13,11,13,12,14,7,10,9,11,12,8,6,11,12,14,15,15,14,13,13,14,14,15,13,11,13,11,7,19,1,1,2,3,1,1,1,2,2,2,2,14,12,5,9,12,14,14,20,1,20,10,1,17,1,1,14,1,1,1,1,1,1,75,20,5,1259670,6092,6492,3742,African_Caribbean,120,68,3,4838.0,Unknown,85125565,9111392.0,2.0,43,378,44,1,0,1,133,8,0.6092881714739349,0.3948663101604278,0.5220588235294117,0.0046629657775584,0.4473684210526315,0.0394736842105263,0.0122530632658164,0.0172543135783946,0.0505924720131114,0.1428571428571428,0.3953488372093026,0.5,327,15,22,45,1,4261,5,24,68,2000000,64814.81481481482,3500000.0,1000000.0,,3000000.0,5,1300000,-0.2,-0.2
221025,André,Gomes,2024,1082,Portugal,GrijÃ³,Portugal,30-07-93,Central Midfield,Midfield,Right,190.0,30-06-26,Wasserman,https://img.a.transfermarkt.technology/portrait/header/221025-1666691237.jpg?lm=1,FR1,Lille Olympique Sporting Club Lille MÃ©tropole,10000000.0,30000000.0,31,130,161,11,12,11,11,16,13,10,9,9,8,15,14,12,17,10,13,9,16,11,13,15,12,13,9,12,11,14,14,8,10,13,12,13,11,12,14,13,12,14,10,13,2,1,2,4,1,1,2,3,3,2,3,13,12,5,13,11,15,14,12,1,1,1,10,1,12,13,10,20,13,9,14,1,1,84,14,20,12530679,6399,6599,5499,Mediterranean_Hispanic,130,29,0,139190.0,LOSC Lille,55027994,27333333.33,3.0,76,563,79,3,1,3,128,1,0.6234453559142631,0.5827807486631016,0.5955882352941175,0.1343955767004278,0.1907894736842105,0.0,0.0497624406101525,0.1497874468617154,0.1518282915080974,0.2857142857142857,0.6279069767441858,0.5416666666666665,372,32,29,78,1,9919,17,111,113,8000000,218750.0,30000000.0,7000000.0,,15000000.0,6,33000000,-0.2,-0.3333333333333333
221311,Iván,Sánchez,2024,366,Spain,JaÃ©n,Spain,23-09-92,Right Winger,Attack,Left,169.0,30-06-25,JV SPORTS ,https://img.a.transfermarkt.technology/portrait/header/221311-1601023639.jpg?lm=1,ES1,Real Valladolid Club de FÃºtbol S.A.D.,1000000.0,1200000.0,32,126,145,13,14,16,11,15,14,7,8,6,8,13,10,7,15,8,11,11,10,12,15,12,13,12,8,16,8,12,12,14,11,10,9,10,13,11,7,9,3,13,13,10,1,1,2,1,2,3,2,1,1,2,2,12,10,8,10,10,11,11,15,1,1,1,1,1,1,1,17,15,18,17,17,20,1,60,20,10,2607408,6299,6299,4249,Mediterranean_Hispanic,121,0,0,7258.0,Unknown,67140188,125000.0,2.0,89,686,89,0,0,3,169,10,0.5837523154273617,0.449090909090909,0.5294117647058822,0.0069997595613007,0.0,0.0,0.0047511877969492,0.0057514378594648,0.0006666851856996,0.1428571428571428,0.13953488372093,0.5833333333333333,475,38,35,64,1,6281,2,22,115,600000,25000.0,1200000.0,400000.0,,,6,550000,-0.4,-0.4
221316,Lucas,Vázquez,2024,418,Spain,A CoruÃ±a,Spain,01-07-91,Right-Back,Defender,Right,173.0,30-06-25,AC Talent,https://img.a.transfermarkt.technology/portrait/header/221316-1536655786.jpg?lm=1,ES1,Real Madrid Club de FÃºtbol,4000000.0,25000000.0,33,147,156,14,13,12,11,13,11,10,11,8,12,13,12,13,13,15,15,14,11,14,11,14,14,14,11,14,13,15,16,14,15,15,7,14,14,15,11,13,8,13,6,16,2,3,3,2,2,3,1,2,1,2,2,9,10,4,14,13,15,14,16,1,1,1,16,1,18,1,1,1,20,1,1,16,1,71,12,20,15126039,7350,7350,6500,Mediterranean_Hispanic,143,9,0,123288.0,Unknown,67135344,9111392.0,2.0,89,7,89,1,1,3,167,11,0.7228102672664726,0.6898395721925134,0.6911764705882353,0.1190403309363494,0.0592105263157894,0.0,0.0197549387346836,0.1247811952988247,0.0505924720131114,0.1428571428571428,0.2325581395348837,0.625,511,57,91,67,0,9813,16,57,81,3500000,91176.4705882353,25000000.0,6000000.0,,,2,2000000,-0.125,-0.3
221322,José,Gayà,2024,1049,Spain,Pedreguer,Spain,25-05-95,Left-Back,Defender,Left,172.0,30-06-27,Unknown,https://img.a.transfermarkt.technology/portrait/header/221322-1605193468.jpg?lm=1,ES1,Valencia Club de FÃºtbol S. A. D.,25000000.0,50000000.0,29,159,160,14,14,14,8,15,14,5,11,8,12,14,13,14,16,12,15,13,14,14,15,16,16,14,15,16,14,15,15,17,16,13,7,14,16,15,11,16,9,14,8,13,2,2,1,1,2,4,2,3,3,2,3,12,12,6,20,15,17,14,10,1,20,1,1,19,1,1,18,1,1,15,1,1,1,66,20,7,50872500,7850,7850,7200,Mediterranean_Hispanic,156,17,3,67280.0,Unknown,67178177,9111392.0,2.0,89,1132,89,1,0,3,208,8,0.7889653347446415,0.7647058823529411,0.7867647058823528,0.0649580391017055,0.1118421052631578,0.0394736842105263,0.1247811952988247,0.2498124531132783,0.0505924720131114,0.1428571428571428,0.2093023255813952,0.4583333333333332,429,15,43,94,1,6372,27,113,120,15000000,435294.1176470588,50000000.0,10000000.0,1000000.0,18000000.0,1,1500000,-0.4,-0.5
221540,Kiril,Despodov,2024,1091,Bulgaria,Kresna,Bulgaria,11-11-96,Right Winger,Attack,Right,180.0,30-06-27,Universal Twenty Two,https://img.a.transfermarkt.technology/portrait/header/221540-1727967569.png?lm=1,GR1,Panthessalonikios Athlitikos Omilos Konstantinoupoliton,7000000.0,7000000.0,28,133,148,14,14,13,12,12,15,11,12,6,5,13,13,5,14,11,12,7,12,10,13,11,16,16,12,13,6,12,8,16,14,13,11,14,16,10,11,11,7,15,10,14,1,2,4,1,1,2,3,4,2,3,1,11,16,9,14,14,14,9,9,1,1,1,1,1,1,1,11,1,11,20,10,20,15,75,9,20,4141797,6650,6650,5300,Northern_European,126,31,6,10000.0,Unknown,22051266,2900000.0,3.0,11,760,12,0,1,7,153,10,0.6301931727970362,0.5614973262032085,0.5661764705882353,0.009647482104698,0.2039473684210526,0.0789473684210526,0.0347586896724181,0.0347586896724181,0.0160837801050029,0.2857142857142857,0.3953488372093026,0.4166666666666665,385,102,120,58,0,11262,7,21,117,8000000,290740.74074074073,8000000.0,800000.0,250000.0,500000.0,6,1750000,0.14285714285714285,0.7777777777777778
221958,Roman,Yaremchuk,2024,683,Ukraine,Lviv,Ukraine,27-11-95,Centre-Forward,Attack,Right,191.0,30-06-28,Vision Foot,https://img.a.transfermarkt.technology/portrait/header/221958-1728418250.png?lm=1,GR1,Olympiakos Syndesmos Filathlon Peiraios,3500000.0,17500000.0,29,130,136,8,11,13,13,14,8,12,12,6,3,13,11,4,15,13,11,12,16,12,14,13,12,8,7,12,6,13,11,12,14,12,15,12,13,13,12,11,8,13,11,5,3,4,2,2,1,2,1,2,3,2,3,8,12,11,12,11,15,14,11,1,1,1,1,1,1,1,1,1,1,14,14,14,20,78,13,20,8999999,6500,6500,5000,Northern_European,129,40,13,44999.0,Unknown,71068795,9500000.0,4.0,103,881,101,0,1,7,141,3,0.6103466525535857,0.5294117647058822,0.588235294117647,0.0434431207977543,0.2631578947368421,0.1710526315789473,0.0172543135783946,0.0872718179544886,0.052751465318481,0.4285714285714285,0.6511627906976742,0.4583333333333332,351,95,33,48,1,10597,26,72,59,2800000,91379.31034482758,17500000.0,4000000.0,150000.0,300000.0,8,5950000,-0.2,-0.06666666666666667
222209,Thomas,Strakosha,2024,2441,Greece,Athens,Albania,19-03-95,Goalkeeper,Goalkeeper,Right,193.0,30-06-29,Unknown,https://img.a.transfermarkt.technology/portrait/header/222209-1728414666.png?lm=1,GR1,Athlitiki Enosi Konstantinoupoleos,2500000.0,25000000.0,29,138,146,1,3,2,2,5,1,4,2,3,1,8,3,1,6,8,14,15,12,11,11,12,15,10,10,8,15,15,15,13,14,13,17,15,13,15,13,12,9,15,8,2,15,10,10,11,15,13,14,17,12,13,11,16,15,5,18,12,15,16,16,20,1,1,1,1,1,1,1,1,1,1,1,1,1,78,8,20,20236060,6750,6900,5750,Mediterranean_Hispanic,136,19,0,46397.0,Unknown,43115047,75000.0,1.0,40,104,0,2,1,3,34,5,0.6632707065361206,0.6096256684491979,0.6397058823529411,0.0447930537356352,0.125,0.0,0.0122530632658164,0.1247811952988247,0.0003888996916581,0.0,0.6976744186046511,0.4583333333333332,0,0,0,0,0,0,10,58,94,2500000,71323.5294117647,25000000.0,6500000.0,300000.0,350000.0,5,3475000,-0.16666666666666666,-0.16666666666666666
222813,Marko,Gruji?,2024,720,Yugoslavia (Republic),Belgrade,Serbia,13-04-96,Defensive Midfield,Midfield,Right,191.0,30-06-26,ROOF,https://img.a.transfermarkt.technology/portrait/header/222813-1606396482.png?lm=1,PO1,Futebol Clube do Porto,6000000.0,20000000.0,28,141,146,9,11,13,10,13,9,14,14,8,11,14,10,13,13,16,14,15,16,13,14,14,13,7,11,13,13,15,15,11,11,15,16,14,12,14,16,14,14,15,9,8,1,2,1,2,1,3,1,1,2,4,2,13,16,10,8,16,14,8,11,1,1,1,1,1,1,20,1,20,1,1,14,1,1,82,12,20,19562398,7050,6750,6050,Mediterranean_Hispanic,140,17,0,27552.0,Unknown,62085429,8000000.0,2.0,110,167,85,3,1,3,100,4,0.6434241862926701,0.641711229946524,0.6691176470588234,0.0265959963576916,0.1118421052631578,0.0,0.0297574393598399,0.0997749437359339,0.044417900497236,0.1428571428571428,0.6511627906976742,0.4166666666666665,279,24,17,56,0,8914,11,75,116,5000000,199000.0,20000000.0,3500000.0,,5000000.0,3,7000000,-0.16666666666666666,-0.375
222859,Florent,Mollet,2024,995,France,Fontaine-lÃ¨s-Dijon,France,19-11-91,Attacking Midfield,Midfield,Right,175.0,30-06-25,Unknown,https://img.a.transfermarkt.technology/portrait/header/222859-1704213537.jpg?lm=1,FR1,Football Club de Nantes,1800000.0,9000000.0,33,126,135,15,14,11,12,14,16,7,16,6,8,14,12,9,14,13,12,11,14,11,14,13,13,13,8,13,9,12,11,12,12,13,6,14,12,13,9,10,13,13,6,12,2,3,3,2,1,1,2,2,2,3,2,6,12,13,14,12,15,13,8,1,1,1,1,1,1,1,12,16,15,15,20,18,10,67,13,20,1600872,6300,6600,4800,Northern_European,126,0,0,25889.0,Unknown,85084448,1533333.333,3.0,34,499,36,3,1,7,93,0,0.6235776660492194,0.5080213903743315,0.5661764705882353,0.0249901748443183,0.0,0.0,0.0087521880470117,0.0447611902975743,0.0084909765993499,0.2857142857142857,0.2790697674418605,0.625,394,62,41,63,2,6195,14,25,53,1500000,48214.28571428572,9000000.0,3500000.0,,150000.0,5,5200000,-0.16666666666666666,-0.25
222977,Casper,Højer,2024,126,Denmark,Copenhagen,Denmark,20-11-94,Left-Back,Defender,Left,183.0,30-06-26,PROSPORT Management,https://img.a.transfermarkt.technology/portrait/header/222977-1694706294.png?lm=1,TR1,Ã‡aykur Rizespor KulÃ¼bÃ¼,1500000.0,2500000.0,30,122,125,15,16,12,11,12,14,6,16,12,11,13,10,12,13,13,14,12,14,13,11,13,15,9,9,13,12,14,15,14,12,10,11,13,13,14,11,14,9,13,7,10,1,4,3,2,1,2,2,1,2,1,3,9,15,4,13,9,14,13,13,1,20,12,1,15,1,1,12,1,1,1,1,1,1,77,20,5,1684165,6092,6092,2492,Northern_European,124,0,0,2649.0,Unknown,27045624,800000.0,2.0,28,382,30,1,0,7,225,8,0.5563641174913998,0.2611764705882352,0.5514705882352942,0.0025492295822643,0.0,0.0,0.0072518129532383,0.0122530632658164,0.0044167893552598,0.1428571428571428,0.4651162790697669,0.5,296,19,56,46,0,10639,10,56,157,1300000,44642.857142857145,2500000.0,300000.0,50000.0,200000.0,4,550000,-0.23529411764705882,-0.23529411764705882
223025,Gökhan,Akkan,2024,44006,TÃ¼rkiye,Yozgat,TÃ¼rkiye,01-01-95,Goalkeeper,Goalkeeper,Right,188.0,30-06-25,GPA Turkey,https://img.a.transfermarkt.technology/portrait/header/223025-1693405889.png?lm=1,TR1,Bodrumspor Spor Faaliyetleri Anonim ?irketi,1200000.0,3200000.0,29,120,130,1,3,2,1,8,1,7,4,2,1,8,3,1,8,8,12,14,12,13,5,10,12,5,10,6,11,12,11,12,16,12,12,8,13,11,12,2,6,1,9,1,11,11,11,6,11,12,12,14,13,14,10,17,14,4,14,12,14,16,14,20,1,1,1,1,1,1,1,1,1,1,1,1,1,84,8,20,2869501,6100,6100,3850,Mediterranean_Hispanic,113,1,0,8295.0,MKE AnkaragÃ¼cÃ¼,70025268,336000.0,1.0,100,1689,100,2,1,3,39,5,0.5574225985710506,0.4064171122994652,0.4705882352941176,0.0080011046661523,0.006578947368421,0.0,0.0057514378594648,0.0157539384846211,0.0018389399705547,0.0,0.581395348837209,0.4583333333333332,0,0,0,0,0,0,13,42,33,1000000,27142.85714285714,3200000.0,500000.0,150000.0,350000.0,4,825000,-0.375,-0.4444444444444444
223053,Unknown,Quini,2024,3060,Spain,CÃ³rdoba,Spain,24-09-89,Right-Back,Defender,Right,178.0,30-06-26,YOU FIRST,https://img.a.transfermarkt.technology/portrait/header/223053-1447238360.jpg?lm=1,GR1,APS Atromitos Athinon,300000.0,1200000.0,35,123,130,8,13,11,9,10,9,8,10,12,11,11,9,12,11,14,12,15,11,12,9,11,12,8,8,14,11,14,15,14,13,12,9,12,13,14,10,13,11,12,13,14,3,3,1,1,2,1,4,2,2,1,1,17,10,7,10,9,14,14,13,1,18,1,19,16,20,1,11,1,14,1,1,11,1,73,10,20,595198,6100,6100,3550,Mediterranean_Hispanic,116,0,0,5745.0,Unknown,67150177,9111392.0,2.0,89,400,89,1,1,3,9,11,0.5574225985710506,0.374331550802139,0.4926470588235294,0.0055387806378288,0.0,0.0,0.0012503125781445,0.0057514378594648,0.0505924720131114,0.1428571428571428,0.3488372093023257,0.7083333333333333,353,13,9,100,0,3729,4,49,245,250000,-1724.1379310344828,1200000.0,400000.0,,,4,950000,-0.2857142857142857,-0.375
223367,Fredrik,Aursnes,2024,294,Norway,Hareid,Norway,10-12-95,Central Midfield,Midfield,Right,181.0,30-06-27,Unknown,https://img.a.transfermarkt.technology/portrait/header/223367-1660759467.jpg?lm=1,PO1,Sport Lisboa e Benfica,20000000.0,20000000.0,29,145,150,13,13,12,7,13,11,9,12,6,12,14,13,12,13,16,15,17,14,16,14,15,15,10,14,13,13,18,17,12,11,14,11,15,13,18,12,16,14,15,3,15,3,3,1,1,2,2,1,3,1,2,3,12,14,6,15,16,15,14,10,1,1,1,1,1,1,19,10,20,10,10,15,10,1,71,10,20,18809999,7250,6550,5500,Northern_European,143,8,0,33500.0,Unknown,53086846,6875000.0,2.0,71,598,73,3,1,7,188,1,0.6169621593014025,0.5828877005347594,0.6911764705882353,0.0323394878559144,0.0526315789473684,0.0,0.0997749437359339,0.0997749437359339,0.0381677268813022,0.1428571428571428,0.418604651162791,0.4583333333333332,496,41,74,74,0,10718,3,11,41,20000000,945238.0952380953,20000000.0,200000.0,300000.0,500000.0,3,1500000,0.0,0.0
223967,Konrad,Laimer,2024,27,Austria,Salzburg,Austria,27-05-97,Central Midfield,Midfield,Right,180.0,30-06-27,ROOF,https://img.a.transfermarkt.technology/portrait/header/223967-1700659266.jpg?lm=1,L1,FC Bayern MÃ¼nchen,30000000.0,30000000.0,27,149,155,8,9,12,10,11,7,6,10,8,15,13,8,15,13,18,15,16,13,14,12,12,18,9,10,11,14,17,18,14,14,12,9,15,15,17,12,13,12,14,4,17,2,1,1,1,3,1,3,1,4,3,2,13,16,8,12,13,14,16,9,1,1,1,16,1,16,17,14,20,13,13,10,12,1,72,12,20,32787087,7444,6894,6094,Northern_European,138,24,2,57496.0,Unknown,16147659,7000000.0,1.0,6,1291,7,3,1,7,68,1,0.6624768457263827,0.6464171122994652,0.6544117647058822,0.0555104397710714,0.1578947368421052,0.0263157894736842,0.1497874468617154,0.1497874468617154,0.038862190616406,0.0,0.3953488372093026,0.375,374,26,34,72,0,10573,14,109,243,25000000,831666.6666666666,30000000.0,6000000.0,700000.0,7000000.0,4,1425000,-0.16666666666666666,-0.10714285714285714
223972,Patrick,Pentz,2024,206,Austria,Salzburg,Austria,02-01-97,Goalkeeper,Goalkeeper,Left,183.0,30-06-28,Unknown,https://img.a.transfermarkt.technology/portrait/header/223972-1689710965.jpg?lm=1,DK1,BrÃ¸ndby IdrÃ¦tsforening,3000000.0,3000000.0,27,124,134,3,4,6,4,11,3,7,6,10,5,10,5,8,9,9,10,11,9,11,9,11,15,6,11,9,15,16,14,11,16,10,13,14,13,14,11,15,4,11,5,4,10,11,12,10,13,10,11,16,13,12,10,8,18,6,8,8,10,10,15,20,1,1,1,1,1,1,1,1,1,1,1,1,1,81,20,11,2042646,6193,6193,4146,Northern_European,118,3,0,9847.0,Unknown,16147449,2550000.0,1.0,6,1291,7,2,0,7,45,5,0.5697274411219899,0.4380748663101604,0.5073529411764706,0.0094997426629986,0.0197368421052631,0.0,0.0147536884221055,0.0147536884221055,0.0141392816467124,0.0,0.4651162790697669,0.375,0,0,0,0,0,0,2,39,152,3000000,113461.53846153847,3000000.0,1000000.0,50000.0,350000.0,3,300000,0.0,1.0
223974,Stefan,Posch,2024,1025,Austria,Judenburg,Austria,14-05-97,Right-Back,Defender,Right,190.0,30-06-26,ROOF,https://img.a.transfermarkt.technology/portrait/header/223974-1725531246.jpg?lm=1,IT1,Bologna Football Club 1909,14000000.0,14000000.0,27,129,138,5,9,9,6,11,5,13,6,10,13,11,9,14,11,8,13,14,16,12,9,13,12,5,10,6,12,16,10,13,13,12,16,14,14,14,12,14,11,16,7,10,3,3,3,3,3,3,1,3,1,4,3,12,15,10,10,16,13,15,18,1,8,20,15,1,11,10,1,7,1,1,1,1,1,82,12,20,3178596,6445,6345,4745,Northern_European,128,16,1,21999.0,Bologna FC 1909,16147386,2600000.0,2.0,6,694,7,1,1,7,40,11,0.5898385816353533,0.502139037433155,0.5808823529411764,0.0212339236795425,0.1052631578947368,0.0131578947368421,0.0697674418604651,0.0697674418604651,0.0144170671407539,0.1428571428571428,0.6279069767441858,0.375,313,21,7,70,0,6060,17,57,71,10000000,352678.5714285714,14000000.0,4000000.0,0.0,2500000.0,3,3275000,-0.2857142857142857,-0.2857142857142857
223979,Xaver,Schlager,2024,23826,Austria,Linz,Austria,28-09-97,Central Midfield,Midfield,Left,174.0,30-06-26,ROOF,https://img.a.transfermarkt.technology/portrait/header/223979-1713945331.jpg?lm=1,L1,RasenBallsport Leipzig,28000000.0,28000000.0,27,145,156,4,8,12,9,14,12,8,12,4,13,14,8,16,14,16,15,16,14,15,14,13,17,11,14,13,14,16,17,12,12,14,9,16,12,16,12,15,12,12,9,14,3,2,1,3,1,2,3,2,2,4,3,13,17,12,12,14,15,12,12,1,12,1,1,10,1,18,12,20,12,10,14,10,1,76,20,13,28322813,7250,6950,6500,Northern_European,142,29,2,86479.0,Unknown,16147660,12000000.0,2.0,6,841,7,3,0,7,162,1,0.6698862132839376,0.6898395721925134,0.6838235294117647,0.0834969249918163,0.1907894736842105,0.0263157894736842,0.1397849462365591,0.1397849462365591,0.0666407400205561,0.1428571428571428,0.2558139534883721,0.375,338,30,45,49,0,10143,9,121,209,28000000,1075000.0,28000000.0,5000000.0,400000.0,10000000.0,3,5100000,0.0,0.0
225004,Valentín,Vada,2024,2698,Argentina,Guadalupe,Argentina,06-03-96,Central Midfield,Midfield,Right,175.0,30-06-25,Unknown,https://img.a.transfermarkt.technology/portrait/header/225004-1722142233.png?lm=1,RU1,FC Rubin Kazan,2000000.0,4000000.0,28,120,132,14,13,13,12,14,14,5,14,5,7,14,14,7,15,13,12,12,14,12,15,12,14,14,10,12,10,14,12,10,12,12,8,12,10,12,11,10,11,15,6,12,2,1,3,1,2,2,1,3,1,3,3,10,14,6,15,12,14,14,11,1,1,1,1,1,1,10,10,20,16,10,19,15,8,71,12,20,1367151,6100,6100,4250,Mediterranean_Hispanic,119,0,0,11499.0,Unknown,85120545,750000.0,1.0,4,572,4,3,1,3,71,1,0.5574225985710506,0.4491978609625668,0.5147058823529411,0.0110949423864458,0.0,0.0,0.0097524381095273,0.0197549387346836,0.0041390038612183,0.0,0.2790697674418605,0.4166666666666665,285,31,23,57,1,5523,2,7,31,1800000,63461.53846153846,4000000.0,1000000.0,150000.0,2500000.0,5,1900000,-0.1,0.2
225122,Gonçalo,Guedes,2024,543,Unknown,Unknown,Portugal,29-11-96,Left Winger,Attack,Right,179.0,30-06-27,Gestifute,https://img.a.transfermarkt.technology/portrait/header/225122-1701334424.jpg?lm=1,GB1,Wolverhampton Wanderers Football Club,15000000.0,40000000.0,28,156,162,10,13,14,13,12,12,8,15,12,7,13,13,7,14,12,13,13,11,12,12,11,13,15,7,14,12,11,13,16,15,13,10,15,16,15,12,12,8,10,10,11,3,2,3,3,1,1,2,3,2,2,1,13,13,7,15,9,13,17,13,1,1,1,1,1,1,1,19,1,17,20,18,18,18,68,10,20,82934091,7800,7500,5750,Mediterranean_Hispanic,142,32,7,104393.0,Unknown,55041710,34200000.0,3.0,105,1549,79,0,1,3,222,7,0.7426567875099233,0.6096256684491979,0.6838235294117647,0.1007949926951053,0.2105263157894736,0.0921052631578947,0.0747686921730432,0.1997999499874969,0.1899774993749826,0.2857142857142857,0.3720930232558141,0.4166666666666665,399,74,75,36,1,10307,7,50,112,15000000,500000.0,40000000.0,12000000.0,3750000.0,17000000.0,6,43000000,0.0,-0.16666666666666666
225339,Queensy,Menig,2024,2381,Netherlands,Amsterdam,Netherlands,19-08-95,Left Winger,Attack,Right,174.0,30-06-26,Forza Sports Group,https://img.a.transfermarkt.technology/portrait/header/225339-1724076899.png?lm=1,TR1,Sivasspor KulÃ¼bÃ¼,1300000.0,2800000.0,29,125,125,10,11,13,12,12,7,7,9,9,5,12,9,5,13,10,12,11,11,11,12,11,12,12,5,13,5,12,12,15,14,12,7,14,15,13,10,12,7,8,7,13,1,4,3,2,3,2,1,3,4,3,3,9,9,3,11,9,11,14,10,1,1,1,1,1,1,1,10,12,14,19,14,20,15,69,8,20,1241951,5850,5850,4650,African_Caribbean,116,0,0,3099.0,Unknown,37039832,500000.0,2.0,67,64,68,0,1,1,183,7,0.5243450648319662,0.4919786096256684,0.4926470588235294,0.0029837573519684,0.0,0.0,0.0062515628907226,0.0137534383595899,0.0027500763910108,0.1428571428571428,0.2558139534883721,0.4583333333333332,0,0,0,0,0,0,5,10,27,900000,28000.0,2800000.0,600000.0,200000.0,750000.0,4,2000000,-0.47058823529411764,-0.6785714285714286
225593,Pere,Milla,2024,714,Spain,Lleida,Spain,23-09-92,Left Winger,Attack,Left,180.0,30-06-27,Unknown,https://img.a.transfermarkt.technology/portrait/header/225593-1541151194.jpg?lm=1,ES1,Reial Club Deportiu Espanyol de Barcelona S.A.D.,2400000.0,3000000.0,32,133,136,11,13,13,14,14,13,12,11,12,6,12,13,7,12,9,12,11,11,11,13,11,15,11,16,14,7,18,18,12,13,10,10,12,12,16,11,11,9,13,11,13,2,2,2,3,3,3,2,3,4,2,3,14,15,9,10,12,14,15,11,1,1,1,1,1,1,1,1,1,1,15,20,15,20,72,20,12,2638543,6250,6250,4750,Mediterranean_Hispanic,128,0,0,6639.0,Unknown,67170824,3000000.0,1.0,89,852,89,0,0,3,170,7,0.5772691188145012,0.5026737967914437,0.5808823529411764,0.006402042473641,0.0,0.0,0.0117529382345586,0.0147536884221055,0.0166393510930859,0.0,0.3953488372093026,0.5833333333333333,442,76,25,68,0,4067,2,6,31,1500000,65217.391304347824,3000000.0,500000.0,,,6,1500000,-0.375,-0.4230769230769231
225657,Philipp,Lienhart,2024,60,Austria,Lilienfeld,Austria,11-07-96,Centre-Back,Defender,Right,189.0,Unknown,YOU FIRST,https://img.a.transfermarkt.technology/portrait/header/225657-1658411602.jpg?lm=1,L1,Sport-Club Freiburg,15000000.0,20000000.0,28,132,138,4,6,11,6,11,4,15,5,8,12,12,6,14,10,5,14,12,16,16,9,14,11,6,10,7,13,16,12,12,10,14,15,17,16,14,12,15,7,14,6,7,1,4,4,3,2,1,3,2,1,2,1,12,14,4,13,14,16,15,18,1,1,20,1,1,1,15,1,12,1,1,1,1,1,83,12,20,3916343,6498,6248,4248,Northern_European,131,9,0,12499.0,Unknown,16130398,1400000.0,2.0,6,833,7,1,1,7,189,2,0.5770044985445886,0.4489839572192513,0.6029411764705883,0.012060559652455,0.0592105263157894,0.0,0.0747686921730432,0.0997749437359339,0.0077502152837578,0.1428571428571428,0.6046511627906974,0.4166666666666665,311,15,2,51,0,6430,18,83,72,15000000,676190.4761904762,20000000.0,5000000.0,,800000.0,1,2200000,0.0,-0.25
225873,Karol,Linetty,2024,416,Poland,?nin,Poland,02-02-95,Central Midfield,Midfield,Right,175.0,30-06-25,Fabryka Futbolu,https://img.a.transfermarkt.technology/portrait/header/225873-1663596553.jpg?lm=1,IT1,Torino Calcio,3500000.0,15000000.0,29,133,138,10,11,12,11,13,9,10,11,8,10,14,10,14,13,13,13,14,13,13,12,12,15,12,13,13,11,14,14,12,12,15,9,16,13,14,12,13,13,14,10,14,4,1,1,1,2,1,1,1,1,2,3,14,13,8,15,10,13,12,11,1,1,1,1,1,1,17,11,20,11,5,16,5,1,73,15,20,6921683,6650,6850,5250,Northern_European,131,41,5,49807.0,Unknown,96032464,5300000.0,2.0,75,6,78,3,1,7,201,1,0.6566551997883038,0.5561497326203209,0.6029411764705883,0.0480858086127266,0.2697368421052631,0.0657894736842105,0.0172543135783946,0.0747686921730432,0.0294174838189949,0.1428571428571428,0.2790697674418605,0.4583333333333332,378,25,31,91,0,4204,18,67,49,3500000,104838.70967741935,15000000.0,3000000.0,700000.0,3000000.0,2,4800000,0.0,0.0
225963,Lautaro,Giannetti,2024,410,Argentina,San NicolÃ¡s,Argentina,13-11-93,Centre-Back,Defender,Right,185.0,30-06-26,PRI Sports,https://img.a.transfermarkt.technology/portrait/header/225963-1678798116.JPG?lm=1,IT1,Udinese Calcio,2500000.0,5000000.0,31,133,135,5,5,9,5,9,5,15,5,8,16,12,8,15,11,14,15,17,13,15,11,14,15,6,13,8,14,15,15,11,9,12,13,14,13,14,14,14,12,13,6,5,1,2,2,2,3,1,1,3,2,3,2,19,13,9,13,14,15,13,13,1,1,20,10,1,1,1,1,1,1,1,1,1,1,80,8,20,2427467,6650,6650,4000,Mediterranean_Hispanic,134,0,0,23640.0,Unknown,14047176,9111392.0,2.0,4,1305,4,1,1,3,205,2,0.6301931727970362,0.4224598930481283,0.625,0.0228185016130636,0.0,0.0,0.0122530632658164,0.0247561890472618,0.0505924720131114,0.1428571428571428,0.5116279069767438,0.5416666666666665,224,5,6,48,2,8455,13,109,235,2500000,106818.18181818182,5000000.0,1500000.0,,,1,300000,0.0,-0.10714285714285714
226012,David,Soria,2024,3709,Spain,Madrid,Spain,04-04-93,Goalkeeper,Goalkeeper,Right,192.0,30-06-26,Promoesport,https://img.a.transfermarkt.technology/portrait/header/226012-1696863038.jpg?lm=1,ES1,Getafe Club de FÃºtbol S.A.D. Team Dubai,5000000.0,18000000.0,31,142,150,4,2,3,2,7,7,4,2,1,2,8,4,1,5,11,15,13,12,14,8,15,13,9,11,11,15,13,14,9,12,13,16,11,9,11,14,12,8,9,9,13,15,15,15,8,16,12,13,15,16,10,14,15,12,10,10,9,12,13,13,20,1,1,1,1,1,1,1,1,1,1,1,1,1,85,8,20,6167600,7000,7000,5600,Mediterranean_Hispanic,141,0,0,20145.0,Unknown,67011248,3000000.0,1.0,89,892,89,2,1,3,105,5,0.6765017200317545,0.5935828877005347,0.6764705882352942,0.0194436692683614,0.0,0.0,0.0247561890472618,0.0897724431107777,0.0166393510930859,0.0,0.6744186046511627,0.5416666666666665,0,0,0,0,0,0,5,20,68,4000000,153846.15384615384,18000000.0,6000000.0,,,2,1100000,-0.2,-0.5
226073,Ivo,Grbic,2024,126,Croatia,Split,Croatia,18-01-96,Goalkeeper,Goalkeeper,Right,195.0,30-06-25,World in Motion,https://img.a.transfermarkt.technology/portrait/header/226073-1683638017.jpg?lm=1,TR1,Ã‡aykur Rizespor KulÃ¼bÃ¼,3000000.0,7000000.0,28,136,147,3,2,3,1,6,7,8,1,3,3,10,1,1,6,11,16,13,14,14,6,11,14,3,12,3,16,12,10,12,12,13,17,13,11,12,16,12,5,6,5,11,15,17,12,7,13,11,14,14,11,12,11,15,13,4,11,15,16,12,15,20,1,1,1,1,1,1,1,1,1,1,1,1,1,83,9,20,6344876,6800,6024,5321,Northern_European,136,2,0,19448.0,Unknown,24039943,3000000.0,2.0,24,1409,25,2,1,7,225,5,0.5473670283143689,0.5637433155080214,0.6397058823529411,0.018770634033953,0.0131578947368421,0.0,0.0147536884221055,0.0347586896724181,0.0166393510930859,0.1428571428571428,0.7441860465116279,0.4166666666666665,0,0,0,0,0,0,0,0,0,2600000,100000.0,7000000.0,3500000.0,,200000.0,6,6700000,-0.2571428571428571,-0.2571428571428571
226261,César,De La Hoz,2024,366,Spain,Orejo,Spain,30-03-92,Defensive Midfield,Midfield,Right,179.0,30-06-25,EMG Mundial,https://img.a.transfermarkt.technology/portrait/header/226261-1688219646.jpg?lm=1,ES1,Real Valladolid Club de FÃºtbol S.A.D.,1000000.0,1200000.0,32,124,130,7,6,9,8,11,8,12,10,5,12,11,3,13,11,14,13,13,15,15,11,15,14,9,14,10,15,15,14,12,10,10,10,12,13,14,12,16,11,16,3,6,2,3,3,1,3,2,3,3,3,3,3,11,13,5,16,13,17,15,12,1,1,15,1,1,1,20,1,18,1,1,1,1,1,74,10,20,2004493,6198,6198,3598,Mediterranean_Hispanic,119,0,0,3632.0,Unknown,67150860,9111392.0,2.0,89,1089,89,3,1,3,169,4,0.5703889917967716,0.3794652406417111,0.5147058823529411,0.0034984313547513,0.0,0.0,0.0047511877969492,0.0057514378594648,0.0505924720131114,0.1428571428571428,0.3720930232558141,0.5833333333333333,356,14,4,67,2,2857,0,0,0,400000,8695.652173913044,1200000.0,500000.0,,200000.0,5,700000,-0.6,-0.6666666666666666
226524,Morten,Thorsby,2024,252,Norway,Oslo,Norway,05-05-96,Central Midfield,Midfield,Right,188.0,30-06-26,Pando,https://img.a.transfermarkt.technology/portrait/header/226524-1725529624.jpg?lm=1,IT1,Genoa Cricket and Football Club,3000000.0,7000000.0,28,129,135,4,6,10,10,11,4,16,6,4,13,11,10,15,11,15,12,15,15,15,12,12,20,9,11,13,15,18,16,12,10,12,16,16,12,19,16,10,12,10,4,15,2,3,2,1,4,2,1,1,3,3,1,12,13,3,13,13,20,15,16,1,1,1,1,11,11,16,13,20,13,1,1,1,1,79,11,20,2991157,6450,6750,5600,Northern_European,127,9,0,19999.0,Unknown,53098756,2533333.333,3.0,71,1096,73,3,1,7,104,1,0.6434241862926701,0.5935828877005347,0.5735294117647058,0.0193026891475241,0.0592105263157894,0.0,0.0147536884221055,0.0347586896724181,0.01404668648018,0.2857142857142857,0.581395348837209,0.4166666666666665,363,29,17,57,2,6440,9,24,33,3000000,101724.13793103448,7000000.0,1500000.0,250000.0,1500000.0,4,1950000,0.0,-0.0625
226973,Harrison,Reed,2024,931,England,Worthing,England,27-01-95,Central Midfield,Midfield,Right,181.0,30-06-27,Unique Sports Group,https://img.a.transfermarkt.technology/portrait/header/226973-1628697428.jpg?lm=1,GB1,Fulham Football Club,13000000.0,18000000.0,29,139,145,12,12,11,8,12,12,12,10,8,14,14,8,15,11,14,12,15,13,14,12,13,15,9,12,13,13,17,17,15,14,14,8,15,15,15,11,14,8,12,10,18,3,3,1,1,2,3,3,3,1,3,3,13,13,4,12,13,16,11,13,1,1,1,12,1,13,18,1,20,15,1,10,14,1,74,10,20,36272499,6950,6950,5250,Northern_European,137,0,0,46397.0,Unknown,29076104,6500000.0,1.0,32,1675,33,3,1,7,95,1,0.6698862132839376,0.5561497326203209,0.6470588235294117,0.0447930537356352,0.0,0.0,0.0647661915478869,0.0897724431107777,0.0360843356759909,0.0,0.418604651162791,0.4583333333333332,362,12,27,56,0,5340,14,50,53,11000000,447916.6666666667,18000000.0,3000000.0,,1500000.0,4,1500000,-0.26666666666666666,-0.3888888888888889
227039,Younes,Namli,2024,1269,Denmark,KÃ¸benhavn,Denmark,20-06-94,Right Winger,Attack,Left,180.0,30-06-25,Forza Sports Group,https://img.a.transfermarkt.technology/portrait/header/227039-1618670255.jpg?lm=1,NL1,Prins Hendrik Ende Desespereert Nimmer Combinatie Zwolle,1600000.0,3000000.0,30,120,128,13,13,14,11,15,13,6,11,6,4,14,13,5,16,9,12,11,13,10,13,12,7,14,4,12,7,11,10,13,15,12,8,13,13,12,8,11,6,9,10,5,1,1,1,1,1,1,1,1,1,1,1,8,10,5,14,12,12,15,12,1,1,1,1,1,1,1,16,15,16,18,17,20,10,63,20,10,2238015,5948,5698,5248,North_African__Middle_Eastern,120,0,0,2249.0,Unknown,27069775,2000000.0,1.0,28,778,30,0,0,6,156,10,0.5042339243186028,0.5559358288770053,0.5220588235294117,0.0021629826758606,0.0,0.0,0.0077519379844961,0.0147536884221055,0.0110836412122558,0.0,0.3953488372093026,0.5,312,34,47,25,1,7681,10,78,155,1600000,56250.0,3000000.0,500000.0,25000.0,250000.0,7,2375000,0.0,0.23076923076923078
227081,Joaquín,Correa,2024,46,Argentina,Juan Bautista Alberdi,Argentina,13-08-94,Second Striker,Attack,Right,188.0,30-06-25,World Soccer Agency,https://img.a.transfermarkt.technology/portrait/header/227081-1724826843.jpg?lm=1,IT1,Football Club Internazionale Milano S.p.A.,6000000.0,38000000.0,30,145,155,13,11,16,13,16,10,11,13,3,4,14,12,5,17,9,14,9,13,9,13,11,13,17,7,14,6,12,9,16,15,11,12,14,17,12,11,11,8,13,10,14,2,1,3,3,2,3,2,2,4,2,2,12,15,2,12,13,17,16,10,1,1,1,1,1,1,1,10,1,8,15,18,12,20,75,13,20,9005434,7250,7100,6400,Mediterranean_Hispanic,140,17,3,124615.0,Unknown,14042683,17937500.0,4.0,4,693,4,0,1,3,89,12,0.6897327335273882,0.6791443850267379,0.6691176470588234,0.1203217050483436,0.1118421052631578,0.0394736842105263,0.0297574393598399,0.1897974493623406,0.0996277674379843,0.4285714285714285,0.581395348837209,0.5,386,65,43,39,2,8252,25,84,50,3000000,93103.44827586207,38000000.0,7500000.0,300000.0,7500000.0,6,12000000,-0.5,-0.7
227110,Jordan,Torunarigha,2024,157,Germany,Chemnitz,Nigeria,07-08-97,Centre-Back,Defender,Left,191.0,30-06-25,11WINS,https://img.a.transfermarkt.technology/portrait/header/227110-1657097718.jpg?lm=1,BE1,Koninklijke Atletiek Associatie Gent,5000000.0,13000000.0,27,129,142,4,10,13,7,12,5,16,8,13,12,13,8,16,13,16,12,17,13,10,13,10,15,13,9,11,11,11,12,14,12,15,16,14,14,13,15,10,9,15,13,11,1,2,3,1,1,2,2,4,3,2,2,10,14,13,11,9,11,11,5,1,15,20,1,11,1,1,1,1,1,1,1,1,1,80,20,9,6410744,6313,6305,5260,African_Caribbean,127,0,0,12499.0,Unknown,91137260,3000000.0,1.0,38,351,70,1,0,1,120,2,0.5845461762370998,0.5572192513368983,0.5735294117647058,0.012060559652455,0.0,0.0,0.0247561890472618,0.0647661915478869,0.0166393510930859,0.0,0.6511627906976742,0.375,316,14,13,69,1,11246,23,87,57,4500000,166666.66666666666,13000000.0,3500000.0,125000.0,4000000.0,1,0,-0.1,-0.25
227805,Jaume,Doménech,2024,1049,Spain,Almenara,Spain,05-11-90,Goalkeeper,Goalkeeper,Right,185.0,30-06-25,Wasserman,https://img.a.transfermarkt.technology/portrait/header/227805-1447247048.jpg?lm=1,ES1,Valencia Club de FÃºtbol S. A. D.,800000.0,7500000.0,34,137,145,6,2,2,1,9,8,2,1,2,3,8,1,2,10,13,12,16,9,14,7,12,17,3,15,3,12,13,14,12,16,11,11,11,12,12,11,11,7,15,7,13,11,13,15,6,12,12,14,16,9,15,12,12,15,10,14,9,15,12,8,20,1,1,1,1,1,1,1,1,1,1,1,1,1,73,7,20,6034434,6850,6850,5250,Mediterranean_Hispanic,132,0,0,28999.0,Unknown,67102156,9111392.0,2.0,89,49,89,2,1,3,208,5,0.6566551997883038,0.5561497326203209,0.6102941176470589,0.027993244541607,0.0,0.0,0.0037509377344336,0.0372593148287071,0.0505924720131114,0.1428571428571428,0.5116279069767438,0.6666666666666665,0,0,0,0,0,0,4,39,222,600000,23076.923076923078,7500000.0,1500000.0,,,1,1000000,-0.25,-0.4
227961,Jaime,Mata,2024,472,Spain,Madrid,Spain,24-10-88,Centre-Forward,Attack,Right,186.0,30-06-25,Unknown,https://img.a.transfermarkt.technology/portrait/header/227961-1530601381.jpg?lm=1,ES1,UniÃ³n Deportiva Las Palmas S.A.D.,900000.0,10000000.0,36,132,141,9,12,13,16,11,9,14,12,8,6,12,14,8,13,11,14,13,13,13,12,13,15,12,10,16,7,12,11,11,12,14,13,12,11,13,13,14,8,12,6,16,2,3,2,1,2,3,3,3,1,1,2,20,13,6,12,14,15,10,9,1,1,1,1,1,1,1,1,1,1,12,12,10,20,75,12,20,1361186,6600,6600,5100,Mediterranean_Hispanic,130,1,0,12079.0,Unknown,67121201,9111392.0,2.0,89,892,89,0,1,3,207,3,0.6235776660492194,0.5401069518716577,0.5955882352941175,0.0116550004007311,0.006578947368421,0.0,0.0042510627656914,0.0497624406101525,0.0505924720131114,0.1428571428571428,0.5348837209302322,0.75,496,154,36,127,3,4960,1,9,62,800000,22222.222222222223,10000000.0,2000000.0,,,3,3100000,-0.1111111111111111,-0.2
228433,Unknown,Wendell,2024,720,Brazil,Fortaleza,Brazil,20-07-93,Left-Back,Defender,Left,176.0,30-06-25,AIS Football,https://img.a.transfermarkt.technology/portrait/header/228433-1669115150.png?lm=1,PO1,Futebol Clube do Porto,5000000.0,25000000.0,31,132,134,10,11,13,10,14,10,8,10,12,12,13,10,14,14,14,13,14,12,9,12,11,14,13,7,13,8,11,15,15,14,13,9,14,15,16,9,11,13,12,4,9,3,2,2,2,3,4,3,3,1,3,3,12,13,13,11,10,11,7,7,1,20,12,1,20,1,1,12,1,1,12,1,1,1,72,20,9,5768098,6600,6100,5550,African_Caribbean,123,0,0,28949.0,Unknown,19149016,5400000.0,2.0,10,502,11,1,0,1,100,8,0.5574225985710506,0.588235294117647,0.5441176470588236,0.0279449636783065,0.0,0.0,0.0247561890472618,0.1247811952988247,0.0299730548070779,0.1428571428571428,0.3023255813953489,0.5416666666666665,406,16,28,101,4,11103,11,60,118,4500000,140322.5806451613,25000000.0,5000000.0,,5000000.0,2,2500000,-0.35714285714285715,-0.1
228444,Ridgeciano,Haps,2024,607,Netherlands,Utrecht,Suriname,12-06-93,Left-Back,Defender,Left,175.0,30-06-26,SEG,https://img.a.transfermarkt.technology/portrait/header/228444-1630656845.jpg?lm=1,IT1,Venezia Football Club,900000.0,6000000.0,31,123,136,12,10,12,10,11,9,7,9,11,11,11,8,12,14,9,12,12,11,11,12,11,13,11,9,13,11,14,16,14,12,13,8,14,14,13,12,13,11,11,16,13,1,4,3,1,3,3,1,1,2,1,1,11,13,8,15,16,16,15,13,1,20,1,1,19,1,1,18,1,1,15,1,1,1,74,20,10,2691785,6150,6350,5000,African_Caribbean,114,8,0,9500.0,Unknown,37020712,3250000.0,2.0,67,1551,90,1,0,1,210,8,0.590500132310135,0.5294117647058822,0.4779411764705882,0.0091646734716934,0.0526315789473684,0.0,0.0042510627656914,0.0297574393598399,0.0180282785632934,0.1428571428571428,0.2790697674418605,0.5416666666666665,355,16,25,50,2,10214,21,111,184,1000000,31666.666666666668,6000000.0,1500000.0,,250000.0,6,2800000,0.1111111111111111,0.0
228645,Wout,Weghorst,2024,610,Netherlands,Borne,Netherlands,07-08-92,Centre-Forward,Attack,Right,197.0,30-06-26,One II Agency,https://img.a.transfermarkt.technology/portrait/header/228645-1727259675.jpg?lm=1,NL1,AFC Ajax Amsterdam,6000000.0,30000000.0,32,140,147,3,8,10,16,14,5,15,8,5,6,12,14,6,12,14,15,18,14,11,12,12,18,10,14,14,7,12,16,10,11,15,18,17,12,17,17,13,8,13,3,5,1,2,1,2,3,3,1,3,1,1,2,16,16,17,12,15,13,7,10,1,1,1,1,1,1,1,1,1,1,1,10,1,20,84,12,20,33405620,7000,7000,6700,Northern_European,138,13,3,51036.0,BeÅŸiktaÅŸ A.Åž.,37026994,7970000.0,4.0,67,229,68,0,1,7,6,3,0.6765017200317545,0.7112299465240641,0.6544117647058822,0.0492725522326519,0.0855263157894736,0.0394736842105263,0.0297574393598399,0.1497874468617154,0.0442512292008111,0.4285714285714285,0.7906976744186047,0.5833333333333333,514,192,62,75,0,9169,11,27,50,5000000,137500.0,30000000.0,10000000.0,,100000.0,8,12625000,-0.16666666666666666,-0.4444444444444444
228940,João,Novais,2024,2425,Portugal,Vila Nova de Gaia,Portugal,10-07-93,Central Midfield,Midfield,Right,183.0,30-06-26,MRP.POSITIONUMBER,https://img.a.transfermarkt.technology/portrait/header/228940-1694440227.png?lm=1,PO1,Rio Ave Futebol Clube,900000.0,4000000.0,31,125,136,15,15,13,10,14,16,4,13,5,6,15,12,7,15,14,10,10,14,13,15,14,11,12,11,13,11,14,7,11,12,14,9,13,12,12,11,12,11,12,7,10,2,2,1,3,1,3,2,3,3,1,3,20,14,6,11,13,12,11,13,1,1,1,1,1,1,14,10,19,11,14,20,12,1,70,13,20,6049532,6300,6250,4850,North_African__Middle_Eastern,125,0,0,24238.0,Unknown,55061113,812500.0,2.0,76,1589,79,3,1,6,171,1,0.5772691188145012,0.5133689839572192,0.5588235294117647,0.0233959407381371,0.0,0.0,0.0042510627656914,0.0197549387346836,0.0044862357287702,0.1428571428571428,0.4651162790697669,0.5416666666666665,393,39,31,66,1,7085,2,4,12,700000,18518.51851851852,4000000.0,1500000.0,,150000.0,6,3200000,-0.2222222222222222,-0.5333333333333333
228948,Thilo,Kehrer,2024,162,Germany,TÃ¼bingen,Germany,21-09-96,Centre-Back,Defender,Right,186.0,30-06-28,Dirk Hebel,https://img.a.transfermarkt.technology/portrait/header/228948-1663242446.jpg?lm=1,FR1,Association sportive de Monaco Football Club,10000000.0,35000000.0,28,135,146,6,10,9,6,13,5,14,8,10,14,13,7,15,13,14,13,14,14,12,12,12,10,9,12,7,11,13,13,13,13,12,14,16,15,14,13,12,13,14,5,17,3,2,2,2,1,2,2,1,3,3,3,10,17,15,6,12,9,14,12,1,12,20,17,8,10,15,1,15,1,1,1,1,1,76,14,20,22075703,6750,6750,5500,Mixed_Race,133,20,0,110192.0,Unknown,91126230,20000000.0,3.0,38,1539,40,1,1,4,24,2,0.6434241862926701,0.5828877005347594,0.6176470588235294,0.1063946072206928,0.131578947368421,0.0,0.0497624406101525,0.1747936984246061,0.1110864190671963,0.2857142857142857,0.5348837209302322,0.4166666666666665,0,0,0,0,0,0,13,80,119,15000000,546296.2962962963,35000000.0,7000000.0,250000.0,3500000.0,3,13000000,0.5,0.6666666666666666
229006,Franck,Honorat,2024,18,France,Toulon,France,11-08-96,Right Winger,Attack,Right,180.0,30-06-28,Gol International,https://img.a.transfermarkt.technology/portrait/header/229006-1691248904.jpg?lm=1,L1,Borussia Verein fÃ¼r LeibesÃ¼bungen 1900 MÃ¶nchengladbach,12000000.0,12000000.0,28,133,136,9,14,13,11,13,12,12,12,5,5,13,12,6,13,6,11,10,13,12,13,12,12,14,7,12,10,14,13,16,13,12,10,14,15,14,12,13,9,12,7,11,3,1,2,3,2,2,1,3,2,1,1,8,13,7,13,10,13,10,12,1,1,1,1,1,13,1,15,1,17,17,1,20,10,70,8,20,6704434,6650,6650,3808,Northern_European,131,0,0,8008.0,Unknown,48036785,5000000.0,3.0,34,1511,36,0,1,7,42,10,0.6301931727970362,0.4019251336898395,0.6029411764705883,0.0077239725108076,0.0,0.0,0.0597649412353088,0.0597649412353088,0.0277507708547459,0.2857142857142857,0.3953488372093026,0.4166666666666665,319,49,61,18,2,4574,6,18,77,12000000,538636.3636363636,12000000.0,1000000.0,,400000.0,5,4800000,0.0,0.0
229604,Gerónimo,Rulli,2024,244,Argentina,La Plata,Argentina,20-05-92,Goalkeeper,Goalkeeper,Right,189.0,30-06-27,CAA Stellar,https://img.a.transfermarkt.technology/portrait/header/229604-1698670758.jpg?lm=1,FR1,Olympique de Marseille,5000000.0,14000000.0,32,143,159,6,2,1,1,12,8,6,3,3,1,12,4,3,13,8,15,15,12,13,10,11,11,1,11,2,13,14,11,12,15,7,14,15,11,13,12,13,8,13,5,14,13,14,12,10,13,15,18,17,14,14,13,15,15,5,18,10,20,13,8,20,1,1,1,1,1,1,1,1,1,1,1,1,1,84,8,20,16510627,7150,7150,6000,Mediterranean_Hispanic,142,3,0,45995.0,Unknown,14030119,5366666.667,6.0,4,784,4,2,1,3,144,5,0.696348240275205,0.6363636363636364,0.6838235294117647,0.0444048755946995,0.0197368421052631,0.0,0.0247561890472618,0.0697674418604651,0.0297878644795688,0.7142857142857142,0.6046511627906974,0.5833333333333333,0,0,0,0,0,0,3,46,104,5000000,163333.33333333334,14000000.0,4000000.0,,100000.0,7,8200000,0.0,-0.375
229804,Aritz,Elustondo,2024,681,Spain,Beasain,Spain,28-03-94,Centre-Back,Defender,Right,180.0,30-06-26,IDUB GLOBAL,https://img.a.transfermarkt.technology/portrait/header/229804-1664970965.jpg?lm=1,ES1,Real Sociedad de FÃºtbol S.A.D.,5000000.0,20000000.0,30,145,145,4,13,10,11,12,7,15,12,9,14,13,6,15,13,13,14,16,13,15,13,14,16,4,17,9,14,16,15,12,12,12,13,13,14,15,14,15,11,13,11,13,3,3,1,3,2,1,2,1,1,1,3,8,12,5,18,13,15,16,14,1,1,20,16,1,1,1,1,1,1,1,1,1,1,72,10,20,31704505,7245,7245,4895,Mediterranean_Hispanic,145,0,0,32504.0,Unknown,67190072,9111392.0,2.0,89,158,89,1,1,3,168,2,0.7089177030960572,0.5181818181818182,0.7058823529411764,0.0313777330589692,0.0,0.0,0.0247561890472618,0.0997749437359339,0.0505924720131114,0.1428571428571428,0.3953488372093026,0.5,336,18,13,61,4,6649,16,55,60,4000000,153846.15384615384,20000000.0,6000000.0,,0.0,1,2000000,-0.2,-0.5555555555555556
229853,Birama,Touré,2024,969,Mali,Kayes,Mali,06-06-92,Defensive Midfield,Midfield,Right,183.0,30-06-26,Unknown,https://img.a.transfermarkt.technology/portrait/header/229853-1599424312.jpg?lm=1,FR1,Montpellier HÃ©rault Sport Club,1500000.0,2000000.0,32,124,129,8,11,11,8,12,9,13,12,6,13,12,10,13,14,13,13,13,13,12,12,11,12,7,14,13,12,16,13,13,13,13,12,15,13,16,13,12,11,14,6,8,4,1,2,3,2,4,3,1,3,4,1,7,13,6,15,12,13,14,14,1,1,8,1,1,1,20,1,17,10,1,1,1,1,76,8,20,1962139,6200,6200,3502,African_Caribbean,124,10,0,5771.0,Unknown,85083759,525000.0,2.0,61,716,61,3,1,1,133,4,0.5706536120666843,0.3691978609625668,0.5514705882352942,0.005563886686745,0.0657894736842105,0.0,0.0072518129532383,0.0097524381095273,0.0028889691380316,0.1428571428571428,0.4651162790697669,0.5833333333333333,0,0,0,0,0,0,2,7,68,1200000,38888.88888888889,2000000.0,500000.0,,750000.0,6,800000,-0.25,-0.25
229970,Tom,Lawrence,2024,124,Wales,Wrexham,Wales,13-01-94,Attacking Midfield,Midfield,Right,175.0,31-05-25,YMU Management Ltd.,https://img.a.transfermarkt.technology/portrait/header/229970-1727380895.jpg?lm=1,SC1,Rangers Football Club,2500000.0,6000000.0,30,122,139,12,12,15,13,13,12,9,12,6,6,12,14,8,14,14,12,8,12,9,12,9,15,14,12,13,5,8,7,13,13,12,8,13,13,11,8,12,14,12,14,12,3,1,1,1,1,2,1,1,1,2,1,12,15,12,14,11,10,10,15,1,1,1,1,1,1,1,15,12,14,19,20,17,14,75,14,20,3558012,6099,5399,3627,Northern_European,111,23,3,28998.0,Unknown,28058330,3380000.0,2.0,109,1676,106,3,1,7,161,0,0.4646731939666578,0.382566844919786,0.4558823529411764,0.0279922789243409,0.1513157894736842,0.0394736842105263,0.0122530632658164,0.0297574393598399,0.0187505208478013,0.1428571428571428,0.2790697674418605,0.5,397,77,57,66,3,8457,3,66,306,2000000,43478.260869565216,6000000.0,1200000.0,,1000000.0,4,3500000,-0.2,-0.42857142857142855
230552,Diego,Laxalt,2024,121,Uruguay,Montevideo,Uruguay,07-02-93,Left-Back,Defender,Left,178.0,30-06-26,Ariel Krasouski,https://img.a.transfermarkt.technology/portrait/header/230552-1721727675.png?lm=1,RU1,FK Dinamo Moskva,3000000.0,18000000.0,31,122,137,10,12,13,7,12,7,6,11,12,12,11,10,12,12,13,12,13,12,12,7,11,13,8,7,14,11,13,12,15,16,8,9,15,15,14,7,12,8,10,4,14,3,2,3,3,1,3,2,2,2,1,2,14,13,7,12,11,14,15,14,1,20,1,1,19,1,1,17,1,1,14,1,1,1,70,20,8,4841552,6200,6826,4928,Mixed_Race,114,24,0,33925.0,Unknown,78048399,7650000.0,4.0,106,975,103,1,0,4,74,8,0.6534797565493516,0.521711229946524,0.4779411764705882,0.0327498751939683,0.1578947368421052,0.0,0.0147536884221055,0.0897724431107777,0.0424734020389455,0.4285714285714285,0.3488372093023257,0.5416666666666665,0,0,0,0,0,0,9,40,87,2800000,75000.0,18000000.0,4000000.0,,3400000.0,11,13800000,-0.06666666666666667,0.0
230784,Thomas,Partey,2024,11,Ghana,Odumase Krobo,Ghana,13-06-93,Defensive Midfield,Midfield,Right,185.0,30-06-25,JJ SPORT,https://img.a.transfermarkt.technology/portrait/header/230784-1668430877.jpg?lm=1,GB1,Arsenal Football Club,18000000.0,50000000.0,31,150,162,8,10,12,10,14,9,13,13,10,12,15,8,14,13,13,15,14,15,13,14,15,13,11,12,13,14,16,15,13,13,12,14,11,14,16,15,12,10,13,13,16,2,2,2,1,3,2,3,3,3,1,2,14,14,9,13,11,14,12,12,1,1,8,8,1,8,19,1,20,8,1,10,8,1,80,11,20,110302341,7500,7750,6900,African_Caribbean,150,40,13,185587.0,Unknown,67175052,50000000.0,1.0,39,1072,41,3,1,1,21,4,0.7757343212490078,0.7326203208556149,0.7426470588235294,0.1791973209914572,0.2631578947368421,0.1710526315789473,0.0897724431107777,0.2498124531132783,0.277757715492097,0.0,0.5116279069767438,0.5416666666666665,443,37,21,105,0,7528,13,88,113,15000000,486666.6666666667,50000000.0,10000000.0,,1000000.0,3,11500000,-0.16666666666666666,-0.4
230921,Mortadha,Ben Ouanes,2024,10484,Tunisia,Sousse,Tunisia,02-07-94,Left Winger,Attack,Left,182.0,30-06-25,4YOURDREAM,https://img.a.transfermarkt.technology/portrait/header/230921-1727699464.jpg?lm=1,TR1,Kas?mpa?a Spor KulÃ¼bÃ¼,1600000.0,1600000.0,30,125,130,9,13,13,12,13,12,13,10,11,12,13,7,13,14,13,13,12,13,12,13,14,14,14,9,13,12,13,13,14,13,12,13,12,13,13,12,14,10,13,8,15,2,2,1,3,2,1,2,3,1,3,2,11,9,3,10,13,14,12,10,1,14,1,1,14,1,1,16,1,10,20,10,18,1,78,20,7,3763765,6196,5365,5552,North_African__Middle_Eastern,130,2,0,8653.0,Unknown,12063540,67000.0,1.0,99,1401,99,0,0,6,117,7,0.4601746493781423,0.5884491978609625,0.5955882352941175,0.0083467956473836,0.0131578947368421,0.0,0.0077519379844961,0.0077519379844961,0.0003444540126114,0.0,0.4418604651162785,0.5,268,36,29,47,1,5716,5,18,30,1500000,50000.0,1600000.0,200000.0,50000.0,50000.0,3,350000,0.0,0.0
230946,Ilya,Lantratov,2024,932,Russia,"Prokhorovka, Belgorod Region",Russia,11-11-95,Goalkeeper,Goalkeeper,Right,194.0,30-06-26,Pavel Andreev,https://img.a.transfermarkt.technology/portrait/header/230946-1721715136.png?lm=1,RU1,"?????????? ???? ""?????????"" ??????",3500000.0,3500000.0,29,122,126,3,1,1,3,7,7,2,3,3,3,12,5,2,8,10,12,15,13,13,10,11,14,3,9,3,16,9,9,8,12,13,15,13,10,9,14,15,14,13,4,11,13,12,12,6,12,13,9,16,12,10,12,10,10,10,12,7,13,15,10,20,1,1,1,1,1,1,1,1,1,1,1,1,1,82,6,20,2971843,6001,6001,3500,Northern_European,118,0,0,23590.0,Unknown,58084845,200000.0,1.0,78,1189,81,2,1,7,3,5,0.5443238952103732,0.3689839572192513,0.5073529411764706,0.0227702207497631,0.0,0.0,0.0172543135783946,0.0172543135783946,0.0010833634267618,0.0,0.7209302325581395,0.4583333333333332,0,0,0,0,0,0,1,2,58,3500000,124107.14285714286,3500000.0,200000.0,25000.0,,6,475000,0.0,0.16666666666666666
231572,Nélson,Semedo,2024,543,Portugal,Lisboa,Portugal,16-11-93,Right-Back,Defender,Right,177.0,30-06-25,Gestifute,https://img.a.transfermarkt.technology/portrait/header/231572-1684487147.jpg?lm=1,GB1,Wolverhampton Wanderers Football Club,12000000.0,40000000.0,31,148,164,8,12,15,9,15,8,7,10,11,11,12,8,14,15,13,14,14,10,12,12,11,15,14,6,15,12,14,15,17,16,14,8,15,16,15,13,13,11,15,7,15,3,1,2,2,3,1,3,2,2,2,3,16,13,10,14,15,15,13,10,1,13,1,20,10,20,1,1,1,10,1,1,10,1,69,10,20,38922317,7400,7350,6200,African_Caribbean,139,24,0,98593.0,Unknown,55061470,33850000.0,2.0,76,843,79,1,1,1,222,11,0.7228102672664726,0.6577540106951871,0.6617647058823528,0.0951944125522519,0.1578947368421052,0.0,0.0597649412353088,0.1997999499874969,0.1880330009166921,0.1428571428571428,0.3255813953488373,0.5416666666666665,422,13,41,73,2,8572,8,51,105,10000000,331666.6666666667,40000000.0,8000000.0,,200000.0,3,15400000,-0.16666666666666666,-0.3333333333333333
231590,Braydon,Manu,2024,1269,Germany,Itzehoe,Ghana,28-03-97,Right Winger,Attack,Right,170.0,30-06-26,SPORTS AGENTS CLUB,https://img.a.transfermarkt.technology/portrait/header/231590-1657037438.jpg?lm=1,NL1,Prins Hendrik Ende Desespereert Nimmer Combinatie Zwolle,1200000.0,1500000.0,27,121,130,3,8,13,12,11,3,7,8,2,7,11,6,7,12,14,12,12,11,9,12,10,16,15,3,13,7,11,13,16,13,9,6,13,16,11,10,13,12,11,8,14,1,1,3,2,1,3,1,1,1,1,3,8,13,9,9,13,12,10,8,1,1,1,10,10,10,1,12,1,15,12,10,18,20,70,15,20,1709826,6049,5749,4049,African_Caribbean,106,0,0,8630.0,Unknown,92092245,200000.0,1.0,38,677,41,0,1,1,156,10,0.5109817412013761,0.4277005347593582,0.4191176470588235,0.0083245864502654,0.0,0.0,0.0057514378594648,0.0072518129532383,0.0010833634267618,0.0,0.1627906976744184,0.375,205,26,33,31,2,3373,12,61,110,1000000,43181.818181818184,1500000.0,300000.0,,175000.0,5,375000,-0.16666666666666666,-0.3333333333333333
232271,Sofiane,Boufal,2024,3948,France,Paris,Morocco,17-09-93,Left Winger,Attack,Right,175.0,30-06-26,Unknown,https://img.a.transfermarkt.technology/portrait/header/232271-1668757196.jpg?lm=1,BE1,Royale Union Saint-Gilloise,6000000.0,15000000.0,31,134,144,12,13,16,12,15,13,7,13,8,6,12,13,5,16,10,10,8,13,11,14,10,12,17,7,12,6,10,8,14,15,17,6,12,14,13,9,11,8,12,10,14,3,2,2,1,3,3,2,2,3,1,2,13,13,9,13,14,12,10,16,1,1,1,1,1,1,1,14,1,14,20,18,18,15,75,10,20,5541345,6700,6700,5250,North_African__Middle_Eastern,127,29,4,29999.0,Unknown,85104863,9233333.333,3.0,34,1122,67,0,1,6,177,7,0.6368086795448531,0.5561497326203209,0.5735294117647058,0.0289588618076162,0.1907894736842105,0.0526315789473684,0.0297574393598399,0.0747686921730432,0.0512699426817411,0.2857142857142857,0.2790697674418605,0.5416666666666665,317,44,37,56,1,6072,16,97,138,4500000,155357.14285714287,15000000.0,3000000.0,,,7,7700000,-0.25,-0.35714285714285715
232320,Atakan,Karazor,2024,79,Germany,Essen,TÃ¼rkiye,13-10-96,Defensive Midfield,Midfield,Right,191.0,30-06-28,EMG Mundial,https://img.a.transfermarkt.technology/portrait/header/232320-1657181595.jpg?lm=1,L1,Verein fÃ¼r Bewegungsspiele Stuttgart 1893,12000000.0,12000000.0,28,128,131,7,9,10,7,13,6,12,8,10,12,14,8,12,14,11,15,12,15,13,15,15,13,10,12,11,14,17,11,10,11,12,15,13,12,14,12,15,8,13,6,8,2,2,4,3,1,3,1,2,3,3,1,12,15,8,14,14,14,14,15,1,1,16,1,1,1,20,1,18,1,1,1,1,1,76,10,20,3250247,6249,6249,4255,North_African__Middle_Eastern,125,0,0,8500.0,Unknown,92074021,800000.0,1.0,38,475,100,3,1,6,211,4,0.5771368086795449,0.4497326203208556,0.5588235294117647,0.0081990562056842,0.0,0.0,0.0597649412353088,0.0597649412353088,0.0044167893552598,0.0,0.6511627906976742,0.4166666666666665,335,15,18,92,0,4092,11,11,18,12000000,478000.0,12000000.0,500000.0,50000.0,200000.0,2,50000,0.0,0.5
232418,Ondrej,Duda,2024,276,Slovakia,Snina,Slovakia,05-12-94,Central Midfield,Midfield,Right,180.0,30-06-26,CAA Stellar,https://img.a.transfermarkt.technology/portrait/header/232418-1716967836.jpg?lm=1,IT1,Verona Hellas Football Club,4000000.0,17000000.0,30,131,138,13,12,13,12,17,12,8,12,4,8,12,15,8,16,12,11,9,12,10,16,10,9,15,6,14,9,11,11,13,13,12,8,10,12,15,11,9,9,12,10,8,1,2,2,3,1,1,4,2,4,3,2,13,14,10,7,10,11,9,14,1,1,1,1,1,1,1,7,15,7,9,20,9,12,74,12,20,3270160,6250,6750,5150,Northern_European,128,59,10,19164.0,Unknown,63023511,3650000.0,4.0,86,1388,86,3,1,7,214,1,0.6434241862926701,0.5454545454545454,0.5808823529411764,0.0184963987304064,0.3881578947368421,0.131578947368421,0.0197549387346836,0.0847711927981995,0.0202505625156254,0.4285714285714285,0.3953488372093026,0.5,377,47,48,89,1,8593,11,61,211,4000000,119696.9696969697,17000000.0,4000000.0,75000.0,4000000.0,5,8500000,0.0,0.0
232454,Nadiem,Amiri,2024,39,Germany,Ludwigshafen am Rhein,Germany,27-10-96,Central Midfield,Midfield,Right,180.0,30-06-28,CAA Base Ltd,https://img.a.transfermarkt.technology/portrait/header/232454-1722885996.jpg?lm=1,L1,1. FuÃŸball- und Sportverein Mainz 05,9000000.0,22000000.0,28,129,140,15,15,13,11,12,14,5,13,7,9,13,12,11,14,15,13,13,12,11,14,11,15,14,12,13,11,17,15,12,13,13,9,16,12,14,11,11,10,11,8,16,2,4,2,2,2,2,2,1,2,3,2,10,14,11,9,13,11,8,8,1,1,1,1,1,1,1,13,20,1,1,18,1,1,77,12,20,3372935,6450,6900,5500,North_African__Middle_Eastern,127,5,0,57692.0,Unknown,91143491,5750000.0,2.0,38,873,40,3,1,6,1,1,0.6632707065361206,0.5828877005347594,0.5735294117647058,0.0556997007552092,0.0328947368421052,0.0,0.0447611902975743,0.1097774443610902,0.0319175532653684,0.1428571428571428,0.3953488372093026,0.4166666666666665,381,42,47,51,3,6939,14,47,105,11000000,389285.71428571426,22000000.0,4000000.0,1000000.0,10000000.0,4,9000000,0.5714285714285714,1.75
232895,Zinedine,Ferhat,2024,1420,Algeria,Bordj MenaÃ¯el,Algeria,01-03-93,Right Winger,Attack,Right,180.0,30-06-25,GFOOT,https://img.a.transfermarkt.technology/portrait/header/232895-1669801210.png?lm=1,FR1,Angers Sporting Club de l'Ouest,1500000.0,8000000.0,31,130,134,14,15,14,10,13,13,7,7,8,7,15,12,8,14,10,13,12,14,12,14,13,13,13,10,13,7,13,12,12,13,15,10,14,13,14,14,12,8,14,6,14,4,1,1,1,1,3,3,1,3,2,2,13,15,8,9,12,13,10,10,1,1,1,5,1,10,1,1,1,19,15,13,20,1,77,10,20,7173755,6450,6500,6000,North_African__Middle_Eastern,130,13,0,25000.0,Unknown,12043455,9111392.0,2.0,1,226,1,0,1,6,18,10,0.6103466525535857,0.6363636363636364,0.5955882352941175,0.0241317410948361,0.0855263157894736,0.0,0.0072518129532383,0.0397599399849962,0.0505924720131114,0.1428571428571428,0.3953488372093026,0.5416666666666665,389,35,89,34,3,5828,12,61,79,1200000,25806.451612903227,8000000.0,2500000.0,,750000.0,4,2300000,-0.2,-0.4
233124,Kortney,Hause,2024,405,England,Redbridge,England,16-07-95,Centre-Back,Defender,Left,191.0,30-06-25,PowerHause SG,https://img.a.transfermarkt.technology/portrait/header/233124-1700671308.jpg?lm=1,GB1,Aston Villa Football Club,2000000.0,8000000.0,29,130,138,5,6,10,6,11,5,15,5,12,13,13,6,14,12,14,13,13,13,13,9,13,9,7,10,13,13,13,13,13,14,12,14,13,14,15,15,11,6,12,13,12,1,1,2,1,3,1,3,2,3,2,1,10,15,7,13,8,10,9,13,1,15,20,1,1,1,1,1,1,1,1,1,1,1,84,20,7,10575488,6494,6494,5244,African_Caribbean,131,0,0,57996.0,Watford,29085910,3400000.0,1.0,32,1210,33,1,0,1,30,2,0.6095527917438476,0.5555080213903743,0.6029411764705883,0.055993248404076,0.0,0.0,0.0097524381095273,0.0397599399849962,0.0188616350454179,0.0,0.6511627906976742,0.4583333333333332,199,10,5,18,0,6976,9,105,844,2000000,75000.0,8000000.0,2000000.0,50000.0,500000.0,5,1950000,0.0,0.0
234029,Grischa,Prömel,2024,533,Germany,Stuttgart,Germany,09-01-95,Central Midfield,Midfield,Right,184.0,30-06-26,Unique Sports Group,https://img.a.transfermarkt.technology/portrait/header/234029-1657200969.jpg?lm=1,L1,TSG 1899 Hoffenheim FuÃŸball-Spielbetriebs GmbH,7000000.0,7500000.0,29,138,141,6,9,12,9,12,6,12,11,10,13,12,9,13,11,16,14,17,11,16,11,13,16,7,13,11,15,16,18,12,12,13,13,17,13,19,13,16,13,15,10,14,2,2,2,4,1,2,2,1,3,3,4,9,15,6,12,14,14,12,16,1,1,1,14,1,12,20,1,20,1,1,8,1,1,78,10,20,10852795,6898,6898,5248,Northern_European,136,0,0,12499.0,Unknown,91144397,9111392.0,2.0,38,1432,40,3,1,7,199,1,0.663006086266208,0.5559358288770053,0.6397058823529411,0.012060559652455,0.0,0.0,0.0347586896724181,0.0372593148287071,0.0505924720131114,0.1428571428571428,0.4883720930232553,0.4583333333333332,301,34,24,53,1,3473,16,96,172,4500000,165740.74074074073,7500000.0,2500000.0,,400000.0,4,325000,-0.35714285714285715,-0.35714285714285715
234193,Birger,Verstraete,2024,2727,Belgium,Oostende,Belgium,16-04-94,Defensive Midfield,Midfield,Right,174.0,30-06-27,SportPlus,https://img.a.transfermarkt.technology/portrait/header/234193-1608908875.jpg?lm=1,BE1,Oud-Heverlee Leuven,1800000.0,4000000.0,30,120,130,11,11,9,12,11,13,11,12,9,11,12,14,11,12,16,12,14,13,12,11,14,14,13,12,8,9,15,15,13,13,12,9,14,13,15,13,14,15,14,12,7,3,1,1,2,3,3,2,1,3,1,3,8,11,1,11,12,14,11,8,1,1,1,1,1,1,17,1,20,1,1,1,1,1,67,9,20,1344314,5749,5749,4749,Northern_European,120,1,0,28747.0,Yellow Red KV Mechelen,18059846,1762500.0,4.0,7,1087,8,3,1,7,146,4,0.5109817412013761,0.5025668449197861,0.5220588235294117,0.0277499089905726,0.006578947368421,0.0,0.0087521880470117,0.0197549387346836,0.0097641601155587,0.4285714285714285,0.2558139534883721,0.5,317,14,13,91,5,10092,9,22,44,2000000,59375.0,4000000.0,800000.0,600000.0,400000.0,8,1550000,0.1111111111111111,0.1111111111111111
234509,André,Onana,2024,985,Cameroon,Nkol Ngok,Cameroon,02-04-96,Goalkeeper,Goalkeeper,Right,190.0,30-06-28,Goal Management,https://img.a.transfermarkt.technology/portrait/header/234509-1686929812.jpg?lm=1,GB1,Manchester United Football Club,35000000.0,45000000.0,28,149,158,2,2,3,1,10,5,5,3,3,3,14,3,3,12,9,13,14,14,13,8,13,15,15,11,2,15,12,12,12,15,15,16,16,12,13,13,12,8,15,7,14,15,14,13,15,15,14,15,15,16,5,15,14,16,5,12,15,12,14,10,20,1,1,1,1,1,1,1,1,1,1,1,1,1,93,6,20,22500000,7600,7100,6050,African_Caribbean,149,30,0,74038.0,Unknown,67201634,25175000.0,2.0,15,1049,15,2,1,1,132,5,0.6897327335273882,0.641711229946524,0.7352941176470587,0.0714836805853958,0.1973684210526315,0.0,0.1747936984246061,0.2248062015503876,0.1398372177004916,0.1428571428571428,0.6279069767441858,0.4166666666666665,0,0,0,0,0,0,6,12,76,35000000,1165000.0,45000000.0,13000000.0,150000.0,3000000.0,3,7000000,0.0,-0.125
234523,Antonio,Sanabria,2024,416,Paraguay,San Lorenzo,Paraguay,04-03-96,Centre-Forward,Attack,Right,180.0,30-06-26,GG11 ,https://img.a.transfermarkt.technology/portrait/header/234523-1692963077.jpg?lm=1,IT1,Torino Calcio,7000000.0,10000000.0,28,131,136,5,9,12,13,15,11,16,11,4,5,12,12,6,14,13,13,12,12,11,12,12,13,13,9,15,5,13,11,14,15,13,13,13,13,12,12,12,9,8,10,11,1,3,1,1,1,4,3,3,1,2,2,11,13,8,12,11,14,13,12,1,1,1,1,1,1,1,1,1,1,10,1,7,20,76,11,20,4686704,6550,6300,5300,Mediterranean_Hispanic,130,29,2,56923.0,Unknown,67181404,6475000.0,4.0,73,1302,75,0,1,3,201,3,0.5838846255623181,0.5614973262032085,0.5955882352941175,0.0549571410776481,0.1907894736842105,0.0263157894736842,0.0347586896724181,0.0497624406101525,0.0359454429289702,0.4285714285714285,0.3953488372093026,0.4166666666666665,319,86,18,30,1,7751,19,69,134,6000000,200000.0,10000000.0,2500000.0,4000000.0,5000000.0,7,11900000,-0.14285714285714285,-0.3684210526315789
234781,Maxwel,Cornet,2024,180,Cote d'Ivoire,Bregbo,Cote d'Ivoire,27-09-96,Left Winger,Attack,Left,179.0,30-06-25,Unique Sports Group,https://img.a.transfermarkt.technology/portrait/header/234781-1663242689.jpg?lm=1,GB1,Southampton Football Club,9000000.0,18000000.0,28,139,143,12,11,12,14,12,11,11,10,10,11,12,10,11,12,8,12,13,12,10,11,10,14,12,6,13,10,13,14,15,12,12,10,15,15,13,12,12,9,13,7,17,2,2,3,3,3,3,1,2,3,3,3,14,13,6,13,10,13,14,14,1,19,1,1,18,1,1,18,1,1,20,1,15,13,69,20,12,29751880,6950,6950,5500,African_Caribbean,126,28,5,75395.0,Unknown,85117459,12783333.33,3.0,23,251,24,0,0,1,186,7,0.6698862132839376,0.5828877005347594,0.5661764705882353,0.0727940232153703,0.1842105263157894,0.0657894736842105,0.0447611902975743,0.0897724431107777,0.0709927127420206,0.2857142857142857,0.3720930232558141,0.4166666666666665,353,63,38,27,1,6733,13,57,152,8000000,274137.9310344828,18000000.0,3000000.0,1000000.0,10000000.0,4,5000000,-0.1111111111111111,-0.2
234803,Andrew,Robertson,2024,31,Scotland,Glasgow,Scotland,11-03-94,Left-Back,Defender,Left,178.0,30-06-26,PLG,https://img.a.transfermarkt.technology/portrait/header/234803-1709147379.jpg?lm=1,GB1,Liverpool Football Club,30000000.0,80000000.0,30,159,165,14,16,12,5,15,9,10,6,13,15,14,7,15,14,17,14,15,15,14,13,15,16,11,15,14,14,16,17,16,14,14,9,17,16,18,12,16,13,15,6,6,2,1,2,2,1,1,3,1,3,2,1,15,16,8,16,15,15,10,13,1,19,1,1,20,1,1,14,1,1,12,1,1,1,64,20,4,200948518,8050,8050,7000,Northern_European,158,59,3,185587.0,Unknown,61043456,6300000.0,2.0,82,545,83,1,0,7,129,8,0.8154273617359089,0.7433155080213903,0.8014705882352942,0.1791973209914572,0.3881578947368421,0.0394736842105263,0.1497874468617154,0.3998499624906226,0.0349731936998249,0.1428571428571428,0.3488372093023257,0.5,532,23,85,69,3,9008,13,47,103,25000000,862068.9655172414,80000000.0,16000000.0,0.0,5000000.0,3,5975000,-0.16666666666666666,-0.2857142857142857
234811,Rui,Silva,2024,150,Portugal,Maia,Portugal,07-02-94,Goalkeeper,Goalkeeper,Left,191.0,30-06-26,Team of Future,https://img.a.transfermarkt.technology/portrait/header/234811-1666770953.jpg?lm=1,ES1,Real Betis BalompiÃ© S.A.D.,8000000.0,15000000.0,30,140,145,4,2,1,1,9,7,8,2,3,2,9,2,2,9,9,13,13,12,13,9,13,13,1,7,3,13,12,14,11,13,14,10,12,11,13,12,12,7,9,6,12,13,14,14,9,16,13,15,16,14,13,13,13,10,12,12,10,15,14,16,20,1,1,1,1,1,1,1,1,1,1,1,1,1,91,20,9,7986750,6850,6750,5500,Mediterranean_Hispanic,137,1,0,18389.0,Unknown,55067163,1000000.0,1.0,76,893,79,2,0,3,164,5,0.6434241862926701,0.5828877005347594,0.6470588235294117,0.0177480453492492,0.006578947368421,0.0,0.0397599399849962,0.0747686921730432,0.0055279313314258,0.0,0.6511627906976742,0.5,0,0,0,0,0,0,2,3,9,5000000,175000.0,15000000.0,7000000.0,,300000.0,3,2000000,-0.375,-0.6666666666666666
235339,Dmitriy,Chistyakov,2024,964,Russia,"Pikalevo, St. Petersburg Region",Russia,13-01-94,Centre-Back,Defender,Right,185.0,30-06-25,ATS,https://img.a.transfermarkt.technology/portrait/header/235339-1721722888.png?lm=1,RU1,AO FK Zenit Sankt-Peterburg,1500000.0,4000000.0,30,123,130,7,7,7,9,11,5,14,7,7,15,11,8,14,8,12,12,13,11,12,7,13,15,7,11,7,14,13,13,12,13,13,13,13,12,12,11,15,8,12,5,7,2,1,2,3,1,2,3,3,2,3,3,14,13,5,11,13,16,14,13,1,1,20,8,1,1,10,1,6,4,1,1,1,1,79,10,20,3593839,5990,5990,4240,Northern_European,122,4,0,29489.0,Unknown,58085203,1687500.0,2.0,78,1144,81,1,1,7,7,2,0.5428684837258534,0.4481283422459892,0.536764705882353,0.0284663970019515,0.0263157894736842,0.0,0.0072518129532383,0.0197549387346836,0.0093474818744965,0.1428571428571428,0.5116279069767438,0.5,328,14,4,57,0,7830,6,18,71,1200000,51086.95652173913,4000000.0,1500000.0,25000.0,,8,1325000,-0.3333333333333333,-0.4
235767,John,Souttar,2024,124,Scotland,Aberdeen,Scotland,25-09-96,Centre-Back,Defender,Right,186.0,31-05-26,Wasserman,https://img.a.transfermarkt.technology/portrait/header/235767-1709884351.jpg?lm=1,SC1,Rangers Football Club,3500000.0,3500000.0,28,124,140,5,9,10,8,13,6,13,9,6,13,13,8,13,13,11,12,13,13,11,14,12,16,11,13,10,13,13,11,12,11,12,14,13,13,13,14,13,8,14,16,12,3,2,2,1,2,2,3,1,2,3,1,19,14,3,10,15,15,14,18,1,1,20,12,1,1,12,1,1,1,1,1,1,1,77,12,20,4791619,6200,6200,4500,Northern_European,124,6,1,9279.0,Unknown,61058341,200000.0,1.0,82,13,83,1,1,7,161,2,0.5706536120666843,0.4759358288770053,0.5514705882352942,0.0089512720559053,0.0394736842105263,0.0131578947368421,0.0172543135783946,0.0172543135783946,0.0010833634267618,0.0,0.5348837209302322,0.4166666666666665,318,12,10,42,0,8824,19,231,222,4500000,186956.52173913043,4500000.0,300000.0,500000.0,600000.0,2,100000,0.5,2.0
235931,Alessandro,Deiola,2024,1390,Italy,San Gavino Monreale,Italy,01-08-95,Central Midfield,Midfield,Right,190.0,30-06-25,Team Raiola,https://img.a.transfermarkt.technology/portrait/header/235931-1692964002.jpg?lm=1,IT1,Cagliari Calcio,1900000.0,2000000.0,29,125,130,10,11,11,10,11,6,11,11,12,12,12,5,12,12,12,12,12,12,12,13,13,10,10,10,13,13,14,13,13,13,13,15,12,13,14,14,12,7,8,9,13,2,3,2,1,3,3,3,1,2,3,2,11,12,4,8,13,13,9,13,1,1,1,1,1,1,15,10,20,14,1,1,1,1,85,11,20,3716339,6250,6250,4950,Mediterranean_Hispanic,125,0,0,10672.0,Unknown,43093890,9111392.0,2.0,52,1298,54,3,1,3,46,1,0.5772691188145012,0.5240641711229946,0.5588235294117647,0.0102963769074562,0.0,0.0,0.0092523130782695,0.0097524381095273,0.0505924720131114,0.1428571428571428,0.6279069767441858,0.4583333333333332,312,25,9,51,2,7063,13,31,75,1600000,59615.38461538462,2000000.0,300000.0,75000.0,1600000.0,9,525000,-0.15789473684210525,0.0
236168,Brandon,Mechele,2024,2282,Belgium,Bredene,Belgium,28-01-93,Centre-Back,Defender,Right,190.0,30-06-27,SportPlus,https://img.a.transfermarkt.technology/portrait/header/236168-1704874625.jpg?lm=1,BE1,Club Brugge Koninklijke Voetbalvereniging,3000000.0,7000000.0,31,127,127,7,7,7,7,10,9,12,11,10,15,10,9,14,9,14,14,10,13,15,10,14,17,11,15,12,14,16,15,10,10,13,15,14,10,14,12,17,13,14,7,10,3,3,2,3,2,2,1,2,3,3,3,12,12,4,19,12,17,11,12,1,1,20,1,1,1,1,1,1,1,1,1,1,1,81,8,20,2154240,6068,6468,4934,Northern_European,126,3,0,12499.0,Unknown,18059927,9111392.0,2.0,7,249,8,1,1,7,53,2,0.6061127282349829,0.5223529411764706,0.5661764705882353,0.012060559652455,0.0197368421052631,0.0,0.0147536884221055,0.0347586896724181,0.0505924720131114,0.1428571428571428,0.6279069767441858,0.5416666666666665,497,25,11,56,0,17752,4,18,43,3000000,78125.0,7000000.0,1500000.0,,1500000.0,2,1300000,0.0,-0.25
236400,Léo,Dubois,2024,7160,France,SegrÃ©,France,14-09-94,Right-Back,Defender,Right,178.0,30-06-25,One Team Football ,https://img.a.transfermarkt.technology/portrait/header/236400-1695642917.png?lm=1,TR1,EyÃ¼p Spor KulÃ¼bÃ¼,3000000.0,16000000.0,30,134,141,14,13,10,9,13,13,11,10,12,12,14,11,13,13,10,14,12,13,14,12,13,14,10,16,12,12,15,15,12,14,13,11,10,12,11,12,14,11,11,9,12,2,1,1,2,3,3,3,1,3,2,4,20,13,6,13,12,14,15,13,1,14,1,20,14,20,11,1,1,1,1,1,1,1,64,14,20,7154625,6700,6700,5250,Northern_European,133,13,0,57692.0,Unknown,85085148,2500000.0,1.0,34,1356,36,1,1,7,66,11,0.6368086795448531,0.5561497326203209,0.6176470588235294,0.0556997007552092,0.0855263157894736,0.0,0.0147536884221055,0.0797699424856214,0.0138614961526709,0.0,0.3488372093023257,0.5,310,11,39,38,0,5457,10,43,72,2700000,82258.06451612903,16000000.0,4000000.0,,400000.0,4,4700000,-0.22857142857142856,-0.22857142857142856
236471,Ozan,Tufan,2024,449,TÃ¼rkiye,Bursa,TÃ¼rkiye,23-03-95,Central Midfield,Midfield,Right,182.0,30-06-27,FutureBall,https://img.a.transfermarkt.technology/portrait/header/236471-1723803359.jpg?lm=1,TR1,Trabzonspor KulÃ¼bÃ¼,3000000.0,11000000.0,29,126,140,6,5,14,13,13,4,13,15,8,12,15,10,13,12,11,12,16,13,10,13,11,12,11,11,12,11,15,13,12,10,15,11,14,12,12,14,9,8,11,7,16,3,3,2,3,1,2,2,2,1,2,2,12,10,10,14,10,8,15,10,1,7,10,14,1,10,19,1,20,10,1,18,10,1,80,10,20,5844356,6292,6392,5092,Mediterranean_Hispanic,122,64,9,26678.0,Unknown,70076282,4000000.0,3.0,100,280,100,3,1,3,204,1,0.5960571579783012,0.5392513368983957,0.536764705882353,0.0257520468671996,0.4210526315789473,0.1184210526315789,0.0147536884221055,0.0547636909227306,0.0221950609739159,0.2857142857142857,0.4418604651162785,0.4583333333333332,388,46,38,52,1,7912,10,27,42,2500000,65714.28571428571,11000000.0,3500000.0,400000.0,7500000.0,9,8000000,-0.10714285714285714,-0.10714285714285714
236490,Ola,Aina,2024,703,England,London,Nigeria,08-10-96,Right-Back,Defender,Right,184.0,30-06-25,Unknown,https://img.a.transfermarkt.technology/portrait/header/236490-1707383919.jpg?lm=1,GB1,Nottingham Forest Football Club,12000000.0,12000000.0,28,132,139,5,12,12,7,11,4,11,6,12,9,11,5,12,12,11,9,9,11,9,10,9,12,14,7,11,9,10,12,17,14,12,11,16,17,13,10,11,11,12,7,16,2,3,2,2,3,1,1,2,4,1,2,12,14,7,10,11,15,14,15,1,17,10,19,19,20,8,18,1,17,1,1,1,1,82,15,20,3882697,6600,6650,5500,African_Caribbean,115,29,0,35577.0,Unknown,28090452,9800000.0,1.0,32,858,70,1,1,1,140,11,0.6301931727970362,0.5828877005347594,0.4852941176470588,0.0343450749174155,0.1907894736842105,0.0,0.0597649412353088,0.0597649412353088,0.05441817828273,0.0,0.4883720930232553,0.4166666666666665,331,10,16,51,1,5962,8,35,94,14000000,562500.0,14000000.0,2000000.0,,1500000.0,6,7500000,0.16666666666666666,0.75
236997,Tiago,Silva,2024,2420,Portugal,Lisboa,Portugal,02-06-93,Central Midfield,Midfield,Right,172.0,30-06-26,MRP.POSITIONUMBER,https://img.a.transfermarkt.technology/portrait/header/236997-1534408061.png?lm=1,PO1,VitÃ³ria Sport Clube,3000000.0,3000000.0,31,128,130,13,13,14,10,14,12,5,13,4,8,14,13,9,15,15,12,13,14,13,15,13,14,14,11,13,11,14,15,12,14,13,6,12,11,13,8,13,15,11,9,9,2,3,3,3,1,3,1,2,2,4,2,10,13,5,15,10,16,13,7,1,1,1,1,1,1,10,1,20,1,1,16,1,1,64,12,20,2249674,6398,6398,4898,Mediterranean_Hispanic,128,0,0,4750.0,Unknown,55060877,9111392.0,2.0,76,843,79,3,1,3,217,1,0.5968510187880391,0.5185026737967914,0.5808823529411764,0.0045779914581496,0.0,0.0,0.0147536884221055,0.0147536884221055,0.0505924720131114,0.1428571428571428,0.2093023255813952,0.5416666666666665,0,0,0,0,0,0,5,14,36,3000000,80000.0,3000000.0,750000.0,,1700000.0,4,1450000,0.0,0.5
237164,Ihlas,Bebou,2024,533,Togo,Aledjo Kadara,Togo,23-04-94,Centre-Forward,Attack,Right,185.0,30-06-26,EMG Mundial,https://img.a.transfermarkt.technology/portrait/header/237164-1723921163.jpg?lm=1,L1,TSG 1899 Hoffenheim FuÃŸball-Spielbetriebs GmbH,4000000.0,16000000.0,30,136,140,8,10,14,13,12,8,9,9,8,7,12,13,8,14,11,12,13,10,12,11,10,11,15,6,14,7,11,13,15,14,14,12,13,17,13,12,12,7,11,12,16,2,2,3,3,2,2,2,3,4,2,3,10,14,8,9,12,13,12,10,1,1,1,1,10,10,1,12,1,16,16,10,19,20,78,9,20,3380204,6650,6650,6250,African_Caribbean,122,26,1,48051.0,Unknown,91132870,6750000.0,2.0,97,38,97,0,1,1,199,3,0.6301931727970362,0.6631016042780749,0.536764705882353,0.0463901846936144,0.1710526315789473,0.0131578947368421,0.0197549387346836,0.0797699424856214,0.0374732631461985,0.1428571428571428,0.5116279069767438,0.5,319,74,53,32,0,3836,16,146,418,2800000,83870.96774193548,16000000.0,5000000.0,,150000.0,2,2500000,-0.3,-0.3
237641,Amr,Warda,2024,3060,Egypt,Alexandria,Egypt,17-09-93,Left Winger,Attack,Right,176.0,30-06-25,Target Sport,https://img.a.transfermarkt.technology/portrait/header/237641-1613847826.jpg?lm=1,GR1,APS Atromitos Athinon,700000.0,2500000.0,31,130,130,13,12,15,12,15,14,15,12,6,6,13,14,7,16,9,12,10,12,13,13,12,13,16,7,13,7,10,13,14,15,10,8,13,13,13,8,10,12,12,4,14,1,3,4,2,1,1,1,3,1,1,3,15,12,19,9,8,4,5,5,1,1,1,1,1,1,1,15,8,14,20,12,17,10,70,10,20,1859999,6500,6250,4000,North_African__Middle_Eastern,129,30,1,4099.0,Unknown,13167267,235000.0,2.0,31,40,32,0,1,6,9,7,0.5772691188145012,0.4224598930481283,0.588235294117647,0.0039493746179776,0.1973684210526315,0.0131578947368421,0.0032508127031757,0.0122530632658164,0.0012778132725909,0.1428571428571428,0.3023255813953489,0.5416666666666665,320,64,52,58,0,13731,2,4,18,700000,25000.0,2500000.0,750000.0,,50000.0,13,3350000,0.0,-0.3
237658,Michel,Aebischer,2024,1025,Switzerland,Fribourg,Switzerland,06-01-97,Central Midfield,Midfield,Right,183.0,30-06-26,Wasserman,https://img.a.transfermarkt.technology/portrait/header/237658-1669289063.jpg?lm=1,IT1,Bologna Football Club 1909,11000000.0,11000000.0,27,129,137,13,11,12,8,14,13,9,12,8,8,15,10,11,14,10,13,10,15,13,12,15,11,11,12,12,9,15,14,12,10,13,9,12,11,15,13,13,10,14,9,12,2,3,1,4,2,2,2,4,2,2,3,12,11,5,13,9,14,12,14,1,1,1,1,1,1,12,10,20,10,1,16,1,1,74,12,20,3916222,6448,6798,4198,Northern_European,128,10,0,12308.0,Unknown,98040986,3000000.0,1.0,92,513,92,3,1,7,40,1,0.6497750727705742,0.4436363636363636,0.5808823529411764,0.0118761267546472,0.0657894736842105,0.0,0.0547636909227306,0.0547636909227306,0.0166393510930859,0.0,0.4651162790697669,0.375,362,29,38,80,0,8881,8,51,107,10000000,416666.6666666667,11000000.0,1000000.0,,900000.0,2,300000,-0.09090909090909091,0.6666666666666666
237662,Breel,Embolo,2024,162,Cameroon,YaoundÃ©,Switzerland,14-02-97,Centre-Forward,Attack,Right,187.0,30-06-26,SEG,https://img.a.transfermarkt.technology/portrait/header/237662-1669288888.jpg?lm=1,FR1,Association sportive de Monaco Football Club,12000000.0,22000000.0,27,141,145,6,8,14,12,12,7,13,12,6,7,13,12,8,14,16,13,16,11,10,14,11,15,15,6,15,7,15,16,14,13,16,14,12,16,13,17,11,12,14,12,14,1,2,1,1,3,2,2,1,1,1,2,14,14,17,12,11,8,10,9,1,1,1,1,1,1,6,12,10,15,12,17,18,20,88,10,20,25187932,7050,7000,6250,African_Caribbean,135,56,9,67122.0,Unknown,98029385,16666666.67,3.0,15,1682,92,0,1,1,24,3,0.6765017200317545,0.6631016042780749,0.6323529411764706,0.0648054715736761,0.3684210526315789,0.1184210526315789,0.0597649412353088,0.1097774443610902,0.0925673861496152,0.2857142857142857,0.5581395348837206,0.375,365,95,62,51,0,8470,22,187,232,12000000,340000.0,22000000.0,5000000.0,16000000.0,18000000.0,4,7150000,0.0,0.0
238055,Unknown,Rafa,2024,114,Portugal,Forte da Casa,Portugal,17-05-93,Second Striker,Attack,Right,172.0,30-06-27,Onsoccer,https://img.a.transfermarkt.technology/portrait/header/238055-1727356372.png?lm=1,TR1,Be?ikta? Jimnastik KulÃ¼bÃ¼,14000000.0,30000000.0,31,155,158,11,11,16,11,15,11,5,12,5,6,14,12,9,15,13,13,11,10,11,15,12,13,19,10,17,7,9,11,18,18,15,5,16,17,13,6,12,6,15,7,10,1,3,2,2,2,1,2,2,2,1,3,8,7,10,14,12,14,9,14,1,1,1,1,1,1,1,14,12,12,20,20,18,14,62,11,20,29699999,7750,7500,6150,Mediterranean_Hispanic,144,25,0,32142.0,Unknown,55063493,8248000.0,2.0,76,503,79,0,1,3,37,12,0.7426567875099233,0.6524064171122994,0.6985294117647058,0.0310281796086739,0.1644736842105263,0.0,0.0697674418604651,0.1497874468617154,0.0457957165476818,0.1428571428571428,0.2093023255813952,0.5416666666666665,0,0,0,0,0,0,13,62,81,12000000,328125.0,30000000.0,6000000.0,,4000000.0,2,0,-0.14285714285714285,-0.3333333333333333
238223,Unknown,Ederson,2024,281,Brazil,Osasco,Brazil,17-08-93,Goalkeeper,Goalkeeper,Left,188.0,30-06-26,Gestifute,https://img.a.transfermarkt.technology/portrait/header/238223-1713391842.jpg?lm=1,GB1,Manchester City Football Club,35000000.0,70000000.0,31,175,180,5,2,11,3,14,8,9,12,2,1,18,12,3,17,12,17,18,20,16,17,15,16,2,7,15,13,14,13,14,13,13,13,15,13,14,13,16,5,16,5,2,13,16,13,15,16,20,13,14,17,6,17,16,14,4,12,20,16,10,18,20,1,1,1,1,1,1,1,1,1,1,1,1,1,86,20,10,325655872,8750,8500,8500,Mediterranean_Hispanic,173,18,0,208785.0,Unknown,55057659,20250000.0,2.0,10,1094,11,2,0,3,131,5,0.8749669224662608,0.9037433155080212,0.9117647058823528,0.2015977103283388,0.1184210526315789,0.0,0.1747936984246061,0.3498374593648412,0.1124753465374038,0.1428571428571428,0.581395348837209,0.5416666666666665,0,0,0,0,0,0,11,26,76,30000000,1060714.2857142857,70000000.0,14000000.0,,900000.0,2,3600000,-0.14285714285714285,-0.25
238266,Duje,Caleta-Car,2024,1041,Croatia,Å ibenik,Croatia,17-09-96,Centre-Back,Defender,Right,193.0,30-06-27,CAA Stellar,https://img.a.transfermarkt.technology/portrait/header/238266-1662069879.jpg?lm=1,FR1,Olympique Lyonnais,7000000.0,25000000.0,28,135,144,5,5,8,7,13,8,15,10,8,14,14,8,14,9,14,15,13,12,13,12,12,15,10,11,8,14,14,14,11,11,15,15,14,12,14,16,14,11,13,12,6,1,3,3,2,4,3,2,3,1,3,1,14,13,8,10,12,14,14,13,1,1,20,1,1,1,1,1,1,1,1,1,1,1,89,11,20,24283271,6750,7050,5250,Northern_European,134,23,1,57996.0,Unknown,24039427,7660000.0,4.0,24,1726,25,1,1,7,143,2,0.6831172267795713,0.5561497326203209,0.625,0.055993248404076,0.1513157894736842,0.0131578947368421,0.0347586896724181,0.1247811952988247,0.0425289591377538,0.4285714285714285,0.6976744186046511,0.4166666666666665,382,15,11,78,5,8511,3,3,18,8000000,226428.57142857142,25000000.0,7000000.0,500000.0,2500000.0,4,9150000,0.14285714285714285,0.14285714285714285
238407,Alexander,Sørloth,2024,13,Norway,Trondheim,Norway,05-12-95,Centre-Forward,Attack,Left,195.0,30-06-28,Keypass AS,https://img.a.transfermarkt.technology/portrait/header/238407-1716403969.jpg?lm=1,ES1,Club AtlÃ©tico de Madrid S.A.D.,25000000.0,25000000.0,29,142,148,7,7,13,15,13,10,15,12,6,6,11,13,5,13,13,13,14,14,13,13,13,13,10,9,12,5,15,13,13,13,16,16,14,15,14,16,13,11,14,4,10,3,3,3,2,1,2,1,4,1,2,2,12,13,5,14,12,14,10,7,1,1,1,1,1,1,1,1,1,1,8,10,8,20,90,20,12,19060367,7100,7100,5750,Northern_European,141,42,15,57692.0,Real San SebastiÃ¡n,53063430,13166666.67,6.0,71,1528,73,0,0,7,52,3,0.6897327335273882,0.6096256684491979,0.6764705882352942,0.0556997007552092,0.2763157894736842,0.1973684210526315,0.1247811952988247,0.1247811952988247,0.0731224015667101,0.7142857142857142,0.7441860465116279,0.4583333333333332,402,143,50,34,1,9960,10,30,25,25000000,831666.6666666666,25000000.0,4000000.0,100000.0,1000000.0,10,18750000,0.0,0.7857142857142857
238537,Wladimiro,Falcone,2024,1005,Italy,Roma,Italy,12-04-95,Goalkeeper,Goalkeeper,Right,195.0,30-06-28,LIAN Sports Group,https://img.a.transfermarkt.technology/portrait/header/238537-1693308504.jpg?lm=1,IT1,Unione Sportiva Lecce,5000000.0,5000000.0,29,128,133,3,1,1,2,9,6,11,2,1,2,10,4,2,9,12,12,13,11,16,12,12,15,13,12,6,13,12,12,12,12,12,17,13,11,13,13,13,6,13,4,11,12,13,11,3,13,12,13,14,10,11,11,10,13,3,15,10,12,10,12,20,1,1,1,1,1,1,1,1,1,1,1,1,1,85,10,20,2489415,6400,6400,4253,Mediterranean_Hispanic,127,0,0,2845.0,Salento,43094480,2003500.0,2.0,52,1244,54,2,1,3,206,5,0.5971156390579518,0.44951871657754,0.5735294117647058,0.0027384905664021,0.0,0.0,0.0247561890472618,0.0247561890472618,0.0111030861968388,0.1428571428571428,0.7441860465116279,0.4583333333333332,0,0,0,0,0,0,2,1,8,4000000,145370.37037037036,5000000.0,1000000.0,100000.0,200000.0,12,1725000,-0.2,-0.2
238639,Steve,Mounié,2024,167,Benin,Parakou,Benin,29-09-94,Centre-Forward,Attack,Right,190.0,30-06-27,Soccermax,https://img.a.transfermarkt.technology/portrait/header/238639-1722849465.jpg?lm=1,L1,FC Augsburg 1907,4500000.0,10000000.0,30,124,141,8,7,11,12,13,6,17,11,5,8,12,12,7,12,9,12,13,12,12,12,11,11,11,11,12,12,11,13,12,13,14,17,12,12,13,16,12,8,10,8,8,2,3,2,4,3,3,1,2,2,3,3,12,15,7,14,11,14,13,12,1,1,1,1,1,1,1,1,1,1,10,1,1,20,83,8,20,2761244,6200,6200,4500,African_Caribbean,123,42,13,9693.0,Unknown,36514846,9000000.0,2.0,8,1118,9,0,1,1,67,3,0.5706536120666843,0.4759358288770053,0.5441176470588236,0.0093510376040331,0.2763157894736842,0.1710526315789473,0.0222555638909727,0.0497624406101525,0.049973610378066,0.1428571428571428,0.6279069767441858,0.5,316,78,24,23,2,1507,5,21,50,3000000,105555.55555555556,10000000.0,2000000.0,,250000.0,5,6300000,-0.5,-0.4
238752,Keita,Baldé,2024,2381,Spain,ArbÃ¹cies,Senegal,08-03-95,Centre-Forward,Attack,Right,178.0,30-06-26,Universal Twenty Two,https://img.a.transfermarkt.technology/portrait/header/238752-1726065554.png?lm=1,TR1,Sivasspor KulÃ¼bÃ¼,1000000.0,30000000.0,29,127,150,10,9,13,12,13,10,10,9,3,4,13,12,2,15,12,12,10,10,10,12,10,18,16,10,14,4,10,12,16,14,13,12,16,15,12,13,11,10,14,9,14,1,3,3,1,1,1,1,1,2,3,1,13,18,11,10,14,14,11,11,1,1,1,1,1,1,1,1,1,1,16,15,15,20,77,12,20,7254833,6350,7237,5452,African_Caribbean,122,40,6,37930.0,Unknown,43093942,15150000.0,2.0,89,82,84,0,1,1,183,3,0.7078592220164065,0.5777540106951871,0.536764705882353,0.0366171723443352,0.2631578947368421,0.0789473684210526,0.0047511877969492,0.1497874468617154,0.0841412261451707,0.1428571428571428,0.3488372093023257,0.4583333333333332,354,82,47,50,3,9203,18,60,47,1000000,30645.16129032258,30000000.0,5000000.0,4000000.0,10000000.0,9,20200000,-0.16666666666666666,-0.3333333333333333
238868,Rubén,Peña,2024,331,Spain,Ãvila,Spain,18-07-91,Right-Back,Defender,Right,170.0,30-06-25,Unknown,https://img.a.transfermarkt.technology/portrait/header/238868-1490952343.jpg?lm=1,ES1,Club AtlÃ©tico Osasuna,2200000.0,10000000.0,33,135,145,8,14,14,9,12,8,8,10,13,12,13,10,14,12,10,13,12,12,13,13,14,11,10,7,14,13,12,13,13,13,13,8,12,13,13,10,12,10,10,7,14,2,2,3,1,1,1,2,2,1,1,3,19,8,4,10,12,11,11,15,1,10,1,20,11,18,1,13,1,16,14,14,16,11,65,12,20,347975206,6650,6650,3400,Mediterranean_Hispanic,126,0,0,12894.0,Unknown,67177699,4100000.0,2.0,89,1713,89,1,1,3,51,11,0.6301931727970362,0.3582887700534758,0.5661764705882353,0.0124419784725286,0.0,0.0,0.010752688172043,0.0497624406101525,0.0227506319619989,0.1428571428571428,0.1627906976744184,0.625,349,21,21,44,1,3970,11,53,92,1800000,53333.333333333336,10000000.0,2000000.0,,,5,3000000,-0.18181818181818182,-0.28
238993,Simone,Scuffet,2024,1390,Italy,Udine,Italy,31-05-96,Goalkeeper,Goalkeeper,Right,193.0,30-06-26,Unknown,https://img.a.transfermarkt.technology/portrait/header/238993-1692963456.jpg?lm=1,IT1,Cagliari Calcio,2500000.0,6000000.0,28,120,129,2,2,1,1,6,1,5,3,2,2,12,1,2,8,8,12,14,14,14,10,12,18,6,11,4,11,11,12,10,12,14,15,15,10,14,12,14,3,13,2,1,13,11,11,4,10,14,14,15,12,13,7,16,16,3,16,18,15,15,13,20,1,1,1,1,1,1,1,1,1,1,1,1,1,86,7,20,1701251,6050,6050,5375,Mediterranean_Hispanic,116,0,0,3650.0,Unknown,43094163,1150000.0,2.0,52,1544,54,2,1,3,46,5,0.5508070918232336,0.56951871657754,0.4926470588235294,0.0035158124655395,0.0,0.0,0.0122530632658164,0.0297574393598399,0.0063612878135503,0.1428571428571428,0.6976744186046511,0.4166666666666665,0,0,0,0,0,0,2,14,29,2000000,66379.31034482758,6000000.0,1000000.0,6000000.0,4000000.0,9,2150000,-0.2,0.0
239046,Ivan,Näsberg,2024,1063,Norway,Oslo,Norway,22-04-96,Centre-Back,Defender,Left,187.0,30-06-27,David Driscoll,https://img.a.transfermarkt.technology/portrait/header/239046-1694780898.png?lm=1,DK1,Viborg Fodsports Forening,600000.0,700000.0,28,120,125,5,9,8,6,10,7,12,8,8,13,12,7,14,11,15,13,14,10,13,10,11,13,4,15,10,14,12,13,11,10,12,15,12,12,13,14,12,7,14,4,8,2,1,3,2,3,1,1,4,2,3,4,19,13,3,16,12,14,13,12,1,10,20,1,1,1,1,1,1,1,1,1,1,1,88,20,8,1786048,5750,5850,2750,Northern_European,118,0,0,9934.0,Unknown,53096761,9111392.0,2.0,71,1096,73,1,0,7,215,2,0.5243450648319662,0.2887700534759358,0.5073529411764706,0.0095837513651414,0.0,0.0,0.0027506876719179,0.0032508127031757,0.0505924720131114,0.1428571428571428,0.5581395348837206,0.4166666666666665,239,10,3,28,0,6811,2,10,51,700000,40000.0,700000.0,100000.0,100000.0,200000.0,4,400000,0.16666666666666666,0.16666666666666666
239743,Przemyslaw,Frankowski,2024,826,Poland,Gda?sk,Poland,12-04-95,Right Midfield,Midfield,Right,175.0,30-06-28,11-Football Players,https://img.a.transfermarkt.technology/portrait/header/239743-1669189009.jpg?lm=1,FR1,Racing Club de Lens,9000000.0,9000000.0,29,125,130,8,12,13,12,12,8,7,12,11,11,13,5,11,13,7,12,9,12,11,12,11,11,14,7,13,11,15,14,14,12,12,8,12,14,13,9,13,6,11,4,15,2,2,3,1,1,2,2,1,3,3,2,8,13,8,12,10,11,11,8,1,1,1,1,20,20,1,16,16,16,14,14,14,10,71,13,20,3363016,6247,6247,4497,Northern_European,119,24,1,10923.0,Unknown,96029182,1291666.667,3.0,75,525,78,3,1,7,158,9,0.5768721884096322,0.475614973262032,0.5147058823529411,0.0105387468412245,0.1578947368421052,0.0131578947368421,0.0447611902975743,0.0447611902975743,0.0071483467151865,0.2857142857142857,0.2790697674418605,0.4583333333333332,405,61,43,46,1,3292,3,6,23,8000000,265000.0,9000000.0,1000000.0,250000.0,400000.0,3,2550000,-0.1111111111111111,-0.1111111111111111
239962,Denis,Vavro,2024,82,Slovakia,PartizÃ¡nske,Slovakia,10-04-96,Centre-Back,Defender,Right,189.0,30-06-25,Unknown,https://img.a.transfermarkt.technology/portrait/header/239962-1656583120.jpg?lm=1,L1,Verein fÃ¼r LeibesÃ¼bungen Wolfsburg,5000000.0,8000000.0,28,132,144,5,10,5,10,11,12,14,13,10,15,11,15,15,10,16,13,16,10,13,8,10,16,6,7,12,14,14,14,12,11,14,16,14,15,15,16,10,9,14,8,12,4,4,1,1,1,1,2,3,1,3,1,15,15,12,14,13,15,13,10,1,1,20,1,1,1,1,1,1,1,1,1,1,1,81,6,20,4983012,6600,6400,5000,Northern_European,132,10,0,16132.0,Unknown,63025710,5466666.667,3.0,86,1126,86,1,1,7,213,2,0.5971156390579518,0.5294117647058822,0.6102941176470589,0.0155686471798664,0.0657894736842105,0.0,0.0247561890472618,0.0397599399849962,0.0303434354676518,0.2857142857142857,0.6046511627906974,0.4166666666666665,364,25,9,56,2,16746,7,16,32,5000000,188461.53846153847,8000000.0,2000000.0,75000.0,350000.0,6,3150000,0.0,0.25
240226,Bernard,Berisha,2024,3725,Jugoslawien (SFR),Pe?,Kosovo,24-10-91,Left Winger,Attack,Right,165.0,30-06-27,Unknown,https://img.a.transfermarkt.technology/portrait/header/240226-1605979135.png?lm=1,RU1,RFK Akhmat Grozny,800000.0,3000000.0,33,124,124,13,11,15,11,12,8,8,9,5,6,10,13,9,14,16,13,15,11,11,11,11,5,11,12,10,12,8,13,15,14,13,5,15,14,13,6,12,14,8,6,10,3,2,1,2,1,3,1,3,2,2,1,9,11,13,10,13,10,6,9,1,1,1,1,12,1,1,16,12,12,20,16,16,11,66,12,20,3447147,6008,5854,3504,Mediterranean_Hispanic,121,20,1,19999.0,Unknown,11022149,940000.0,3.0,55,1131,59,0,1,3,157,7,0.5248743053717915,0.3694117647058823,0.5294117647058822,0.0193026891475241,0.131578947368421,0.0131578947368421,0.0037509377344336,0.0147536884221055,0.005194588738576,0.2857142857142857,0.0465116279069768,0.625,343,51,39,81,0,5506,5,56,189,800000,22500.0,3000000.0,500000.0,,,3,125000,-0.1111111111111111,-0.2
240306,Bruno,Fernandes,2024,985,Portugal,Maia,Portugal,08-09-94,Attacking Midfield,Midfield,Right,179.0,30-06-27,MRP.POSITIONUMBER,https://img.a.transfermarkt.technology/portrait/header/240306-1683882766.jpg?lm=1,GB1,Manchester United Football Club,65000000.0,90000000.0,30,166,174,16,16,11,15,17,16,10,16,4,3,17,19,8,17,18,16,17,15,14,18,10,17,17,17,17,6,15,15,13,15,13,9,18,14,19,10,12,13,13,3,15,1,1,2,3,3,3,1,1,3,1,1,18,15,5,13,14,17,6,7,1,1,1,1,1,1,1,10,16,10,12,20,14,10,69,13,20,265261481,8300,8500,7750,Mediterranean_Hispanic,165,46,8,289979.0,Unknown,43124203,16648000.0,5.0,76,893,79,3,1,3,132,0,0.8749669224662608,0.8235294117647058,0.8529411764705881,0.2800000386246906,0.3026315789473684,0.1052631578947368,0.3248312078019504,0.4498624656164041,0.092463679546654,0.5714285714285714,0.3720930232558141,0.5,571,176,146,113,1,13357,4,6,13,55000000,1526388.888888889,90000000.0,12000000.0,3500000.0,6500000.0,4,18000000,-0.21428571428571427,-0.21428571428571427
240414,Alex,Meret,2024,6195,Italy,Udine,Italy,22-03-97,Goalkeeper,Goalkeeper,Left,190.0,30-06-25,Unknown,https://img.a.transfermarkt.technology/portrait/header/240414-1695025886.jpg?lm=1,IT1,SocietÃ  Sportiva Calcio Napoli,12000000.0,40000000.0,27,147,156,1,2,2,1,7,1,6,2,3,2,8,3,3,8,8,14,12,12,12,5,14,11,3,9,3,16,13,13,10,18,14,16,13,12,13,13,12,3,12,11,1,14,14,13,5,16,10,15,17,12,11,10,7,13,3,14,11,15,15,12,20,1,1,1,1,1,1,1,1,1,1,1,1,1,80,20,7,18050738,7343,7343,5843,Mediterranean_Hispanic,143,2,0,53462.0,Unknown,43140326,26000000.0,1.0,52,1544,54,2,0,3,184,5,0.7218840963217783,0.6195721925133689,0.6911764705882353,0.0516151397199903,0.0131578947368421,0.0,0.0597649412353088,0.1997999499874969,0.1444206783521764,0.0,0.6279069767441858,0.375,0,0,0,0,0,0,15,106,136,12000000,371875.0,40000000.0,7000000.0,600000.0,4000000.0,3,4400000,0.0,-0.2
241076,Emmanuel,Gyasi,2024,749,Italy,Palermo,Ghana,11-01-94,Left Winger,Attack,Right,181.0,30-06-25,Unknown,https://img.a.transfermarkt.technology/portrait/header/241076-1663687225.jpg?lm=1,IT1,Empoli Football Club S.r.l.,1800000.0,2500000.0,30,132,136,7,13,14,12,13,7,12,11,4,7,14,11,8,13,13,12,12,11,13,13,12,13,12,8,14,8,13,12,14,13,13,10,13,14,14,12,12,9,11,2,15,1,1,1,3,1,1,4,1,3,2,3,12,14,13,11,9,13,11,11,1,1,1,1,12,12,1,14,1,14,20,13,16,18,74,8,20,5037830,6597,5921,4610,African_Caribbean,125,3,0,3654.0,Unknown,43112998,1000500.0,2.0,52,1111,41,0,1,1,64,7,0.5337390844138661,0.4877005347593582,0.5588235294117647,0.0035196749346035,0.0197368421052631,0.0,0.0087521880470117,0.0122530632658164,0.0055307091863662,0.1428571428571428,0.418604651162791,0.5,422,61,39,82,0,3335,3,15,98,2000000,75000.0,2500000.0,500000.0,50000.0,75000.0,6,350000,0.1111111111111111,0.0
241229,Jordan,Amavi,2024,3911,France,Toulon,France,09-03-94,Left-Back,Defender,Left,176.0,30-06-25,Classico,https://img.a.transfermarkt.technology/portrait/header/241229-1598304378.jpg?lm=1,FR1,Stade brestois 29,2000000.0,16000000.0,30,122,140,5,13,13,6,13,5,13,10,12,11,13,8,13,13,10,14,13,13,14,10,12,14,12,8,13,11,13,15,12,13,12,10,13,13,13,13,12,10,13,13,10,1,2,1,4,1,3,1,1,1,2,3,10,15,7,14,11,15,14,13,1,20,1,1,17,1,1,15,1,1,10,1,1,1,70,20,10,974063,6100,6100,4000,African_Caribbean,122,0,0,57533.0,Getafe,85126966,10500000.0,2.0,34,1511,36,1,0,1,196,8,0.5574225985710506,0.4224598930481283,0.536764705882353,0.0555461676099138,0.0,0.0,0.0097524381095273,0.0797699424856214,0.058307175199311,0.1428571428571428,0.3023255813953489,0.5,265,8,15,65,4,5887,10,97,228,2000000,60344.8275862069,16000000.0,4000000.0,,2500000.0,5,8500000,0.6666666666666666,0.3333333333333333
241477,Thomas,Ouwejan,2024,467,Netherlands,Alkmaar,Netherlands,30-09-96,Left-Back,Defender,Left,183.0,30-06-27,SEG,https://img.a.transfermarkt.technology/portrait/header/241477-1723716748.jpg?lm=1,NL1,Nijmegen Eendracht Combinatie,1500000.0,3000000.0,28,130,137,17,16,11,9,12,15,7,11,15,11,13,7,12,13,11,13,12,12,11,13,12,15,12,8,16,11,12,15,13,12,13,8,16,13,15,11,14,5,13,6,17,1,1,4,3,3,3,3,1,2,3,2,12,15,6,13,14,14,14,16,1,20,10,1,18,1,16,15,15,1,10,8,1,1,74,20,8,2956287,6600,6250,5100,Northern_European,121,0,0,19177.0,Unknown,37047791,9111392.0,2.0,67,45,68,1,0,7,138,8,0.5772691188145012,0.5401069518716577,0.5294117647058822,0.0185089517548645,0.0,0.0,0.0072518129532383,0.0147536884221055,0.0505924720131114,0.1428571428571428,0.4651162790697669,0.4166666666666665,293,15,39,15,0,6745,13,39,93,1200000,50000.0,3000000.0,600000.0,,400000.0,3,900000,-0.2,-0.29411764705882354
241481,Jairo,Riedewald,2024,1096,Netherlands,Haarlem,Netherlands,09-09-96,Defensive Midfield,Midfield,Left,182.0,30-06-25,Unknown,https://img.a.transfermarkt.technology/portrait/header/241481-1614864924.jpg?lm=1,BE1,Royal Antwerp Football Club,3000000.0,8000000.0,28,121,149,8,9,11,7,13,8,10,6,8,13,13,8,13,11,8,13,10,12,12,13,12,9,10,8,10,12,12,11,12,14,13,11,13,14,13,15,10,6,11,5,15,1,2,2,2,1,3,3,2,3,2,1,13,14,5,7,11,13,10,9,1,15,13,1,12,1,20,6,18,1,1,1,1,1,82,20,11,2844447,6048,6048,5348,African_Caribbean,118,3,0,52196.0,Unknown,37041918,9000000.0,1.0,67,585,68,3,0,1,173,4,0.550542471553321,0.5666310160427807,0.5073529411764706,0.0503926682612226,0.0197368421052631,0.0,0.0147536884221055,0.0397599399849962,0.049973610378066,0.0,0.4418604651162785,0.4166666666666665,252,8,7,19,1,10838,12,35,95,2200000,78000.0,8000000.0,2000000.0,1500000.0,5000000.0,2,800000,-0.26666666666666666,0.1
241501,Stijn,Spierings,2024,206,Netherlands,Alkmaar,Netherlands,12-03-96,Defensive Midfield,Midfield,Right,188.0,30-06-27,Stirr Associates,https://img.a.transfermarkt.technology/portrait/header/241501-1682946518.jpg?lm=1,DK1,BrÃ¸ndby IdrÃ¦tsforening,4500000.0,6000000.0,28,124,130,12,9,10,12,14,12,11,13,8,9,13,15,11,14,12,13,10,15,13,14,13,13,14,9,12,14,12,12,11,10,13,14,14,11,13,14,13,8,12,5,12,3,3,3,3,4,1,3,1,2,1,2,13,13,7,11,14,13,14,13,1,1,6,1,1,1,20,10,16,10,12,14,10,10,83,12,20,2175899,6199,6199,3856,Northern_European,124,0,0,4999.0,Unknown,37047790,500000.0,2.0,67,45,68,3,1,7,45,4,0.570521301931728,0.4070588235294117,0.5514705882352942,0.0048184301573859,0.0,0.0,0.0222555638909727,0.0297574393598399,0.0027500763910108,0.1428571428571428,0.581395348837209,0.4166666666666665,353,46,45,73,3,9440,1,2,19,3500000,132692.3076923077,6000000.0,1000000.0,50000.0,350000.0,6,1500000,-0.2222222222222222,-0.3
241641,Bernardo,Silva,2024,281,Portugal,Lisboa,Portugal,10-08-94,Attacking Midfield,Midfield,Left,173.0,30-06-26,Gestifute,https://img.a.transfermarkt.technology/portrait/header/241641-1684311533.jpg?lm=1,GB1,Manchester City Football Club,70000000.0,100000000.0,30,176,180,14,15,17,15,17,13,10,13,2,12,17,13,8,18,13,16,15,16,15,17,15,16,17,12,17,13,16,20,15,19,16,7,17,14,17,9,16,10,16,6,13,2,2,1,3,2,1,1,1,2,2,2,15,17,14,11,13,17,12,8,1,1,1,1,1,1,1,12,20,16,12,20,19,9,64,20,8,347975206,8800,8750,8500,Mediterranean_Hispanic,174,70,8,208785.0,Unknown,55041632,32875000.0,2.0,76,843,79,3,0,3,131,0,0.9080444562053454,0.9037433155080212,0.9191176470588234,0.2015977103283388,0.4605263157894737,0.1052631578947368,0.3498374593648412,0.4998749687421855,0.1826161837828828,0.1428571428571428,0.2325581395348837,0.5,577,104,95,68,0,12782,8,27,63,60000000,1980000.0,100000000.0,20000000.0,,12000000.0,2,1000000,-0.14285714285714285,-0.25
241923,Lorenzo,Montipò,2024,276,Italy,Novara,Italy,20-02-96,Goalkeeper,Goalkeeper,Right,191.0,30-06-25,Unknown,https://img.a.transfermarkt.technology/portrait/header/241923-1724828092.jpg?lm=1,IT1,Verona Hellas Football Club,3500000.0,4500000.0,28,133,139,3,2,3,1,10,1,7,1,1,3,7,3,3,8,10,12,13,12,11,9,11,13,8,10,9,12,11,10,12,14,11,15,13,11,14,11,12,8,12,9,1,15,14,14,8,13,16,14,17,11,12,12,11,13,2,14,11,13,14,11,20,1,1,1,1,1,1,1,1,1,1,1,1,1,82,8,20,4163418,6650,6650,4450,Northern_European,131,0,0,9615.0,Unknown,43124226,1050000.0,2.0,52,1057,54,2,1,7,214,5,0.6301931727970362,0.4705882352941176,0.6029411764705883,0.0092757194572844,0.0,0.0,0.0172543135783946,0.0222555638909727,0.0058057168254673,0.1428571428571428,0.6511627906976742,0.4166666666666665,0,0,0,0,0,0,3,4,12,3000000,112500.0,4500000.0,500000.0,75000.0,250000.0,5,125000,-0.14285714285714285,-0.25
242086,Patrik,Schick,2024,15,Czech Republic,Praha,Czech Republic,24-01-96,Centre-Forward,Attack,Left,191.0,30-06-27,Unknown,https://img.a.transfermarkt.technology/portrait/header/242086-1727378322.jpg?lm=1,L1,Bayer 04 Leverkusen FuÃŸball,22000000.0,50000000.0,28,152,155,8,10,15,16,16,9,14,14,4,6,12,12,7,15,12,14,13,14,13,14,14,11,15,6,14,7,12,12,15,14,14,15,13,15,14,12,15,6,14,9,8,1,3,2,3,2,2,2,1,4,1,3,14,16,12,9,12,14,12,17,1,1,1,1,1,1,1,10,1,14,10,12,14,20,86,20,12,56430002,7600,7000,6250,Northern_European,151,33,17,110000.0,Unknown,25042141,9111392.0,2.0,26,1180,28,0,0,7,36,3,0.6765017200317545,0.6631016042780749,0.75,0.106209208705619,0.2171052631578947,0.2236842105263157,0.1097774443610902,0.2498124531132783,0.0505924720131114,0.1428571428571428,0.6511627906976742,0.4166666666666665,314,115,25,23,0,6665,22,261,222,22000000,751724.1379310344,50000000.0,12000000.0,200000.0,3500000.0,5,7650000,0.0,0.0
242273,Pedro,Chirivella,2024,995,Spain,Valencia,Spain,23-05-97,Defensive Midfield,Midfield,Right,178.0,30-06-26,Promoesport,https://img.a.transfermarkt.technology/portrait/header/242273-1703065623.jpg?lm=1,FR1,Football Club de Nantes,7000000.0,7000000.0,27,131,134,12,8,12,7,15,10,8,11,4,12,15,9,12,13,12,13,14,15,14,13,14,13,12,7,12,13,14,13,12,14,14,8,11,12,14,12,14,7,12,9,6,2,2,1,3,2,1,2,3,2,1,2,14,13,5,12,11,13,13,11,1,1,10,1,1,1,18,1,20,1,1,11,1,1,0,10,20,6406161,6546,6546,3996,Mediterranean_Hispanic,131,0,0,6999.0,Unknown,67185037,2300000.0,1.0,89,1556,89,3,1,3,93,4,0.6164329187615771,0.4220320855614973,0.6029411764705883,0.0067496646894043,0.0,0.0,0.0347586896724181,0.0347586896724181,0.0127503541765049,0.0,0.3488372093023257,0.375,295,8,23,42,0,4451,2,12,49,5000000,257894.73684210525,7000000.0,2000000.0,100000.0,600000.0,5,850000,-0.2857142857142857,-0.2857142857142857
242359,Juan,Musso,2024,13,Argentina,San NicolÃ¡s de los Arroyos,Argentina,06-05-94,Goalkeeper,Goalkeeper,Right,191.0,30-06-25,World Soccer Agency,https://img.a.transfermarkt.technology/portrait/header/242359-1663583047.jpg?lm=1,ES1,Club AtlÃ©tico de Madrid S.A.D.,5000000.0,20000000.0,30,145,157,7,3,2,1,8,9,8,2,3,2,10,3,2,7,5,13,13,12,14,12,12,15,3,12,1,13,15,13,12,16,13,14,14,13,12,12,12,12,14,3,13,15,12,12,5,14,11,14,18,14,11,15,15,13,4,15,8,18,14,11,20,1,1,1,1,1,1,1,1,1,1,1,1,1,93,7,20,19938228,7250,7150,5750,Mediterranean_Hispanic,142,2,0,56923.0,Unknown,14048328,12250000.0,2.0,4,1306,4,2,1,3,52,5,0.696348240275205,0.6096256684491979,0.6838235294117647,0.0549571410776481,0.0131578947368421,0.0,0.0247561890472618,0.0997749437359339,0.0680296674907636,0.1428571428571428,0.6511627906976742,0.5,0,0,0,0,0,0,5,13,37,4000000,159000.0,20000000.0,6000000.0,,100000.0,3,4000000,-0.2,-0.5
242631,Alex,Iwobi,2024,931,Nigeria,Lagos,Nigeria,03-05-96,Left Winger,Attack,Right,183.0,30-06-28,Unknown,https://img.a.transfermarkt.technology/portrait/header/242631-1679652866.jpg?lm=1,GB1,Fulham Football Club,25000000.0,32000000.0,28,136,155,9,14,16,11,13,9,9,13,4,8,12,11,11,14,9,13,10,13,13,12,14,15,15,8,14,14,15,15,14,13,15,12,13,14,16,13,13,8,13,7,15,1,3,2,2,3,2,4,1,3,2,1,14,13,7,12,13,15,14,15,1,1,1,1,1,12,15,13,20,13,13,15,13,8,82,8,20,32508319,6799,6949,5849,African_Caribbean,133,58,10,115992.0,Unknown,28084930,28050000.0,2.0,69,789,70,0,1,1,95,7,0.6697539031489812,0.6202139037433154,0.6176470588235294,0.1119951873635462,0.381578947368421,0.131578947368421,0.1247811952988247,0.1597899474868717,0.155809883607878,0.1428571428571428,0.4651162790697669,0.4166666666666665,0,0,0,0,0,0,7,24,36,25000000,1000000.0,32000000.0,6500000.0,,10000000.0,2,7000000,0.0,-0.10714285714285714
242632,Glen,Kamara,2024,273,Finland,Tampere,Finland,28-10-95,Central Midfield,Midfield,Right,178.0,30-06-28,StormSportsX,https://img.a.transfermarkt.technology/portrait/header/242632-1663177745.jpg?lm=1,FR1,Stade Rennais Football Club,6000000.0,7500000.0,29,128,139,5,13,14,6,17,7,9,7,8,13,14,12,11,18,7,14,4,15,10,15,12,14,14,5,14,12,12,11,15,13,16,11,17,16,14,9,12,6,12,6,11,1,1,1,4,3,2,3,2,1,1,2,13,11,6,12,15,16,13,14,1,1,1,1,1,1,17,1,20,1,1,14,1,1,78,8,20,8286494,6392,6392,4992,African_Caribbean,132,46,1,23198.0,Unknown,28084932,5285000.0,3.0,33,1470,35,3,1,1,195,1,0.5960571579783012,0.5285561497326202,0.6102941176470589,0.0223916987814875,0.3026315789473684,0.0131578947368421,0.0297574393598399,0.0372593148287071,0.0293341481707825,0.2857142857142857,0.3488372093023257,0.4583333333333332,377,11,25,35,0,13915,3,11,22,6000000,318055.55555555556,7500000.0,1500000.0,,,3,900000,0.0,0.0
242940,Edoardo,Goldaniga,2024,1047,Italy,Milano,Italy,02-11-93,Centre-Back,Defender,Right,193.0,30-06-26,GR Sports,https://img.a.transfermarkt.technology/portrait/header/242940-1725530007.jpg?lm=1,IT1,Calcio Como,1200000.0,3000000.0,31,124,134,5,7,7,7,11,6,14,7,11,12,10,6,14,11,14,15,13,11,11,9,12,13,7,12,7,14,12,12,12,11,13,15,15,12,14,15,12,10,12,6,10,2,2,2,3,1,3,3,3,1,1,4,13,14,7,15,10,17,15,10,1,1,20,10,1,7,1,1,1,1,1,1,1,1,87,10,20,2960625,6200,6200,4850,Mediterranean_Hispanic,123,0,0,17787.0,Unknown,43080121,1433333.333,6.0,52,952,54,1,1,3,47,2,0.5706536120666843,0.5133689839572192,0.5441176470588236,0.0171667437551117,0.0,0.0,0.0057514378594648,0.0147536884221055,0.0079354056112669,0.7142857142857142,0.6976744186046511,0.5416666666666665,328,21,4,87,2,3749,11,39,57,1200000,43269.230769230766,3000000.0,1000000.0,,350000.0,9,4775000,0.0,0.3333333333333333
243028,Jan,Bednarek,2024,180,Poland,S?upca,Poland,12-04-96,Centre-Back,Defender,Right,189.0,30-06-27,Fabryka Futbolu,https://img.a.transfermarkt.technology/portrait/header/243028-1709158468.jpg?lm=1,GB1,Southampton Football Club,11000000.0,25000000.0,28,140,145,2,7,9,7,11,3,14,5,5,15,12,5,14,13,12,14,17,13,14,9,14,13,8,13,5,14,14,15,13,12,13,14,17,13,17,15,13,5,13,9,9,2,3,2,3,2,2,1,3,4,3,3,12,13,4,14,13,12,12,10,1,1,20,13,1,1,13,1,1,1,1,1,1,1,77,11,20,35991161,6995,6264,5654,Northern_European,140,42,1,69595.0,Aston Villa,96047750,6000000.0,1.0,75,1264,78,1,1,7,186,2,0.5791214607038899,0.5993582887700534,0.6691176470588234,0.0671934430725168,0.2763157894736842,0.0131578947368421,0.0547636909227306,0.1247811952988247,0.0333064807355759,0.0,0.6046511627906974,0.4166666666666665,0,0,0,0,0,0,2,5,25,11000000,353225.8064516129,25000000.0,4000000.0,100000.0,500000.0,5,12500000,0.0,0.0
243188,László,Bénes,2024,89,Slovakia,DunajskÃ¡ Streda,Slovakia,09-09-97,Central Midfield,Midfield,Left,181.0,Unknown,ROOF,https://img.a.transfermarkt.technology/portrait/header/243188-1719585148.jpg?lm=1,L1,1. FC Union Berlin,5000000.0,10000000.0,27,124,133,16,16,12,10,14,16,6,13,4,10,15,12,11,16,13,12,11,14,11,16,12,11,15,6,12,11,12,12,11,14,12,8,11,12,14,8,12,8,11,12,13,2,1,2,1,3,3,3,1,1,2,1,12,13,7,10,12,13,10,16,1,1,1,1,1,1,14,14,20,14,12,17,12,8,72,20,8,2351113,6188,5890,4490,Northern_European,124,7,1,19177.0,Unknown,38039792,3166666.667,3.0,86,437,86,3,0,7,0,1,0.5296374702302197,0.4748663101604277,0.5514705882352942,0.0185089517548645,0.0460526315789473,0.0131578947368421,0.0247561890472618,0.0497624406101525,0.0175653027417428,0.2857142857142857,0.418604651162791,0.375,238,30,44,36,2,7141,19,104,169,4000000,150000.0,10000000.0,2000000.0,1500000.0,1500000.0,7,7500000,-0.2,0.0
243714,Kingsley,Coman,2024,27,France,Paris,France,13-06-96,Left Winger,Attack,Right,181.0,30-06-27,CAA Base Ltd,https://img.a.transfermarkt.technology/portrait/header/243714-1700040256.jpg?lm=1,L1,FC Bayern MÃ¼nchen,40000000.0,65000000.0,28,162,165,11,13,17,12,15,6,9,14,4,7,13,10,8,17,13,13,12,12,12,14,12,14,17,5,14,8,12,12,19,17,13,9,13,17,12,10,13,5,16,13,16,1,1,2,3,4,1,3,1,3,2,2,16,18,12,14,14,13,11,12,1,1,1,1,12,12,1,15,10,15,20,12,18,12,75,12,20,82080002,8100,7750,7600,African_Caribbean,155,40,5,287670.0,Unknown,85104424,21000000.0,1.0,34,1122,36,0,1,1,68,7,0.7757343212490078,0.8074866310160427,0.7794117647058822,0.2777704283574753,0.2631578947368421,0.0657894736842105,0.1997999499874969,0.3248312078019504,0.1166421289480263,0.0,0.418604651162791,0.4166666666666665,355,70,69,15,1,8497,46,149,85,35000000,1014705.8823529412,65000000.0,15000000.0,2500000.0,20000000.0,2,6750000,-0.3,-0.46153846153846156
243760,Álex,Muñoz,2024,472,Spain,Sant Joan d'Alacant,Spain,30-07-94,Left-Back,Defender,Left,187.0,30-06-26,JV SPORTS ,https://img.a.transfermarkt.technology/portrait/header/default.jpg?lm=1,ES1,UniÃ³n Deportiva Las Palmas S.A.D.,1200000.0,1200000.0,30,127,138,11,14,12,11,12,12,11,17,11,12,13,12,13,13,10,13,12,13,12,13,13,13,13,11,15,12,13,13,13,13,9,13,13,14,14,12,14,9,12,11,15,1,2,3,1,1,2,1,2,1,1,2,11,14,9,10,12,12,13,12,1,20,15,1,18,1,1,8,1,1,1,1,1,1,70,20,5,3485252,6342,6342,4242,Mediterranean_Hispanic,127,0,0,9666.0,Unknown,67101620,300000.0,1.0,89,1319,89,1,0,3,207,8,0.5894416512304843,0.4483422459893048,0.5735294117647058,0.0093249659378509,0.0,0.0,0.0057514378594648,0.0057514378594648,0.0016389344148448,0.0,0.5581395348837206,0.5,327,19,6,78,0,3631,6,63,394,1200000,50000.0,1200000.0,200000.0,,0.0,6,500000,0.0,0.0
244192,Pierluigi,Gollini,2024,252,Italy,Bologna,Italy,18-03-95,Goalkeeper,Goalkeeper,Right,194.0,30-06-25,CAA Base Ltd,https://img.a.transfermarkt.technology/portrait/header/244192-1695026486.jpg?lm=1,IT1,Genoa Cricket and Football Club,4000000.0,17000000.0,29,135,145,6,1,3,2,10,7,10,2,2,2,10,3,1,9,11,14,15,13,12,8,11,14,3,13,3,13,15,15,12,14,14,16,15,12,10,15,13,5,12,5,12,14,13,12,16,13,12,14,14,14,14,13,14,15,8,10,13,13,12,10,20,1,1,1,1,1,1,1,1,1,1,1,1,1,94,8,20,2309130,6750,6750,5800,Mediterranean_Hispanic,135,1,0,28461.0,ACF Fiorentina,43090278,4700000.0,2.0,52,220,54,2,1,3,104,5,0.6434241862926701,0.6149732620320855,0.6323529411764706,0.027473742452494,0.006578947368421,0.0,0.0197549387346836,0.0847711927981995,0.0260840578904969,0.1428571428571428,0.7209302325581395,0.4583333333333332,0,0,0,0,0,0,9,32,86,2500000,79310.3448275862,17000000.0,3000000.0,,1000000.0,6,8500000,-0.375,-0.4444444444444444
244940,Salih,ÃÂZcan,2024,82,Germany,KÃ¶ln,TÃ¼rkiye,11-01-98,Defensive Midfield,Midfield,Right,183.0,30-06-25,Dirk Hebel,https://img.a.transfermarkt.technology/portrait/header/244940-1709561120.jpg?lm=1,L1,Verein fÃ¼r LeibesÃ¼bungen Wolfsburg,10000000.0,17000000.0,26,141,150,10,12,13,9,12,11,12,11,6,14,15,12,14,13,17,14,17,13,12,13,14,16,12,13,12,13,14,16,12,12,16,12,16,13,15,15,13,10,15,5,17,1,3,3,2,3,1,1,1,2,1,1,8,16,7,12,13,13,17,14,1,1,1,1,1,1,18,7,20,7,1,10,1,1,75,10,20,15221217,7046,7046,5496,Northern_European,139,5,0,76711.0,Unknown,91139869,5000000.0,1.0,38,777,100,3,1,7,213,4,0.6825879862397459,0.5824598930481283,0.6617647058823528,0.0740647755374384,0.0328947368421052,0.0,0.0497624406101525,0.0847711927981995,0.0277507708547459,0.0,0.4651162790697669,0.3333333333333332,330,42,23,40,0,5075,10,12,15,7000000,300000.0,17000000.0,4000000.0,500000.0,3000000.0,4,7500000,-0.3,-0.46153846153846156
245014,Enis,Bardhi,2024,449,Macedonia,Blace,North Macedonia,02-07-95,Attacking Midfield,Midfield,Right,172.0,30-06-25,Unknown,https://img.a.transfermarkt.technology/portrait/header/245014-1723801171.jpg?lm=1,TR1,Trabzonspor KulÃ¼bÃ¼,6000000.0,20000000.0,29,136,146,14,13,14,12,14,17,7,17,5,7,15,12,9,15,12,13,13,14,13,14,14,16,15,8,14,8,14,13,13,13,15,6,14,12,14,8,13,9,13,8,13,1,2,2,3,2,1,1,4,1,3,3,15,12,7,13,13,14,15,8,1,1,1,1,1,1,1,16,18,12,16,20,12,8,70,12,20,8991106,6850,7050,5200,Northern_European,137,48,11,41667.0,Unknown,27102027,2250000.0,2.0,60,204,71,3,1,7,204,0,0.6831172267795713,0.5508021390374331,0.6470588235294117,0.0402256840674116,0.3157894736842105,0.1447368421052631,0.0297574393598399,0.0997749437359339,0.0124725686824634,0.1428571428571428,0.2093023255813952,0.4583333333333332,358,60,35,47,0,3666,8,32,53,4700000,139393.9393939394,20000000.0,3000000.0,,450000.0,2,2800000,-0.27692307692307694,-0.21666666666666667
245056,Saša,Luki?,2024,931,Yugoslavia (Republic),Å abac,Serbia,13-08-96,Central Midfield,Midfield,Right,182.0,30-06-27,Unknown,https://img.a.transfermarkt.technology/portrait/header/245056-1596015377.jpg?lm=1,GB1,Fulham Football Club,10000000.0,15000000.0,28,137,143,12,11,13,11,14,7,11,13,4,10,15,14,14,14,15,13,12,14,13,13,13,14,14,10,13,13,14,13,13,12,14,11,14,13,14,13,13,14,13,9,11,2,2,2,3,1,1,1,2,3,2,1,12,13,9,12,12,15,13,13,1,1,1,1,1,1,17,1,20,1,1,17,1,1,77,12,20,9337307,6850,6900,5200,Mediterranean_Hispanic,137,30,1,25000.0,Unknown,62124117,5750000.0,2.0,110,1725,85,3,1,3,95,1,0.6632707065361206,0.5508021390374331,0.6470588235294117,0.0241317410948361,0.1973684210526315,0.0131578947368421,0.0497624406101525,0.0747686921730432,0.0319175532653684,0.1428571428571428,0.4418604651162785,0.4166666666666665,304,20,11,71,1,5441,11,30,42,10000000,396000.0,15000000.0,2000000.0,200000.0,2200000.0,4,2300000,0.0,0.0
245228,Tarik,Tissoudali,2024,1091,Netherlands,Amsterdam,Morocco,02-04-93,Centre-Forward,Attack,Right,182.0,30-06-26,PURE,https://img.a.transfermarkt.technology/portrait/header/245228-1727967656.png?lm=1,GR1,Panthessalonikios Athlitikos Omilos Konstantinoupoliton,6000000.0,7500000.0,31,128,138,8,12,15,13,13,8,8,9,8,4,14,11,3,15,9,12,14,14,14,14,7,9,15,7,12,6,11,11,15,13,10,6,10,15,11,7,12,7,12,10,15,4,2,2,1,3,2,2,3,3,2,2,10,12,3,8,10,10,6,20,1,1,1,1,1,1,1,19,1,16,20,13,18,19,70,9,20,2431000,6200,6200,3650,North_African__Middle_Eastern,116,9,2,6499.0,Unknown,37052200,1475000.0,2.0,67,64,67,0,1,6,153,3,0.5706536120666843,0.3850267379679144,0.4926470588235294,0.0062668560563997,0.0592105263157894,0.0263157894736842,0.0297574393598399,0.0372593148287071,0.0081668935248201,0.1428571428571428,0.4418604651162785,0.5416666666666665,389,126,69,38,0,9644,4,69,244,5000000,168965.5172413793,7500000.0,1000000.0,,,7,1700000,-0.23076923076923078,-0.23076923076923078
245537,Nabil,Bentaleb,2024,1082,France,Lille,Algeria,24-11-94,Defensive Midfield,Midfield,Left,187.0,30-06-26,Unknown,https://img.a.transfermarkt.technology/portrait/header/245537-1672670443.jpg?lm=1,FR1,Lille Olympique Sporting Club Lille MÃ©tropole,10000000.0,20000000.0,30,127,136,9,11,13,10,14,10,8,13,9,10,14,17,12,15,14,13,15,13,11,13,11,12,12,10,12,11,10,14,12,12,15,14,14,11,14,12,11,13,13,11,8,1,2,3,3,1,3,1,1,1,3,3,14,14,15,8,13,8,12,8,1,1,1,1,1,1,17,1,20,1,1,12,1,1,78,20,12,3730034,6350,6350,5000,North_African__Middle_Eastern,127,35,5,14999.0,Unknown,28085752,11750000.0,2.0,34,834,1,3,0,6,128,4,0.590500132310135,0.5294117647058822,0.5735294117647058,0.014474602817478,0.2302631578947368,0.0657894736842105,0.0497624406101525,0.0997749437359339,0.0652518125503486,0.1428571428571428,0.5581395348837206,0.5,303,32,25,67,2,7974,17,133,240,8000000,267857.14285714284,20000000.0,7000000.0,,10000000.0,6,8400000,-0.2,0.0
245744,Takuma,Asano,2024,237,Japan,"Komono, Mie",Japan,10-11-94,Right Winger,Attack,Right,173.0,30-06-26,Unknown,https://img.a.transfermarkt.technology/portrait/header/245744-1657284052.jpg?lm=1,ES1,Real Club Deportivo Mallorca S.A.D.,4000000.0,4000000.0,30,127,129,7,8,12,12,11,7,11,8,4,6,10,12,7,12,14,13,12,10,10,10,9,13,11,8,14,7,10,15,16,16,10,9,12,16,13,9,12,5,12,6,13,1,3,1,3,1,3,2,4,3,3,1,11,14,12,13,11,10,12,15,1,1,1,1,1,1,1,11,1,12,19,10,20,16,71,10,20,1647745,5995,6695,4495,10,116,36,7,7758.0,Unknown,45078327,2500000.0,2.0,54,742,56,0,1,0,166,10,0.6361471288700714,0.4754010695187165,0.4926470588235294,0.0074825681943053,0.2368421052631578,0.0921052631578947,0.0197549387346836,0.0197549387346836,0.0138614961526709,0.1428571428571428,0.2325581395348837,0.5,340,78,43,10,0,8931,9,48,64,2500000,98000.0,4000000.0,1500000.0,50000.0,650000.0,6,3000000,-0.375,-0.375
246204,Salvi,Sánchez,2024,714,Spain,SanlÃºcar de Barrameda,Spain,30-03-91,Right Winger,Attack,Right,170.0,30-06-25,Promoesport,https://img.a.transfermarkt.technology/portrait/header/246204-1601023429.jpg?lm=1,ES1,Reial Club Deportiu Espanyol de Barcelona S.A.D.,1200000.0,2800000.0,33,124,132,11,11,14,8,13,10,5,9,12,6,10,10,9,13,8,12,11,12,11,10,11,15,13,8,11,8,12,14,15,13,8,7,10,15,13,8,11,7,12,5,7,2,2,1,2,3,3,3,1,1,1,2,15,13,6,9,8,13,10,17,1,5,1,11,7,13,1,11,1,19,14,11,20,12,64,12,20,1598524,6200,6200,4200,Mediterranean_Hispanic,120,0,0,6023.0,Unknown,67193445,700000.0,1.0,89,1313,89,0,1,3,170,10,0.5706536120666843,0.4438502673796791,0.5220588235294117,0.0058072222377793,0.0,0.0,0.0057514378594648,0.0137534383595899,0.0038612183671768,0.0,0.1627906976744184,0.625,0,0,0,0,0,0,3,9,32,900000,25000.0,2800000.0,800000.0,,,2,200000,-0.25,-0.4
246291,Diego,Llorente,2024,150,Spain,Madrid,Spain,16-08-93,Centre-Back,Defender,Right,186.0,30-06-28,Unknown,https://img.a.transfermarkt.technology/portrait/header/246291-1675246130.jpg?lm=1,ES1,Real Betis BalompiÃ© S.A.D.,7000000.0,25000000.0,31,129,153,3,6,10,6,13,3,13,6,10,13,14,9,15,14,13,15,17,14,11,14,12,12,8,10,9,13,15,15,12,10,9,13,13,15,14,13,9,12,10,14,14,3,1,1,2,1,1,2,1,3,3,1,14,14,8,12,12,14,13,12,1,12,20,12,1,10,12,1,1,1,1,1,1,1,75,13,20,8060759,6450,6900,6000,Mediterranean_Hispanic,128,10,0,63795.0,Unknown,67011217,11416666.67,3.0,89,892,89,1,1,3,164,2,0.6632707065361206,0.6363636363636364,0.5808823529411764,0.0615928629296634,0.0657894736842105,0.0,0.0347586896724181,0.1247811952988247,0.0633999092752576,0.2857142857142857,0.5348837209302322,0.5416666666666665,392,23,6,76,2,4852,17,83,58,6000000,183333.33333333334,25000000.0,5000000.0,,0.0,7,8100000,-0.14285714285714285,-0.25
246968,Ayoze,Pérez,2024,1050,Spain,Santa Cruz de Tenerife,Spain,29-07-93,Left Winger,Attack,Right,178.0,30-06-28,Unknown,https://img.a.transfermarkt.technology/portrait/header/246968-1716803546.jpg?lm=1,ES1,Villarreal Club de FÃºtbol S.A.D.,7000000.0,30000000.0,31,136,142,7,12,15,14,15,9,11,9,4,5,13,11,10,14,6,14,10,12,12,13,13,13,15,10,15,8,14,16,12,14,13,8,15,13,14,9,11,7,14,8,16,3,2,3,1,2,1,1,3,3,1,3,13,15,5,12,13,13,12,14,1,1,1,1,1,1,1,1,1,15,13,20,19,18,72,12,20,16944171,6800,6800,5750,Mediterranean_Hispanic,130,0,0,92793.0,Unknown,67172040,13133333.33,3.0,89,1324,89,0,1,3,216,7,0.6500396930404869,0.6096256684491979,0.5955882352941175,0.0895938324093985,0.0,0.0,0.0347586896724181,0.1497874468617154,0.0729372112003111,0.2857142857142857,0.3488372093023257,0.5416666666666665,438,108,42,33,1,5898,8,28,44,10000000,334482.7586206897,30000000.0,6000000.0,,1000000.0,4,14000000,0.42857142857142855,0.42857142857142855
247377,Kevin,Bonifazi,2024,1005,Italy,Rieti,Italy,19-05-96,Centre-Back,Defender,Right,187.0,30-06-25,MM-Management,https://img.a.transfermarkt.technology/portrait/header/247377-1663656615.jpg?lm=1,IT1,Unione Sportiva Lecce,1800000.0,7000000.0,28,127,133,4,6,11,8,9,7,14,8,13,14,12,4,15,11,13,12,14,12,11,11,12,15,12,11,8,13,11,11,12,12,15,15,13,12,14,16,12,13,11,9,6,2,4,3,2,1,2,2,2,2,1,1,13,13,10,14,12,7,13,11,1,1,20,12,1,1,1,1,1,1,1,1,1,1,84,9,20,2523962,6350,6450,5050,Mediterranean_Hispanic,126,0,0,35577.0,Unknown,43094128,8425000.0,2.0,52,1230,54,1,1,3,206,2,0.6037311458057687,0.53475935828877,0.5661764705882353,0.0343450749174155,0.0,0.0,0.0087521880470117,0.0347586896724181,0.0467790771965887,0.1428571428571428,0.5581395348837206,0.4166666666666665,219,10,1,23,2,4725,19,84,130,1000000,34259.25925925926,7000000.0,1500000.0,,200000.0,11,4650000,-0.4444444444444444,-0.6
247555,Edimilson,Fernandes,2024,3911,Switzerland,Sion,Switzerland,15-04-96,Defensive Midfield,Midfield,Right,187.0,30-06-25,Wasserman,https://img.a.transfermarkt.technology/portrait/header/247555-1628596987.jpg?lm=1,FR1,Stade brestois 29,3500000.0,8000000.0,28,128,135,13,12,12,8,13,12,11,12,7,12,13,6,12,15,13,13,12,12,12,13,12,13,13,4,12,12,12,11,12,12,14,12,12,13,14,13,13,11,13,11,19,2,2,1,2,2,1,3,2,2,2,3,12,12,14,8,11,10,11,13,1,10,18,12,10,15,15,15,20,12,10,12,10,8,77,10,20,2816697,6400,6450,5500,African_Caribbean,122,22,2,34614.0,Unknown,98030084,6950000.0,2.0,92,1377,92,3,1,1,196,4,0.6037311458057687,0.5828877005347594,0.536764705882353,0.0334151854902487,0.1447368421052631,0.0263157894736842,0.0172543135783946,0.0397599399849962,0.0385844051223645,0.1428571428571428,0.5581395348837206,0.4166666666666665,353,27,30,60,1,10749,15,82,103,3500000,118965.5172413793,8000000.0,1500000.0,750000.0,4500000.0,8,5850000,0.0,-0.36363636363636365
247589,Dan,Glazer,2024,49702,Israel,Tel-Aviv,Israel,20-09-96,Defensive Midfield,Midfield,Right,178.0,30-06-27,Unknown,https://img.a.transfermarkt.technology/portrait/header/247589-1722314668.png?lm=1,RU1,FK Nizhny Novgorod,800000.0,1600000.0,28,120,138,7,7,9,7,7,12,9,10,13,14,9,12,14,9,15,14,14,12,13,10,13,13,6,14,8,15,14,17,11,11,12,10,13,11,16,12,14,10,14,5,12,2,1,3,2,3,3,2,3,1,3,1,12,12,5,12,10,13,13,12,1,8,15,14,10,13,20,10,15,11,1,11,1,1,67,10,20,1280958,6135,6135,5237,Northern_European,116,16,0,10489.0,Unknown,42056072,100000.0,1.0,51,1482,53,3,1,7,79,4,0.5620534532945224,0.55475935828877,0.4926470588235294,0.0101196689477765,0.1052631578947368,0.0,0.0037509377344336,0.0077519379844961,0.0005277924386788,0.0,0.3488372093023257,0.4166666666666665,315,5,8,85,1,10638,8,18,34,700000,12500.0,1600000.0,250000.0,,,2,200000,-0.3,-0.4166666666666667
247915,Jonas,Omlin,2024,18,Switzerland,Sarnen,Switzerland,10-01-94,Goalkeeper,Goalkeeper,Right,190.0,30-06-27,Signature - ISCM AG,https://img.a.transfermarkt.technology/portrait/header/247915-1691248651.jpg?lm=1,L1,Borussia Verein fÃ¼r LeibesÃ¼bungen 1900 MÃ¶nchengladbach,6000000.0,9000000.0,30,138,140,2,3,2,3,8,7,2,1,1,1,11,5,1,7,8,14,14,13,14,6,13,12,4,13,3,16,11,7,10,13,12,15,10,10,12,13,14,6,12,12,13,13,14,13,6,12,13,14,16,13,14,14,11,12,6,11,12,16,13,14,20,1,1,1,1,1,1,1,1,1,1,1,1,1,80,11,20,5972873,6750,6850,5350,Northern_European,136,4,0,22559.0,Unknown,98033113,5666666.667,3.0,92,1346,92,2,1,7,42,5,0.6566551997883038,0.5668449197860962,0.6397058823529411,0.0217746693485076,0.0263157894736842,0.0,0.0297574393598399,0.0447611902975743,0.0314545774438178,0.2857142857142857,0.6279069767441858,0.5,0,0,0,0,0,0,15,107,153,4000000,141071.42857142858,9000000.0,2000000.0,,50000.0,5,4550000,-0.3333333333333333,-0.5555555555555556
248732,Pawe?,Dawidowicz,2024,276,Poland,Olsztyn,Poland,20-05-95,Centre-Back,Defender,Right,189.0,30-06-25,INNfootball,https://img.a.transfermarkt.technology/portrait/header/248732-1663671757.jpg?lm=1,IT1,Verona Hellas Football Club,3000000.0,5000000.0,29,129,134,6,8,10,7,11,6,14,9,7,15,11,8,15,11,15,12,14,11,12,10,12,14,8,10,5,14,14,12,11,10,13,16,14,12,13,17,13,6,14,9,13,1,2,3,4,2,4,3,2,1,1,2,13,15,6,12,12,15,14,13,1,1,20,11,1,1,15,1,10,1,1,1,1,1,80,8,20,3170192,6450,5801,5000,Northern_European,126,8,0,7307.0,Unknown,96044665,3000000.0,2.0,75,1083,78,1,1,7,214,2,0.5178618682191056,0.5294117647058822,0.5661764705882353,0.0070470748073352,0.0526315789473684,0.0,0.0147536884221055,0.0247561890472618,0.0166393510930859,0.1428571428571428,0.6046511627906974,0.4583333333333332,319,8,4,76,4,2036,23,96,143,2500000,90740.74074074074,5000000.0,1000000.0,1200000.0,1500000.0,5,750000,-0.16666666666666666,-0.10714285714285714
248738,Sergio,Herrera,2024,331,Spain,Miranda de Ebro,Spain,05-06-93,Goalkeeper,Goalkeeper,Right,192.0,30-06-26,YOU FIRST,https://img.a.transfermarkt.technology/portrait/header/248738-1653038712.jpg?lm=1,ES1,Club AtlÃ©tico Osasuna,6000000.0,8000000.0,31,132,142,4,3,3,1,10,9,3,2,2,3,9,2,2,9,10,13,12,12,14,9,12,15,5,11,3,11,13,12,11,14,10,13,13,11,14,14,14,9,13,15,13,13,13,14,13,14,10,14,16,12,11,13,9,13,7,12,10,12,11,20,20,1,1,1,1,1,1,1,1,1,1,1,1,1,82,9,20,5788304,6600,6600,4750,Mediterranean_Hispanic,129,0,0,11901.0,Unknown,67181753,300000.0,1.0,89,957,89,2,1,3,51,5,0.6235776660492194,0.5026737967914437,0.588235294117647,0.0114831205273815,0.0,0.0,0.0297574393598399,0.0397599399849962,0.0016389344148448,0.0,0.6744186046511627,0.5416666666666665,0,0,0,0,0,0,6,27,215,4000000,162500.0,8000000.0,2000000.0,,,3,600000,-0.3333333333333333,-0.3333333333333333
248999,Lucas,Höler,2024,60,Germany,Achim,Germany,10-07-94,Centre-Forward,Attack,Right,184.0,Unknown,Unique Sports Group,https://img.a.transfermarkt.technology/portrait/header/248999-1658413525.jpg?lm=1,L1,Sport-Club Freiburg,4000000.0,6500000.0,30,133,136,7,9,13,13,11,8,14,12,4,6,12,11,8,11,16,12,14,12,12,12,12,15,8,10,15,7,13,17,13,12,14,13,15,16,16,12,17,5,16,5,7,4,2,3,1,3,1,2,3,3,1,2,7,15,6,12,14,13,14,14,1,1,1,1,1,1,1,13,8,13,13,10,13,20,83,12,20,2635506,6300,6300,4750,Northern_European,131,0,0,9000.0,Unknown,91137228,2000000.0,1.0,38,21,40,0,1,7,189,3,0.5838846255623181,0.5026737967914437,0.6029411764705883,0.0086818648386888,0.0,0.0,0.0197549387346836,0.032258064516129,0.0110836412122558,0.0,0.4883720930232553,0.5,411,89,48,43,0,3946,5,14,81,3500000,118965.5172413793,6500000.0,1500000.0,,300000.0,3,775000,-0.125,-0.3
249089,Lewis,Cook,2024,989,England,York,England,03-02-97,Central Midfield,Midfield,Right,175.0,30-06-28,CAA Stellar,https://img.a.transfermarkt.technology/portrait/header/249089-1700671190.jpg?lm=1,GB1,Association Football Club Bournemouth,12000000.0,20000000.0,27,130,169,9,10,12,10,14,5,6,9,3,7,15,7,14,14,14,13,14,14,12,15,12,15,13,14,12,12,15,14,13,14,14,8,16,13,14,13,14,8,13,2,13,3,2,1,1,2,1,1,2,4,1,3,13,13,2,13,12,16,12,13,1,1,1,1,1,1,20,1,20,1,1,12,1,1,71,10,20,13093423,6499,6499,5249,Northern_European,128,1,0,40597.0,Unknown,29127852,7000000.0,1.0,32,1688,33,3,1,7,22,1,0.6102143424186293,0.5560427807486631,0.5808823529411764,0.0391924735927818,0.006578947368421,0.0,0.0597649412353088,0.0997749437359339,0.038862190616406,0.0,0.2790697674418605,0.375,329,5,19,58,2,3379,5,150,283,14000000,554000.0,20000000.0,4000000.0,1500000.0,6000000.0,1,1000000,0.16666666666666666,0.4
249121,Noah,Sonko Sundberg,2024,2381,Sweden,Nacka,The Gambia,06-06-96,Centre-Back,Defender,Right,187.0,30-06-25,11MANGMT,https://img.a.transfermarkt.technology/portrait/header/249121-1724072811.png?lm=1,TR1,Sivasspor KulÃ¼bÃ¼,1500000.0,2000000.0,28,124,135,5,9,8,7,10,7,14,9,14,13,11,8,13,11,14,15,13,13,15,10,13,13,8,11,9,14,13,12,12,9,11,14,12,13,13,14,14,12,15,6,8,2,3,3,1,1,3,3,1,4,2,1,14,12,6,10,13,12,9,7,1,1,20,5,1,1,1,1,1,1,1,1,1,1,84,8,20,1692897,6200,5500,4576,African_Caribbean,125,11,0,1849.0,Unknown,93049245,550000.0,1.0,91,1011,96,1,1,1,183,2,0.4780365175972479,0.4840641711229946,0.5588235294117647,0.0017767357694569,0.0723684210526315,0.0,0.0072518129532383,0.0097524381095273,0.0030278618850523,0.0,0.5581395348837206,0.4166666666666665,0,0,0,0,0,0,2,9,28,1500000,52777.77777777778,2000000.0,300000.0,150000.0,500000.0,7,750000,0.0,-0.16666666666666666
249126,Harry,Winks,2024,1003,England,Hemel Hempstead,England,02-02-96,Defensive Midfield,Midfield,Right,178.0,30-06-26,CAA Stellar,https://img.a.transfermarkt.technology/portrait/header/249126-1663679564.jpg?lm=1,GB1,Leicester City Football Club,12000000.0,40000000.0,28,138,144,10,10,13,10,14,11,8,12,5,12,15,12,13,14,13,14,14,16,13,12,13,14,10,11,13,13,16,15,13,13,16,6,11,12,14,11,13,6,12,13,10,2,3,2,2,1,2,4,1,1,1,2,12,13,7,14,14,16,14,12,1,1,1,1,1,1,16,1,20,13,1,1,1,1,74,12,20,16236262,6893,6893,5743,Northern_European,137,10,1,104393.0,U.C. Sampdoria,28088513,11600000.0,1.0,32,610,33,3,1,7,127,4,0.6623445355914264,0.6088770053475935,0.6470588235294117,0.1007949926951053,0.0657894736842105,0.0131578947368421,0.0597649412353088,0.1997999499874969,0.0644184560682241,0.0,0.3488372093023257,0.4166666666666665,325,11,9,51,0,10008,10,74,151,12000000,440000.0,40000000.0,8000000.0,,1000000.0,2,5000000,0.0,0.0
249157,Fredrik,Jensen,2024,167,Finland,Porvoo,Finland,09-09-97,Attacking Midfield,Midfield,Right,183.0,30-06-25,V4S,https://img.a.transfermarkt.technology/portrait/header/249157-1722850499.jpg?lm=1,L1,FC Augsburg 1907,3500000.0,3500000.0,27,120,130,10,11,11,11,11,10,7,13,6,6,12,10,7,14,10,12,8,14,10,13,12,11,13,7,15,9,13,16,11,12,10,10,16,13,14,11,11,7,12,7,15,3,3,2,1,2,4,3,4,1,2,3,14,12,5,13,15,13,15,18,1,1,1,1,1,1,1,15,15,13,17,20,14,16,80,10,20,1298928,5950,5750,4257,Northern_European,114,20,7,9581.0,Unknown,33049957,3000000.0,1.0,33,1176,35,3,1,7,67,0,0.5111140513363324,0.449946524064171,0.4779411764705882,0.0092428884702401,0.131578947368421,0.0921052631578947,0.0172543135783946,0.0172543135783946,0.0166393510930859,0.0,0.4651162790697669,0.375,207,24,24,5,1,6809,19,111,110,3500000,161904.7619047619,3500000.0,500000.0,100000.0,3000000.0,1,1000000,0.0,0.0
249513,Diego,Rico,2024,3709,Spain,Burgos,Spain,23-02-93,Left-Back,Defender,Left,183.0,30-06-26,IDUB GLOBAL,https://img.a.transfermarkt.technology/portrait/header/249513-1697221474.jpg?lm=1,ES1,Getafe Club de FÃºtbol S.A.D. Team Dubai,1500000.0,10000000.0,31,134,134,13,14,11,7,12,12,10,13,12,10,12,8,11,12,13,14,12,12,13,10,12,16,13,10,12,11,14,16,14,12,11,12,16,13,16,14,13,11,15,7,14,1,1,3,1,1,1,1,3,2,1,3,15,12,6,14,7,17,13,12,1,20,14,1,20,1,1,12,1,1,1,1,1,1,75,20,11,4575237,6700,6700,4250,Mediterranean_Hispanic,128,0,0,15871.0,Unknown,67149986,4500000.0,4.0,89,278,89,1,0,3,105,8,0.6368086795448531,0.4491978609625668,0.5808823529411764,0.015316621073438,0.0,0.0,0.0072518129532383,0.0497624406101525,0.0249729159143309,0.4285714285714285,0.4651162790697669,0.5416666666666665,383,11,29,77,1,5265,9,43,87,1300000,33333.333333333336,10000000.0,2500000.0,,300000.0,4,10700000,-0.13333333333333333,-0.6285714285714286
249565,Youri,Tielemans,2024,405,Belgium,Sint-Pieters-Leeuw,Belgium,07-05-97,Central Midfield,Midfield,Right,177.0,30-06-27,Claes Agency,https://img.a.transfermarkt.technology/portrait/header/249565-1716886438.jpg?lm=1,GB1,Aston Villa Football Club,30000000.0,55000000.0,27,152,170,11,13,13,12,16,12,9,12,3,11,18,15,12,17,13,15,12,15,12,17,16,14,15,14,15,12,14,13,12,13,12,8,17,10,12,10,14,8,12,5,15,1,2,3,2,2,1,3,1,2,2,1,11,17,7,13,13,14,15,15,1,1,1,1,1,1,18,8,20,8,1,14,1,1,72,14,20,44325652,7600,7600,6500,Mixed_Race,150,52,5,139190.0,Unknown,18077264,35000000.0,2.0,7,1375,8,3,1,4,30,1,0.755887801005557,0.6898395721925134,0.7426470588235294,0.1343955767004278,0.3421052631578947,0.0657894736842105,0.1497874468617154,0.274818704676169,0.1944220672796466,0.1428571428571428,0.3255813953488373,0.375,526,74,73,62,0,13627,7,43,50,30000000,852941.1764705882,55000000.0,11000000.0,12000000.0,25000000.0,3,12000000,0.2,0.5
249730,Guillermo,Maripán,2024,416,Chile,Vitacura,Chile,06-05-94,Centre-Back,Defender,Right,193.0,30-06-26,TRDS,https://img.a.transfermarkt.technology/portrait/header/249730-1614089620.jpg?lm=1,IT1,Torino Calcio,10000000.0,15000000.0,30,131,140,6,5,7,7,10,6,15,8,7,14,12,4,15,10,14,14,15,12,13,9,12,14,5,10,7,15,14,13,11,11,13,16,15,11,15,15,12,12,13,4,8,1,1,3,1,1,2,1,2,1,1,3,11,13,6,14,12,13,9,9,1,1,20,1,1,1,8,1,1,1,1,1,1,1,83,9,20,4942356,6544,6544,4994,Mediterranean_Hispanic,129,38,2,8054.0,Unknown,75030680,10065000.0,2.0,19,1616,19,1,1,3,201,2,0.6161682984916644,0.5287700534759358,0.588235294117647,0.007768390905044,0.25,0.0263157894736842,0.0497624406101525,0.0747686921730432,0.05589044140115,0.1428571428571428,0.6976744186046511,0.5,287,19,7,50,3,5819,11,37,49,4000000,150000.0,15000000.0,4000000.0,,,3,5250000,-0.6,-0.6
249952,Berkay,ÃÂZcan,2024,6890,Germany,Karlsruhe,TÃ¼rkiye,15-02-98,Central Midfield,Midfield,Right,178.0,30-06-27,Unknown,https://img.a.transfermarkt.technology/portrait/header/249952-1695642760.png?lm=1,TR1,?stanbul Ba?ak?ehir Futbol KulÃ¼bÃ¼,4000000.0,5000000.0,26,120,135,15,14,12,9,15,13,7,10,8,5,14,12,6,15,9,12,15,13,9,16,12,12,14,8,14,6,13,11,9,12,16,9,15,12,12,13,11,6,14,4,14,1,3,1,2,2,1,1,3,1,1,3,10,16,10,7,14,13,11,15,1,1,1,1,1,1,8,15,16,1,15,20,1,10,79,12,20,3130365,6100,6100,5000,North_African__Middle_Eastern,118,6,0,8295.0,Unknown,92071861,2000000.0,2.0,38,710,100,3,1,6,4,1,0.5574225985710506,0.5294117647058822,0.5073529411764706,0.0080011046661523,0.0394736842105263,0.0,0.0197549387346836,0.0247561890472618,0.0110836412122558,0.1428571428571428,0.3488372093023257,0.3333333333333332,350,38,44,12,0,5876,11,33,47,2700000,96296.29629629629,5000000.0,1300000.0,750000.0,2500000.0,2,0,-0.35714285714285715,-0.35714285714285715
249994,José,Sá,2024,543,Portugal,Braga,Portugal,17-01-93,Goalkeeper,Goalkeeper,Right,192.0,30-06-27,Gestifute,https://img.a.transfermarkt.technology/portrait/header/249994-1696600015.jpg?lm=1,GB1,Wolverhampton Wanderers Football Club,10000000.0,18000000.0,31,141,145,6,2,3,3,9,9,8,2,3,3,9,5,3,8,9,15,16,13,12,10,13,15,5,11,3,14,16,10,9,14,12,13,13,9,13,12,12,5,15,10,11,14,15,14,13,14,13,15,16,13,12,13,10,14,6,12,15,16,9,14,20,1,1,1,1,1,1,1,1,1,1,1,1,1,84,8,20,30991542,6950,6500,5500,Mediterranean_Hispanic,140,0,0,46397.0,Unknown,55038655,3900000.0,3.0,76,237,79,2,1,3,222,5,0.6103466525535857,0.5828877005347594,0.6691176470588234,0.0447930537356352,0.0,0.0,0.0497624406101525,0.0897724431107777,0.0216394899858329,0.2857142857142857,0.6744186046511627,0.5416666666666665,0,0,0,0,0,0,3,11,58,8000000,292592.5925925926,18000000.0,4000000.0,,1000000.0,4,2000000,-0.42857142857142855,-0.5
250013,Angelo,Fulgini,2024,826,Cote d'Ivoire,Abidjan,France,20-08-96,Attacking Midfield,Midfield,Right,182.0,30-06-27,TEAM REAG CONSULTING,https://img.a.transfermarkt.technology/portrait/header/250013-1657707374.jpg?lm=1,FR1,Racing Club de Lens,7000000.0,12000000.0,28,134,142,14,12,15,11,14,15,11,12,5,11,14,13,11,16,12,12,12,13,12,15,12,14,16,10,13,11,12,12,12,15,12,11,16,13,14,11,12,10,12,6,17,3,2,3,3,3,3,4,1,1,3,2,13,14,5,14,11,15,11,10,1,1,1,12,1,12,12,12,20,12,12,18,12,14,71,10,20,7472536,6700,6800,5250,North_African__Middle_Eastern,133,0,0,34520.0,Unknown,85133890,4866666.667,3.0,23,14,36,3,1,6,158,0,0.6500396930404869,0.5561497326203209,0.6176470588235294,0.0333244174672438,0.0,0.0,0.0347586896724181,0.0597649412353088,0.0270100095391538,0.2857142857142857,0.4418604651162785,0.4166666666666665,343,39,25,35,1,4474,9,24,48,6000000,221153.84615384616,12000000.0,3000000.0,400000.0,1250000.0,4,5850000,-0.14285714285714285,-0.25
250153,Pasquale,Mazzocchi,2024,6195,Italy,Napoli,Italy,27-07-95,Right-Back,Defender,Right,183.0,30-06-27,Luigi Lauro SBM srl ,https://img.a.transfermarkt.technology/portrait/header/250153-1725529479.jpg?lm=1,IT1,SocietÃ  Sportiva Calcio Napoli,3000000.0,5000000.0,29,135,140,11,14,15,7,14,8,7,9,8,11,13,7,12,13,13,14,15,14,12,11,13,17,12,9,14,12,14,16,14,15,11,8,13,14,14,11,15,12,12,7,15,1,1,2,1,1,3,2,1,3,4,4,12,13,6,12,11,11,12,13,1,18,1,19,19,20,1,10,1,10,10,1,10,1,73,8,20,6045722,6750,7100,4500,Mediterranean_Hispanic,132,0,0,3845.0,Unknown,43124221,1145000.0,4.0,52,1016,54,1,1,3,184,11,0.6897327335273882,0.4759358288770053,0.6102941176470589,0.0037041078324113,0.0,0.0,0.0147536884221055,0.0247561890472618,0.0063335092641462,0.4285714285714285,0.4651162790697669,0.4583333333333332,0,0,0,0,0,0,7,18,95,3000000,113461.53846153847,5000000.0,1000000.0,50000.0,50000.0,7,1425000,0.0,-0.25
250426,Adam,Armstrong,2024,180,England,West Denton,England,10-02-97,Centre-Forward,Attack,Right,173.0,30-06-27,CAA Stellar,https://img.a.transfermarkt.technology/portrait/header/250426-1708002412.jpg?lm=1,GB1,Southampton Football Club,16000000.0,18000000.0,27,133,138,7,8,13,13,13,12,8,14,4,5,10,13,5,11,7,13,11,10,11,10,10,13,11,6,11,6,13,12,17,14,10,8,14,17,15,9,12,6,12,2,12,4,2,1,3,1,1,2,2,2,2,1,15,15,4,13,13,15,13,15,1,1,1,1,1,1,1,1,1,1,20,14,11,18,69,13,20,18221214,6650,6650,4750,Northern_European,127,0,0,57996.0,Unknown,28091349,9800000.0,2.0,32,1656,33,0,1,7,186,3,0.6301931727970362,0.5026737967914437,0.5735294117647058,0.055993248404076,0.0,0.0,0.0797699424856214,0.0897724431107777,0.05441817828273,0.1428571428571428,0.2325581395348837,0.375,453,143,54,27,0,4535,2,10,20,16000000,656250.0,18000000.0,3000000.0,750000.0,1500000.0,5,1250000,0.0,0.0
250478,Matt,Targett,2024,762,England,Eastleigh,England,18-09-95,Left-Back,Defender,Left,183.0,30-06-26,Straight Ace Sports,https://img.a.transfermarkt.technology/portrait/header/250478-1643653374.jpg?lm=1,GB1,Newcastle United Football Club,8000000.0,17000000.0,29,139,140,12,13,13,11,13,10,12,6,10,12,13,7,14,13,12,13,12,13,13,13,13,14,10,9,14,13,14,14,14,14,14,12,13,14,14,14,18,7,13,11,12,2,2,3,2,1,3,1,2,1,2,3,10,12,6,14,12,15,14,10,1,20,1,1,17,1,1,1,1,1,1,1,1,1,81,20,11,43272461,6950,6950,5500,Northern_European,138,0,0,92793.0,Unknown,28084863,16500000.0,2.0,32,445,33,1,0,7,137,8,0.6698862132839376,0.5828877005347594,0.6544117647058822,0.0895938324093985,0.0,0.0,0.0397599399849962,0.0847711927981995,0.0916414344842912,0.1428571428571428,0.4651162790697669,0.4583333333333332,276,9,17,28,0,6485,14,113,201,8000000,310000.0,17000000.0,3000000.0,,3000000.0,2,5000000,-0.2,-0.2
250779,Brendan,Chardonnet,2024,3911,France,Saint-Renan,France,22-12-94,Centre-Back,Defender,Right,181.0,30-06-25,NexSt11,https://img.a.transfermarkt.technology/portrait/header/250779-1582538208.jpg?lm=1,FR1,Stade brestois 29,8000000.0,8000000.0,30,126,127,4,7,10,6,12,6,14,7,6,14,11,9,13,12,11,12,14,13,14,10,13,13,8,12,8,14,14,14,11,12,14,13,14,12,14,15,13,11,13,6,10,4,3,3,4,2,3,4,1,2,3,2,20,12,6,16,12,14,14,15,1,8,20,10,8,10,10,1,1,1,1,1,1,1,80,8,20,3267021,6300,6300,3770,Northern_European,126,0,0,11323.0,Unknown,85139266,9111392.0,2.0,34,1279,36,1,1,7,196,2,0.5838846255623181,0.3978609625668449,0.5661764705882353,0.0109249937476282,0.0,0.0,0.0397599399849962,0.0397599399849962,0.0505924720131114,0.1428571428571428,0.418604651162791,0.5,270,14,3,44,4,7807,7,12,31,8000000,318000.0,8000000.0,150000.0,0.0,250000.0,1,75000,0.0,0.14285714285714285
250844,Alexander,Djiku,2024,36,France,Montpellier,Ghana,09-08-94,Centre-Back,Defender,Right,182.0,30-06-26,Unknown,https://img.a.transfermarkt.technology/portrait/header/250844-1728391726.JPG?lm=1,TR1,FenerbahÃ§e Spor KulÃ¼bÃ¼,9000000.0,10000000.0,30,133,136,6,11,10,5,12,6,15,5,11,14,11,8,14,12,15,13,17,13,15,8,13,14,10,10,10,14,13,15,13,12,15,12,15,13,15,14,14,12,11,6,11,1,3,2,3,3,2,3,3,2,4,2,7,14,7,13,12,13,12,12,1,1,20,10,1,1,15,1,1,1,1,1,1,1,74,8,20,4097847,6644,6644,4100,African_Caribbean,134,17,1,16097.0,Unknown,48036760,3250000.0,2.0,34,978,41,1,1,1,84,2,0.6293993119872983,0.4331550802139037,0.625,0.0155348505755561,0.1118421052631578,0.0131578947368421,0.0447611902975743,0.0497624406101525,0.0180282785632934,0.1428571428571428,0.4418604651162785,0.5,309,9,5,76,6,4079,17,88,127,8500000,311111.1111111111,10000000.0,2000000.0,,,4,2450000,-0.05555555555555555,0.0
251075,Zeki,ÃÂ¡Elik,2024,12,TÃ¼rkiye,Bursa,TÃ¼rkiye,17-02-97,Right-Back,Defender,Right,180.0,30-06-26,F-F SPORT,https://img.a.transfermarkt.technology/portrait/header/251075-1725530746.jpg?lm=1,IT1,Associazione Sportiva Roma,6000000.0,20000000.0,27,139,147,9,13,11,10,12,5,10,8,13,13,14,5,15,12,8,13,15,13,14,8,14,14,10,7,14,12,14,16,14,12,12,11,14,15,15,13,13,4,12,5,17,3,1,3,2,1,1,2,1,3,3,3,14,15,8,12,11,14,8,9,1,15,10,20,10,18,1,1,1,1,1,1,1,1,78,12,20,10619598,6950,6700,5000,Mediterranean_Hispanic,136,32,2,49230.0,Unknown,70097248,3716666.667,3.0,100,280,100,1,1,3,29,11,0.6368086795448531,0.5294117647058822,0.6397058823529411,0.0475286474502393,0.2105263157894736,0.0263157894736842,0.0297574393598399,0.0997749437359339,0.0206209431761993,0.2857142857142857,0.3953488372093026,0.375,342,12,19,65,2,5347,7,23,33,5000000,188461.53846153847,20000000.0,5000000.0,,350000.0,3,4300000,-0.16666666666666666,-0.16666666666666666
251106,Enes,ÃÅNal,2024,989,TÃ¼rkiye,Bursa,TÃ¼rkiye,10-05-97,Centre-Forward,Attack,Right,187.0,30-06-28,FutureBall,https://img.a.transfermarkt.technology/portrait/header/251106-1669365680.jpg?lm=1,GB1,Association Football Club Bournemouth,15000000.0,25000000.0,27,134,142,6,9,13,15,14,15,12,13,6,6,10,14,6,15,7,12,11,13,11,11,12,15,14,9,14,7,11,12,13,15,13,10,12,12,12,14,13,4,17,6,11,3,2,2,2,3,1,3,4,2,3,4,8,15,5,12,12,15,12,10,1,1,1,1,1,1,1,1,1,1,5,14,5,20,75,16,20,4630645,6600,6500,5950,Mediterranean_Hispanic,133,27,2,12079.0,Unknown,70087488,10975000.0,4.0,100,280,100,0,1,3,22,3,0.6103466525535857,0.6310160427807486,0.6176470588235294,0.0116550004007311,0.1776315789473684,0.0263157894736842,0.0747686921730432,0.1247811952988247,0.0609461373927053,0.4285714285714285,0.5581395348837206,0.375,367,97,31,42,1,5128,10,84,213,13000000,379411.76470588235,25000000.0,8000000.0,3000000.0,7000000.0,8,16700000,-0.2777777777777778,-0.48
251299,Finn,Dahmen,2024,167,Germany,Wiesbaden,Germany,27-03-98,Goalkeeper,Goalkeeper,Right,186.0,30-06-26,CN Sports,https://img.a.transfermarkt.technology/portrait/header/251299-1722849607.jpg?lm=1,L1,FC Augsburg 1907,3500000.0,5000000.0,26,122,135,1,3,1,1,11,4,6,2,2,1,12,4,1,11,11,12,12,12,12,11,12,13,7,7,1,14,11,10,10,15,14,15,16,11,11,12,13,6,16,3,10,12,12,12,8,13,12,14,14,12,8,11,7,15,12,15,14,16,14,14,20,1,1,1,1,1,1,1,1,1,1,1,1,1,80,7,20,635345,6100,6100,4112,Northern_European,122,0,0,7671.0,Unknown,92071481,9111392.0,2.0,38,1665,40,2,1,7,67,5,0.5574225985710506,0.4344385026737967,0.536764705882353,0.0073985594921625,0.0,0.0,0.0172543135783946,0.0247561890472618,0.0505924720131114,0.1428571428571428,0.5348837209302322,0.3333333333333332,0,0,0,0,0,0,2,10,123,2500000,115476.19047619047,5000000.0,1500000.0,,150000.0,1,1000000,-0.5,-0.5
251302,Niklas,Dorsch,2024,2036,Germany,Lichtenfels,Germany,15-01-98,Defensive Midfield,Midfield,Right,178.0,30-06-28,Unknown,https://img.a.transfermarkt.technology/portrait/header/251302-1722850585.jpg?lm=1,L1,1. FuÃŸballclub Heidenheim 1846,4000000.0,10000000.0,26,130,142,9,10,12,9,13,7,8,9,6,11,16,9,12,14,12,14,13,15,12,14,14,15,11,12,11,12,17,14,11,15,13,9,13,11,15,9,14,10,15,7,10,1,1,1,1,1,2,1,3,2,3,1,7,11,9,12,14,10,13,8,1,1,1,1,1,1,20,12,20,12,10,12,10,1,76,10,20,5548404,6450,6450,4500,Northern_European,126,0,0,18500.0,Unknown,91144312,4666666.667,3.0,38,831,40,3,1,7,2,4,0.6037311458057687,0.4759358288770053,0.5661764705882353,0.0178552288657763,0.0,0.0,0.0197549387346836,0.0497624406101525,0.0258988675629878,0.2857142857142857,0.3488372093023257,0.3333333333333332,297,19,21,64,1,4640,16,89,95,3500000,137000.0,10000000.0,2000000.0,200000.0,1500000.0,4,2800000,-0.125,-0.5
251303,Johannes,Eggestein,2024,35,Germany,Hannover,Germany,08-05-98,Centre-Forward,Attack,Right,183.0,Unknown,ROOF,https://img.a.transfermarkt.technology/portrait/header/251303-1723632371.jpeg?lm=1,L1,FuÃŸball-Club St. Pauli von 1910,2000000.0,10000000.0,26,121,133,7,9,12,13,14,8,12,11,4,6,13,11,8,14,11,13,9,12,11,14,12,11,11,7,13,7,16,13,13,13,12,10,14,11,12,10,10,5,12,5,14,3,2,1,1,1,1,2,2,4,3,1,10,15,6,10,13,14,13,16,1,1,1,1,1,1,1,10,12,14,10,20,14,18,75,12,20,1870531,6046,6046,3996,Northern_European,119,0,0,9500.0,Unknown,91143690,800000.0,2.0,38,596,40,0,1,7,101,3,0.5502778512834083,0.4220320855614973,0.5147058823529411,0.0091646734716934,0.0,0.0,0.0097524381095273,0.0497624406101525,0.0044167893552598,0.1428571428571428,0.4651162790697669,0.3333333333333332,313,132,44,10,0,4607,7,36,83,2500000,84000.0,10000000.0,2500000.0,400000.0,7500000.0,3,4100000,0.25,0.6666666666666666
251309,Dennis,Geiger,2024,533,Germany,Mosbach,Germany,10-06-98,Central Midfield,Midfield,Right,173.0,30-06-27,WINStar Management ,https://img.a.transfermarkt.technology/portrait/header/251309-1723921207.jpg?lm=1,L1,TSG 1899 Hoffenheim FuÃŸball-Spielbetriebs GmbH,3000000.0,13000000.0,26,135,144,15,13,11,8,15,14,7,12,6,12,15,12,12,15,15,14,14,16,13,15,14,13,11,9,10,12,17,13,12,14,13,6,12,10,14,10,13,12,12,13,11,4,2,3,2,1,3,1,2,1,2,1,9,14,7,12,15,13,15,11,1,1,1,1,1,1,20,1,20,1,1,14,1,1,65,10,20,6480280,6749,6749,5299,Northern_European,132,0,0,26370.0,Unknown,91143563,9111392.0,2.0,38,984,40,3,1,7,199,1,0.6432918761577137,0.5613903743315507,0.6102941176470589,0.0254546367492687,0.0,0.0,0.0147536884221055,0.0647661915478869,0.0505924720131114,0.1428571428571428,0.2325581395348837,0.3333333333333332,226,26,46,69,3,3186,37,166,212,3000000,131818.18181818182,13000000.0,3000000.0,125000.0,8500000.0,0,0,0.0,-0.25
251322,Philipp,Köhn,2024,162,Germany,Dinslaken,Switzerland,02-04-98,Goalkeeper,Goalkeeper,Right,190.0,30-06-28,Unknown,https://img.a.transfermarkt.technology/portrait/header/251322-1661531623.png?lm=1,FR1,Association sportive de Monaco Football Club,5000000.0,8000000.0,26,129,137,2,5,4,2,10,2,6,7,8,5,11,5,6,8,11,11,13,13,12,10,11,13,4,9,3,14,14,12,12,13,13,14,15,12,14,13,13,7,11,5,2,13,13,11,6,13,11,14,14,15,12,13,9,16,8,9,15,14,12,14,20,1,1,1,1,1,1,1,1,1,1,1,1,1,80,10,20,3527549,6304,6297,4153,Northern_European,125,0,0,7363.0,Unknown,92071859,4450000.0,2.0,38,415,92,2,1,7,24,5,0.583487695157449,0.4388235294117646,0.5588235294117647,0.0071011493742317,0.0,0.0,0.0247561890472618,0.0397599399849962,0.0246951304202894,0.1428571428571428,0.6279069767441858,0.3333333333333332,0,0,0,0,0,0,7,36,185,4000000,185714.2857142857,8000000.0,2000000.0,,300000.0,4,3600000,-0.2,-0.5
251680,Brandon,Thomas,2024,1091,Spain,SantanyÃ­,Spain,04-02-95,Centre-Forward,Attack,Right,173.0,30-06-25,Promoesport,https://img.a.transfermarkt.technology/portrait/header/251680-1727967689.png?lm=1,GR1,Panthessalonikios Athlitikos Omilos Konstantinoupoliton,1800000.0,2000000.0,29,125,135,7,10,12,14,11,6,8,13,5,6,11,13,6,13,8,13,15,13,10,11,10,13,12,9,15,11,15,15,13,13,12,8,12,14,15,12,13,6,10,13,14,1,1,3,1,2,3,2,2,2,1,2,8,13,13,9,9,9,10,10,1,1,1,1,1,1,1,10,1,10,17,10,16,20,73,12,20,2429083,5988,6242,2748,Northern_European,120,0,0,11827.0,Unknown,67182717,2500000.0,2.0,89,1333,89,0,1,7,153,3,0.5762106377348505,0.2885561497326203,0.5220588235294117,0.0114116648496968,0.0,0.0,0.0087521880470117,0.0097524381095273,0.0138614961526709,0.1428571428571428,0.2325581395348837,0.4583333333333332,0,0,0,0,0,0,5,38,256,1600000,62500.0,2000000.0,500000.0,200000.0,300000.0,8,1000000,-0.1111111111111111,0.06666666666666667
251813,Niclas,Eliasson,2024,2441,Sweden,Varberg,Sweden,07-12-95,Right Midfield,Midfield,Left,178.0,30-06-28,Nordic Sky,https://img.a.transfermarkt.technology/portrait/header/251813-1728415836.png?lm=1,GR1,Athlitiki Enosi Konstantinoupoleos,4500000.0,5000000.0,29,120,135,11,15,14,11,13,12,5,9,3,4,12,8,4,13,9,11,11,10,11,14,11,12,14,4,13,7,10,12,15,15,11,7,12,15,12,7,12,4,12,5,13,1,1,3,2,3,2,2,2,1,1,3,12,13,3,6,12,13,13,15,1,1,1,1,1,1,1,16,1,16,20,1,19,10,64,20,8,3341249,6250,6000,3000,African_Caribbean,117,0,0,8077.0,Unknown,93052049,2333333.333,3.0,91,1563,91,3,0,1,34,9,0.5441915850754168,0.3155080213903743,0.4999999999999999,0.0077906001021623,0.0,0.0,0.0222555638909727,0.0247561890472618,0.012935544504014,0.2857142857142857,0.3488372093023257,0.4583333333333332,394,42,106,19,0,10132,4,22,83,4500000,172000.0,5000000.0,1000000.0,250000.0,150000.0,5,1150000,0.0,0.5
251845,Sergi,Canós,2024,1049,Spain,Nules,Spain,02-02-97,Right Winger,Attack,Right,177.0,30-06-27,Unknown,https://img.a.transfermarkt.technology/portrait/header/251845-1538466933.jpg?lm=1,ES1,Valencia Club de FÃºtbol S. A. D.,2500000.0,14000000.0,27,130,137,12,13,14,11,14,11,9,12,5,5,13,11,9,14,14,13,13,13,12,13,13,15,15,9,12,10,12,14,13,14,13,9,13,13,12,11,12,9,12,8,13,2,1,3,2,3,1,2,1,2,3,2,13,14,7,12,12,13,8,10,1,1,1,1,12,18,1,10,1,12,15,12,20,12,0,11,20,14826149,6700,6550,5500,Northern_European,128,0,0,40597.0,Unknown,28094954,2050000.0,3.0,89,1063,89,0,1,7,208,10,0.6169621593014025,0.5828877005347594,0.5808823529411764,0.0391924735927818,0.0,0.0,0.0122530632658164,0.0697674418604651,0.0113614267062973,0.2857142857142857,0.3255813953488373,0.375,345,50,50,39,1,6183,4,21,41,1500000,54347.82608695652,14000000.0,5000000.0,250000.0,2500000.0,4,9750000,-0.4,-0.4
251876,Pablo,Maffeo,2024,237,Spain,Sant Joan DespÃ­,Argentina,12-07-97,Right-Back,Defender,Right,172.0,30-06-27,Promoesport,https://img.a.transfermarkt.technology/portrait/header/251876-1699449290.jpg?lm=1,ES1,Real Club Deportivo Mallorca S.A.D.,5000000.0,10000000.0,27,135,151,6,13,13,7,11,7,9,11,12,12,12,8,15,12,14,12,16,10,10,10,11,17,13,8,13,12,14,17,16,15,15,8,15,14,14,10,14,12,16,6,10,1,1,2,1,3,1,2,1,2,1,4,10,16,13,9,14,8,10,8,1,1,8,20,1,20,1,1,1,12,1,1,12,1,68,12,20,7064704,6750,6750,5150,Mediterranean_Hispanic,128,0,0,28845.0,Unknown,28095341,4033333.333,3.0,89,1318,4,1,1,3,166,11,0.6434241862926701,0.5454545454545454,0.5808823529411764,0.0278445394826415,0.0,0.0,0.0247561890472618,0.0497624406101525,0.022380251301425,0.2857142857142857,0.2093023255813952,0.375,298,8,27,61,3,4600,11,38,93,5000000,188461.53846153847,10000000.0,3000000.0,100000.0,10000000.0,6,2200000,0.0,-0.375
251892,Juan,Soriano,2024,1244,Spain,BenacazÃ³n,Spain,23-08-97,Goalkeeper,Goalkeeper,Left,185.0,30-06-27,Unknown,https://img.a.transfermarkt.technology/portrait/header/251892-1583333927.jpg?lm=1,ES1,Club Deportivo LeganÃ©s S.A.D.,1500000.0,2500000.0,27,125,143,5,3,2,1,7,9,4,3,1,2,7,3,2,7,9,13,13,13,14,7,13,16,7,12,5,13,12,11,9,14,12,12,12,9,13,12,14,8,11,6,14,13,14,13,10,13,12,13,16,12,13,12,11,12,14,15,11,13,11,15,20,1,1,1,1,1,1,1,1,1,1,1,1,1,78,20,8,1447077,6140,6140,3590,Mediterranean_Hispanic,127,0,0,6282.0,Unknown,67193103,9111392.0,2.0,89,170,89,2,0,3,54,5,0.5627150039693041,0.3786096256684491,0.5735294117647058,0.0060573171096757,0.0,0.0,0.0072518129532383,0.0122530632658164,0.0505924720131114,0.1428571428571428,0.5116279069767438,0.375,0,0,0,0,0,0,1,2,12,1500000,59090.90909090909,2500000.0,500000.0,,600000.0,5,900000,0.0,0.25
251896,Jesús,Vallejo,2024,418,Spain,Zaragoza,Spain,05-01-97,Centre-Back,Defender,Right,184.0,30-06-25,Unknown,https://img.a.transfermarkt.technology/portrait/header/251896-1684241186.jpg?lm=1,ES1,Real Madrid Club de FÃºtbol,1000000.0,15000000.0,27,134,150,5,8,9,7,12,6,12,8,9,15,12,9,16,13,14,17,13,15,12,12,14,14,7,14,8,14,16,10,11,12,11,13,15,13,12,12,16,11,15,15,10,2,3,1,1,3,1,2,1,2,2,3,12,9,4,12,15,14,16,18,1,1,20,13,1,8,11,1,1,1,1,1,1,1,79,9,20,3918239,6700,6700,5750,Mediterranean_Hispanic,132,0,0,38461.0,Unknown,67192921,5000000.0,1.0,89,1699,89,1,1,3,167,2,0.6368086795448531,0.6096256684491979,0.6102941176470589,0.0371299151125861,0.0,0.0,0.0047511877969492,0.0747686921730432,0.0277507708547459,0.0,0.4883720930232553,0.375,174,3,3,25,3,5167,23,135,168,1000000,21428.571428571428,15000000.0,3000000.0,2000000.0,15000000.0,7,12000000,0.0,-0.3333333333333333
251897,Asier,Villalibre,2024,1108,Spain,Gernika,Spain,30-09-97,Centre-Forward,Attack,Left,182.0,30-06-28,Unknown,https://img.a.transfermarkt.technology/portrait/header/251897-1709676417.png?lm=1,ES1,Deportivo AlavÃ©s S.A.D.,2500000.0,4500000.0,27,128,142,7,11,11,13,12,8,14,12,7,7,11,16,8,12,13,13,14,12,13,11,12,15,13,14,14,13,13,16,12,12,12,12,12,13,14,15,13,12,14,12,11,3,3,1,4,1,3,4,3,2,4,2,17,13,7,10,12,12,10,17,1,1,1,1,1,1,1,1,1,1,10,1,10,20,87,20,11,8746774,6400,6400,4900,Mediterranean_Hispanic,128,0,0,9770.0,Unknown,67195730,1000000.0,1.0,89,535,89,0,0,3,59,3,0.5971156390579518,0.5187165775401069,0.5808823529411764,0.0094253901335158,0.0,0.0,0.0122530632658164,0.0222555638909727,0.0055279313314258,0.0,0.4418604651162785,0.375,302,70,26,17,0,6295,6,26,120,2200000,75000.0,4500000.0,1500000.0,400000.0,600000.0,8,1100000,-0.12,-0.12
252641,Pione,Sisto,2024,605,Uganda,Kampala,Denmark,04-02-95,Left Winger,Attack,Right,172.0,30-06-26,SEG,https://img.a.transfermarkt.technology/portrait/header/252641-1695400846.png?lm=1,GR1,Aris Thessalonikis,1300000.0,15000000.0,29,129,155,13,14,15,11,15,13,7,14,3,5,13,11,7,16,11,13,7,10,7,11,10,6,16,6,14,5,8,11,15,14,14,7,14,14,11,9,8,3,13,4,14,3,2,4,2,1,1,2,1,3,4,3,4,11,18,10,7,5,15,15,1,1,1,1,1,1,1,17,8,19,20,11,19,10,64,14,20,2309168,6245,6245,5245,African_Caribbean,126,26,1,15964.0,Unknown,27058550,4250000.0,2.0,102,704,30,0,1,1,20,7,0.5766075681397195,0.555614973262032,0.5661764705882353,0.0154064234791769,0.1710526315789473,0.0131578947368421,0.0062515628907226,0.0747686921730432,0.0235839884441234,0.1428571428571428,0.2093023255813952,0.4583333333333332,396,66,37,22,0,11163,6,20,89,1300000,42857.142857142855,15000000.0,5000000.0,300000.0,3500000.0,5,2950000,0.0,-0.23529411764705882
253341,Rob,Holding,2024,873,England,Stalybridge,England,20-09-95,Centre-Back,Defender,Right,189.0,30-06-26,CAA Stellar,https://img.a.transfermarkt.technology/portrait/header/253341-1683101805.jpeg?lm=1,GB1,Crystal Palace Football Club,5000000.0,18000000.0,29,136,155,2,6,10,5,13,6,14,5,11,15,12,5,15,12,13,14,15,13,13,12,13,14,8,13,5,14,16,15,13,13,14,15,14,13,15,13,13,12,12,10,10,2,1,3,1,4,2,2,3,4,2,1,11,12,5,12,14,14,14,14,1,1,20,10,1,8,1,1,1,1,1,1,1,1,0,8,20,20183497,6800,6800,6000,Northern_European,137,0,0,46397.0,Unknown,29108071,2100000.0,2.0,32,1418,33,1,1,7,58,2,0.6500396930404869,0.6363636363636364,0.6470588235294117,0.0447930537356352,0.0,0.0,0.0247561890472618,0.0897724431107777,0.0116392122003388,0.1428571428571428,0.6046511627906974,0.4583333333333332,238,10,2,30,1,11608,4,54,270,4000000,163043.47826086957,18000000.0,6000000.0,,1500000.0,2,4250000,-0.2,-0.2
253677,Tyrone,Mings,2024,405,England,Bath,England,13-03-93,Centre-Back,Defender,Left,196.0,30-06-26,Wasserman,https://img.a.transfermarkt.technology/portrait/header/253677-1593437372.jpg?lm=1,GB1,Aston Villa Football Club,10000000.0,32000000.0,31,140,142,9,10,13,6,11,5,16,9,12,12,14,2,15,13,15,13,16,14,12,12,12,16,12,17,13,13,15,14,14,14,13,15,14,14,14,15,12,14,13,10,10,1,2,3,3,2,2,3,2,4,4,2,11,15,6,13,14,16,12,14,1,15,20,1,1,1,1,1,1,1,1,1,1,1,78,20,7,34449545,7000,7500,5750,Mixed_Race,139,17,2,81194.0,Unknown,29074544,16800000.0,2.0,32,156,33,1,0,4,30,2,0.7426567875099233,0.6096256684491979,0.6617647058823528,0.0783936377409577,0.1118421052631578,0.0263157894736842,0.0497624406101525,0.1597899474868717,0.0933081474485402,0.1428571428571428,0.7674418604651163,0.5416666666666665,264,9,17,51,0,4269,6,182,446,8000000,295370.3703703704,32000000.0,6000000.0,,300000.0,2,16000000,-0.38461538461538464,-0.5
254003,Myenty,Abena,2024,232,Suriname,Paramaribo,Suriname,12-12-94,Centre-Back,Defender,Right,187.0,30-06-26,PURE,https://img.a.transfermarkt.technology/portrait/header/254003-1724133504.png?lm=1,RU1,FK Spartak Moskva,1000000.0,1000000.0,30,120,125,7,8,7,10,7,9,14,8,8,12,13,7,15,8,15,10,12,10,11,9,14,15,12,11,11,12,12,14,12,11,13,14,14,11,13,16,12,12,9,2,9,3,2,3,2,2,4,2,2,1,4,3,9,12,1,10,10,15,10,10,1,1,20,14,1,12,12,1,1,1,1,1,1,1,87,5,20,423576,5948,5469,3819,African_Caribbean,115,8,0,1684.0,Unknown,37028457,9111392.0,2.0,90,1119,90,1,1,1,82,2,0.4739349034136014,0.4031016042780748,0.4852941176470588,0.0016174089205654,0.0526315789473684,0.0,0.0047511877969492,0.0047511877969492,0.0505924720131114,0.1428571428571428,0.5581395348837206,0.5,318,11,12,36,2,16260,6,22,52,800000,31250.0,1000000.0,200000.0,,,6,550000,-0.2,0.0
255469,Joel,Andersson,2024,865,Sweden,GÃ¶teborg,Sweden,11-11-96,Right-Back,Defender,Right,178.0,31-12-26,Nordic Sky,https://img.a.transfermarkt.technology/portrait/header/255469-1530601840.jpg?lm=1,DK1,Fodbold Club Midtjylland,850000.0,2500000.0,28,125,135,7,13,10,7,12,6,10,8,8,11,11,5,12,14,15,14,11,13,12,12,12,13,10,10,12,11,13,15,13,11,10,8,11,13,15,8,12,7,5,7,14,2,1,4,3,3,2,2,3,2,3,1,17,13,3,15,12,13,14,14,1,18,1,20,17,18,1,13,10,16,10,1,12,1,71,14,20,1280622,6044,6044,3495,Northern_European,114,8,0,4033.0,Unknown,93048556,1300000.0,1.0,91,582,91,1,1,7,86,11,0.5500132310134956,0.3684491978609625,0.4779411764705882,0.003885643878421,0.0526315789473684,0.0,0.0040010002500625,0.0122530632658164,0.0071946442956748,0.0,0.3488372093023257,0.4166666666666665,0,0,0,0,0,0,2,53,258,1300000,54545.454545454544,2500000.0,500000.0,150000.0,750000.0,1,600000,0.5294117647058824,0.3
255501,Iñigo,Lekue,2024,621,Spain,Bilbao,Spain,04-05-93,Right-Back,Defender,Right,180.0,30-06-25,Unknown,https://img.a.transfermarkt.technology/portrait/header/255501-1709675295.png?lm=1,ES1,Athletic Club Bilbao,3000000.0,7500000.0,31,134,144,9,13,12,7,11,7,10,7,8,12,11,5,14,13,10,13,13,10,12,11,12,13,12,8,13,12,14,15,13,13,13,10,13,14,15,12,11,5,2,13,15,2,2,1,3,2,4,3,3,4,3,1,10,14,7,14,9,14,12,14,1,15,1,20,15,19,1,10,1,15,10,1,15,1,71,11,20,13725712,6700,6700,5200,Mediterranean_Hispanic,123,0,0,15662.0,Unknown,67184347,9111392.0,2.0,89,191,89,1,1,3,33,11,0.6368086795448531,0.5508021390374331,0.5441176470588236,0.0151148070648421,0.0,0.0,0.0147536884221055,0.0372593148287071,0.0505924720131114,0.1428571428571428,0.3953488372093026,0.5416666666666665,318,5,22,35,0,6720,8,50,206,2500000,104166.66666666667,7500000.0,3500000.0,,,1,1000000,-0.16666666666666666,-0.16666666666666666
255508,Iñaki,Williams,2024,621,Spain,Bilbao,Ghana,15-06-94,Right Winger,Attack,Right,186.0,30-06-28,Unknown,https://img.a.transfermarkt.technology/portrait/header/255508-1709676323.png?lm=1,ES1,Athletic Club Bilbao,25000000.0,50000000.0,30,153,159,7,12,14,11,14,9,13,10,7,7,10,9,7,14,10,12,15,10,12,12,11,12,11,7,14,11,12,15,16,13,11,12,18,18,14,13,11,11,14,1,13,4,1,1,1,2,3,3,1,4,1,2,14,14,11,14,10,13,10,8,1,1,1,1,1,1,1,15,1,15,19,17,20,19,80,10,20,134999997,7650,7650,6900,African_Caribbean,138,0,0,220548.0,Unknown,67184349,9111392.0,2.0,89,191,41,0,1,1,33,10,0.7625033077533738,0.7326203208556149,0.6544117647058822,0.2129562662284052,0.0,0.0,0.1247811952988247,0.2498124531132783,0.0505924720131114,0.1428571428571428,0.5348837209302322,0.5,487,129,68,40,0,7422,8,32,36,20000000,740740.7407407408,50000000.0,10000000.0,,2500000.0,1,2500000,-0.2,-0.2
255838,Patrick,Ciurria,2024,2919,Italy,Sassuolo,Italy,09-02-95,Right Midfield,Midfield,Left,178.0,30-06-26,TMP SOCCER srl ,https://img.a.transfermarkt.technology/portrait/header/255838-1695030937.jpg?lm=1,IT1,Associazione Calcio Monza,4000000.0,5000000.0,29,127,133,11,12,12,11,12,9,8,11,8,10,11,11,12,12,12,13,12,11,12,12,12,13,13,10,13,12,11,10,14,13,9,8,11,13,14,8,12,11,11,10,15,3,2,1,3,4,2,2,3,3,2,2,11,13,7,12,14,13,14,11,1,1,1,10,1,19,1,1,1,19,12,15,20,17,67,20,11,3116002,6350,6000,5200,Mediterranean_Hispanic,118,0,0,24231.0,Unknown,43115532,1060000.0,2.0,52,1347,54,3,0,3,28,9,0.5441915850754168,0.5508021390374331,0.5073529411764706,0.023389181417275,0.0,0.0,0.0197549387346836,0.0247561890472618,0.0058612739242756,0.1428571428571428,0.3488372093023257,0.4583333333333332,348,41,50,30,0,5036,7,24,167,3000000,109259.25925925926,5000000.0,1400000.0,300000.0,200000.0,4,1450000,-0.25,-0.4
255901,Rodrigo,De Paul,2024,13,Argentina,SarandÃ­,Argentina,24-05-94,Central Midfield,Midfield,Right,180.0,30-06-26,Augustin Jimenez,https://img.a.transfermarkt.technology/portrait/header/255901-1712816368.jpg?lm=1,ES1,Club AtlÃ©tico de Madrid S.A.D.,30000000.0,40000000.0,30,154,160,15,16,17,13,16,14,8,15,3,10,16,15,12,16,13,15,13,13,12,15,14,15,16,15,13,6,15,14,14,14,14,9,15,14,13,12,13,15,14,8,14,1,3,3,3,2,1,3,3,3,2,1,13,16,11,14,14,15,12,12,1,1,1,1,1,1,1,12,20,12,16,18,15,12,70,12,20,40726823,7500,7650,6700,Mediterranean_Hispanic,150,41,2,111504.0,Unknown,14048343,17183333.33,3.0,4,1342,4,3,1,3,52,1,0.7625033077533738,0.7112299465240641,0.7426470588235294,0.1076614970736968,0.2697368421052631,0.0263157894736842,0.1497874468617154,0.1997999499874969,0.0954378362176727,0.2857142857142857,0.3953488372093026,0.5,468,57,71,79,4,6613,1,4,18,25000000,741935.4838709678,40000000.0,10000000.0,2000000.0,4000000.0,5,6000000,-0.16666666666666666,-0.16666666666666666
255906,Scott,Mckenna,2024,472,Scotland,Kirriemuir,Scotland,12-11-96,Centre-Back,Defender,Left,189.0,30-06-27,Wasserman,https://img.a.transfermarkt.technology/portrait/header/255906-1718274297.jpg?lm=1,ES1,UniÃ³n Deportiva Las Palmas S.A.D.,9000000.0,10000000.0,28,126,148,4,5,7,6,10,7,15,10,10,13,11,10,14,10,15,13,14,12,12,8,12,15,7,16,7,13,12,13,12,11,11,15,12,14,13,15,14,13,14,8,11,2,3,1,3,2,2,2,4,2,1,1,12,15,7,12,12,14,10,13,1,1,20,1,1,1,1,1,1,1,1,1,1,1,73,20,9,12110099,6600,6300,4750,Northern_European,125,26,1,28998.0,Unknown,61064267,3270000.0,1.0,82,733,83,1,0,7,207,2,0.5838846255623181,0.5026737967914437,0.5588235294117647,0.0279922789243409,0.1710526315789473,0.0131578947368421,0.0447611902975743,0.0497624406101525,0.01813939276091,0.0,0.6046511627906974,0.4166666666666665,293,10,6,37,2,7151,11,72,93,6000000,313157.8947368421,10000000.0,3000000.0,,50000.0,4,4950000,-0.3333333333333333,-0.4
255942,Nicolò,Barella,2024,46,Italy,Cagliari,Italy,07-02-97,Central Midfield,Midfield,Right,175.0,30-06-29,Unknown,https://img.a.transfermarkt.technology/portrait/header/255942-1725531625.jpg?lm=1,IT1,Football Club Internazionale Milano S.p.A.,80000000.0,80000000.0,27,160,171,12,13,14,11,15,14,7,13,3,11,16,12,17,15,19,14,18,14,13,16,14,19,14,14,15,14,18,20,14,15,16,8,17,15,15,13,16,14,15,9,12,2,3,3,4,2,3,2,1,3,2,2,12,18,4,15,17,19,11,11,1,1,1,1,1,1,12,8,20,8,1,14,1,1,68,9,20,52249999,8000,8000,7800,Mediterranean_Hispanic,162,39,8,178076.0,Unknown,43139595,32500000.0,1.0,52,295,54,3,1,3,89,1,0.808811854988092,0.8288770053475936,0.8308823529411764,0.171944569706462,0.256578947368421,0.1052631578947368,0.3998499624906226,0.3998499624906226,0.1805327925775716,0.0,0.2790697674418605,0.375,435,36,64,102,3,8253,13,49,43,80000000,2498437.5,80000000.0,9000000.0,800000.0,15000000.0,4,10250000,0.0,0.06666666666666667
255995,Mario,González,2024,3329,Spain,Villarcayo,Spain,25-02-96,Centre-Forward,Attack,Right,183.0,30-06-25,YOU FIRST,https://img.a.transfermarkt.technology/portrait/header/255995-1691270189.jpg?lm=1,PO1,Futebol Clube de FamalicÃ£o,2500000.0,4000000.0,28,122,125,7,10,12,13,12,6,13,12,7,6,10,10,5,12,11,13,8,11,9,9,11,12,14,8,13,6,10,7,16,14,10,12,13,15,12,12,12,7,16,5,14,2,3,2,1,3,2,3,3,2,3,3,14,11,6,12,15,11,12,15,1,1,1,1,1,1,1,1,1,1,14,1,14,20,76,10,20,352687,5950,5950,4251,Mediterranean_Hispanic,117,0,0,6028.0,Oud-Heverlee Leuven,67216777,9111392.0,2.0,89,1601,89,0,1,3,99,3,0.5375760783275999,0.4493048128342246,0.4999999999999999,0.0058120503241094,0.0,0.0,0.0122530632658164,0.0197549387346836,0.0505924720131114,0.1428571428571428,0.4651162790697669,0.4166666666666665,0,0,0,0,0,0,5,10,28,2000000,83333.33333333333,4000000.0,500000.0,,200000.0,8,2225000,-0.2,-0.3333333333333333
256120,Wilfrid,Kaptoum,2024,3385,Cameroon,Douala,Cameroon,07-07-96,Central Midfield,Midfield,Right,174.0,30-06-25,YOU FIRST,https://img.a.transfermarkt.technology/portrait/header/256120-1646576481.jpg?lm=1,GR1,Panserraikos Serres,450000.0,4000000.0,28,120,135,10,10,14,8,15,10,12,9,7,8,13,12,9,15,8,11,13,13,9,14,12,10,12,6,12,14,12,12,13,15,14,7,15,12,12,11,8,10,13,7,9,2,2,3,1,1,2,3,3,3,3,1,9,15,4,12,10,8,11,10,1,1,1,1,1,1,8,10,20,10,9,15,9,1,72,9,20,728719,5852,5393,4060,African_Caribbean,119,0,0,11294.0,Unknown,67185039,9111392.0,2.0,15,426,15,3,1,1,152,1,0.4638793331569198,0.4288770053475935,0.5147058823529411,0.0108969908469139,0.0,0.0,0.0020005001250312,0.0197549387346836,0.0505924720131114,0.1428571428571428,0.2558139534883721,0.4166666666666665,182,11,5,19,0,6741,9,89,216,400000,4166.666666666667,4000000.0,1000000.0,300000.0,300000.0,7,2400000,-0.1111111111111111,-0.42857142857142855
256178,Joe,Gomez,2024,31,England,London,England,23-05-97,Centre-Back,Defender,Right,188.0,30-06-27,Wasserman,https://img.a.transfermarkt.technology/portrait/header/256178-1595946530.jpg?lm=1,GB1,Liverpool Football Club,28000000.0,42000000.0,27,151,164,4,8,11,3,15,5,15,2,16,15,14,4,15,14,14,15,14,15,13,7,14,13,6,9,9,15,14,14,16,15,14,14,15,16,15,15,12,9,14,12,13,4,2,1,2,1,3,2,3,4,1,1,14,14,6,14,13,15,11,14,1,15,20,17,1,13,12,1,1,1,1,1,1,1,87,8,20,39460388,7550,7200,6000,Mixed_Race,152,11,0,110192.0,Unknown,29115800,4900000.0,1.0,32,858,33,1,1,4,129,2,0.702963747023022,0.6363636363636364,0.7573529411764706,0.1063946072206928,0.0723684210526315,0.0,0.1397849462365591,0.2098024506126531,0.0271951998666629,0.0,0.581395348837209,0.375,0,0,0,0,0,0,13,262,232,28000000,931666.6666666666,42000000.0,8500000.0,3500000.0,18000000.0,1,2000000,0.0,0.2727272727272727
256267,Vedat,Muriqi,2024,237,Yugoslavia (Republic),Prizren,Kosovo,24-04-94,Centre-Forward,Attack,Left,194.0,30-06-27,FutureBall,https://img.a.transfermarkt.technology/portrait/header/256267-1627914833.jpg?lm=1,ES1,Real Club Deportivo Mallorca S.A.D.,12000000.0,17000000.0,30,131,142,4,9,10,12,11,3,17,12,3,9,12,15,7,11,16,15,17,12,15,13,12,17,12,8,15,9,19,19,10,10,16,17,15,11,13,18,13,7,13,7,5,3,3,3,3,1,3,3,2,2,3,1,14,15,5,17,17,15,13,15,1,1,1,1,1,1,1,1,1,1,1,5,1,20,92,20,11,13910065,6550,7150,5500,Northern_European,129,42,20,76922.0,Unknown,11022221,7134000.0,5.0,110,1188,59,0,0,7,166,3,0.696348240275205,0.5828877005347594,0.588235294117647,0.0742685207805663,0.2763157894736842,0.2631578947368421,0.0597649412353088,0.0847711927981995,0.0396066557404372,0.5714285714285714,0.7209302325581395,0.5,0,0,0,0,0,0,7,34,65,8000000,240151.51515151514,17000000.0,5000000.0,,450000.0,7,12325000,-0.3333333333333333,-0.4666666666666667
256339,Emil,Audero,2024,1047,Indonesia,Mataram,Italy,18-01-97,Goalkeeper,Goalkeeper,Right,192.0,30-06-28,TMP SOCCER srl ,https://img.a.transfermarkt.technology/portrait/header/256339-1663679682.jpg?lm=1,IT1,Calcio Como,5000000.0,15000000.0,27,129,138,3,1,2,2,6,5,6,2,1,1,10,2,1,6,12,13,13,12,11,9,13,15,10,15,1,13,15,13,12,13,13,15,18,12,12,13,12,4,15,3,10,10,12,12,4,10,13,16,16,10,10,16,10,12,4,13,11,15,12,12,20,1,1,1,1,1,1,1,1,1,1,1,1,1,83,10,20,2641827,6450,6500,5250,10,128,0,0,28461.0,Unknown,43152255,13000000.0,2.0,47,927,54,2,1,0,47,5,0.6103466525535857,0.5561497326203209,0.5808823529411764,0.027473742452494,0.0,0.0,0.0247561890472618,0.0747686921730432,0.0721964499013861,0.1428571428571428,0.6744186046511627,0.375,0,0,0,0,0,0,2,17,114,5000000,188461.53846153847,15000000.0,5000000.0,200000.0,1300000.0,4,2800000,0.0,-0.16666666666666666
256429,Sergi,Guardiola,2024,367,Spain,Manacor,Spain,29-05-91,Centre-Forward,Attack,Left,185.0,30-06-25,JV SPORTS ,https://img.a.transfermarkt.technology/portrait/header/256429-1521447903.jpg?lm=1,ES1,Rayo Vallecano de Madrid S.A.D.,800000.0,7500000.0,33,131,139,7,12,13,14,12,9,14,12,7,3,13,12,4,13,11,13,13,14,13,12,13,16,11,12,15,10,12,14,12,12,11,14,15,14,12,14,15,9,17,8,13,3,2,2,1,4,3,2,2,1,2,3,14,13,10,12,13,14,13,12,1,1,1,1,1,1,1,12,1,12,17,17,15,20,76,20,8,2685172,6550,6550,4550,Mediterranean_Hispanic,128,0,0,5345.0,Unknown,67138759,2000000.0,2.0,89,904,89,0,0,3,163,3,0.6169621593014025,0.481283422459893,0.5808823529411764,0.0051525337314251,0.0,0.0,0.0037509377344336,0.0372593148287071,0.0110836412122558,0.1428571428571428,0.5116279069767438,0.625,386,90,20,52,1,3506,0,0,0,600000,10000.0,7500000.0,2500000.0,,,9,8950000,-0.25,-0.4
256448,Gianluca,Mancini,2024,12,Italy,Pontedera,Italy,17-04-96,Centre-Back,Defender,Right,190.0,30-06-27,GR Sports,https://img.a.transfermarkt.technology/portrait/header/256448-1663581060.jpg?lm=1,IT1,Associazione Sportiva Roma,25000000.0,30000000.0,28,144,150,5,9,10,11,12,5,16,6,9,14,14,6,15,12,19,14,13,15,16,10,12,18,8,12,12,14,18,16,12,12,12,16,16,13,16,14,14,18,10,8,12,3,1,2,1,2,2,1,2,1,1,1,6,13,17,12,12,16,3,2,1,1,20,8,1,1,12,1,1,1,1,1,1,1,82,11,20,18715437,7199,7199,6199,Mediterranean_Hispanic,143,9,0,71154.0,Unknown,43093502,8683333.333,3.0,52,1165,54,1,1,3,29,2,0.7028314368880656,0.6576470588235294,0.6911764705882353,0.0686988403902252,0.0592105263157894,0.0,0.1247811952988247,0.1497874468617154,0.0482143022472846,0.2857142857142857,0.6279069767441858,0.4166666666666665,0,0,0,0,0,0,10,17,15,18000000,689423.0769230769,30000000.0,7000000.0,75000.0,200000.0,3,6000000,-0.28,-0.1
256453,Unknown,Bressan,2024,653,Brazil,Caxias do Sul,Brazil,15-01-93,Centre-Back,Defender,Right,185.0,30-06-25,Unknown,https://img.a.transfermarkt.technology/portrait/header/256453-1727961863.jpg?lm=1,GR1,Omilos Filathlon Irakliou FC,400000.0,2500000.0,31,120,130,6,7,8,8,11,10,15,7,8,14,10,11,13,10,12,13,12,12,11,7,8,12,5,13,11,14,13,13,13,12,14,13,14,13,13,14,13,14,12,6,10,1,1,4,1,1,3,1,1,3,3,2,7,11,9,10,9,9,9,11,1,8,20,14,1,10,13,1,8,1,1,1,1,1,79,12,20,664373,6031,6031,3765,Northern_European,121,0,0,5237.0,Unknown,19124865,265000.0,1.0,10,337,11,1,1,7,145,2,0.5482931992590633,0.3973262032085561,0.5294117647058822,0.0050482470666961,0.0,0.0,0.0017504376094023,0.0122530632658164,0.0014444845690158,0.0,0.5116279069767438,0.5416666666666665,324,9,5,79,3,9457,10,36,121,350000,3846.153846153846,2500000.0,500000.0,,750000.0,8,1200000,-0.125,-0.36363636363636365
257062,Álvaro,García,2024,367,Spain,Utrera,Spain,27-10-92,Left Winger,Attack,Left,167.0,30-06-26,YOU FIRST,https://img.a.transfermarkt.technology/portrait/header/257062-1709114307.jpg?lm=1,ES1,Rayo Vallecano de Madrid S.A.D.,3000000.0,6000000.0,32,141,142,9,11,13,11,12,8,6,10,5,7,11,9,7,13,10,13,12,10,11,11,11,11,12,8,14,8,12,13,18,14,11,5,14,17,12,8,12,6,13,10,11,2,1,2,3,1,3,2,3,3,2,1,19,8,4,10,12,14,9,10,1,9,1,4,10,7,1,19,1,14,20,15,17,16,58,20,9,9012919,7048,7048,5548,Mediterranean_Hispanic,125,0,0,21126.0,Unknown,67184140,4500000.0,1.0,89,1552,89,0,0,3,163,7,0.6828526065096586,0.5880213903743315,0.5588235294117647,0.0203909398063164,0.0,0.0,0.0147536884221055,0.0297574393598399,0.0249729159143309,0.0,0.0930232558139532,0.5833333333333333,458,70,48,60,0,2693,2,16,84,2500000,73333.33333333333,6000000.0,1000000.0,,300000.0,4,300000,-0.16666666666666666,-0.5
257376,Domingos,Duarte,2024,3709,Portugal,Cascais,Portugal,10-03-95,Centre-Back,Defender,Right,192.0,30-06-26,ROOF,https://img.a.transfermarkt.technology/portrait/header/257376-1583309064.jpg?lm=1,ES1,Getafe Club de FÃºtbol S.A.D. Team Dubai,2000000.0,12000000.0,29,138,153,4,6,9,9,11,6,14,6,9,15,11,11,14,11,13,13,14,13,15,8,13,14,7,13,8,15,15,14,12,12,14,15,16,13,15,15,13,13,12,10,3,1,2,1,4,3,3,1,3,2,2,3,14,13,5,14,11,15,15,15,1,1,20,1,1,1,1,1,1,1,1,1,1,1,84,8,20,8620126,6900,6900,4750,Mediterranean_Hispanic,137,3,0,18130.0,Unknown,55063355,2120000.0,2.0,76,324,79,1,1,3,105,2,0.6632707065361206,0.5026737967914437,0.6470588235294117,0.0174979504773528,0.0197368421052631,0.0,0.0097524381095273,0.0597649412353088,0.0117503263979554,0.1428571428571428,0.6744186046511627,0.4583333333333332,328,14,3,73,4,5096,1,1,4,800000,27884.615384615383,12000000.0,3000000.0,,75000.0,5,1450000,-0.6,-0.7333333333333333
257448,Gelson,Martins,2024,683,Cape Verde,Praia,Portugal,11-05-95,Right Winger,Attack,Right,173.0,30-06-26,Universal Twenty Two,https://img.a.transfermarkt.technology/portrait/header/257448-1728418178.png?lm=1,GR1,Olympiakos Syndesmos Filathlon Peiraios,2500000.0,35000000.0,29,126,145,7,10,14,10,15,7,4,10,2,5,13,12,5,15,10,13,10,12,10,12,10,15,16,6,14,7,9,10,15,16,12,7,14,15,13,9,8,7,14,6,14,3,1,3,1,2,3,3,1,1,1,1,16,16,6,15,14,12,14,13,1,1,1,10,1,10,1,12,1,18,15,13,20,12,74,11,20,1682127,6293,6293,5493,African_Caribbean,121,21,0,69041.0,Unknown,55063369,18333333.33,3.0,17,1181,79,0,1,1,141,10,0.5829584546176237,0.582139037433155,0.5294117647058822,0.0666584911071477,0.1381578947368421,0.0,0.0122530632658164,0.1747936984246061,0.1018269025806272,0.2857142857142857,0.2325581395348837,0.4583333333333332,363,58,64,36,1,6535,19,50,65,3000000,81481.48148148147,35000000.0,10000000.0,,5000000.0,3,13000000,0.2,0.2
257455,João,Palhinha,2024,27,Portugal,Lisboa,Portugal,09-07-95,Defensive Midfield,Midfield,Right,190.0,30-06-28,GonÃ§alo Palhinha,https://img.a.transfermarkt.technology/portrait/header/257455-1684773447.jpg?lm=1,L1,FC Bayern MÃ¼nchen,50000000.0,60000000.0,29,152,160,5,12,11,10,13,4,15,14,10,15,14,10,17,13,17,16,17,14,17,13,14,15,6,13,11,17,16,14,11,10,15,16,17,12,14,16,18,16,11,5,13,3,1,2,2,1,2,3,1,3,1,2,16,12,5,16,14,19,15,12,1,1,14,1,1,1,20,1,17,1,1,1,1,1,84,12,20,55536838,7500,7500,6000,Northern_European,152,14,2,69595.0,Unknown,55070285,25312333.33,3.0,76,843,79,3,1,7,68,4,0.7426567875099233,0.6363636363636364,0.7573529411764706,0.0671934430725168,0.0921052631578947,0.0263157894736842,0.2498124531132783,0.2998249562390597,0.1406002018389399,0.2857142857142857,0.6279069767441858,0.4583333333333332,333,23,5,91,0,6998,6,26,73,40000000,1425892.857142857,60000000.0,10000000.0,,500000.0,6,13375000,-0.2727272727272727,-0.3333333333333333
257462,Luka,Jovi?,2024,5,Yugoslavia (Republic),Loznica,Serbia,23-12-97,Centre-Forward,Attack,Right,182.0,30-06-25,LIAN Sports Group,https://img.a.transfermarkt.technology/portrait/header/257462-1657519856.jpg?lm=1,IT1,Associazione Calcio Milan,7000000.0,60000000.0,27,140,155,7,11,12,14,14,8,15,10,4,5,12,11,5,13,7,16,13,14,9,12,10,14,13,7,16,6,10,7,13,14,17,12,11,15,11,14,11,6,17,9,7,3,4,2,2,1,2,1,2,1,3,2,11,9,12,7,16,10,10,15,1,1,1,1,1,1,1,10,1,10,10,12,10,20,79,17,20,10668922,7000,7000,6750,Northern_European,139,26,9,30877.0,Unknown,62113639,18888000.0,5.0,110,867,85,0,1,7,27,3,0.6765017200317545,0.7165775401069518,0.6617647058823528,0.0298066737671722,0.1710526315789473,0.1184210526315789,0.0347586896724181,0.2998249562390597,0.1049084696797133,0.5714285714285714,0.4418604651162785,0.375,299,82,26,21,1,9259,26,76,57,4000000,104838.70967741935,60000000.0,20000000.0,3000000.0,40000000.0,7,25250000,-0.42857142857142855,-0.2
257474,Vanja,Milinkovi?-Savi?,2024,416,Unknown,Unknown,Serbia,20-02-97,Goalkeeper,Goalkeeper,Right,202.0,30-06-26,DOO Magnum,https://img.a.transfermarkt.technology/portrait/header/257474-1630509279.jpg?lm=1,IT1,Torino Calcio,5000000.0,6000000.0,27,130,139,14,1,1,2,10,16,9,14,2,2,9,2,1,8,11,11,13,10,13,9,13,16,8,14,7,12,11,11,12,13,11,17,11,10,13,12,12,8,12,10,10,15,14,14,15,13,16,13,12,12,11,12,10,13,11,11,12,12,13,13,20,1,1,1,1,1,1,1,1,1,1,1,1,1,92,9,20,3143521,6500,6700,4000,Northern_European,130,4,0,14230.0,Unknown,62142830,2175000.0,2.0,105,1549,85,2,1,7,201,5,0.6368086795448531,0.4224598930481283,0.5955882352941175,0.0137320431399169,0.0263157894736842,0.0,0.0247561890472618,0.0297574393598399,0.0120558904414011,0.1428571428571428,0.9069767441860468,0.375,0,0,0,0,0,0,12,19,16,8000000,268518.51851851854,8000000.0,2000000.0,750000.0,2000000.0,6,2075000,0.6,0.6
257668,Wilmar,Barrios,2024,964,Colombia,Cartagena de Indias,Colombia,16-10-93,Defensive Midfield,Midfield,Right,178.0,30-06-27,POSSOFUTBOL ,https://img.a.transfermarkt.technology/portrait/header/257668-1721723531.png?lm=1,RU1,AO FK Zenit Sankt-Peterburg,12000000.0,20000000.0,31,144,146,10,10,11,6,12,6,9,11,6,18,13,6,15,11,15,17,18,15,18,8,13,14,9,11,8,16,18,18,14,14,14,9,16,13,17,10,17,13,10,8,12,2,1,2,2,1,4,1,2,3,1,3,17,12,14,12,14,11,12,10,1,1,13,10,1,1,20,1,15,7,1,1,1,1,74,10,20,16290400,7000,6361,5077,African_Caribbean,143,53,1,49169.0,Unknown,76033272,8800000.0,2.0,20,321,20,3,1,1,7,4,0.5919555437946546,0.5376470588235294,0.6911764705882353,0.0474697447970127,0.3486842105263157,0.0131578947368421,0.0597649412353088,0.0997749437359339,0.0488624684019,0.1428571428571428,0.3488372093023257,0.5416666666666665,423,9,13,93,4,9639,1,4,23,10000000,408695.652173913,20000000.0,4000000.0,,,2,4400000,-0.16666666666666666,-0.2857142857142857
257732,Amir,Rrahmani,2024,6195,Yugoslavia (Republic),PrishtinÃ«,Kosovo,24-02-94,Centre-Back,Defender,Right,192.0,30-06-27,Soccer11,https://img.a.transfermarkt.technology/portrait/header/257732-1663579350.jpg?lm=1,IT1,SocietÃ  Sportiva Calcio Napoli,15000000.0,25000000.0,30,149,153,5,9,8,10,11,6,16,8,11,15,12,7,15,10,15,15,15,13,14,10,14,15,4,11,10,14,15,16,12,11,15,16,14,12,16,16,14,12,13,8,12,3,2,3,3,1,3,1,2,2,2,3,12,14,6,13,12,15,10,12,1,14,20,13,1,1,1,1,1,1,1,1,1,1,83,13,20,26788546,7443,6615,6181,Northern_European,149,48,6,44423.0,Unknown,11023165,6440000.0,3.0,110,1187,59,1,1,7,184,2,0.6255623180735644,0.6557219251336898,0.7352941176470587,0.042886925252533,0.3157894736842105,0.0789473684210526,0.0747686921730432,0.1247811952988247,0.0357509930831411,0.2857142857142857,0.6744186046511627,0.5,394,21,10,52,0,5486,13,42,72,12000000,397500.0,25000000.0,5000000.0,,425000.0,5,3850000,-0.2,-0.4
257814,Gregor,Kobel,2024,16,Switzerland,ZÃ¼rich,Switzerland,06-12-97,Goalkeeper,Goalkeeper,Right,196.0,30-06-28,SBE Management AG,https://img.a.transfermarkt.technology/portrait/header/257814-1709559904.jpg?lm=1,L1,Borussia Dortmund,40000000.0,40000000.0,27,145,155,4,1,1,1,12,6,7,1,2,2,13,6,2,11,13,15,15,17,12,12,11,17,1,14,1,14,14,11,11,14,14,16,13,10,10,12,14,4,15,4,11,16,14,15,14,13,13,16,16,15,10,14,12,17,4,10,14,17,13,16,20,1,1,1,1,1,1,1,1,1,1,1,1,1,88,7,20,44042647,7250,6650,5250,Northern_European,145,3,0,38355.0,Unknown,98040383,7446000.0,3.0,92,1711,92,2,1,7,41,5,0.6301931727970362,0.5561497326203209,0.7058823529411764,0.0370275596823891,0.0197368421052631,0.0,0.1997999499874969,0.1997999499874969,0.0413400372232561,0.2857142857142857,0.7674418604651163,0.375,0,0,0,0,0,0,22,44,33,40000000,1599000.0,40000000.0,1000000.0,100000.0,1000000.0,4,7575000,0.0,0.0
257851,Rúben,Vezo,2024,7160,Portugal,SetÃºbal,Portugal,25-04-94,Centre-Back,Defender,Right,182.0,30-06-25,Gestifute,https://img.a.transfermarkt.technology/portrait/header/257851-1720641452.png?lm=1,TR1,EyÃ¼p Spor KulÃ¼bÃ¼,1500000.0,10000000.0,30,135,140,6,8,10,6,12,7,14,7,12,13,12,10,15,12,12,14,13,13,11,11,12,13,6,12,10,14,12,15,14,14,12,14,12,14,14,13,13,8,12,8,12,1,1,1,3,1,3,3,3,2,3,3,11,12,5,14,13,16,13,14,1,7,20,14,1,1,10,1,1,1,1,1,1,1,80,10,20,8752856,6734,6384,5884,Mediterranean_Hispanic,134,0,0,17903.0,Unknown,55067158,3525000.0,2.0,76,1363,79,1,1,3,66,2,0.5949986768986505,0.6239572192513368,0.625,0.0172787553579688,0.0,0.0,0.0072518129532383,0.0497624406101525,0.0195560987805216,0.1428571428571428,0.4418604651162785,0.5,302,7,11,51,3,6058,7,41,62,1500000,25806.451612903227,10000000.0,2000000.0,,2500000.0,6,3700000,0.0,-0.16666666666666666
258004,Rúben,Dias,2024,281,Portugal,Amadora,Portugal,14-05-97,Centre-Back,Defender,Right,187.0,30-06-27,Gestifute,https://img.a.transfermarkt.technology/portrait/header/258004-1684921271.jpg?lm=1,GB1,Manchester City Football Club,80000000.0,80000000.0,27,174,177,4,11,12,6,13,5,15,4,5,17,14,8,18,13,16,17,18,15,16,13,15,18,8,17,8,17,16,17,13,13,12,16,18,13,18,16,18,13,15,4,8,1,3,2,3,1,1,3,1,3,2,2,18,18,8,16,16,18,14,16,1,1,20,1,1,1,1,1,1,1,1,1,1,1,83,12,20,347975206,8700,8500,8500,Mediterranean_Hispanic,172,37,2,202986.0,Unknown,55070299,71600000.0,1.0,76,57,79,1,1,3,131,2,0.8749669224662608,0.9037433155080212,0.9044117647058822,0.1959980958027514,0.2434210526315789,0.0263157894736842,0.3998499624906226,0.3998499624906226,0.3977610489180254,0.0,0.5581395348837206,0.375,407,16,13,77,2,10350,8,43,40,75000000,2883653.846153846,80000000.0,7500000.0,350000.0,14000000.0,2,15000000,-0.0625,-0.0625
258005,João,Carvalho,2024,1465,Portugal,Castanheira De PÃªra,Portugal,09-03-97,Attacking Midfield,Midfield,Right,172.0,30-06-27,SEG,https://img.a.transfermarkt.technology/portrait/header/258005-1541149759.JPG?lm=1,PO1,Grupo Desportivo Estoril Praia,1200000.0,10000000.0,27,121,130,13,13,15,10,15,13,6,12,5,5,15,11,5,16,8,13,8,13,8,15,12,8,15,6,12,6,13,10,12,13,14,6,12,12,11,8,9,8,12,5,11,3,3,1,2,2,2,2,4,2,1,1,8,9,7,15,8,14,10,11,1,1,1,1,1,1,1,10,14,7,16,20,10,7,64,13,20,2450248,6050,6350,4050,Mediterranean_Hispanic,119,0,0,19999.0,Grupo Desportivo Estoril Praia - SAD,55070295,15000000.0,1.0,76,326,79,3,1,3,109,0,0.590500132310135,0.427807486631016,0.5147058823529411,0.0193026891475241,0.0,0.0,0.0057514378594648,0.0497624406101525,0.0833078696630462,0.0,0.2093023255813952,0.375,332,37,37,34,2,7298,1,3,25,1000000,23809.52380952381,10000000.0,3000000.0,500000.0,2500000.0,9,10350000,-0.16666666666666666,-0.3333333333333333
258027,Renato,Sanches,2024,294,Portugal,Lisboa,Portugal,18-08-97,Central Midfield,Midfield,Right,176.0,30-06-25,Gestifute,https://img.a.transfermarkt.technology/portrait/header/258027-1725535661.jpg?lm=1,PO1,Sport Lisboa e Benfica,6500000.0,30000000.0,27,145,156,9,12,15,10,14,9,9,15,10,10,14,11,11,16,17,11,16,14,12,13,11,18,13,8,12,9,10,18,15,15,18,10,17,13,16,14,12,13,15,4,13,1,3,3,2,2,1,2,1,1,2,3,6,15,13,13,9,11,10,10,1,1,1,1,1,1,18,13,20,13,11,15,15,1,76,10,20,18839539,7250,7300,6000,African_Caribbean,140,32,3,77534.0,Unknown,55070298,23333333.33,3.0,76,843,79,3,1,1,188,1,0.7161947605186557,0.6363636363636364,0.6691176470588234,0.074859478547364,0.2105263157894736,0.0394736842105263,0.032258064516129,0.1497874468617154,0.1296054519847773,0.2857142857142857,0.3023255813953489,0.375,286,18,20,47,2,8854,30,158,110,5000000,155555.55555555556,30000000.0,8000000.0,30000000.0,20000000.0,8,24700000,-0.23076923076923078,-0.5
258039,Aurélio,Buta,2024,1421,Angola,Miconge,Portugal,10-02-97,Right-Back,Defender,Right,172.0,30-06-25,Proeleven S.A.,https://img.a.transfermarkt.technology/portrait/header/258039-1725288770.png?lm=1,FR1,Stade de Reims,5000000.0,8000000.0,27,121,128,5,11,12,6,12,5,5,6,10,11,11,8,11,13,12,13,13,11,11,10,11,13,14,9,16,11,12,13,15,15,11,7,14,15,14,10,13,7,12,18,10,2,2,2,3,2,4,1,3,2,1,1,15,13,6,15,13,14,13,12,1,10,1,20,7,18,1,7,1,14,7,1,10,1,66,9,20,1164799,6100,6100,4250,African_Caribbean,112,0,0,8500.0,Unknown,55070291,9111392.0,2.0,3,950,79,1,1,1,197,11,0.5574225985710506,0.4491978609625668,0.463235294117647,0.0081990562056842,0.0,0.0,0.0247561890472618,0.0397599399849962,0.0505924720131114,0.1428571428571428,0.2093023255813952,0.375,263,8,34,50,1,6202,9,84,202,5000000,210869.5652173913,8000000.0,2000000.0,,600000.0,3,250000,0.0,-0.375
258878,Tosin,Adarabioyo,2024,631,England,London,England,24-09-97,Centre-Back,Defender,Right,196.0,30-06-28,WNRS,https://img.a.transfermarkt.technology/portrait/header/258878-1646903871.jpg?lm=1,GB1,Chelsea Football Club,20000000.0,20000000.0,27,136,155,8,8,11,9,13,6,13,9,11,14,14,11,14,13,9,12,11,14,12,14,11,14,14,10,8,13,12,13,15,13,14,16,15,15,14,13,12,6,10,12,12,2,1,2,2,3,1,4,3,3,3,2,13,17,12,7,13,14,14,15,1,1,20,12,1,1,11,1,1,1,1,1,1,1,80,11,20,24463146,6800,6800,4750,African_Caribbean,135,0,0,46397.0,Unknown,28100239,1650000.0,1.0,32,858,33,1,1,1,50,2,0.6500396930404869,0.5026737967914437,0.6323529411764706,0.0447930537356352,0.0,0.0,0.0997749437359339,0.0997749437359339,0.0091391427539653,0.0,0.7674418604651163,0.375,306,13,5,24,1,6955,4,22,88,20000000,897727.2727272727,20000000.0,4000000.0,,1000000.0,4,1000000,0.0,0.6666666666666666
258889,Dominic,Solanke,2024,148,England,Basingstoke,England,14-09-97,Centre-Forward,Attack,Right,186.0,30-06-30,Unknown,https://img.a.transfermarkt.technology/portrait/header/258889-1708340487.jpg?lm=1,GB1,Tottenham Hotspur Football Club,45000000.0,45000000.0,27,135,150,5,10,12,14,14,8,12,10,7,7,11,12,8,15,13,13,13,13,11,11,12,12,12,5,15,9,14,17,14,12,13,14,17,14,13,14,13,8,12,8,7,2,2,1,1,3,2,3,2,2,1,2,12,15,6,10,11,12,12,12,1,1,1,1,1,1,1,1,1,1,1,12,1,20,74,12,20,34828546,6750,6750,5300,African_Caribbean,134,1,0,52196.0,Unknown,29125191,42750000.0,2.0,32,153,33,0,1,1,202,3,0.6434241862926701,0.5614973262032085,0.625,0.0503926682612226,0.006578947368421,0.0,0.2248062015503876,0.2248062015503876,0.2374788188560793,0.1428571428571428,0.5348837209302322,0.375,350,134,41,23,0,5568,10,61,66,45000000,1790000.0,45000000.0,3000000.0,2000000.0,10000000.0,4,14650000,0.125,0.8
258916,Kieran,Dowell,2024,124,England,Ormskirk,England,10-10-97,Attacking Midfield,Midfield,Left,183.0,31-05-26,Unknown,https://img.a.transfermarkt.technology/portrait/header/258916-1520418638.jpg?lm=1,SC1,Rangers Football Club,1500000.0,3000000.0,27,122,145,13,14,15,11,14,14,8,14,5,7,15,12,7,16,7,14,9,15,13,15,12,13,14,8,14,6,13,10,10,14,15,11,12,10,13,9,8,6,14,10,13,1,1,2,3,1,1,2,2,2,3,3,14,14,6,11,12,14,12,12,1,1,1,1,1,1,1,10,15,14,18,20,19,1,67,20,9,4120355,6096,6096,4496,Northern_European,122,0,0,28998.0,Unknown,28098206,2200000.0,1.0,32,1093,33,3,0,7,161,0,0.5568933580312252,0.4755080213903743,0.536764705882353,0.0279922789243409,0.0,0.0,0.0072518129532383,0.0147536884221055,0.0121947831884219,0.0,0.4651162790697669,0.375,257,48,26,25,0,8038,3,44,92,1000000,41666.666666666664,3000000.0,500000.0,,3000000.0,5,750000,-0.3333333333333333,-0.5
258919,Dean,Henderson,2024,873,England,Whitehaven,England,12-03-97,Goalkeeper,Goalkeeper,Right,188.0,30-06-28,CAA Stellar,https://img.a.transfermarkt.technology/portrait/header/258919-1716297478.jpg?lm=1,GB1,Crystal Palace Football Club,12000000.0,22000000.0,27,140,160,3,3,3,1,11,6,5,3,2,1,12,1,3,10,15,14,14,11,12,8,13,14,13,12,13,12,13,8,13,15,12,14,15,11,12,12,14,7,13,5,12,13,14,15,13,13,14,15,15,10,14,13,12,17,12,15,12,14,14,11,20,1,1,1,1,1,1,1,1,1,1,1,1,1,85,8,20,24881967,7089,7089,5989,Northern_European,139,1,0,139190.0,Nottingham Forest,29125334,17500000.0,1.0,32,1661,33,2,1,7,58,5,0.6882773220428685,0.635187165775401,0.6617647058823528,0.1343955767004278,0.006578947368421,0.0,0.0597649412353088,0.1097774443610902,0.0971971443651212,0.0,0.581395348837209,0.375,0,0,0,0,0,0,5,39,168,15000000,745000.0,22000000.0,6000000.0,,250000.0,6,14900000,0.25,0.25
258923,Marcus,Rashford,2024,985,England,Manchester,England,31-10-97,Left Winger,Attack,Right,185.0,30-06-28,Unknown,https://img.a.transfermarkt.technology/portrait/header/258923-1674473054.jpg?lm=1,GB1,Manchester United Football Club,60000000.0,85000000.0,27,151,173,6,13,15,14,14,13,6,12,3,2,14,16,3,15,14,12,12,12,12,13,11,16,18,10,15,4,13,10,18,16,15,8,17,17,14,13,11,6,18,6,10,2,2,2,2,3,2,1,1,2,3,1,16,16,4,16,15,17,12,18,1,1,1,1,1,1,1,14,1,11,20,14,14,17,70,8,20,78771918,7750,7850,7000,African_Caribbean,144,46,12,260981.0,Unknown,28100266,9111392.0,2.0,32,905,33,0,1,1,132,7,0.7889653347446415,0.7433155080213903,0.6985294117647058,0.2519990691449555,0.3026315789473684,0.1578947368421052,0.2998249562390597,0.4248562140535133,0.0505924720131114,0.1428571428571428,0.5116279069767438,0.375,442,143,63,37,2,11619,13,52,142,55000000,1793103.448275862,85000000.0,16000000.0,10000000.0,65000000.0,0,0,-0.08333333333333333,-0.21428571428571427
258987,Carl,Starfelt,2024,940,Sweden,Stockholm,Sweden,01-06-95,Centre-Back,Defender,Right,187.0,30-06-27,BHM Sports Agency,https://img.a.transfermarkt.technology/portrait/header/258987-1600613124.png?lm=1,ES1,Real Club Celta de Vigo S. A. D.,6000000.0,6500000.0,29,128,135,7,10,12,5,10,7,15,6,8,12,14,6,12,12,12,16,17,11,11,12,13,12,6,10,8,13,15,14,12,12,12,12,13,14,14,13,14,6,11,5,6,2,3,3,3,2,3,2,3,1,3,2,17,13,4,8,13,13,14,14,1,1,20,1,1,1,1,1,1,1,1,1,1,1,80,12,20,6510964,6400,6100,3256,Northern_European,127,5,0,19719.0,Unknown,93055760,3833333.333,3.0,91,1426,91,1,1,7,165,2,0.5574225985710506,0.3428877005347593,0.5735294117647058,0.0190323163130415,0.0328947368421052,0.0,0.0297574393598399,0.032258064516129,0.021269109325259,0.2857142857142857,0.5581395348837206,0.4583333333333332,0,0,0,0,0,0,5,41,62,6000000,227884.61538461538,6500000.0,1500000.0,,100000.0,4,3050000,0.0,0.2
259025,Umut,Bozok,2024,449,France,Saint-Avold,TÃ¼rkiye,19-09-96,Centre-Forward,Attack,Right,178.0,30-06-25,InsideSport,https://img.a.transfermarkt.technology/portrait/header/259025-1723802633.jpg?lm=1,TR1,Trabzonspor KulÃ¼bÃ¼,1800000.0,6000000.0,28,120,135,5,10,12,13,12,10,12,10,5,6,12,15,6,13,12,14,13,13,13,13,14,14,13,7,14,9,13,13,12,13,13,9,14,12,12,11,12,14,13,6,10,3,3,3,3,2,3,1,3,2,1,2,13,14,6,12,10,14,8,14,1,1,1,1,1,1,1,1,1,1,13,13,13,20,70,12,20,3130365,6100,6000,4100,Mediterranean_Hispanic,119,0,0,46529.0,Unknown,85138169,1216666.667,3.0,34,1269,100,0,1,3,204,3,0.5441915850754168,0.4331550802139037,0.5147058823529411,0.0449205152147484,0.0,0.0,0.0087521880470117,0.0297574393598399,0.0067316684741242,0.2857142857142857,0.3488372093023257,0.4166666666666665,243,87,23,30,0,3459,5,17,35,1400000,39130.434782608696,6000000.0,2000000.0,,500000.0,5,5600000,-0.2222222222222222,-0.4166666666666667
259881,Damian,Szymanski,2024,2441,Poland,Kra?nik,Poland,16-06-95,Defensive Midfield,Midfield,Right,185.0,30-06-27,Unknown,https://img.a.transfermarkt.technology/portrait/header/259881-1728415516.png?lm=1,GR1,Athlitiki Enosi Konstantinoupoleos,3500000.0,3500000.0,29,120,130,7,12,10,10,11,9,12,11,8,13,12,10,13,11,14,12,15,11,12,12,10,14,9,12,12,13,14,15,12,12,14,11,16,12,15,13,13,12,14,7,9,3,3,3,3,4,2,1,1,1,3,2,12,13,5,13,11,15,12,12,1,1,1,1,1,1,19,1,20,1,1,10,1,1,76,12,20,2116123,6000,5500,2750,Northern_European,119,8,1,11827.0,Unknown,96067434,941666.6667,3.0,75,754,78,3,1,7,34,4,0.4780365175972479,0.2887700534759358,0.5147058823529411,0.0114116648496968,0.0526315789473684,0.0131578947368421,0.0172543135783946,0.0172543135783946,0.0052038482552293,0.2857142857142857,0.5116279069767438,0.4583333333333332,324,24,25,72,0,10140,4,51,160,3500000,143750.0,3500000.0,500000.0,75000.0,150000.0,4,800000,0.0,0.0
260053,Jiri,Pavlenka,2024,1091,CSSR,Hlu?Ã­n,Czech Republic,14-04-92,Goalkeeper,Goalkeeper,Right,196.0,30-06-25,SPORT INVEST,https://img.a.transfermarkt.technology/portrait/header/260053-1727966969.png?lm=1,GR1,Panthessalonikios Athlitikos Omilos Konstantinoupoliton,1500000.0,12000000.0,32,132,160,5,2,1,2,8,8,9,3,1,2,9,2,3,8,8,12,15,11,14,7,11,13,1,10,2,8,12,10,12,16,15,15,14,10,10,16,15,6,16,5,14,14,14,12,6,12,9,17,17,13,13,10,14,18,5,12,14,17,15,17,20,1,1,1,1,1,1,1,1,1,1,1,1,1,85,7,20,4423499,6591,6991,5741,Northern_European,130,14,0,42281.0,Unknown,25039108,1700000.0,2.0,14,629,28,2,1,7,153,5,0.6753109288171474,0.6086631016042781,0.5955882352941175,0.0408185730687413,0.0921052631578947,0.0,0.0072518129532383,0.0597649412353088,0.0094169282480068,0.1428571428571428,0.7674418604651163,0.5833333333333333,0,0,0,0,0,0,11,31,82,1200000,31666.666666666668,12000000.0,3000000.0,,,3,1800000,-0.2,-0.4
260827,Joachim,Andersen,2024,931,Denmark,Frederiksberg,Denmark,31-05-96,Centre-Back,Defender,Right,192.0,30-06-29,SEG,https://img.a.transfermarkt.technology/portrait/header/260827-1668183482.jpg?lm=1,GB1,Fulham Football Club,35000000.0,35000000.0,28,142,151,8,9,9,6,13,11,13,8,5,15,15,9,14,14,12,15,13,15,13,13,13,15,11,13,11,14,14,12,13,11,13,17,14,12,13,14,13,12,12,7,8,1,3,3,3,2,3,1,2,2,3,3,11,15,3,12,14,16,13,14,1,1,20,1,1,1,10,1,1,1,1,1,1,1,85,11,20,29396945,7100,7100,5900,Northern_European,141,17,0,86994.0,Unknown,27069975,14684000.0,5.0,28,509,30,1,1,7,95,2,0.6897327335273882,0.6256684491978609,0.6764705882352942,0.0839942178838111,0.1118421052631578,0.0,0.1747936984246061,0.1747936984246061,0.0815522653407039,0.5714285714285714,0.6744186046511627,0.4166666666666665,338,12,9,54,3,4539,7,27,33,32000000,1098275.8620689656,35000000.0,4000000.0,200000.0,900000.0,6,7050000,-0.08571428571428572,-0.08571428571428572
260841,Daniel,Iversen,2024,1003,Denmark,GÃ¸rding,Denmark,19-07-97,Goalkeeper,Goalkeeper,Right,191.0,30-06-25,First Touch,https://img.a.transfermarkt.technology/portrait/header/260841-1683029575.jpg?lm=1,GB1,Leicester City Football Club,3000000.0,5000000.0,27,124,150,6,3,3,1,10,8,2,2,3,3,10,3,2,9,9,11,12,10,11,9,12,14,1,12,3,13,12,11,9,14,10,15,12,9,12,13,14,6,10,3,14,14,14,13,4,13,11,15,15,9,14,11,15,14,2,12,6,20,14,15,20,1,1,1,1,1,1,1,1,1,1,1,1,1,80,8,20,3685842,6200,6000,3753,Northern_European,121,0,0,23198.0,Unknown,27102367,260000.0,1.0,28,584,30,2,1,7,127,5,0.5441915850754168,0.396042780748663,0.5294117647058822,0.0223916987814875,0.0,0.0,0.0147536884221055,0.0247561890472618,0.0014167060196116,0.0,0.6511627906976742,0.375,0,0,0,0,0,0,0,0,0,3000000,196666.66666666666,5000000.0,1000000.0,50000.0,,7,2400000,0.0,-0.25
261504,Aleix,García,2024,15,Spain,Ulldecona,Spain,28-06-97,Central Midfield,Midfield,Right,173.0,30-06-29,MagicPlayers,https://img.a.transfermarkt.technology/portrait/header/261504-1727378020.jpg?lm=1,L1,Bayer 04 Leverkusen FuÃŸball,20000000.0,25000000.0,27,124,142,12,12,13,9,14,13,7,11,2,7,14,10,9,14,10,12,11,14,13,15,14,12,14,11,14,12,14,14,11,12,14,8,14,12,12,10,13,7,12,6,11,2,3,3,3,1,2,3,2,2,3,3,12,11,8,12,13,16,14,13,1,1,1,1,1,1,18,10,20,10,10,14,10,1,68,12,20,1363599,6150,6150,4500,Mediterranean_Hispanic,124,0,0,5408.0,Unknown,67190888,11000000.0,2.0,89,1547,89,3,1,3,36,1,0.5640381053188674,0.4759358288770053,0.5514705882352942,0.0052133676191837,0.0,0.0,0.0997749437359339,0.1247811952988247,0.0610850301397261,0.1428571428571428,0.2325581395348837,0.375,287,20,30,25,1,7111,1,2,15,20000000,950000.0,25000000.0,5000000.0,,1000000.0,6,7400000,-0.2,0.0
261905,Suat,Serdar,2024,276,Germany,Bingen,Germany,11-04-97,Central Midfield,Midfield,Right,184.0,30-06-28,Sports360 GmbH,https://img.a.transfermarkt.technology/portrait/header/261905-1657098674.jpg?lm=1,IT1,Verona Hellas Football Club,5000000.0,25000000.0,27,136,143,7,9,15,11,14,7,10,13,9,11,13,10,12,15,18,12,17,14,11,12,11,13,12,11,14,10,15,16,14,13,13,12,11,14,15,12,9,10,15,7,15,1,3,3,2,2,3,1,2,4,1,2,14,17,8,10,10,13,14,10,1,1,1,1,1,1,18,12,20,12,13,15,13,1,75,10,20,8520252,6642,6642,4892,North_African__Middle_Eastern,132,4,0,28846.0,Unknown,91137136,7833333.333,3.0,38,193,40,3,1,6,214,1,0.6291346917173856,0.5178609625668449,0.6102941176470589,0.0278455050999075,0.0263157894736842,0.0,0.0247561890472618,0.1247811952988247,0.0434919488485791,0.2857142857142857,0.4883720930232553,0.375,327,39,26,55,3,6087,23,81,74,5000000,190384.61538461538,25000000.0,5000000.0,300000.0,3000000.0,3,7000000,0.0,0.25
261927,Ricardo,Horta,2024,1075,Portugal,Almada,Portugal,15-09-94,Left Winger,Attack,Right,173.0,30-06-28,Proeleven S.A.,https://img.a.transfermarkt.technology/portrait/header/261927-1702415787.jpg?lm=1,PO1,Sporting Clube de Braga,15000000.0,20000000.0,30,150,153,12,13,16,14,15,12,7,13,6,5,13,14,8,16,8,12,8,14,11,15,13,13,17,13,16,8,9,10,16,15,13,7,16,15,13,7,15,6,14,7,12,4,1,2,1,2,1,3,3,2,2,2,10,14,6,16,15,15,11,14,1,1,1,1,1,1,1,14,1,12,20,19,18,15,63,11,20,30000000,7500,7200,6000,Mediterranean_Hispanic,142,4,1,9500.0,Unknown,55069796,500000.0,1.0,76,46,79,0,1,3,192,7,0.702963747023022,0.6363636363636364,0.6838235294117647,0.0091646734716934,0.0263157894736842,0.0131578947368421,0.0747686921730432,0.0997749437359339,0.0027500763910108,0.0,0.2325581395348837,0.5,0,0,0,0,0,0,7,18,31,12000000,383870.96774193546,20000000.0,3000000.0,700000.0,2500000.0,2,1800000,-0.2,-0.4
262226,Timothy,Castagne,2024,931,Belgium,Arlon,Belgium,05-12-95,Right-Back,Defender,Right,185.0,30-06-27,SENERGIES BV,https://img.a.transfermarkt.technology/portrait/header/262226-1665067689.jpg?lm=1,GB1,Fulham Football Club,17000000.0,28000000.0,29,145,152,8,14,13,10,12,6,9,8,8,11,13,5,12,14,12,12,11,12,12,11,12,15,11,9,13,12,15,16,15,14,14,12,13,15,15,11,15,13,14,10,16,1,3,3,1,1,2,2,4,1,2,2,14,13,10,14,13,15,13,15,1,18,12,20,18,20,1,16,1,16,1,1,10,1,80,10,20,41754125,7250,7250,5500,Northern_European,128,24,2,81194.0,Unknown,18074558,13466666.67,3.0,7,87,8,1,1,7,95,11,0.7095792537708389,0.5828877005347594,0.5808823529411764,0.0783936377409577,0.1578947368421052,0.0263157894736842,0.0847711927981995,0.1397849462365591,0.0747891145309591,0.2857142857142857,0.5116279069767438,0.4583333333333332,365,18,26,28,1,8285,8,60,74,15000000,540740.7407407408,28000000.0,8000000.0,400000.0,2000000.0,3,15000000,-0.11764705882352941,-0.11764705882352941
262396,Unai,Simón,2024,621,Unknown,Unknown,Spain,11-06-97,Goalkeeper,Goalkeeper,Right,190.0,30-06-29,CAA Stellar,https://img.a.transfermarkt.technology/portrait/header/262396-1709674901.png?lm=1,ES1,Athletic Club Bilbao,30000000.0,30000000.0,27,154,168,6,2,1,1,13,8,13,1,2,3,12,3,2,13,13,13,12,15,13,14,14,15,3,12,1,15,13,12,13,14,7,15,12,13,12,12,15,5,9,12,14,16,15,15,13,14,13,15,16,13,9,15,11,14,4,9,11,10,10,18,20,1,1,1,1,1,1,1,1,1,1,1,1,1,89,10,20,108900010,7700,7700,6950,Mediterranean_Hispanic,153,25,0,48957.0,Unknown,67200923,9111392.0,2.0,105,1549,89,2,1,3,33,5,0.7691188145011907,0.7379679144385026,0.7647058823529411,0.0472650339366188,0.1644736842105263,0.0,0.1497874468617154,0.1497874468617154,0.0505924720131114,0.1428571428571428,0.6279069767441858,0.375,0,0,0,0,0,0,5,30,124,28000000,1116000.0,30000000.0,10000000.0,100000.0,500000.0,2,2400000,-0.06666666666666667,0.12
262523,Davide,Calabria,2024,5,Italy,Brescia,Italy,06-12-96,Right-Back,Defender,Right,176.0,30-06-25,YOU FIRST,https://img.a.transfermarkt.technology/portrait/header/262523-1684856316.jpg?lm=1,IT1,Associazione Calcio Milan,13000000.0,25000000.0,28,149,156,5,12,11,8,12,4,9,11,14,14,13,10,15,12,13,14,15,12,13,12,13,16,6,13,14,14,16,15,15,16,14,9,14,14,14,13,14,10,13,12,16,1,1,1,1,1,3,2,3,3,1,2,13,15,4,17,14,15,14,14,1,17,1,20,13,18,12,10,12,13,1,1,1,1,70,12,20,59572585,7450,7150,5850,Mediterranean_Hispanic,143,7,0,71154.0,Unknown,43123020,9111392.0,2.0,52,257,54,1,1,3,27,11,0.696348240275205,0.6203208556149732,0.6911764705882353,0.0686988403902252,0.0460526315789473,0.0,0.0647661915478869,0.1247811952988247,0.0505924720131114,0.1428571428571428,0.3023255813953489,0.4166666666666665,0,0,0,0,0,0,31,131,96,7500000,232031.25,25000000.0,5000000.0,700000.0,4000000.0,1,550000,-0.4230769230769231,-0.5
262709,Sebastian,Ring,2024,3999,Sweden,Ã–rebro,Sweden,18-04-95,Left-Back,Defender,Right,178.0,30-06-25,Unknown,https://img.a.transfermarkt.technology/portrait/header/262709-1728394054.png?lm=1,GR1,PAS Lamia 1964,300000.0,600000.0,29,126,139,8,14,10,7,11,6,8,10,16,13,12,7,13,12,12,14,14,13,13,12,12,16,9,9,11,11,15,17,13,13,12,8,12,15,14,10,15,8,15,15,14,3,2,3,2,1,3,3,1,2,1,3,7,12,4,14,10,17,15,18,1,12,12,20,1,20,8,1,8,10,1,1,10,1,72,10,20,1025513,6284,6284,5001,Northern_European,124,1,0,5752.0,Unknown,35017378,9111392.0,2.0,91,1717,91,1,1,7,147,8,0.5817676634030167,0.52951871657754,0.5514705882352942,0.0055455399586908,0.006578947368421,0.0,0.0012503125781445,0.0027506876719179,0.0505924720131114,0.1428571428571428,0.3488372093023257,0.4583333333333332,301,14,16,56,1,4478,0,0,0,300000,11250.0,600000.0,250000.0,,75000.0,4,325000,0.0,0.0
262749,David,Raya,2024,11,Spain,Barcelona,Spain,15-09-95,Goalkeeper,Goalkeeper,Right,183.0,30-06-28,FUTBOL21 AGENCY,https://img.a.transfermarkt.technology/portrait/header/262749-1668168018.jpg?lm=1,GB1,Arsenal Football Club,35000000.0,35000000.0,29,140,149,1,2,3,1,10,1,8,2,2,2,13,4,2,11,12,13,13,13,13,14,12,14,13,10,6,13,12,13,12,16,10,12,16,11,12,10,13,5,13,5,1,13,13,13,15,14,13,14,16,17,13,13,14,15,6,14,12,13,7,12,20,1,1,1,1,1,1,1,1,1,1,1,1,1,70,10,20,35167242,7250,7000,6000,Mediterranean_Hispanic,138,1,0,46397.0,Unknown,29111433,17625000.0,2.0,89,141,89,2,1,3,21,5,0.6765017200317545,0.6363636363636364,0.6544117647058822,0.0447930537356352,0.006578947368421,0.0,0.1747936984246061,0.1747936984246061,0.097891608100225,0.1428571428571428,0.4651162790697669,0.4583333333333332,0,0,0,0,0,0,2,20,103,40000000,1660416.6666666667,40000000.0,1000000.0,,150000.0,2,3000000,0.14285714285714285,0.14285714285714285
262939,Johan,Mojica,2024,237,Colombia,Santiago de Cali,Colombia,21-08-92,Left-Back,Defender,Left,185.0,30-06-27,LF Sport Management,https://img.a.transfermarkt.technology/portrait/header/262939-1541161893.jpg?lm=1,ES1,Real Club Deportivo Mallorca S.A.D.,2200000.0,5000000.0,32,136,142,13,13,14,9,12,13,11,10,12,9,13,6,11,13,14,12,12,10,10,12,10,13,13,7,14,11,11,13,16,14,14,10,17,17,15,11,7,11,13,12,14,1,1,2,3,1,3,4,3,2,1,3,12,12,6,10,12,11,10,10,1,19,1,1,20,1,1,18,1,1,14,1,1,1,66,20,8,5685403,6700,6024,4718,African_Caribbean,129,20,1,16393.0,Unknown,76020280,2740000.0,5.0,20,1334,20,1,0,1,166,8,0.5473670283143689,0.4992513368983956,0.588235294117647,0.0158206732862948,0.131578947368421,0.0131578947368421,0.010752688172043,0.0247561890472618,0.0151948665240701,0.5714285714285714,0.5116279069767438,0.5833333333333333,0,0,0,0,0,0,8,65,206,2200000,63333.333333333336,5000000.0,2000000.0,,300000.0,8,1900000,0.0,-0.12
262980,Jefferson,Lerma,2024,873,Colombia,Cerrito,Colombia,25-10-94,Defensive Midfield,Midfield,Right,179.0,30-06-26,ABADSPORT,https://img.a.transfermarkt.technology/portrait/header/262980-1693334146.jpg?lm=1,GB1,Crystal Palace Football Club,18000000.0,25000000.0,30,134,148,9,10,11,8,12,9,10,13,8,13,13,9,16,12,14,15,16,12,14,11,13,15,9,9,12,13,13,15,13,13,15,14,17,12,15,14,11,13,14,6,14,1,1,2,1,3,2,1,1,1,1,3,14,14,10,13,12,15,7,7,1,1,1,10,1,12,20,1,20,12,1,9,1,1,70,8,20,17920615,6694,6594,5594,African_Caribbean,134,32,1,52196.0,Unknown,76038475,15550000.0,2.0,20,342,20,3,1,1,58,4,0.6227838052394814,0.5929411764705882,0.625,0.0503926682612226,0.2105263157894736,0.0131578947368421,0.0897724431107777,0.1247811952988247,0.0863635100975027,0.1428571428571428,0.3720930232558141,0.5,425,23,17,125,3,4654,15,39,48,14000000,552000.0,25000000.0,5000000.0,,200000.0,2,23000000,-0.3,-0.3
263236,Kevin,Danso,2024,826,Austria,Voitsberg,Austria,19-09-98,Centre-Back,Defender,Right,190.0,30-06-27,HD,https://img.a.transfermarkt.technology/portrait/header/263236-1691217955.png?lm=1,FR1,Racing Club de Lens,25000000.0,25000000.0,26,129,142,5,7,8,10,9,5,15,7,14,13,12,10,13,10,13,12,15,11,10,8,11,15,7,10,13,11,12,14,13,12,14,17,16,16,13,15,14,12,13,4,16,3,1,1,3,3,1,4,2,1,2,3,15,17,6,11,13,12,14,10,1,1,20,1,1,1,14,1,10,1,1,1,1,1,85,10,20,5612540,6448,6148,4748,African_Caribbean,126,10,0,14999.0,Unknown,91144914,5500000.0,1.0,6,1624,7,1,1,1,158,2,0.5637734850489547,0.5024598930481283,0.5661764705882353,0.014474602817478,0.0657894736842105,0.0,0.1247811952988247,0.1247811952988247,0.0305286257951609,0.0,0.6279069767441858,0.3333333333333332,243,16,14,46,2,3833,11,31,46,25000000,957692.3076923077,25000000.0,1500000.0,1000000.0,8000000.0,3,2800000,0.0,0.13636363636363635
263380,Attila,Szalai,2024,533,Hungary,Budapest,Hungary,20-01-98,Centre-Back,Defender,Left,192.0,30-06-27,ROGON,https://img.a.transfermarkt.technology/portrait/header/263380-1691269895.jpg?lm=1,L1,TSG 1899 Hoffenheim FuÃŸball-Spielbetriebs GmbH,2000000.0,15000000.0,26,125,135,4,12,11,6,14,5,13,5,3,15,14,6,14,14,8,12,15,17,12,12,12,13,5,12,9,12,14,15,10,8,15,16,12,13,14,16,15,8,9,6,9,1,2,1,1,2,3,4,3,2,1,2,19,11,6,10,10,17,10,15,1,17,20,1,1,1,14,1,1,1,1,1,1,1,83,20,8,5578312,6492,5742,4992,Northern_European,126,27,0,22435.0,Unknown,16147693,5478333.333,3.0,45,273,47,1,0,7,199,2,0.5100555702566817,0.5285561497326202,0.5661764705882353,0.0216549328075225,0.1776315789473684,0.0,0.0097524381095273,0.0747686921730432,0.0304082520792244,0.2857142857142857,0.6744186046511627,0.3333333333333332,282,17,13,45,1,6142,4,9,21,2000000,86363.63636363637,15000000.0,4000000.0,,300000.0,5,13200000,-0.5,-0.8
263727,Joan,Jordán,2024,1108,Spain,RegencÃ³s,Spain,06-07-94,Central Midfield,Midfield,Right,185.0,30-06-25,LEADERBROCK,https://img.a.transfermarkt.technology/portrait/header/263727-1620305031.jpg?lm=1,ES1,Deportivo AlavÃ©s S.A.D.,3500000.0,30000000.0,30,146,149,15,11,12,10,16,15,9,12,3,10,15,12,12,14,10,13,11,16,15,15,16,14,13,11,14,12,14,13,13,13,12,11,14,12,14,13,16,9,13,7,11,1,2,3,4,2,3,2,3,3,1,2,14,13,8,12,14,15,13,9,1,1,1,1,1,1,16,1,20,1,1,14,1,1,74,12,20,18718439,7200,7200,5750,Mediterranean_Hispanic,145,0,0,32145.0,Unknown,67187249,9111392.0,2.0,89,1214,89,3,1,3,59,1,0.702963747023022,0.6096256684491979,0.7058823529411764,0.0310310764604719,0.0,0.0,0.0172543135783946,0.1497874468617154,0.0505924720131114,0.1428571428571428,0.5116279069767438,0.5,427,38,27,87,0,6684,6,27,39,2500000,83333.33333333333,30000000.0,8000000.0,,300000.0,5,6000000,-0.2857142857142857,-0.5
263860,Unknown,Jason,2024,8024,Spain,A CoruÃ±a,Spain,06-07-94,Right Winger,Attack,Right,178.0,30-06-25,LEADERBROCK,https://img.a.transfermarkt.technology/portrait/header/263860-1647530884.jpg?lm=1,PO1,Futebol Clube de Arouca,2500000.0,6000000.0,30,128,135,13,13,13,12,12,13,8,13,8,9,13,12,9,13,10,12,9,13,11,13,12,13,14,9,14,9,12,12,13,13,11,9,13,14,13,10,9,8,12,9,10,3,3,3,1,1,2,3,1,2,1,2,12,14,8,11,13,12,13,12,1,1,1,13,1,15,1,13,1,18,15,15,20,1,65,8,20,4929361,6397,6397,4247,Mediterranean_Hispanic,122,0,0,10502.0,Unknown,67184262,9111392.0,2.0,89,7,89,0,1,3,98,10,0.5967187086530829,0.4488770053475935,0.536764705882353,0.0101322219722346,0.0,0.0,0.0122530632658164,0.0297574393598399,0.0505924720131114,0.1428571428571428,0.3488372093023257,0.5,347,39,21,53,0,3828,2,8,43,2500000,92000.0,6000000.0,1800000.0,,,6,3000000,-0.16666666666666666,0.3888888888888889
263905,Dmitriy,Barinov,2024,932,Russia,"Ogudnevo, Moskau Oblast",Russia,11-09-96,Defensive Midfield,Midfield,Right,181.0,30-06-26,Pavel Banatin,https://img.a.transfermarkt.technology/portrait/header/263905-1721715727.png?lm=1,RU1,"?????????? ???? ""?????????"" ??????",8000000.0,12500000.0,28,130,140,8,7,9,10,12,7,11,13,7,14,12,12,13,12,15,15,16,13,15,9,13,14,11,15,12,15,16,14,12,15,14,9,17,13,15,10,13,14,11,12,10,1,2,1,2,3,1,2,4,1,1,1,18,8,6,10,9,10,11,10,1,7,16,10,1,1,20,1,16,1,1,10,1,1,72,9,20,7737940,6485,6485,4241,Northern_European,130,13,0,27999.0,Unknown,58100321,9111392.0,2.0,78,1074,81,3,1,7,3,4,0.6083620005292405,0.448235294117647,0.5955882352941175,0.0270276272755977,0.0855263157894736,0.0,0.0397599399849962,0.0622655663915979,0.0505924720131114,0.1428571428571428,0.418604651162791,0.4166666666666665,0,0,0,0,0,0,9,47,156,8000000,300000.0,12500000.0,2500000.0,500000.0,1000000.0,0,0,0.0,0.0
263918,Aleksandr,Golovin,2024,162,Russia,"Kaltan, Kemerovo Oblast",Russia,30-05-96,Attacking Midfield,Midfield,Right,178.0,30-06-29,Unknown,https://img.a.transfermarkt.technology/portrait/header/263918-1614091807.jpg?lm=1,FR1,Association sportive de Monaco Football Club,30000000.0,30000000.0,28,146,158,14,13,16,12,15,13,7,13,3,10,15,13,11,16,12,13,12,11,13,16,12,15,15,11,13,11,14,14,14,15,14,10,13,14,13,10,11,8,15,10,15,2,2,3,1,2,1,3,3,1,3,1,10,15,4,15,17,16,14,12,1,1,1,1,1,1,12,18,15,12,15,20,14,1,69,12,20,48427533,7300,7500,6250,Northern_European,145,45,5,88219.0,Unknown,58104594,30000000.0,1.0,78,702,81,3,1,7,24,0,0.7426567875099233,0.6631016042780749,0.7058823529411764,0.0851770990346724,0.2960526315789473,0.0657894736842105,0.1497874468617154,0.1497874468617154,0.1666435178754965,0.0,0.3488372093023257,0.4166666666666665,389,52,56,62,4,7425,25,66,96,30000000,907575.7575757576,30000000.0,5000000.0,100000.0,3000000.0,2,5250000,0.0,0.0
263962,Anton,Zinkovskiy,2024,232,Russia,Novorossijsk,Russia,14-04-96,Left Winger,Attack,Right,175.0,30-06-27,Pavel Andreev,https://img.a.transfermarkt.technology/portrait/header/263962-1655992616.png?lm=1,RU1,FK Spartak Moskva,3000000.0,4000000.0,28,124,133,14,14,14,10,12,13,8,14,7,11,12,13,9,13,7,10,12,10,9,12,10,3,13,9,12,6,9,11,15,15,10,8,12,14,13,6,15,5,13,5,14,1,3,2,1,2,4,2,1,1,3,1,18,12,5,12,11,10,13,14,1,6,1,1,1,1,1,17,1,11,20,14,14,12,67,10,20,4047118,6000,6000,3750,Northern_European,120,0,0,22997.0,Unknown,58104527,1775000.0,2.0,78,1060,81,0,1,7,82,7,0.5441915850754168,0.3957219251336898,0.5220588235294117,0.0221976097110197,0.0,0.0,0.0147536884221055,0.0197549387346836,0.0098336064890691,0.1428571428571428,0.2790697674418605,0.4166666666666665,326,61,54,22,0,4974,2,4,19,2500000,114285.71428571429,4000000.0,600000.0,,100000.0,4,100000,-0.16666666666666666,-0.2857142857142857
264372,Viktor,Tsygankov,2024,12321,Israel,Nahariya,Ukraine,15-11-97,Right Winger,Attack,Left,178.0,30-06-27,Unknown,https://img.a.transfermarkt.technology/portrait/header/264372-1715881945.jpg?lm=1,ES1,Girona FÃºtbol Club S. A. D.,30000000.0,30000000.0,27,139,145,14,13,15,12,15,14,7,13,9,6,14,15,8,16,10,12,9,12,11,14,12,15,14,13,14,8,11,11,15,14,12,9,10,14,13,12,10,7,7,13,10,1,1,2,3,1,3,2,2,2,2,2,13,15,5,17,5,14,16,8,1,1,1,1,1,1,1,15,8,15,16,14,20,11,72,20,11,18833234,6991,6991,4991,Northern_European,138,40,7,38500.0,Unknown,71080414,5000000.0,1.0,51,1013,101,0,0,7,107,10,0.6753109288171474,0.5284491978609626,0.6544117647058822,0.0371675741859605,0.2631578947368421,0.0921052631578947,0.1497874468617154,0.1497874468617154,0.0277507708547459,0.0,0.3488372093023257,0.375,312,107,80,21,0,10748,20,58,55,22000000,968181.8181818182,30000000.0,8000000.0,700000.0,8000000.0,1,0,-0.26666666666666666,-0.12
265078,Patrick,Cutrone,2024,1047,Italy,Como,Italy,03-01-98,Centre-Forward,Attack,Right,183.0,30-06-28,Unknown,https://img.a.transfermarkt.technology/portrait/header/265078-1714818222.jpg?lm=1,IT1,Calcio Como,5000000.0,30000000.0,26,120,136,4,8,11,12,12,7,13,10,6,5,11,12,6,12,14,15,14,13,12,8,14,14,10,10,14,6,12,14,13,13,13,12,13,14,12,13,11,10,12,7,5,3,2,3,1,1,2,4,2,1,3,2,10,14,5,13,10,14,11,13,1,1,1,1,1,1,1,1,1,1,1,1,1,20,75,10,20,1746401,6000,6000,5250,Mediterranean_Hispanic,120,1,0,9336.0,Unknown,43167351,18000000.0,1.0,52,377,54,0,1,3,47,3,0.5441915850754168,0.5561497326203209,0.5220588235294117,0.0090063122400679,0.006578947368421,0.0,0.0247561890472618,0.1497874468617154,0.0999749993055362,0.0,0.4651162790697669,0.3333333333333332,354,115,34,23,1,6553,6,11,30,7000000,216406.25,30000000.0,5000000.0,300000.0,30000000.0,6,10600000,0.4,1.8
265088,Manuel,Locatelli,2024,506,Italy,Lecco,Italy,08-01-98,Defensive Midfield,Midfield,Right,185.0,30-06-28,Castelnovo,https://img.a.transfermarkt.technology/portrait/header/265088-1630490000.jpg?lm=1,IT1,Juventus Football Club,28000000.0,35000000.0,26,149,162,11,11,12,11,15,10,13,14,7,12,16,11,16,15,14,15,15,14,13,14,13,17,13,14,14,14,17,15,12,13,14,13,14,12,14,13,14,14,14,11,13,1,1,4,2,3,1,3,3,3,2,3,13,17,4,13,13,16,20,17,1,1,1,1,1,1,20,1,20,1,1,11,1,1,75,10,20,37258394,7450,7450,6500,Mediterranean_Hispanic,148,24,3,106731.0,Juventus,43167354,25200000.0,2.0,52,809,54,3,1,3,116,4,0.7360412807621064,0.6898395721925134,0.7279411764705881,0.1030526058630349,0.1578947368421052,0.0394736842105263,0.1397849462365591,0.1747936984246061,0.1399761104475124,0.1428571428571428,0.5116279069767438,0.3333333333333332,360,18,29,82,0,6464,8,24,38,28000000,1074038.4615384615,35000000.0,5000000.0,5000000.0,8000000.0,3,150000,0.0,-0.15151515151515152
265153,Aleksandr,Selikhov,2024,232,Russia,Orel,Russia,07-04-94,Goalkeeper,Goalkeeper,Right,190.0,30-06-25,Pavel Andreev,https://img.a.transfermarkt.technology/portrait/header/265153-1632577500.png?lm=1,RU1,FK Spartak Moskva,1500000.0,5800000.0,30,121,130,5,3,1,2,11,10,10,3,3,2,10,5,2,6,9,16,12,12,13,8,11,18,2,11,1,11,14,11,7,13,13,15,10,9,11,12,14,12,14,16,11,12,12,12,9,15,13,13,15,9,8,13,12,15,13,7,13,15,14,13,20,1,1,1,1,1,1,1,1,1,1,1,1,1,80,7,20,2440412,5853,5853,3969,Northern_European,120,0,0,28657.0,Unknown,58084835,3500000.0,1.0,78,1090,81,2,1,7,82,5,0.5247419952368352,0.4191443850267379,0.5220588235294117,0.0276630034366318,0.0,0.0,0.0072518129532383,0.0287571892973243,0.0194172060335009,0.0,0.6279069767441858,0.5,0,0,0,0,0,0,14,99,318,1500000,63636.36363636364,5800000.0,1500000.0,,,1,500000,0.0,-0.25
265324,Victor,Edvardsen,2024,1435,Sweden,GÃ¶teborg,Sweden,14-01-96,Centre-Forward,Attack,Right,185.0,30-06-26,Unknown,https://img.a.transfermarkt.technology/portrait/header/265324-1690213229.jpg?lm=1,NL1,Go Ahead Eagles,800000.0,1800000.0,28,123,134,11,10,12,14,13,9,11,11,7,5,11,14,6,13,12,12,16,13,12,11,13,14,12,7,14,6,13,15,13,11,15,11,12,14,15,15,14,10,10,7,7,1,3,1,2,1,2,3,3,1,1,2,19,13,10,7,14,11,9,8,1,1,1,1,1,1,1,14,1,10,17,12,12,20,87,7,20,1344748,6161,5911,3012,Northern_European,123,0,0,2329.0,Unknown,93056768,700000.0,2.0,91,582,91,0,1,7,108,3,0.5324159830643027,0.3167914438502673,0.5441176470588236,0.0022402320571413,0.0,0.0,0.0037509377344336,0.0087521880470117,0.0038612183671768,0.1428571428571428,0.5116279069767438,0.4166666666666665,304,122,41,49,0,7702,0,0,0,900000,68750.0,1800000.0,600000.0,,,4,1075000,0.125,0.0
266768,Nicolas,Moumi Ngamaleu,2024,121,Cameroon,YaoundÃ©,Cameroon,09-07-94,Left Winger,Attack,Right,181.0,30-06-26,BG Sports,https://img.a.transfermarkt.technology/portrait/header/266768-1663086781.png?lm=1,RU1,FK Dinamo Moskva,4500000.0,6000000.0,30,127,134,11,12,14,11,14,8,8,12,6,5,12,10,6,14,8,11,9,13,11,11,9,11,15,8,12,7,13,13,14,15,11,10,14,14,14,9,8,7,9,6,14,3,1,2,1,4,1,2,3,2,2,3,11,13,6,13,12,14,9,13,1,1,1,1,1,1,1,1,1,16,15,10,20,18,74,10,20,8738777,6550,6550,4400,African_Caribbean,121,40,4,42079.0,Unknown,13171659,2250000.0,2.0,15,1682,15,0,1,1,74,7,0.6169621593014025,0.4652406417112299,0.5294117647058822,0.0406235183810074,0.2631578947368421,0.0526315789473684,0.0222555638909727,0.0297574393598399,0.0124725686824634,0.1428571428571428,0.418604651162791,0.5,347,65,63,48,1,7450,8,14,29,5000000,184259.25925925927,6000000.0,1200000.0,,,3,1575000,0.1111111111111111,0.42857142857142855
266807,Ángel,Correa,2024,13,Argentina,Rosario,Argentina,09-03-95,Right Winger,Attack,Right,171.0,30-06-26,Augustin Jimenez,https://img.a.transfermarkt.technology/portrait/header/266807-1701212448.jpg?lm=1,ES1,Club AtlÃ©tico de Madrid S.A.D.,18000000.0,45000000.0,29,156,162,13,15,16,13,16,10,8,11,9,5,15,11,6,17,10,15,11,13,13,15,14,13,18,10,17,8,11,13,14,16,14,6,16,14,12,10,15,13,12,8,11,3,1,1,1,3,2,2,1,1,1,1,13,14,10,15,14,14,14,11,1,1,1,1,1,1,1,13,1,18,15,18,20,18,67,12,20,44000003,7700,7600,7150,North_African__Middle_Eastern,147,20,3,96153.0,Unknown,14043349,10500000.0,1.0,4,1248,4,0,1,6,52,10,0.755887801005557,0.7593582887700534,0.7205882352941175,0.0928383064231894,0.131578947368421,0.0394736842105263,0.0897724431107777,0.2248062015503876,0.058307175199311,0.0,0.1860465116279068,0.4583333333333332,518,98,83,78,3,9814,7,46,201,15000000,433823.5294117647,45000000.0,10000000.0,5000000.0,9000000.0,1,0,-0.16666666666666666,-0.25
267160,Adam,Buksa,2024,865,Poland,KrakÃ³w,Poland,12-07-96,Centre-Forward,Attack,Left,191.0,30-06-28,Unknown,https://img.a.transfermarkt.technology/portrait/header/267160-1725875279.jpg?lm=1,DK1,Fodbold Club Midtjylland,6000000.0,9000000.0,28,130,135,7,9,11,15,14,9,15,12,7,7,11,11,8,10,14,12,11,12,14,11,13,13,11,10,16,10,13,14,11,11,15,15,13,11,13,12,14,7,13,14,10,2,1,2,3,2,1,1,2,2,1,2,10,11,2,8,9,12,12,7,1,1,1,1,1,1,1,1,1,1,15,12,12,20,78,20,14,11708698,6450,6150,4750,Northern_European,129,9,5,14310.0,Unknown,96055358,2434166.667,6.0,75,756,78,0,0,7,86,3,0.5640381053188674,0.5026737967914437,0.588235294117647,0.0138092925211977,0.0592105263157894,0.0657894736842105,0.0297574393598399,0.0447611902975743,0.0134957452540348,0.7142857142857142,0.6511627906976742,0.4166666666666665,0,0,0,0,0,0,7,59,161,6000000,212500.0,9000000.0,2000000.0,150000.0,225000.0,7,4625000,0.0,0.09090909090909091
267383,Rifat,Zhemaletdinov,2024,2410,Russia,Moskau,Russia,20-09-96,Attacking Midfield,Midfield,Right,184.0,30-06-25,Shpinev Vadim,https://img.a.transfermarkt.technology/portrait/header/267383-1725271456.png?lm=1,RU1,PFK CSKA Moskva,3000000.0,7500000.0,28,130,133,11,11,14,13,13,6,8,12,8,8,12,10,7,13,11,12,12,12,13,14,12,14,12,8,13,10,14,10,14,12,12,11,14,14,14,12,12,13,13,7,14,3,3,1,1,1,2,2,2,3,3,3,7,11,7,6,8,10,11,14,1,1,1,1,1,1,1,12,16,17,15,19,20,14,80,10,20,5171316,6400,6400,4250,Mediterranean_Hispanic,125,9,1,24931.0,Unknown,58104534,825000.0,2.0,78,985,81,3,1,3,148,0,0.5971156390579518,0.4491978609625668,0.5588235294117647,0.0240651135034815,0.0592105263157894,0.0131578947368421,0.0147536884221055,0.0372593148287071,0.0045556821022806,0.1428571428571428,0.4883720930232553,0.4166666666666665,263,40,30,39,0,6086,5,41,223,2500000,85576.92307692308,7500000.0,1000000.0,275000.0,1200000.0,3,1000000,-0.16666666666666666,-0.375
268112,Gyrano,Kerk,2024,1096,Netherlands,Amsterdam,Suriname,02-12-95,Right Winger,Attack,Right,183.0,30-06-25,ESA,https://img.a.transfermarkt.technology/portrait/header/268112-1658227780.png?lm=1,BE1,Royal Antwerp Football Club,2200000.0,6500000.0,29,127,135,12,11,12,11,12,10,8,12,7,6,10,12,8,14,14,11,13,12,11,12,9,15,16,5,14,8,12,11,15,13,13,11,12,15,14,16,10,6,12,6,11,3,2,1,2,3,1,2,2,3,1,1,8,14,6,12,13,13,10,15,1,1,1,1,1,1,1,1,1,16,10,10,20,15,91,10,20,7698146,6161,6403,5256,African_Caribbean,124,0,0,15341.0,Unknown,37041414,7000000.0,1.0,67,64,90,0,1,1,173,10,0.5975125694628208,0.5567914438502674,0.5514705882352942,0.0148048439224532,0.0,0.0,0.010752688172043,0.032258064516129,0.038862190616406,0.0,0.4651162790697669,0.4583333333333332,432,96,75,41,0,9898,0,0,0,2500000,94230.76923076923,6500000.0,1500000.0,250000.0,250000.0,4,0,0.13636363636363635,-0.16666666666666666
268113,Sean,Klaiber,2024,206,Netherlands,Nieuwegein,Suriname,31-07-94,Right-Back,Defender,Right,184.0,30-06-25,SEG,https://img.a.transfermarkt.technology/portrait/header/268113-1601549160.jpg?lm=1,DK1,BrÃ¸ndby IdrÃ¦tsforening,2500000.0,5000000.0,30,127,131,10,12,10,7,10,8,11,9,11,13,11,11,14,12,11,12,12,12,13,12,12,13,8,12,13,14,15,14,12,12,14,11,12,12,12,12,13,7,11,13,16,2,4,3,1,2,1,2,3,2,3,3,11,10,3,11,11,13,11,16,1,13,7,18,12,20,16,7,16,19,1,11,16,1,76,8,20,5080554,6250,6250,5100,African_Caribbean,116,3,0,5999.0,Unknown,37028465,2625000.0,2.0,67,1044,90,1,1,1,45,11,0.5772691188145012,0.5401069518716577,0.4926470588235294,0.0057840474233951,0.0197368421052631,0.0,0.0122530632658164,0.0247561890472618,0.0145559598877746,0.1428571428571428,0.4883720930232553,0.5,329,24,35,38,1,10223,11,104,335,2200000,76785.71428571429,5000000.0,1500000.0,50000.0,300000.0,5,1750000,-0.12,-0.12
268167,ÃÂ¬Lex,Corredera,2024,3719,Spain,Sant Joan de les Abadesses,Spain,19-03-96,Central Midfield,Midfield,Left,178.0,30-06-26,YOU FIRST,https://img.a.transfermarkt.technology/portrait/header/268167-1726388660.png?lm=1,RU1,FK Khimki,1000000.0,1000000.0,28,126,139,13,12,14,11,15,13,5,12,7,7,16,12,8,15,11,12,12,14,13,15,14,15,13,9,13,11,14,13,12,13,11,9,12,12,13,9,14,9,13,7,14,1,2,1,2,2,3,4,2,3,3,3,12,14,7,11,12,14,12,13,1,1,1,1,1,1,14,14,20,14,12,17,12,1,72,20,8,2349953,6250,6250,3750,Mediterranean_Hispanic,126,0,0,7715.0,Unknown,67191243,500000.0,1.0,89,1320,89,3,0,3,76,1,0.5772691188145012,0.3957219251336898,0.5661764705882353,0.0074410466518669,0.0,0.0,0.0047511877969492,0.0047511877969492,0.0027500763910108,0.0,0.3488372093023257,0.4166666666666665,236,19,14,27,2,3315,2,6,31,800000,35294.117647058825,1000000.0,400000.0,,,4,450000,-0.2,0.0
268429,Sandi,Lovri?,2024,410,Austria,Lienz,Slovenia,28-03-98,Central Midfield,Midfield,Right,180.0,30-06-27,Universal Twenty Two,https://img.a.transfermarkt.technology/portrait/header/268429-1725531957.jpg?lm=1,IT1,Udinese Calcio,8000000.0,10000000.0,26,130,143,8,10,13,8,14,8,9,13,8,9,13,12,11,14,13,12,11,12,12,13,13,12,11,9,12,12,14,14,13,13,12,13,14,13,14,12,13,9,11,3,3,1,3,3,1,1,1,1,3,4,1,3,14,9,8,13,9,12,11,13,1,1,1,1,1,1,10,1,20,3,1,18,1,1,75,13,20,2300591,6500,6650,4500,Northern_European,129,22,3,24439.0,Unknown,16135875,9111392.0,2.0,6,832,87,3,1,7,205,1,0.6301931727970362,0.4759358288770053,0.588235294117647,0.023590029808605,0.1447368421052631,0.0394736842105263,0.0397599399849962,0.0497624406101525,0.0505924720131114,0.1428571428571428,0.3953488372093026,0.3333333333333332,324,26,44,50,2,5522,11,40,54,8000000,265000.0,10000000.0,1000000.0,350000.0,1000000.0,2,1000000,0.0,-0.1111111111111111
268506,Fabrizio,Angileri,2024,3709,Argentina,JunÃ­n,Argentina,15-03-94,Left-Back,Defender,Left,185.0,30-06-26,Unknown,https://img.a.transfermarkt.technology/portrait/header/268506-1625760521.png?lm=1,ES1,Getafe Club de FÃºtbol S.A.D. Team Dubai,1000000.0,4300000.0,30,130,135,13,13,13,9,13,13,9,12,13,13,12,10,11,13,12,13,11,12,12,14,13,10,9,4,13,13,12,13,14,14,12,11,13,13,15,11,10,5,10,9,15,2,2,2,2,2,3,1,1,4,3,2,12,14,8,12,12,11,10,10,1,20,1,1,17,1,1,15,1,1,1,1,1,1,84,20,9,3003507,6494,6494,3994,Mediterranean_Hispanic,128,0,0,10070.0,Unknown,14079839,2000000.0,1.0,4,695,4,1,0,3,105,8,0.6095527917438476,0.4218181818181817,0.5808823529411764,0.0097150753133186,0.0,0.0,0.0047511877969492,0.0212553138284571,0.0110836412122558,0.0,0.5116279069767438,0.5,204,8,32,29,3,8094,8,29,52,700000,25000.0,4300000.0,1000000.0,,,3,600000,-0.3,-0.5333333333333333
268670,Gerard,Gumbau,2024,367,Spain,Campllong,Spain,18-12-94,Defensive Midfield,Midfield,Left,188.0,30-06-25,CONTROL ORIENTADO,https://img.a.transfermarkt.technology/portrait/header/268670-1499871303.jpg?lm=1,ES1,Rayo Vallecano de Madrid S.A.D.,3000000.0,3500000.0,30,128,135,10,11,8,9,14,12,12,14,10,11,16,12,14,14,12,14,11,14,15,16,13,12,9,8,13,15,15,15,9,9,8,15,13,12,13,13,14,9,14,7,12,4,3,2,3,1,2,2,2,3,1,2,13,14,5,11,10,13,8,16,1,1,12,1,1,1,20,1,17,1,1,1,1,1,77,20,10,1704499,6200,6200,4500,Mediterranean_Hispanic,131,0,0,6023.0,Unknown,67207185,262500.0,2.0,89,308,89,3,0,3,163,4,0.5706536120666843,0.4759358288770053,0.6029411764705883,0.0058072222377793,0.0,0.0,0.0147536884221055,0.0172543135783946,0.0014305952943137,0.1428571428571428,0.581395348837209,0.5,368,20,33,114,2,3549,0,0,0,2000000,73076.92307692308,3500000.0,1000000.0,,0.0,5,2100000,-0.3333333333333333,-0.42857142857142855
269878,Marcus,Ingvartsen,2024,2778,Denmark,Farum,Denmark,04-01-96,Centre-Forward,Attack,Left,187.0,30-06-25,People In Sport,https://img.a.transfermarkt.technology/portrait/header/269878-1676499596.jpg?lm=1,DK1,Fodbold Club NordsjÃ¦lland,6500000.0,6500000.0,28,129,132,13,9,12,14,14,14,12,13,4,7,13,14,7,14,14,15,12,13,12,14,12,15,13,6,15,8,14,12,12,12,13,12,12,12,12,13,13,10,14,10,15,3,3,1,3,1,2,1,3,1,3,3,15,14,11,8,12,13,14,12,1,1,1,1,1,1,1,10,14,10,12,16,12,20,79,20,12,4142203,6450,6250,5000,Northern_European,129,1,1,24931.0,Unknown,27088228,2925000.0,4.0,28,486,30,0,0,7,87,3,0.5772691188145012,0.5294117647058822,0.588235294117647,0.0240651135034815,0.006578947368421,0.0131578947368421,0.032258064516129,0.032258064516129,0.0162226728520236,0.4285714285714285,0.5581395348837206,0.4166666666666665,303,90,22,38,0,5432,7,38,148,6000000,228846.15384615384,6500000.0,1000000.0,,800000.0,4,3750000,-0.07692307692307693,-0.07692307692307693
270171,Vitaly,Janelt,2024,1148,Germany,Hamburg,Germany,10-05-98,Defensive Midfield,Midfield,Left,184.0,30-06-26,Wasserman,https://img.a.transfermarkt.technology/portrait/header/270171-1649932358.jpg?lm=1,GB1,Brentford Football Club,22000000.0,22000000.0,26,135,148,10,12,13,12,13,9,12,13,12,12,14,8,14,13,16,14,16,13,14,13,12,15,8,12,11,12,15,15,12,12,14,12,16,12,15,14,14,12,14,5,13,1,1,1,2,1,1,2,3,3,1,2,14,13,11,10,14,13,12,16,1,12,10,12,1,1,20,1,20,1,1,1,1,1,79,20,10,25632341,6750,6750,5250,Northern_European,136,0,0,46397.0,Unknown,91143519,283333.3333,3.0,38,594,40,3,0,7,43,4,0.6434241862926701,0.5561497326203209,0.6397058823529411,0.0447930537356352,0.0,0.0,0.1097774443610902,0.1097774443610902,0.0015463392499791,0.2857142857142857,0.4883720930232553,0.3333333333333332,311,24,19,46,1,5713,4,46,90,22000000,951086.9565217391,22000000.0,150000.0,125000.0,450000.0,2,75000,0.0,0.0
270393,Robert,Skov,2024,89,Spain,Marbella,Denmark,20-05-96,Left Midfield,Midfield,Left,185.0,Unknown,Unknown,https://img.a.transfermarkt.technology/portrait/header/270393-1726350741.jpg?lm=1,L1,1. FC Union Berlin,3000000.0,14000000.0,28,142,145,15,13,12,10,11,16,9,15,8,8,14,15,10,14,12,14,10,15,13,14,13,13,15,8,16,9,13,13,13,13,10,11,12,13,14,10,13,8,11,10,19,1,3,2,3,1,2,3,2,1,1,2,12,15,4,12,15,14,17,16,1,15,1,10,15,16,1,15,10,18,16,12,20,8,81,20,12,17083737,7100,6750,6100,Northern_European,133,11,5,38462.0,Unknown,27094768,5500000.0,2.0,89,912,30,3,0,7,0,6,0.6434241862926701,0.6470588235294117,0.6176470588235294,0.0371308807298521,0.0723684210526315,0.0657894736842105,0.0147536884221055,0.0697674418604651,0.0305286257951609,0.1428571428571428,0.5116279069767438,0.4166666666666665,321,72,57,24,1,6538,12,50,141,3000000,118000.0,14000000.0,3000000.0,150000.0,600000.0,4,2350000,-0.4,-0.5384615384615384
270541,Serhou,Guirassy,2024,16,France,Arles,Guinea,12-03-96,Centre-Forward,Attack,Right,187.0,30-06-28,KGSMI,https://img.a.transfermarkt.technology/portrait/header/270541-1727815486.jpg?lm=1,L1,Borussia Dortmund,40000000.0,40000000.0,28,129,135,6,9,11,14,12,10,15,11,5,5,13,13,6,12,12,13,15,11,8,11,12,13,14,6,12,6,15,14,13,12,15,15,14,15,14,15,13,5,12,12,7,2,1,1,3,3,3,2,3,2,3,3,9,16,13,9,11,12,14,14,1,1,1,1,1,1,1,12,1,10,16,8,10,20,82,10,20,4615653,6449,6449,3999,African_Caribbean,126,0,0,22998.0,VfB Stuttgart,85111795,9111392.0,2.0,34,86,44,0,1,1,41,3,0.6035988356708124,0.4223529411764705,0.5661764705882353,0.0221985753282857,0.0,0.0,0.1997999499874969,0.1997999499874969,0.0505924720131114,0.1428571428571428,0.5581395348837206,0.4166666666666665,325,131,22,28,1,6883,17,75,88,40000000,1372413.7931034483,40000000.0,3000000.0,300000.0,2000000.0,8,10100000,0.0,0.0
271021,Unknown,Stoichkov,2024,1108,Spain,San Roque (CÃ¡diz),Spain,05-11-93,Second Striker,Attack,Right,178.0,30-06-27,Promoesport,https://img.a.transfermarkt.technology/portrait/header/271021-1572959967.jpg?lm=1,ES1,Deportivo AlavÃ©s S.A.D.,4000000.0,4000000.0,31,124,134,13,14,15,14,14,11,8,9,8,6,14,8,5,15,8,12,8,12,11,15,13,9,15,10,13,6,11,12,11,13,11,8,12,11,11,10,13,9,6,8,10,3,4,3,1,1,2,3,3,1,3,1,9,10,3,12,9,10,11,20,1,1,1,1,1,1,1,1,15,1,17,20,14,18,75,12,20,2337585,6200,6200,3800,Mediterranean_Hispanic,117,0,0,7339.0,Unknown,67175447,783333.3333,3.0,89,1307,89,0,1,3,59,12,0.5706536120666843,0.4010695187165775,0.4999999999999999,0.0070779745598475,0.0,0.0,0.0197549387346836,0.0197549387346836,0.0043241941903941,0.2857142857142857,0.3488372093023257,0.5416666666666665,339,104,19,46,1,3754,0,0,0,2500000,104166.66666666667,4000000.0,1500000.0,,,6,4400000,-0.375,-0.375
271335,Unknown,Fabiano,2024,605,Brazil,SÃ£o JosÃ© do Oeste,Brazil,18-11-91,Centre-Back,Defender,Right,188.0,30-06-27,Energy Sports,https://img.a.transfermarkt.technology/portrait/header/271335-1605700461.png?lm=1,GR1,Aris Thessalonikis,800000.0,1500000.0,33,130,136,6,2,3,3,8,9,10,3,2,1,10,2,3,6,13,12,14,10,12,7,11,12,3,12,3,13,12,12,7,13,15,16,14,8,10,17,12,10,8,12,13,16,12,13,5,13,14,14,16,10,12,17,13,11,4,13,7,14,11,12,20,1,1,1,1,1,1,1,1,1,1,1,1,1,90,8,20,347975206,6500,5570,4557,Mediterranean_Hispanic,130,0,0,4800.0,Unknown,19030218,9111392.0,2.0,10,1452,11,1,1,3,20,2,0.4872982270441915,0.4820320855614973,0.5955882352941175,0.0046262723214501,0.0,0.0,0.0037509377344336,0.0072518129532383,0.0505924720131114,0.1428571428571428,0.581395348837209,0.625,341,14,9,72,1,9307,4,16,33,700000,13043.478260869566,1500000.0,500000.0,,,6,1550000,-0.125,-0.2222222222222222
271455,Mihailo,Ristic,2024,940,Bosnia-Herzegovina,Bijeljina,Serbia,31-10-95,Left-Back,Defender,Left,180.0,30-06-26,AC Talent,https://img.a.transfermarkt.technology/portrait/header/271455-1661241997.jpg?lm=1,ES1,Real Club Celta de Vigo S. A. D.,1000000.0,3500000.0,29,132,136,13,16,14,8,13,13,9,14,9,12,14,14,12,14,14,13,12,14,13,12,13,13,13,12,13,11,13,13,13,13,13,10,12,14,13,10,12,14,12,9,16,3,2,3,1,4,1,3,1,2,3,2,12,13,10,15,13,14,12,12,1,19,1,1,20,1,12,15,15,1,11,1,1,1,79,20,8,2440349,6600,6750,5000,Northern_European,131,9,0,18569.0,Unknown,62137429,1366666.667,3.0,9,190,85,1,0,7,165,8,0.6434241862926701,0.5294117647058822,0.6029411764705883,0.0179218564571309,0.0592105263157894,0.0,0.0047511877969492,0.0172543135783946,0.0075650249562487,0.2857142857142857,0.3953488372093026,0.4583333333333332,250,15,23,30,2,5998,8,46,69,900000,16666.666666666668,3500000.0,1500000.0,,1000000.0,5,2000000,-0.1,-0.35714285714285715
272261,Antonín,Barák,2024,10484,Czech Republic,P?Ã­bram,Czech Republic,03-12-94,Attacking Midfield,Midfield,Left,190.0,30-06-25,Unknown,https://img.a.transfermarkt.technology/portrait/header/272261-1727699332.jpg?lm=1,TR1,Kas?mpa?a Spor KulÃ¼bÃ¼,3900000.0,20000000.0,30,143,148,10,11,14,15,15,12,14,13,4,8,15,10,12,14,11,17,13,14,12,13,14,13,14,13,17,9,16,14,11,12,15,14,14,12,15,16,14,11,14,12,11,2,2,3,1,2,2,2,2,2,3,3,13,14,5,15,10,14,12,15,1,1,1,1,1,1,12,10,19,10,8,20,8,10,86,20,11,9765282,7150,6500,5500,Northern_European,143,31,8,17787.0,ACF Fiorentina,25040431,4315000.0,4.0,26,1107,28,3,0,7,117,0,0.6103466525535857,0.5828877005347594,0.6911764705882353,0.0171667437551117,0.2039473684210526,0.1052631578947368,0.0192548137034258,0.0997749437359339,0.0239451095863773,0.4285714285714285,0.6279069767441858,0.5,334,69,24,38,1,6682,16,83,129,3400000,112068.96551724138,20000000.0,4000000.0,150000.0,250000.0,6,13750000,-0.24444444444444444,-0.43333333333333335
272278,Chris,Führich,2024,79,Germany,Castrop-Rauxel,Germany,09-01-98,Left Winger,Attack,Right,181.0,30-06-28,KL Sportsbase,https://img.a.transfermarkt.technology/portrait/header/272278-1691999004.jpg?lm=1,L1,Verein fÃ¼r Bewegungsspiele Stuttgart 1893,22000000.0,28000000.0,26,130,136,13,13,14,11,13,13,7,13,5,8,13,12,11,13,10,12,13,11,11,13,12,15,14,8,14,10,13,13,13,14,12,9,13,14,13,10,12,6,11,6,16,2,3,2,3,2,2,3,2,3,2,3,7,13,7,13,13,15,13,13,1,1,1,1,10,14,1,10,16,15,15,16,20,10,69,12,20,4339450,6450,6450,4850,Northern_European,129,0,0,14383.0,Unknown,91178612,1600000.0,2.0,38,334,40,0,1,7,211,7,0.6037311458057687,0.5133689839572192,0.588235294117647,0.0138797825816163,0.0,0.0,0.1097774443610902,0.1397849462365591,0.0088613572599238,0.1428571428571428,0.418604651162791,0.3333333333333332,300,58,43,18,0,2443,9,22,54,18000000,815909.0909090909,28000000.0,6000000.0,,150000.0,3,325000,-0.35714285714285715,0.058823529411764705
272587,Daniel-Kofi,Kyereh,2024,60,Ghana,Accra,Ghana,08-03-96,Attacking Midfield,Midfield,Right,179.0,Unknown,Alfaria sports GmbH,https://img.a.transfermarkt.technology/portrait/header/272587-1658413205.jpg?lm=1,L1,Sport-Club Freiburg,3500000.0,8000000.0,28,124,126,9,10,13,13,11,10,11,10,9,8,12,10,5,13,9,10,9,10,11,11,11,10,13,7,12,7,11,12,14,14,12,12,11,14,11,10,12,14,11,7,12,2,1,3,3,2,2,2,3,3,4,2,8,12,6,12,14,12,14,14,1,1,1,1,1,1,1,16,16,16,18,20,16,17,73,10,20,2238657,6099,6099,4499,Mixed_Race,108,12,0,4999.0,Unknown,91179959,4500000.0,1.0,39,20,41,3,1,4,189,0,0.5572902884360942,0.4758288770053475,0.4338235294117646,0.0048184301573859,0.0789473684210526,0.0,0.0172543135783946,0.0397599399849962,0.0249729159143309,0.0,0.3720930232558141,0.4166666666666665,227,67,47,36,1,2692,12,147,366,1500000,49166.666666666664,8000000.0,2000000.0,25000.0,50000.0,4,2275000,-0.5714285714285714,-0.75
272622,Issa,Diop,2024,931,France,Toulouse,France,09-01-97,Centre-Back,Defender,Right,194.0,30-06-27,firsteleven ISM,https://img.a.transfermarkt.technology/portrait/header/272622-1660565295.jpg?lm=1,GB1,Fulham Football Club,20000000.0,35000000.0,27,136,150,3,3,11,6,11,5,16,9,8,13,10,4,15,11,14,14,12,12,12,9,13,15,3,14,11,14,13,14,14,13,14,17,16,14,13,16,14,13,14,5,7,2,2,3,3,3,2,3,3,3,3,2,15,15,2,13,12,14,13,14,1,1,20,1,1,1,1,1,1,1,1,1,1,1,92,5,20,25902156,6800,6300,5750,African_Caribbean,135,0,0,75395.0,Unknown,85140415,21400000.0,2.0,34,1512,36,1,1,1,95,2,0.5838846255623181,0.6096256684491979,0.6323529411764706,0.0727940232153703,0.0,0.0,0.0997749437359339,0.1747936984246061,0.1188644129003583,0.1428571428571428,0.7209302325581395,0.375,293,16,7,52,1,5350,9,38,69,20000000,679310.3448275862,35000000.0,7000000.0,,6000000.0,2,6000000,0.0,-0.09090909090909091
272636,Harold,Moukoudi,2024,2441,France,Bondy,Cameroon,27-11-97,Centre-Back,Defender,Right,191.0,30-06-26,ROGON,https://img.a.transfermarkt.technology/portrait/header/272636-1728415050.png?lm=1,GR1,Athlitiki Enosi Konstantinoupoleos,4000000.0,5000000.0,27,125,135,3,6,8,5,12,6,14,7,7,14,11,9,15,12,15,12,15,13,12,8,12,15,9,10,8,13,13,15,12,11,15,15,15,13,14,16,13,12,14,10,10,1,1,1,2,3,1,2,1,3,2,1,12,15,12,12,12,13,9,10,1,1,20,7,1,6,10,1,1,1,1,1,1,1,84,6,20,4009498,6250,6050,3000,African_Caribbean,125,11,0,22451.0,Unknown,85133797,9111392.0,2.0,34,223,15,1,1,1,34,2,0.5508070918232336,0.3155080213903743,0.5588235294117647,0.0216703826837786,0.0723684210526315,0.0,0.0197549387346836,0.0247561890472618,0.0505924720131114,0.1428571428571428,0.6511627906976742,0.375,257,17,3,40,0,7244,13,38,38,4000000,188095.2380952381,5000000.0,1000000.0,150000.0,1000000.0,5,1900000,0.0,-0.2
272638,Jérôme,Onguéné,2024,24,Cameroon,Mbalmayo,Cameroon,22-12-97,Centre-Back,Defender,Right,186.0,30-06-27,fair-sport GmbH,https://img.a.transfermarkt.technology/portrait/header/272638-1663065454.jpg?lm=1,L1,Eintracht Frankfurt FuÃŸball AG,400000.0,5000000.0,27,123,134,4,6,8,6,12,5,13,5,8,12,11,8,14,11,14,12,17,12,11,9,11,17,6,11,6,13,14,15,13,11,15,14,16,14,14,15,11,10,15,6,7,1,3,1,3,1,3,2,1,2,3,3,11,13,8,11,15,12,10,12,1,1,20,1,1,1,12,1,10,1,1,1,1,1,79,12,20,3027232,6400,6150,4750,African_Caribbean,123,10,0,7691.0,Unknown,85135912,2250000.0,2.0,15,932,15,1,1,1,63,2,0.5640381053188674,0.5026737967914437,0.5441176470588236,0.0074178718374827,0.0657894736842105,0.0,0.0017504376094023,0.0247561890472618,0.0124725686824634,0.1428571428571428,0.5348837209302322,0.375,182,14,5,30,1,7231,11,53,84,300000,-13043.478260869566,5000000.0,1500000.0,1500000.0,3000000.0,8,4850000,-0.25,-0.7
272642,Allan,Saint-Maximin,2024,36,France,ChÃ¢tenay-Malabry,France,12-03-97,Left Winger,Attack,Right,173.0,30-06-25,KSM Sports,https://img.a.transfermarkt.technology/portrait/header/272642-1728392760.JPG?lm=1,TR1,FenerbahÃ§e Spor KulÃ¼bÃ¼,18000000.0,40000000.0,27,150,165,12,13,19,10,15,11,5,10,4,2,12,12,3,16,7,10,9,12,12,13,12,11,19,10,13,6,11,10,16,16,12,6,14,17,13,14,12,6,12,12,15,2,3,2,2,2,1,2,2,1,1,3,7,15,7,12,10,13,14,15,1,1,1,1,1,1,1,15,1,15,20,14,19,15,67,8,20,71200836,7493,6745,5993,African_Caribbean,138,0,0,104393.0,Unknown,85132406,15050000.0,4.0,34,360,36,0,1,1,84,7,0.6427626356178884,0.635614973262032,0.6544117647058822,0.1007949926951053,0.0,0.0,0.0897724431107777,0.1997999499874969,0.0835856551570876,0.4285714285714285,0.2325581395348837,0.375,0,0,0,0,0,0,24,63,62,17000000,510606.0606060606,40000000.0,8000000.0,2000000.0,15000000.0,7,16000000,-0.05555555555555555,-0.15
272706,James,Lawrence,2024,723,England,Henley-on-Thames,Wales,22-08-92,Centre-Back,Defender,Right,188.0,30-06-26,PUM,https://img.a.transfermarkt.technology/portrait/header/272706-1725529467.jpg?lm=1,NL1,Almere City Football Club,400000.0,1500000.0,32,112,-75,2,6,8,6,12,3,15,8,7,13,12,7,12,11,15,11,13,12,12,12,10,14,8,13,7,12,12,12,11,9,14,18,14,12,12,13,13,9,12,4,6,1,3,4,3,3,1,4,1,3,1,2,10,13,6,16,11,13,12,15,1,1,20,1,1,1,14,1,1,1,1,1,1,1,84,8,20,28679999,5489,5489,3491,Mixed_Race,110,0,0,9588.0,1. FC Magdeburg,91205066,9111392.0,2.0,32,611,106,1,1,4,17,2,0.4765811061127283,0.3680213903743315,0.4485294117647059,0.0092496477911022,0.0,0.0,0.0017504376094023,0.0072518129532383,0.0505924720131114,0.1428571428571428,0.581395348837209,0.5833333333333333,0,0,0,0,0,0,23,121,135,350000,11956.521739130434,1500000.0,250000.0,,,4,450000,-0.125,-0.3
272812,Kingsley,Ehizibue,2024,410,Germany,MÃ¼nchen,Netherlands,25-05-95,Right-Back,Defender,Right,189.0,30-06-26,Unknown,https://img.a.transfermarkt.technology/portrait/header/272812-1657109971.jpg?lm=1,IT1,Udinese Calcio,2200000.0,2500000.0,29,125,130,8,12,12,8,10,7,10,7,14,12,11,8,13,11,12,8,14,9,8,9,9,12,10,9,12,11,10,16,16,13,13,15,16,18,15,12,9,11,12,3,9,1,2,1,2,3,3,2,1,1,2,3,9,13,8,14,8,16,15,13,1,1,1,20,1,20,1,1,1,15,1,1,10,1,83,7,20,2072819,6250,6000,4250,African_Caribbean,115,0,0,17799.0,Unknown,37053569,1750000.0,2.0,38,1006,68,1,1,1,205,11,0.5441915850754168,0.4491978609625668,0.4852941176470588,0.0171783311623038,0.0,0.0,0.010752688172043,0.0122530632658164,0.0096947137420483,0.1428571428571428,0.6046511627906974,0.4583333333333332,332,14,27,53,1,5662,4,27,212,3000000,114423.07692307692,3000000.0,800000.0,,500000.0,2,500000,0.36363636363636365,0.2
272855,Paul,Onuachu,2024,180,Nigeria,Lagos,Nigeria,28-05-94,Centre-Forward,Attack,Right,201.0,30-06-26,CMG Sports,https://img.a.transfermarkt.technology/portrait/header/272855-1695672883.png?lm=1,GB1,Southampton Football Club,13000000.0,22000000.0,30,130,136,4,9,11,14,13,7,14,11,6,10,12,8,7,13,15,14,16,11,14,11,13,13,14,6,14,6,14,13,9,13,17,20,14,14,13,17,15,15,14,5,3,3,2,3,1,2,2,1,1,1,4,3,9,13,4,14,12,12,11,9,1,1,1,1,1,1,1,1,1,1,1,1,1,20,93,12,20,25765738,7001,6750,5501,African_Caribbean,133,15,3,25000.0,Unknown,27091941,12000000.0,2.0,69,789,70,0,1,1,186,3,0.6434241862926701,0.582994652406417,0.6176470588235294,0.0241317410948361,0.0986842105263157,0.0394736842105263,0.0647661915478869,0.1097774443610902,0.0666407400205561,0.1428571428571428,0.8837209302325584,0.5,384,183,40,51,0,9560,8,34,64,11000000,353225.8064516129,22000000.0,4000000.0,,200000.0,6,4600000,-0.15384615384615385,-0.15384615384615385
272930,Jamiro,Monteiro,2024,1269,Netherlands,Rotterdam,Cape Verde,23-11-93,Central Midfield,Midfield,Right,175.0,30-06-26,Prestige Sports,https://img.a.transfermarkt.technology/portrait/header/272930-1678020376.jpg?lm=1,NL1,Prins Hendrik Ende Desespereert Nimmer Combinatie Zwolle,2000000.0,4000000.0,31,123,125,11,9,13,10,14,11,11,11,6,6,14,12,7,13,5,12,12,12,10,12,11,10,14,7,14,7,15,13,14,12,12,11,14,14,14,9,12,5,13,5,13,1,3,2,3,3,1,1,3,2,3,3,14,13,3,10,11,10,11,10,1,1,1,1,1,1,11,13,20,13,11,17,10,1,64,12,20,1330512,6122,6010,3760,African_Caribbean,116,24,2,25080.0,Unknown,37041867,1414750.0,4.0,67,1253,17,3,1,1,156,1,0.5455146864249801,0.3967914438502673,0.4926470588235294,0.0242089904761169,0.1578947368421052,0.0263157894736842,0.0097524381095273,0.0197549387346836,0.0078321620045001,0.4285714285714285,0.2790697674418605,0.5416666666666665,309,36,42,53,3,5154,2,7,27,1500000,58695.65217391304,4000000.0,1000000.0,,,6,1650000,-0.25,-0.5
272999,Miguel,Almirón,2024,762,Paraguay,AsunciÃ³n,Paraguay,10-02-94,Right Winger,Attack,Left,174.0,30-06-26,Osvaldo Daniel Campo,https://img.a.transfermarkt.technology/portrait/header/272999-1674210265.jpg?lm=1,GB1,Newcastle United Football Club,20000000.0,35000000.0,30,140,158,10,11,13,11,12,10,6,9,4,8,12,11,10,12,7,12,11,9,12,13,11,12,13,6,15,11,15,19,16,15,12,6,10,17,15,10,13,9,11,11,14,2,1,3,2,2,2,1,1,1,2,2,14,10,8,12,8,14,13,12,1,1,1,1,1,1,1,17,12,16,17,19,20,13,70,20,6,48521667,6996,7246,5646,Mediterranean_Hispanic,131,44,6,86994.0,Unknown,79024232,10766666.67,3.0,73,103,75,0,0,3,137,10,0.7090500132310135,0.5985026737967913,0.6029411764705883,0.0839942178838111,0.2894736842105263,0.0789473684210526,0.0997749437359339,0.1747936984246061,0.0597886978527181,0.2857142857142857,0.2558139534883721,0.5,340,56,38,26,0,7273,13,32,50,16000000,608000.0,35000000.0,10000000.0,,,2,5500000,-0.2,-0.4666666666666667
273132,Robin,Gosens,2024,430,Germany,Emmerich,Germany,05-07-94,Left Midfield,Midfield,Left,183.0,30-06-25,MVP United,https://img.a.transfermarkt.technology/portrait/header/273132-1686641124.jpg?lm=1,IT1,Associazione Calcio Fiorentina,12000000.0,35000000.0,30,145,156,11,14,11,15,13,6,16,13,8,12,13,6,15,14,13,15,13,14,13,12,13,16,10,10,17,11,15,14,15,12,14,14,12,16,13,13,13,10,15,12,12,1,3,1,1,2,2,3,1,2,2,4,12,16,5,12,15,17,14,13,1,20,1,1,20,1,1,19,1,1,1,1,1,1,76,20,9,15000000,7250,7200,6500,Northern_European,141,13,2,28461.0,FC Internazionale Milano,37041773,10442500.0,4.0,38,462,40,3,0,7,26,6,0.702963747023022,0.6898395721925134,0.6764705882352942,0.027473742452494,0.0855263157894736,0.0263157894736842,0.0597649412353088,0.1747936984246061,0.0579877218811633,0.4285714285714285,0.4651162790697669,0.5,436,52,41,56,0,7350,16,60,93,8000000,263333.3333333333,35000000.0,7000000.0,,450000.0,5,11050000,-0.3333333333333333,-0.4666666666666667
273152,Nemanja,Maksimovic,2024,265,Yugoslavia (Republic),Banja Kovilja?a,Serbia,26-01-95,Central Midfield,Midfield,Right,189.0,30-06-27,Promoesport,https://img.a.transfermarkt.technology/portrait/header/273152-1665056964.jpg?lm=1,GR1,Panathinaikos Athlitikos Omilos,5500000.0,25000000.0,29,140,150,12,12,12,11,13,10,12,14,9,11,14,5,11,12,14,12,12,13,12,14,13,15,12,13,14,13,15,15,13,12,11,13,14,14,15,15,10,10,15,11,20,3,1,3,3,1,1,1,1,2,3,1,14,15,11,13,14,13,14,13,1,1,1,1,1,1,20,10,18,15,1,12,1,1,75,12,20,7812294,7000,6850,6250,Northern_European,134,39,0,23075.0,Unknown,62097340,6000000.0,2.0,110,135,85,3,1,7,150,1,0.6566551997883038,0.6631016042780749,0.625,0.0222729278577684,0.256578947368421,0.0,0.0272568142035508,0.1247811952988247,0.0333064807355759,0.1428571428571428,0.6046511627906974,0.4583333333333332,388,27,12,43,0,8665,4,7,18,5000000,153906.25,25000000.0,5000000.0,100000.0,2000000.0,4,5000000,-0.16666666666666666,-0.16666666666666666
273945,Miroslav,Bogosavac,2024,3725,Yugoslavia (Republic),Sremska Mitrovica,Serbia,14-10-96,Left-Back,Defender,Left,176.0,30-06-27,FAMILY FOOTBALL,https://img.a.transfermarkt.technology/portrait/header/273945-1605978554.png?lm=1,RU1,RFK Akhmat Grozny,2000000.0,3500000.0,28,123,129,10,11,13,6,12,6,11,7,11,12,12,10,13,12,11,13,12,11,12,11,11,13,11,10,11,13,13,14,13,13,13,11,13,13,14,13,16,10,12,10,8,1,1,3,1,3,1,1,1,2,3,3,11,11,8,13,12,13,12,13,1,20,10,10,15,10,13,13,1,10,1,1,1,1,69,20,12,3502631,6031,5687,4237,Northern_European,122,1,0,5800.0,Unknown,62137792,500000.0,1.0,110,1410,85,1,0,7,157,8,0.5027785128340831,0.447807486631016,0.536764705882353,0.0055918895874593,0.006578947368421,0.0,0.0097524381095273,0.0172543135783946,0.0027500763910108,0.0,0.3023255813953489,0.4166666666666665,293,4,21,37,0,4572,3,30,190,1800000,73913.04347826086,3500000.0,500000.0,100000.0,550000.0,3,850000,-0.21739130434782608,-0.28
274461,Felix,Passlack,2024,80,Germany,Bottrop,Germany,29-05-98,Right-Back,Defender,Right,170.0,30-06-25,Unknown,https://img.a.transfermarkt.technology/portrait/header/274461-1691250368.jpg?lm=1,L1,Verein fÃ¼r LeibesÃ¼bungen Bochum 1848 FuÃŸballgemeinschaft,2500000.0,3000000.0,26,128,135,11,11,11,10,10,11,8,9,14,9,10,14,10,11,15,8,15,9,8,8,8,15,11,11,10,10,16,16,16,14,11,7,15,16,14,10,10,7,12,4,17,1,4,2,1,2,1,3,2,3,2,1,7,12,8,15,10,14,15,12,1,15,1,20,14,20,1,12,10,15,10,10,15,1,74,12,20,1100089,6250,6250,4750,Northern_European,108,0,0,19230.0,Unknown,92071494,9111392.0,2.0,38,231,40,1,1,7,212,11,0.5772691188145012,0.5026737967914437,0.4338235294117646,0.018560129469963,0.0,0.0,0.0122530632658164,0.0147536884221055,0.0505924720131114,0.1428571428571428,0.1627906976744184,0.3333333333333332,229,53,56,30,1,7094,8,12,29,2000000,71428.57142857143,3000000.0,1000000.0,3000000.0,1500000.0,5,2200000,0.1111111111111111,0.3333333333333333
274839,Wilfred,Ndidi,2024,1003,Nigeria,Lagos,Nigeria,16-12-96,Defensive Midfield,Midfield,Right,183.0,30-06-27,Wonder Sports,https://img.a.transfermarkt.technology/portrait/header/274839-1718269781.jpg?lm=1,GB1,Leicester City Football Club,16000000.0,60000000.0,28,149,163,10,10,12,7,13,10,14,12,10,13,13,6,19,13,14,18,13,12,13,13,12,14,11,10,11,15,15,17,13,12,11,15,17,12,16,14,14,10,13,10,12,1,1,2,3,1,3,1,3,2,1,1,14,16,5,14,14,14,12,14,1,6,14,8,6,6,20,1,19,1,1,10,1,1,74,8,20,51973011,7449,7749,5999,African_Caribbean,144,48,0,92793.0,Unknown,18091791,8890000.0,2.0,69,789,70,3,1,1,127,4,0.7756020111140514,0.6362566844919786,0.6985294117647058,0.0895938324093985,0.3157894736842105,0.0,0.0797699424856214,0.2998249562390597,0.0493624822911747,0.1428571428571428,0.4651162790697669,0.4166666666666665,374,25,24,61,0,6971,10,85,75,18000000,574193.5483870967,60000000.0,10000000.0,800000.0,14000000.0,1,6000000,0.125,0.0
274862,Moses,Simon,2024,995,Nigeria,Jos,Nigeria,12-07-95,Left Winger,Attack,Right,168.0,30-06-26,CAA Base Ltd,https://img.a.transfermarkt.technology/portrait/header/274862-1703065226.jpg?lm=1,FR1,Football Club de Nantes,12000000.0,12000000.0,29,135,138,11,13,15,12,14,10,6,11,4,5,14,11,6,15,8,11,15,11,12,13,11,12,16,9,17,10,11,11,16,14,11,5,12,16,13,10,12,8,9,11,10,2,2,3,1,4,3,1,1,1,3,1,12,14,9,12,12,13,13,11,1,1,1,1,1,1,1,17,7,12,20,12,18,12,66,9,20,9954790,6750,6750,4700,African_Caribbean,133,53,7,34496.0,Unknown,13139098,3100000.0,3.0,69,691,70,0,1,1,93,7,0.6434241862926701,0.4973262032085561,0.6176470588235294,0.0333012426528596,0.3486842105263157,0.0921052631578947,0.0597649412353088,0.0597649412353088,0.0171949220811689,0.2857142857142857,0.1162790697674416,0.4583333333333332,386,73,68,21,1,7574,8,46,98,12000000,431481.48148148146,12000000.0,3000000.0,350000.0,4000000.0,3,7900000,0.0,0.2
275218,Augusto,Batalla,2024,367,Argentina,Hurlingham,Argentina,30-04-96,Goalkeeper,Goalkeeper,Right,186.0,30-06-25,Hernan Berman,https://img.a.transfermarkt.technology/portrait/header/275218-1656336113.JPG?lm=1,ES1,Rayo Vallecano de Madrid S.A.D.,5000000.0,6000000.0,28,121,124,6,2,2,3,11,9,2,1,3,1,9,1,2,9,11,11,16,9,9,10,10,14,8,13,2,11,15,14,10,12,15,13,12,11,13,14,10,11,6,9,11,11,10,12,6,15,13,14,15,8,12,14,20,13,7,15,3,9,4,4,20,1,1,1,1,1,1,1,1,1,1,1,1,1,79,8,20,878463,5850,5850,3300,Mediterranean_Hispanic,118,0,0,7548.0,Club AtlÃ©tico San Lorenzo de Almagro,14059327,9111392.0,2.0,4,643,4,2,1,3,163,5,0.5243450648319662,0.3475935828877005,0.5073529411764706,0.0072797885684434,0.0,0.0,0.0247561890472618,0.0297574393598399,0.0505924720131114,0.1428571428571428,0.5348837209302322,0.4166666666666665,0,0,0,0,0,0,2,3,12,6000000,268181.8181818182,6000000.0,1000000.0,100000.0,3000000.0,7,2750000,0.2,0.0
275303,Hans,Hateboer,2024,273,Netherlands,Beerta,Netherlands,09-01-94,Right-Back,Defender,Right,187.0,30-06-26,SEG,https://img.a.transfermarkt.technology/portrait/header/275303-1661509184.jpg?lm=1,FR1,Stade Rennais Football Club,3500000.0,18000000.0,30,141,149,8,12,10,11,11,8,14,8,11,13,11,8,13,12,16,12,16,14,14,8,12,16,8,11,13,13,16,15,15,11,14,14,16,17,15,16,12,15,13,10,12,2,1,1,2,2,3,2,2,2,1,1,16,13,3,13,13,15,14,12,1,1,13,20,1,20,1,1,1,16,1,1,1,1,72,8,20,11012888,7048,6748,5898,Northern_European,137,13,0,28461.0,Unknown,37046941,2020000.0,2.0,67,163,68,1,1,7,195,11,0.6431595660227574,0.6254545454545454,0.6470588235294117,0.027473742452494,0.0855263157894736,0.0,0.0172543135783946,0.0897724431107777,0.0111947554098724,0.1428571428571428,0.5581395348837206,0.5,429,18,35,76,1,9070,10,79,209,3000000,109259.25925925926,18000000.0,4000000.0,,500000.0,3,550000,-0.14285714285714285,-0.25
275935,Dorukhan,Toköz,2024,7160,TÃ¼rkiye,Eskisehir,TÃ¼rkiye,21-05-96,Central Midfield,Midfield,Right,180.0,30-06-25,Foot & Ball,https://img.a.transfermarkt.technology/portrait/header/275935-1695116313.png?lm=1,TR1,EyÃ¼p Spor KulÃ¼bÃ¼,1500000.0,7000000.0,28,125,130,8,8,11,9,12,8,12,12,5,13,12,6,14,12,17,12,17,11,14,10,12,16,9,8,12,14,17,18,12,12,14,10,13,12,14,13,13,12,12,8,17,2,3,2,3,1,2,2,1,3,3,3,20,18,7,12,14,16,13,10,1,1,1,18,1,1,20,1,18,1,1,1,1,1,73,8,20,3717309,6200,6200,5000,Mediterranean_Hispanic,123,14,1,44312.0,Unknown,70097267,150000.0,1.0,100,470,100,3,1,3,66,1,0.5706536120666843,0.5294117647058822,0.5441176470588236,0.042779741736006,0.0921052631578947,0.0131578947368421,0.0072518129532383,0.0347586896724181,0.0008055779327203,0.0,0.3953488372093026,0.4166666666666665,220,9,19,34,1,4237,18,145,228,1400000,46428.57142857143,7000000.0,1200000.0,,100000.0,4,3650000,-0.3333333333333333,-0.6
276853,Andries,Noppert,2024,306,Netherlands,Heerenveen,Netherlands,07-04-94,Goalkeeper,Goalkeeper,Left,203.0,30-06-27,World Soccer Consult,https://img.a.transfermarkt.technology/portrait/header/276853-1723714874.jpg?lm=1,NL1,Sportclub Heerenveen,1500000.0,5000000.0,30,120,125,3,1,1,3,6,1,5,1,2,3,9,3,2,5,12,10,15,12,13,7,12,14,15,13,8,13,12,14,7,11,14,20,15,7,12,16,13,6,13,6,1,18,14,11,11,13,11,13,14,14,14,11,16,14,6,12,15,16,14,9,20,1,1,1,1,1,1,1,1,1,1,1,1,1,87,20,6,3415498,6250,6250,4250,Northern_European,121,0,0,1749.0,Unknown,37045758,9111392.0,2.0,67,603,68,2,0,7,190,5,0.5772691188145012,0.4491978609625668,0.5294117647058822,0.001680174042856,0.0,0.0,0.0072518129532383,0.0247561890472618,0.0505924720131114,0.1428571428571428,0.9302325581395344,0.5,0,0,0,0,0,0,3,47,365,1000000,36538.46153846154,5000000.0,1500000.0,,50000.0,5,575000,-0.3333333333333333,-0.6666666666666666
276896,Samuel,Gigot,2024,398,France,Avignon,France,12-10-93,Centre-Back,Defender,Right,187.0,30-06-25,Unknown,https://img.a.transfermarkt.technology/portrait/header/276896-1703066101.jpg?lm=1,IT1,SocietÃ  Sportiva Lazio S.p.A.,9000000.0,11000000.0,31,136,140,1,10,11,9,12,10,15,13,2,16,13,4,12,12,10,14,15,13,12,11,11,18,16,13,10,14,15,12,12,13,13,15,16,14,12,15,13,7,15,11,12,1,3,3,3,4,3,2,1,1,2,3,15,14,5,11,17,17,17,15,1,1,20,1,1,1,9,1,6,1,1,1,1,1,83,10,20,5222234,6290,6290,5490,North_African__Middle_Eastern,135,0,0,43499.0,Unknown,48031358,3266666.667,3.0,34,111,36,1,1,6,185,2,0.5825615242127548,0.5818181818181818,0.6323529411764706,0.0419946948987405,0.0,0.0,0.0447611902975743,0.0547636909227306,0.0181208737298258,0.2857142857142857,0.5581395348837206,0.5416666666666665,0,0,0,0,0,0,15,57,182,4000000,120312.5,11000000.0,4000000.0,,150000.0,5,6400000,-0.5555555555555556,-0.6
277033,David,Brooks,2024,989,England,Warrington,Wales,08-07-97,Right Winger,Attack,Left,173.0,30-06-26,Unique Sports Group,https://img.a.transfermarkt.technology/portrait/header/277033-1700650102.jpg?lm=1,GB1,Association Football Club Bournemouth,8000000.0,30000000.0,27,132,164,9,11,15,13,14,10,8,8,4,7,14,8,9,15,6,14,6,14,9,15,13,14,18,5,15,8,12,15,14,16,15,6,11,15,12,7,12,3,9,10,6,2,1,3,3,3,3,1,1,3,3,1,10,16,4,14,14,14,13,13,1,1,1,1,1,1,1,1,13,18,1,20,20,13,65,20,9,21585132,6600,6750,5500,Northern_European,130,21,2,40597.0,Unknown,28095352,11300000.0,1.0,32,1645,106,0,0,7,22,10,0.6434241862926701,0.5828877005347594,0.5955882352941175,0.0391924735927818,0.1381578947368421,0.0263157894736842,0.0397599399849962,0.1497874468617154,0.0627517431039751,0.0,0.2325581395348837,0.375,196,28,32,23,0,5080,14,150,325,9000000,416666.6666666667,30000000.0,6000000.0,,5000000.0,3,6000000,0.125,0.0
277118,Manu,García,2024,605,Spain,Oviedo,Spain,02-01-98,Attacking Midfield,Midfield,Right,169.0,30-06-26,IFM,https://img.a.transfermarkt.technology/portrait/header/277118-1647530564.jpg?lm=1,GR1,Aris Thessalonikis,2500000.0,5000000.0,26,130,145,11,12,14,9,16,13,6,9,6,9,15,8,9,15,11,11,11,11,12,16,13,14,17,10,15,12,12,13,13,13,13,7,14,12,11,9,12,6,9,8,12,1,3,2,2,1,4,1,1,2,2,2,18,11,5,17,12,12,16,16,1,1,1,1,1,1,1,1,19,1,10,20,14,1,65,13,20,5444999,6500,6500,5000,Mediterranean_Hispanic,128,1,0,18923.0,Unknown,28100242,2483333.333,3.0,89,1104,89,3,1,3,20,0,0.6103466525535857,0.5294117647058822,0.5808823529411764,0.0182636849692982,0.006578947368421,0.0,0.0122530632658164,0.0247561890472618,0.0137689009861385,0.2857142857142857,0.13953488372093,0.3333333333333332,290,21,40,32,0,4263,5,42,263,3000000,83333.33333333333,5000000.0,1000000.0,1000000.0,5000000.0,5,4250000,0.2,0.2
277137,Renato,Tapia,2024,1244,Peru,Lima,Peru,28-07-95,Defensive Midfield,Midfield,Right,185.0,30-06-26,AGREF,https://img.a.transfermarkt.technology/portrait/header/277137-1718679726.jpg?lm=1,ES1,Club Deportivo LeganÃ©s S.A.D.,5000000.0,20000000.0,29,145,150,9,7,11,8,13,8,13,11,11,14,14,12,15,15,16,14,15,13,15,12,12,14,12,13,12,15,15,17,13,14,14,14,15,13,15,14,11,12,15,9,14,2,2,2,2,3,1,2,1,3,4,1,9,15,7,12,13,15,12,14,1,1,15,1,1,1,20,5,17,5,1,2,1,1,80,10,20,7056909,6600,6600,5600,African_Caribbean,144,75,5,12348.0,Unknown,77029444,1500000.0,1.0,74,836,76,3,1,1,54,4,0.6235776660492194,0.5935828877005347,0.6985294117647058,0.0119147514452876,0.4934210526315789,0.0657894736842105,0.0247561890472618,0.0997749437359339,0.0083057862718408,0.0,0.5116279069767438,0.4583333333333332,305,12,7,53,1,6718,14,64,92,5000000,159677.4193548387,20000000.0,5000000.0,300000.0,2500000.0,6,850000,0.0,0.0
277179,Unknown,Angeliño,2024,12,Spain,Coristanco,Spain,04-01-97,Left-Back,Defender,Left,171.0,30-06-28,WAKAI SPORTS,https://img.a.transfermarkt.technology/portrait/header/277179-1706626191.jpg?lm=1,IT1,Associazione Sportiva Roma,8000000.0,35000000.0,27,149,156,13,17,13,10,12,13,8,11,10,10,15,10,15,15,13,15,13,14,13,14,15,13,13,9,14,11,16,17,15,14,13,9,13,13,16,10,14,8,13,4,11,4,2,1,1,2,2,2,3,1,3,1,14,16,7,11,10,15,11,14,1,20,8,1,19,1,8,16,8,1,14,1,1,1,69,20,8,25253317,7248,7248,5998,Mediterranean_Hispanic,143,0,0,57533.0,TSG Hoffenheim,28095342,9040000.0,5.0,89,383,89,1,0,3,29,8,0.7093146335009262,0.6361497326203208,0.6911764705882353,0.0555461676099138,0.0,0.0,0.0397599399849962,0.1747936984246061,0.0501958387732992,0.5714285714285714,0.1860465116279068,0.375,403,26,83,47,1,11613,3,10,41,8000000,308000.0,35000000.0,10000000.0,,500000.0,8,21500000,0.0,0.0
277384,Martin,Valjent,2024,237,Slovakia,Dubnica nad VÃ¡hom,Slovakia,11-12-95,Centre-Back,Defender,Right,187.0,30-06-25,20 Sport,https://img.a.transfermarkt.technology/portrait/header/277384-1568027892.jpg?lm=1,ES1,Real Club Deportivo Mallorca S.A.D.,6000000.0,6000000.0,29,129,141,4,8,7,7,12,4,15,4,7,14,12,5,14,10,13,13,12,13,13,11,13,10,11,10,9,14,13,13,12,12,13,13,13,13,14,15,14,11,13,5,14,2,1,3,3,4,3,1,2,1,1,2,15,11,5,15,11,13,12,10,1,11,20,15,1,6,14,1,12,5,1,2,3,1,70,10,20,3395807,6400,6500,4250,Northern_European,128,13,0,8491.0,Unknown,43143925,1000000.0,2.0,86,434,86,1,1,7,166,2,0.6103466525535857,0.4491978609625668,0.5808823529411764,0.0081903656502901,0.0855263157894736,0.0,0.0297574393598399,0.0297574393598399,0.0055279313314258,0.1428571428571428,0.5581395348837206,0.4583333333333332,395,8,3,57,2,2970,2,6,17,6000000,219444.44444444444,6000000.0,1000000.0,100000.0,1100000.0,1,0,0.0,0.3333333333333333
278296,Antonio,Raíllo,2024,237,Spain,CÃ³rdoba,Spain,08-10-91,Centre-Back,Defender,Right,187.0,30-06-26,Promoesport,https://img.a.transfermarkt.technology/portrait/header/278296-1447228780.jpg?lm=1,ES1,Real Club Deportivo Mallorca S.A.D.,2000000.0,4000000.0,33,125,128,5,6,7,7,9,8,14,7,9,13,11,3,13,10,14,14,14,12,15,9,15,5,7,13,8,13,15,15,10,10,11,13,12,12,14,14,14,11,4,13,16,1,3,2,1,1,2,1,3,1,1,2,7,13,5,9,12,12,11,17,1,1,20,1,1,1,17,1,1,1,1,1,1,1,77,8,20,1823372,6200,6200,3550,Mediterranean_Hispanic,122,0,0,6023.0,Unknown,67148381,9111392.0,2.0,89,400,89,1,1,3,166,2,0.5706536120666843,0.374331550802139,0.536764705882353,0.0058072222377793,0.0,0.0,0.0097524381095273,0.0197549387346836,0.0505924720131114,0.1428571428571428,0.5581395348837206,0.625,378,23,9,100,5,2712,2,32,171,2000000,74074.07407407407,4000000.0,1500000.0,,,3,400000,0.0,-0.2
278332,Florian,Neuhaus,2024,18,Germany,Landsberg am Lech,Germany,16-03-97,Central Midfield,Midfield,Right,185.0,30-06-27,CN Sports,https://img.a.transfermarkt.technology/portrait/header/278332-1662966489.jpg?lm=1,L1,Borussia Verein fÃ¼r LeibesÃ¼bungen 1900 MÃ¶nchengladbach,5000000.0,38000000.0,27,141,150,11,9,13,11,15,12,7,14,4,12,15,8,13,15,13,13,13,15,13,15,14,13,13,8,12,12,12,13,12,12,14,11,17,13,16,11,12,11,14,6,16,3,4,2,2,1,2,2,3,3,3,2,8,13,8,12,12,14,11,12,1,1,1,1,1,1,15,12,20,12,10,15,10,8,77,12,20,19064308,7150,7150,6150,Northern_European,140,10,2,57533.0,Unknown,91167376,9111392.0,2.0,38,796,40,3,1,7,42,1,0.696348240275205,0.6524064171122994,0.6691176470588234,0.0555461676099138,0.0657894736842105,0.0263157894736842,0.0247561890472618,0.1897974493623406,0.0505924720131114,0.1428571428571428,0.5116279069767438,0.375,315,47,40,52,0,4211,13,59,106,3500000,125925.92592592593,38000000.0,7000000.0,,1500000.0,2,7200000,-0.5,-0.6111111111111112
278343,Felix,Uduokhai,2024,114,Germany,Annaberg-Buchholz,Germany,09-09-97,Centre-Back,Defender,Left,193.0,30-06-25,CN Sports,https://img.a.transfermarkt.technology/portrait/header/278343-1727357502.png?lm=1,TR1,Be?ikta? Jimnastik KulÃ¼bÃ¼,8500000.0,16000000.0,27,134,150,5,9,9,6,11,5,14,7,10,14,13,9,14,12,10,13,15,13,12,12,12,11,9,10,8,12,14,13,13,12,15,16,16,15,14,14,12,7,14,7,14,2,2,1,3,3,2,3,3,1,1,2,11,16,6,12,10,14,15,15,1,15,20,1,11,1,10,1,10,1,1,1,1,8,78,20,12,7769901,6750,6750,5500,Mixed_Race,134,0,0,14383.0,Unknown,91144514,4333333.333,3.0,38,72,40,1,0,4,37,2,0.6434241862926701,0.5828877005347594,0.625,0.0138797825816163,0.0,0.0,0.0422605651412853,0.0797699424856214,0.024046964265674,0.2857142857142857,0.6976744186046511,0.375,0,0,0,0,0,0,20,89,99,8000000,281250.0,16000000.0,4000000.0,150000.0,8000000.0,3,5700000,0.14285714285714285,0.14285714285714285
278359,Borja,Iglesias,2024,940,Spain,Santiago de Compostela,Spain,17-01-93,Centre-Forward,Attack,Right,187.0,30-06-25,Unknown,https://img.a.transfermarkt.technology/portrait/header/278359-1686661509.jpg?lm=1,ES1,Real Club Celta de Vigo S. A. D.,5000000.0,28000000.0,31,151,155,5,11,13,16,13,10,16,12,7,7,12,14,8,13,12,15,14,13,14,12,14,14,12,13,16,9,15,16,13,13,13,15,14,15,13,16,12,7,13,6,10,3,2,1,2,3,2,1,1,2,2,2,11,12,6,12,14,16,18,14,1,1,1,1,1,1,1,1,1,1,10,1,14,20,86,11,20,18054223,7100,7100,6000,Mediterranean_Hispanic,150,0,0,25377.0,Unknown,67173048,19000000.0,2.0,89,1335,89,0,1,3,165,3,0.6897327335273882,0.6363636363636364,0.7426470588235294,0.0244957788041216,0.0,0.0,0.0247561890472618,0.1397849462365591,0.1055307091863662,0.1428571428571428,0.5581395348837206,0.5416666666666665,0,0,0,0,0,0,4,7,22,4000000,125862.06896551725,28000000.0,10000000.0,,,5,20300000,-0.2,-0.5
278531,Sebastiano,Luperto,2024,1390,Italy,Lecce,Italy,06-09-96,Centre-Back,Defender,Left,191.0,30-06-28,Unknown,https://img.a.transfermarkt.technology/portrait/header/278531-1634293876.jpg?lm=1,IT1,Cagliari Calcio,3500000.0,5000000.0,28,128,134,5,9,7,6,10,7,15,6,11,14,12,9,13,10,14,14,14,13,13,10,11,12,5,11,9,14,13,14,12,11,12,16,15,13,14,15,12,10,10,5,12,3,3,2,3,3,3,1,1,3,3,2,12,14,5,14,12,13,13,10,1,15,20,4,1,1,1,1,1,1,1,1,1,1,75,20,8,1540325,6400,6400,5150,Mediterranean_Hispanic,128,0,0,24903.0,Empoli Football Club,43095145,2163333.333,3.0,52,808,54,1,0,3,46,2,0.5971156390579518,0.5454545454545454,0.5808823529411764,0.0240380762200332,0.0,0.0,0.0172543135783946,0.0247561890472618,0.0119910738242728,0.2857142857142857,0.6511627906976742,0.4166666666666665,317,10,9,30,5,4614,7,21,38,3500000,141666.66666666666,5000000.0,1000000.0,150000.0,1000000.0,6,1000000,0.0,0.16666666666666666
278654,Emre,Akbaba,2024,7160,France,Seine-Saint-Denis,TÃ¼rkiye,04-10-92,Attacking Midfield,Midfield,Left,180.0,30-06-26,Unknown,https://img.a.transfermarkt.technology/portrait/header/278654-1695118241.png?lm=1,TR1,EyÃ¼p Spor KulÃ¼bÃ¼,1200000.0,5500000.0,32,120,130,14,15,13,13,13,14,10,14,7,3,14,13,4,16,13,13,8,14,12,14,13,12,15,12,14,6,14,13,11,14,10,8,10,11,11,11,14,10,11,12,12,2,3,2,1,2,3,3,1,1,1,1,10,15,5,18,15,15,14,13,1,1,1,1,1,1,1,10,14,8,12,20,14,17,70,20,8,3195580,6050,6050,5000,Mediterranean_Hispanic,119,6,3,21211.0,Unknown,70085757,2250000.0,2.0,34,1358,100,3,0,3,66,0,0.5508070918232336,0.5294117647058822,0.5147058823529411,0.0204730172739272,0.0394736842105263,0.0394736842105263,0.0057514378594648,0.0272568142035508,0.0124725686824634,0.1428571428571428,0.3953488372093026,0.5833333333333333,387,104,49,53,1,5937,9,97,193,1000000,27142.85714285714,5500000.0,2000000.0,,50000.0,7,3400000,-0.23076923076923078,-0.375
278837,Luis,Rioja,2024,1049,Spain,Sevilla,Spain,16-10-93,Left Winger,Attack,Left,176.0,30-06-26,Promoesport,https://img.a.transfermarkt.technology/portrait/header/278837-1647530464.jpg?lm=1,ES1,Valencia Club de FÃºtbol S. A. D.,4000000.0,4000000.0,31,125,130,14,12,14,12,12,15,6,8,6,8,11,5,9,13,12,12,11,11,11,12,13,5,10,12,13,12,11,13,15,14,7,7,14,17,14,9,16,7,1,11,16,2,3,2,3,1,3,3,2,1,2,3,8,11,6,12,10,9,11,10,1,1,1,1,1,1,1,19,1,11,20,12,19,1,65,20,5,3116779,6200,6200,3500,Mediterranean_Hispanic,124,0,0,14419.0,Unknown,67196000,1116666.667,3.0,89,1364,89,0,0,3,208,7,0.5706536120666843,0.3689839572192513,0.5514705882352942,0.0139145448031927,0.0,0.0,0.0197549387346836,0.0197549387346836,0.0061760974860412,0.2857142857142857,0.3023255813953489,0.5416666666666665,401,45,21,43,2,2133,0,0,0,2000000,80952.38095238095,4000000.0,2000000.0,,,4,3300000,-0.5,-0.3333333333333333
279242,Zelimkhan,Bakaev,2024,3719,Russia,Nazran,Russia,01-07-96,Right Winger,Attack,Left,180.0,30-06-25,prosm,https://img.a.transfermarkt.technology/portrait/header/279242-1721723862.png?lm=1,RU1,FK Khimki,1800000.0,10000000.0,28,125,133,11,11,15,10,13,11,9,13,5,3,11,16,9,14,12,10,11,12,9,11,10,16,14,11,13,8,9,10,14,15,13,9,13,15,12,10,13,12,13,6,13,1,3,1,2,1,1,4,1,2,3,2,19,16,13,16,13,18,13,11,1,7,1,1,7,10,1,13,13,14,16,17,20,1,75,20,12,5120953,6199,6199,4699,Mediterranean_Hispanic,122,12,1,21152.0,Unknown,58104551,9111392.0,2.0,78,1022,81,0,0,3,76,10,0.570521301931728,0.4972192513368983,0.536764705882353,0.0204160458552327,0.0789473684210526,0.0131578947368421,0.0087521880470117,0.0497624406101525,0.0505924720131114,0.1428571428571428,0.3953488372093026,0.4166666666666665,328,47,48,43,2,6805,8,13,36,2000000,71296.29629629629,10000000.0,2000000.0,,200000.0,6,4525000,0.0,0.0
279455,Harry,Wilson,2024,931,Wales,Wrexham,Wales,22-03-97,Right Winger,Attack,Left,173.0,30-06-26,Unique Sports Group,https://img.a.transfermarkt.technology/portrait/header/279455-1668070758.jpg?lm=1,GB1,Fulham Football Club,17000000.0,25000000.0,27,135,140,14,15,15,14,14,16,5,14,3,6,14,15,7,15,11,12,10,15,9,14,14,15,14,12,14,7,12,13,14,14,14,6,13,14,13,8,12,5,12,9,9,3,1,2,1,3,2,3,2,3,1,1,11,14,8,16,10,14,10,13,1,1,1,1,1,1,1,13,11,11,16,18,20,12,0,20,9,33726766,6750,7000,5250,Northern_European,136,39,5,46397.0,Unknown,28094949,14000000.0,1.0,109,1676,106,0,0,7,95,10,0.6765017200317545,0.5561497326203209,0.6397058823529411,0.0447930537356352,0.256578947368421,0.0657894736842105,0.0847711927981995,0.1247811952988247,0.0777521597822161,0.0,0.2325581395348837,0.375,352,96,76,43,2,5764,9,44,69,17000000,804761.9047619047,25000000.0,4500000.0,100000.0,1000000.0,7,18400000,0.0,0.0
279457,Ryan,Kent,2024,36,England,Oldham,England,11-11-96,Left Winger,Attack,Right,176.0,30-06-27,Unknown,https://img.a.transfermarkt.technology/portrait/header/279457-1696447371.png?lm=1,TR1,FenerbahÃ§e Spor KulÃ¼bÃ¼,2700000.0,17500000.0,28,132,151,14,13,16,11,13,14,6,15,3,5,11,9,7,13,12,10,6,11,10,14,10,3,18,5,13,10,12,6,16,14,15,6,13,16,10,5,3,12,12,7,11,3,4,1,2,3,3,1,3,2,1,1,15,14,4,18,15,17,10,7,1,1,1,1,1,1,1,14,1,14,20,18,19,14,65,16,20,7335319,6600,6600,5750,Northern_European,126,0,0,23198.0,Unknown,28094948,7200000.0,1.0,32,1077,33,0,1,7,84,7,0.6235776660492194,0.6096256684491979,0.5661764705882353,0.0223916987814875,0.0,0.0,0.013253313328332,0.0872718179544886,0.039973332592572,0.0,0.3023255813953489,0.4166666666666665,355,48,72,22,0,10532,5,41,71,2700000,113043.47826086957,17500000.0,3500000.0,100000.0,1500000.0,4,2150000,-0.22857142857142856,-0.6142857142857143
279570,Daler,Kuzyaev,2024,738,Russia,"Naberezhnye Chelny, Tatarstan Republic",Russia,15-01-93,Central Midfield,Midfield,Right,182.0,30-06-25,Unknown,https://img.a.transfermarkt.technology/portrait/header/279570-1658064471.png?lm=1,FR1,Le Havre Athletic Club,8000000.0,11000000.0,31,133,136,10,10,12,12,12,10,9,13,10,12,14,13,13,13,11,14,14,14,17,12,13,10,10,10,12,13,16,13,12,12,12,10,13,14,14,10,16,7,13,10,16,2,2,1,2,2,1,1,2,3,2,1,19,13,5,10,13,16,13,14,1,1,1,14,12,14,16,14,20,15,13,13,12,8,72,11,20,6993353,6500,6500,5250,Northern_European,131,42,2,31260.0,Unknown,58090284,2150000.0,2.0,78,1010,81,3,1,7,126,1,0.6103466525535857,0.5561497326203209,0.6029411764705883,0.0301765051800538,0.2763157894736842,0.0263157894736842,0.0397599399849962,0.0547636909227306,0.0119169976943803,0.1428571428571428,0.4418604651162785,0.5416666666666665,352,28,36,54,1,7179,9,42,132,6000000,212500.0,11000000.0,2000000.0,,100000.0,3,1500000,-0.25,-0.4
280387,Vincent,Sierro,2024,415,Switzerland,Sion,Switzerland,08-10-95,Central Midfield,Midfield,Right,185.0,30-06-26,Gold Kick SA,https://img.a.transfermarkt.technology/portrait/header/280387-1708555105.jpg?lm=1,FR1,Toulouse Football Club,4000000.0,4000000.0,29,124,126,12,12,12,9,13,9,11,14,6,9,14,13,9,14,15,15,10,13,11,12,14,13,11,9,12,11,15,15,11,10,13,13,17,12,15,10,12,8,13,11,12,2,2,3,3,2,2,3,1,2,2,3,10,12,6,13,9,14,16,16,1,1,1,1,1,1,17,10,20,10,10,14,10,1,79,12,20,2301539,6167,6167,3934,Northern_European,124,0,0,10633.0,Unknown,98034038,1233333.333,3.0,92,1377,92,3,1,7,203,1,0.5662873776131252,0.4154010695187165,0.5514705882352942,0.0102587178340818,0.0,0.0,0.0197549387346836,0.0197549387346836,0.0068242636351009,0.2857142857142857,0.5116279069767438,0.4583333333333332,373,49,27,76,0,8910,18,76,126,4000000,152884.61538461538,4000000.0,600000.0,25000.0,750000.0,5,1300000,0.0,1.0
280575,Elvis,Rexhbecaj,2024,167,Yugoslavia (Republic),Prizren,Kosovo,01-11-97,Central Midfield,Midfield,Left,182.0,30-06-26,Soccertalk GmbH,https://img.a.transfermarkt.technology/portrait/header/280575-1723534071.jpg?lm=1,L1,FC Augsburg 1907,3500000.0,8000000.0,27,128,135,13,11,11,9,12,12,7,10,4,13,12,10,13,12,16,13,16,12,15,12,12,14,9,8,13,13,16,16,12,12,14,10,18,13,16,11,13,11,12,3,16,2,1,1,2,3,3,1,3,1,1,3,12,12,8,12,14,15,12,11,1,8,8,8,10,10,18,10,20,10,7,16,7,1,75,20,12,3727980,6400,6400,5100,Northern_European,127,0,0,23972.0,Unknown,91177383,1700000.0,1.0,110,1188,59,3,0,7,67,1,0.5971156390579518,0.5401069518716577,0.5735294117647058,0.0231390865453787,0.0,0.0,0.0172543135783946,0.0397599399849962,0.0094169282480068,0.0,0.4418604651162785,0.375,295,30,23,46,0,4033,5,15,91,3500000,181578.94736842104,8000000.0,3000000.0,50000.0,200000.0,4,2600000,0.0,0.0
280701,Théo,Bongonda,2024,232,Belgium,Charleroi,DR Congo,20-11-95,Right Winger,Attack,Left,175.0,30-06-27,Libera Sports,https://img.a.transfermarkt.technology/portrait/header/280701-1689146026.png?lm=1,RU1,FK Spartak Moskva,5000000.0,11000000.0,29,133,140,10,12,14,11,14,11,7,12,9,6,14,7,7,14,12,12,14,10,11,9,12,12,15,12,14,6,13,13,15,14,12,13,10,15,11,8,9,6,12,9,9,1,1,1,2,1,1,2,3,1,2,2,15,14,17,12,12,12,13,9,1,1,1,1,1,1,1,17,1,16,20,18,18,12,73,20,12,3957817,6500,6600,5000,Mixed_Race,127,3,0,22741.0,Unknown,18081111,3406666.667,6.0,7,347,29,0,0,4,82,10,0.6235776660492194,0.5294117647058822,0.5735294117647058,0.0219504116909213,0.0197368421052631,0.0,0.0247561890472618,0.0547636909227306,0.018898673113142,0.7142857142857142,0.2790697674418605,0.4583333333333332,377,84,58,35,2,7735,4,7,37,6000000,198333.33333333334,11000000.0,2000000.0,1500000.0,2500000.0,5,3500000,0.2,0.2
280730,Álvaro,Odriozola,2024,681,Spain,Donostia-San SebastiÃ¡n,Spain,14-12-95,Right-Back,Defender,Right,176.0,30-06-29,Best of You,https://img.a.transfermarkt.technology/portrait/header/280730-1579598607.jpg?lm=1,ES1,Real Sociedad de FÃºtbol S.A.D.,2500000.0,30000000.0,29,141,150,11,14,13,9,13,8,9,10,14,12,15,8,13,14,12,12,15,12,13,12,12,12,11,9,13,14,15,15,15,15,13,8,15,16,13,13,13,8,13,9,11,1,3,3,2,3,2,1,2,3,2,3,13,14,5,11,12,14,15,14,1,9,1,20,9,18,1,1,1,1,1,1,1,1,66,9,20,10407824,7050,7200,6000,Mediterranean_Hispanic,137,4,1,123288.0,Unknown,67199408,17500000.0,2.0,89,423,89,1,1,3,168,11,0.702963747023022,0.6363636363636364,0.6470588235294117,0.1190403309363494,0.0263157894736842,0.0131578947368421,0.0122530632658164,0.1497874468617154,0.0971971443651212,0.1428571428571428,0.3023255813953489,0.4583333333333332,254,9,28,29,1,5078,18,67,73,1200000,32142.85714285714,30000000.0,5000000.0,,300000.0,7,14000000,-0.52,-0.6
281404,Unknown,Kenedy,2024,366,Brazil,Santa Rita do SapucaÃ­,Brazil,08-02-96,Left Winger,Attack,Left,180.0,30-06-27,Unknown,https://img.a.transfermarkt.technology/portrait/header/281404-1455120897.jpg?lm=1,ES1,Real Valladolid Club de FÃºtbol S.A.D.,2000000.0,12000000.0,28,130,142,11,12,13,12,13,13,10,14,4,7,12,11,11,14,11,13,11,12,11,12,11,13,15,10,13,12,12,12,13,13,13,13,14,13,13,14,10,11,11,6,13,3,2,3,1,3,1,1,2,3,4,1,15,13,7,12,12,9,12,12,1,11,1,1,16,1,1,16,1,12,20,10,17,12,81,20,11,3957817,6500,6500,5500,Mediterranean_Hispanic,126,0,0,28998.0,Unknown,19192323,4250000.0,2.0,10,1329,11,0,0,3,169,7,0.6103466525535857,0.5828877005347594,0.5661764705882353,0.0279922789243409,0.0,0.0,0.0097524381095273,0.0597649412353088,0.0235839884441234,0.1428571428571428,0.3953488372093026,0.4166666666666665,237,22,26,20,1,5743,11,58,110,500000,12500.0,12000000.0,4000000.0,2000000.0,8000000.0,8,14500000,-0.75,-0.75
281769,Mario,Hermoso,2024,12,Spain,Madrid,Spain,18-06-95,Centre-Back,Defender,Left,184.0,30-06-27,CAA Base Ltd,https://img.a.transfermarkt.technology/portrait/header/281769-1666818938.jpg?lm=1,IT1,Associazione Sportiva Roma,25000000.0,35000000.0,29,143,158,7,10,10,7,10,8,14,9,14,15,12,10,16,12,13,14,14,14,14,11,12,14,8,10,9,15,14,14,14,14,13,11,13,15,14,14,12,11,13,8,15,1,1,1,2,1,3,1,1,2,3,3,13,12,12,9,10,13,7,7,1,17,20,1,12,1,1,8,1,1,1,1,1,1,75,20,10,13716520,7150,7150,6150,Mediterranean_Hispanic,142,5,0,164999.0,Unknown,67196188,18750000.0,2.0,89,892,89,1,0,3,29,2,0.696348240275205,0.6524064171122994,0.6838235294117647,0.1593171927188595,0.0328947368421052,0.0,0.1247811952988247,0.1747936984246061,0.1041417817161587,0.1428571428571428,0.4883720930232553,0.4583333333333332,0,0,0,0,0,0,15,35,43,10000000,316129.03225806454,35000000.0,8000000.0,200000.0,500000.0,5,8200000,-0.6,-0.6
281917,Dmitriy,Skopintsev,2024,121,Russia,Voronezh,Russia,02-03-97,Left-Back,Defender,Left,177.0,30-06-29,Unknown,https://img.a.transfermarkt.technology/portrait/header/281917-1721727569.png?lm=1,RU1,FK Dinamo Moskva,3500000.0,4500000.0,27,123,132,12,12,14,9,11,9,5,12,13,10,11,11,10,16,12,12,13,13,12,10,9,12,13,8,11,9,14,14,14,16,9,8,9,15,13,10,12,6,8,11,13,3,2,1,1,2,3,2,3,3,3,3,13,13,7,6,14,12,12,15,1,18,1,10,20,12,1,15,1,1,12,1,1,1,67,20,10,3801891,5996,5996,3746,Northern_European,119,0,0,14499.0,Unknown,58110292,2420000.0,4.0,78,1630,81,1,0,7,74,8,0.5436623445355915,0.3952941176470588,0.5147058823529411,0.0139917941844734,0.0,0.0,0.0172543135783946,0.0222555638909727,0.0134170393622045,0.4285714285714285,0.3255813953488373,0.375,0,0,0,0,0,0,3,12,41,3000000,112000.0,4500000.0,1000000.0,250000.0,400000.0,7,2000000,-0.14285714285714285,0.0
281963,Lucas,Hernández,2024,583,France,Marseille,France,14-02-96,Left-Back,Defender,Left,184.0,30-06-28,Unknown,https://img.a.transfermarkt.technology/portrait/header/281963-1667830435.jpg?lm=1,FR1,Paris Saint-Germain Football Club,40000000.0,70000000.0,28,155,160,4,12,12,7,12,9,14,7,12,16,14,7,17,13,17,15,19,14,15,12,14,19,10,12,12,16,15,18,14,13,15,13,13,15,15,13,14,12,15,11,14,1,1,3,3,2,3,1,3,3,3,3,12,17,18,12,15,12,10,8,1,18,20,10,14,1,1,1,1,1,1,1,1,1,79,20,7,55282496,7750,7650,7250,Mediterranean_Hispanic,156,32,0,249315.0,Unknown,67197145,62500000.0,2.0,34,919,36,1,0,3,154,8,0.7625033077533738,0.7700534759358288,0.7867647058823528,0.2407341781196921,0.2105263157894736,0.0,0.1997999499874969,0.3498374593648412,0.3472040890024722,0.1428571428571428,0.4883720930232553,0.4166666666666665,307,7,15,59,0,11199,23,149,220,32000000,1148148.148148148,70000000.0,14000000.0,,10000000.0,2,0,-0.2,-0.28888888888888886
281989,Luis,Milla,2024,3709,Spain,Madrid,Spain,07-10-94,Central Midfield,Midfield,Right,175.0,30-06-27,Promoesport,https://img.a.transfermarkt.technology/portrait/header/281989-1669364960.jpg?lm=1,ES1,Getafe Club de FÃºtbol S.A.D. Team Dubai,3500000.0,6000000.0,30,134,144,14,12,12,11,14,14,7,12,9,10,14,14,11,14,12,13,14,13,14,14,13,16,13,14,13,11,15,15,12,14,13,9,13,13,15,10,15,8,13,6,13,1,1,1,1,1,2,2,1,1,2,2,14,15,7,9,13,14,12,11,1,1,1,1,1,1,15,8,20,12,1,14,1,1,68,10,20,6617469,6700,6700,4500,Mediterranean_Hispanic,135,0,0,14096.0,Unknown,67191561,3500000.0,3.0,89,892,89,3,1,3,105,1,0.6368086795448531,0.4759358288770053,0.6323529411764706,0.0136026504262717,0.0,0.0,0.0172543135783946,0.0297574393598399,0.0194172060335009,0.2857142857142857,0.2790697674418605,0.5,324,25,26,57,1,2765,6,47,152,3500000,122222.22222222222,6000000.0,2000000.0,,,6,5150000,0.0,0.4
282041,Presnel,Kimpembe,2024,583,France,Beaumont-sur-Oise,France,13-08-95,Centre-Back,Defender,Left,183.0,30-06-26,CAA Stellar,https://img.a.transfermarkt.technology/portrait/header/282041-1672304083.jpg?lm=1,FR1,Paris Saint-Germain Football Club,9000000.0,40000000.0,29,159,164,4,10,10,6,13,5,16,6,8,16,12,10,17,13,17,15,18,15,16,10,14,16,8,12,10,15,16,16,13,13,16,14,16,14,16,16,14,9,16,7,10,3,1,2,3,1,1,2,3,1,1,1,9,17,7,14,15,15,16,14,1,10,20,1,1,1,7,1,1,1,1,1,1,1,77,20,10,57206289,7950,7950,7050,African_Caribbean,159,28,0,191781.0,Unknown,85141999,9111392.0,2.0,34,160,36,1,0,1,154,2,0.8021963482402752,0.748663101604278,0.8088235294117647,0.1851783543371182,0.1842105263157894,0.0,0.0447611902975743,0.1997999499874969,0.0505924720131114,0.1428571428571428,0.4651162790697669,0.4583333333333332,281,4,2,61,2,8130,15,137,639,8000000,290740.74074074073,40000000.0,7000000.0,,2000000.0,0,0,-0.3333333333333333,-0.6
282076,Ianis,Hagi,2024,124,TÃ¼rkiye,Istanbul,Romania,22-10-98,Attacking Midfield,Midfield,Right,182.0,31-05-26,AC Talent,https://img.a.transfermarkt.technology/portrait/header/282076-1718262072.jpg?lm=1,SC1,Rangers Football Club,1800000.0,7000000.0,26,126,139,16,16,13,13,15,17,6,15,5,7,15,14,5,16,9,13,12,12,13,14,10,13,14,13,12,8,13,14,9,11,12,8,14,9,12,10,11,10,15,5,12,2,3,4,3,3,1,2,3,2,1,2,15,15,8,12,15,14,14,12,1,1,1,1,1,1,1,1,14,1,15,20,19,11,72,18,20,6713022,6300,6500,5500,Mediterranean_Hispanic,125,24,2,23198.0,Unknown,57122678,3250000.0,4.0,100,667,80,3,1,3,161,0,0.6103466525535857,0.5828877005347594,0.5588235294117647,0.0223916987814875,0.1578947368421052,0.0263157894736842,0.0087521880470117,0.0347586896724181,0.0180282785632934,0.4285714285714285,0.4418604651162785,0.3333333333333332,277,56,51,39,1,10026,3,72,372,1500000,42592.59259259259,7000000.0,2000000.0,750000.0,6000000.0,6,2450000,-0.25,-0.5714285714285714
282144,Marin,Pongra?I?,2024,430,Germany,Landshut,Croatia,11-09-97,Centre-Back,Defender,Right,193.0,30-06-29,Match2gether,https://img.a.transfermarkt.technology/portrait/header/282144-1657202331.jpg?lm=1,IT1,Associazione Calcio Fiorentina,7000000.0,10000000.0,27,130,139,4,7,12,6,12,5,13,6,8,13,13,7,14,12,17,12,16,12,12,12,12,13,11,7,8,13,11,9,13,11,15,15,12,16,12,16,13,15,12,11,10,2,3,2,2,1,3,4,1,4,2,3,11,13,19,5,10,10,5,5,1,1,20,16,1,1,14,1,1,1,1,1,1,1,95,13,20,3363593,6500,6800,5500,Mediterranean_Hispanic,129,5,0,42192.0,Salento,91175664,6650000.0,4.0,38,797,25,1,1,3,26,2,0.6500396930404869,0.5828877005347594,0.588235294117647,0.0407326331320665,0.0328947368421052,0.0,0.0347586896724181,0.0497624406101525,0.0369176921581154,0.4285714285714285,0.6976744186046511,0.375,223,3,1,51,3,7049,12,107,134,10000000,433695.652173913,10000000.0,2000000.0,25000.0,2500000.0,6,7475000,0.42857142857142855,0.6666666666666666
282199,Erik,Palmer-Brown,2024,265,United States,"Napoleon, Ohio",United States,24-04-97,Centre-Back,Defender,Right,186.0,30-06-27,PROSPORT Management,https://img.a.transfermarkt.technology/portrait/header/282199-1600160216.png?lm=1,GR1,Panathinaikos Athlitikos Omilos,1200000.0,3000000.0,27,126,134,5,6,8,6,10,10,13,9,6,13,11,7,14,12,14,12,12,12,12,9,11,14,7,9,8,14,13,13,13,11,13,15,15,13,14,16,12,10,10,10,8,1,3,1,2,3,3,2,1,3,1,1,7,15,6,8,8,9,10,7,1,12,20,14,1,1,16,1,1,1,1,1,1,1,88,11,20,3240351,6295,6295,4010,African_Caribbean,124,4,0,11999.0,Unknown,72040029,1500000.0,1.0,104,1015,102,1,1,1,150,2,0.5832230748875364,0.4235294117647058,0.5514705882352942,0.0115777510194504,0.0263157894736842,0.0,0.0057514378594648,0.0147536884221055,0.0083057862718408,0.0,0.5348837209302322,0.375,208,4,1,24,1,6371,8,62,233,1000000,40909.09090909091,3000000.0,600000.0,50000.0,300000.0,8,1250000,-0.16666666666666666,-0.5
282250,Birger,Meling,2024,190,Norway,Stavanger,Norway,17-12-94,Left-Back,Defender,Left,173.0,30-06-27,GOLDBAEK SPORT GmbH,https://img.a.transfermarkt.technology/portrait/header/282250-1695237819.jpg?lm=1,DK1,Football Club KÃ¸benhavn,3500000.0,7000000.0,30,131,135,14,13,11,6,12,6,10,8,12,12,13,7,12,12,14,14,13,13,13,11,13,17,8,13,13,13,16,16,14,15,13,9,14,13,15,10,13,6,14,9,13,3,3,2,4,4,1,3,3,2,2,3,18,15,4,12,14,18,16,12,1,20,5,1,19,1,12,15,13,1,14,1,1,1,64,20,6,5522380,6550,6550,5250,Northern_European,128,22,0,23014.0,Unknown,29126536,9111392.0,2.0,71,1420,73,1,0,7,90,8,0.6169621593014025,0.5561497326203209,0.5808823529411764,0.0222140252045418,0.1447368421052631,0.0,0.0172543135783946,0.0347586896724181,0.0505924720131114,0.1428571428571428,0.2325581395348837,0.5,351,12,38,50,3,8652,7,55,112,3500000,161904.7619047619,7000000.0,1000000.0,,500000.0,4,3300000,0.0,-0.125
282388,Giovanni,Simeone,2024,6195,Argentina,Buenos Aires,Argentina,05-07-95,Centre-Forward,Attack,Right,180.0,30-06-26,Unknown,https://img.a.transfermarkt.technology/portrait/header/282388-1690294694.jpg?lm=1,IT1,SocietÃ  Sportiva Calcio Napoli,10000000.0,25000000.0,29,143,150,6,8,12,16,13,8,16,12,4,4,11,14,7,13,12,15,14,12,13,11,12,13,11,9,16,3,15,18,14,12,14,16,14,15,16,14,14,8,11,8,8,1,1,3,3,2,2,1,2,1,3,2,14,14,8,12,11,15,10,8,1,1,1,1,1,1,1,1,1,1,8,1,10,20,81,10,20,11770090,7146,6996,5746,Mediterranean_Hispanic,143,5,1,53364.0,Parthenope,14031138,11520000.0,5.0,4,275,4,0,1,3,184,3,0.6759724794919291,0.6091978609625668,0.6911764705882353,0.0515205092279214,0.0328947368421052,0.0131578947368421,0.0497624406101525,0.1247811952988247,0.0639739992777577,0.5714285714285714,0.3953488372093026,0.4583333333333332,387,101,29,30,0,4349,5,11,20,10000000,333333.3333333333,25000000.0,3500000.0,2000000.0,8000000.0,7,15250000,0.0,-0.23076923076923078
282411,Marcos,Llorente,2024,13,Spain,Madrid,Spain,30-01-95,Right Midfield,Midfield,Right,184.0,30-06-27,Unknown,https://img.a.transfermarkt.technology/portrait/header/282411-1684159821.jpg?lm=1,ES1,Club AtlÃ©tico de Madrid S.A.D.,30000000.0,80000000.0,29,155,163,9,11,12,12,12,8,13,11,7,11,15,11,15,14,13,15,13,15,14,14,14,16,9,12,13,12,16,16,13,11,11,10,18,14,16,15,15,14,13,7,19,3,3,1,3,2,3,1,1,3,3,1,12,15,5,16,16,18,13,12,1,1,12,13,1,18,19,1,20,19,1,18,13,14,73,10,20,99928133,7750,7750,7150,Mediterranean_Hispanic,142,16,0,153846.0,Unknown,67196198,30000000.0,1.0,89,892,89,3,1,3,52,9,0.7757343212490078,0.7593582887700534,0.6838235294117647,0.1485476633510588,0.1052631578947368,0.0,0.1497874468617154,0.3998499624906226,0.1666435178754965,0.0,0.4883720930232553,0.4583333333333332,377,36,43,54,1,7924,10,47,252,28000000,992857.1428571428,80000000.0,20000000.0,,,5,15200000,-0.06666666666666667,-0.06666666666666667
282421,Javi,Muñoz,2024,472,Spain,Parla,Spain,28-02-95,Central Midfield,Midfield,Right,177.0,30-06-25,Gesport Espizua SL,https://img.a.transfermarkt.technology/portrait/header/282421-1698852390.jpg?lm=1,ES1,UniÃ³n Deportiva Las Palmas S.A.D.,3000000.0,3000000.0,29,124,136,14,13,13,11,14,14,7,12,8,7,14,12,8,14,8,13,8,12,16,14,14,15,12,11,13,9,14,11,14,11,12,7,12,12,12,10,14,8,14,8,12,3,2,1,4,2,3,3,2,2,1,3,10,12,8,11,10,13,12,13,1,1,1,1,1,1,12,1,20,14,1,15,10,1,70,12,20,1491437,6150,6150,4000,Mediterranean_Hispanic,123,0,0,6587.0,Unknown,67199309,9111392.0,2.0,89,1124,89,3,1,3,207,1,0.5640381053188674,0.4224598930481283,0.5441176470588236,0.0063518303758085,0.0,0.0,0.0147536884221055,0.0147536884221055,0.0505924720131114,0.1428571428571428,0.3255813953488373,0.4583333333333332,368,20,23,66,2,2224,1,3,19,3000000,120833.33333333333,3000000.0,150000.0,,0.0,8,1950000,0.0,0.5
282429,Sergio,Reguilón,2024,148,Spain,Madrid,Spain,16-12-96,Left-Back,Defender,Left,178.0,30-06-25,Sports Invest UK ltd,https://img.a.transfermarkt.technology/portrait/header/282429-1705521655.jpg?lm=1,GB1,Tottenham Hotspur Football Club,12000000.0,28000000.0,28,141,152,10,12,12,10,13,9,11,11,13,13,12,12,14,13,15,14,14,13,12,13,14,15,12,12,15,13,15,16,15,14,13,8,15,15,15,12,13,8,14,8,13,2,2,2,3,2,1,1,3,2,2,2,13,14,7,12,11,13,9,11,1,20,8,1,17,1,1,14,1,1,12,1,1,1,64,20,7,27507440,7050,7500,6250,Mediterranean_Hispanic,140,6,0,57996.0,A. Madrid,67211900,30000000.0,1.0,89,892,89,1,0,3,202,8,0.7426567875099233,0.6631016042780749,0.6691176470588234,0.055993248404076,0.0394736842105263,0.0,0.0597649412353088,0.1397849462365591,0.1666435178754965,0.0,0.3488372093023257,0.4166666666666665,0,0,0,0,0,0,10,43,68,11000000,400000.0,28000000.0,5000000.0,,300000.0,9,18800000,-0.08333333333333333,0.1
282660,Maximilian,Mittelstädt,2024,79,Germany,Berlin,Germany,18-03-97,Left-Back,Defender,Left,180.0,30-06-28,Sports360 GmbH,https://img.a.transfermarkt.technology/portrait/header/282660-1723707584.jpg?lm=1,L1,Verein fÃ¼r Bewegungsspiele Stuttgart 1893,17000000.0,17000000.0,27,133,141,12,13,13,6,14,11,12,11,12,10,14,10,12,14,13,10,14,13,10,12,10,14,13,11,11,9,14,16,14,14,12,12,13,14,15,11,9,12,13,7,16,3,1,1,1,4,3,4,1,1,1,1,7,12,6,15,11,12,14,10,1,20,1,8,20,8,14,18,14,5,14,1,1,1,71,20,9,4470057,6641,6641,4741,Northern_European,123,0,0,26849.0,Unknown,91143714,500000.0,1.0,38,178,40,1,0,7,211,8,0.6290023815824293,0.5017112299465241,0.5441176470588236,0.0259171674196871,0.0,0.0,0.0847711927981995,0.0847711927981995,0.0027500763910108,0.0,0.3953488372093026,0.375,308,20,40,48,2,7078,13,25,31,20000000,714285.7142857143,20000000.0,3000000.0,125000.0,1500000.0,1,3000000,0.17647058823529413,3.0
282700,Enric,Franquesa,2024,1244,Spain,Sant Cugat del VallÃ©s,Spain,26-02-97,Left-Back,Defender,Left,175.0,30-06-26,AC Talent,https://img.a.transfermarkt.technology/portrait/header/282700-1625480292.jpg?lm=1,ES1,Club Deportivo LeganÃ©s S.A.D.,1500000.0,1500000.0,27,124,132,9,13,12,9,11,11,9,9,13,12,11,8,12,13,12,12,11,11,12,12,12,12,8,8,10,12,14,14,14,13,13,8,13,14,14,12,13,8,12,8,14,1,1,3,2,2,1,1,3,1,1,1,12,12,8,12,13,13,14,12,1,20,10,8,16,8,1,15,1,1,12,1,1,1,70,20,11,2270796,6200,6200,3600,Mediterranean_Hispanic,121,0,0,4794.0,Unknown,67231278,232500.0,2.0,89,1315,89,1,0,3,54,8,0.5706536120666843,0.3796791443850267,0.5294117647058822,0.004620478617854,0.0,0.0,0.0072518129532383,0.0072518129532383,0.0012639239978888,0.1428571428571428,0.2790697674418605,0.375,232,12,9,29,1,4549,3,34,265,1500000,63636.36363636364,1500000.0,75000.0,,200000.0,6,125000,0.0,0.25
282721,Uri,Busquets,2024,8024,Spain,Sant Feliu de GuÃ­xols,Spain,20-01-99,Defensive Midfield,Midfield,Right,185.0,30-06-25,SEG,https://img.a.transfermarkt.technology/portrait/header/282721-1527584622.jpg?lm=1,PO1,Futebol Clube de Arouca,400000.0,2500000.0,25,120,143,7,8,9,8,14,7,12,9,6,12,15,7,13,13,14,13,12,12,12,15,13,14,11,12,11,14,15,13,11,12,11,13,15,12,11,12,15,10,12,12,15,3,4,3,1,3,3,2,1,1,2,2,12,13,5,14,13,15,12,15,1,1,16,1,1,1,20,1,19,1,1,1,1,1,77,8,20,1286200,6000,6000,3700,Mediterranean_Hispanic,118,0,0,2050.0,Unknown,67225653,9111392.0,2.0,89,1316,89,3,1,3,98,4,0.5441915850754168,0.3903743315508021,0.5073529411764706,0.0019708248399247,0.0,0.0,0.0017504376094023,0.0122530632658164,0.0505924720131114,0.1428571428571428,0.5116279069767438,0.2916666666666665,175,2,3,18,0,3438,6,40,227,300000,5000.0,2500000.0,600000.0,2500000.0,2500000.0,4,1000000,-0.25,-0.3333333333333333
282727,Unknown,Monchu,2024,605,Spain,Palma de Mallorca,Spain,13-09-99,Central Midfield,Midfield,Right,173.0,30-06-29,LIAN Sports Group,https://img.a.transfermarkt.technology/portrait/header/282727-1696516454.jpg?lm=1,GR1,Aris Thessalonikis,5000000.0,5000000.0,25,131,150,15,11,11,9,14,14,6,12,5,10,14,15,11,14,15,15,13,14,14,14,15,15,13,13,11,15,13,12,12,12,12,7,15,13,13,11,15,8,13,6,12,2,2,2,3,2,2,3,3,3,1,2,12,14,5,13,14,15,13,10,1,1,1,1,1,1,19,1,20,1,1,14,1,1,68,10,20,7103999,6500,6500,4252,Mediterranean_Hispanic,131,0,0,4293.0,Unknown,67246433,1850000.0,3.0,89,1112,89,3,1,3,20,1,0.6103466525535857,0.4494117647058823,0.6029411764705883,0.0041367043675834,0.0,0.0,0.0247561890472618,0.0247561890472618,0.0102502847301313,0.2857142857142857,0.2325581395348837,0.2916666666666665,260,30,22,65,4,4133,4,5,31,5000000,261111.11111111112,5000000.0,1000000.0,300000.0,900000.0,5,5100000,0.0,0.0
282810,Carles,Pérez,2024,3709,Spain,Granollers,Spain,16-02-98,Right Winger,Attack,Left,173.0,30-06-25,F&H Sport Management,https://img.a.transfermarkt.technology/portrait/header/282810-1698852701.jpg?lm=1,ES1,Getafe Club de FÃºtbol S.A.D. Team Dubai,2500000.0,10000000.0,26,134,145,13,12,16,10,17,9,8,14,6,6,13,9,7,15,12,10,12,10,11,12,10,13,15,5,10,5,11,12,16,17,11,6,13,15,12,9,10,6,10,10,16,1,4,2,1,2,3,2,1,3,2,3,11,12,6,13,12,11,12,13,1,1,1,1,1,1,1,10,15,12,15,15,20,10,75,20,8,2829168,6700,6850,5500,Mediterranean_Hispanic,128,0,0,58461.0,Vigo,67215283,9100000.0,2.0,89,554,89,0,0,3,105,10,0.6566551997883038,0.5828877005347594,0.5808823529411764,0.0564422604327703,0.0,0.0,0.0122530632658164,0.0497624406101525,0.050529181366149,0.1428571428571428,0.2325581395348837,0.3333333333333332,248,43,28,18,0,6789,17,44,51,3000000,116666.66666666667,10000000.0,2000000.0,,1500000.0,4,12000000,0.2,-0.25
283170,Iñaki,Peña,2024,131,Spain,Alicante,Spain,02-03-99,Goalkeeper,Goalkeeper,Right,184.0,30-06-26,WAKAI SPORTS,https://img.a.transfermarkt.technology/portrait/header/283170-1702502364.jpg?lm=1,ES1,Futbol Club Barcelona,8000000.0,8000000.0,25,130,150,4,2,3,3,11,7,8,1,2,1,14,7,2,10,9,13,13,11,13,10,14,14,8,11,2,12,12,9,12,14,12,13,13,11,10,11,15,5,15,8,15,11,13,12,5,11,14,13,14,9,8,12,12,13,5,14,15,14,13,15,20,1,1,1,1,1,1,1,1,1,1,1,1,1,78,10,20,3878949,6500,6500,4500,Mediterranean_Hispanic,128,0,0,12848.0,Unknown,67221484,9111392.0,2.0,89,43,89,2,1,3,96,5,0.6103466525535857,0.4759358288770053,0.5808823529411764,0.0123975600782922,0.0,0.0,0.0397599399849962,0.0397599399849962,0.0505924720131114,0.1428571428571428,0.4883720930232553,0.2916666666666665,0,0,0,0,0,0,5,12,122,10000000,576470.5882352941,10000000.0,200000.0,,2500000.0,2,1400000,0.25,0.25
283196,Kasper,Dolberg,2024,58,Denmark,Silkeborg,Denmark,06-10-97,Centre-Forward,Attack,Right,187.0,30-06-27,ROOF,https://img.a.transfermarkt.technology/portrait/header/283196-1725633296.jpg?lm=1,BE1,Royal Sporting Club Anderlecht,10000000.0,23000000.0,27,133,150,8,11,13,13,13,13,13,14,6,3,12,14,4,16,10,14,12,15,11,13,12,8,14,4,14,8,8,6,15,15,13,13,12,14,12,12,12,11,10,13,13,1,1,3,2,2,1,1,1,2,3,3,15,14,5,14,14,14,16,16,1,1,1,1,1,1,1,1,1,1,15,12,14,20,82,10,20,10076857,6900,6900,5500,Northern_European,132,35,10,57496.0,Sevilla,27102380,8590000.0,3.0,28,1370,30,0,1,7,175,3,0.6632707065361206,0.5828877005347594,0.6102941176470589,0.0555104397710714,0.2302631578947368,0.131578947368421,0.0497624406101525,0.1147786946736684,0.0476957693269257,0.2857142857142857,0.5581395348837206,0.375,329,114,32,12,0,7269,20,76,103,13000000,488461.53846153844,23000000.0,5000000.0,300000.0,12000000.0,4,13000000,0.08333333333333333,0.3
283223,Emre,Mor,2024,7160,Denmark,BrÃ¸nshÃ¸j,TÃ¼rkiye,24-07-97,Right Winger,Attack,Left,169.0,30-06-25,Nima Modyr,https://img.a.transfermarkt.technology/portrait/header/283223-1712157441.png?lm=1,TR1,EyÃ¼p Spor KulÃ¼bÃ¼,1800000.0,5000000.0,27,125,150,13,9,17,12,14,10,5,11,5,4,13,11,5,14,16,13,10,10,8,13,9,13,17,1,15,2,12,13,17,17,15,6,13,13,13,6,12,13,10,8,14,3,1,3,1,3,3,3,3,1,1,1,7,10,17,5,15,6,4,4,1,1,1,1,1,1,1,10,8,10,16,15,20,13,64,20,8,5086844,6350,6100,5000,North_African__Middle_Eastern,121,15,1,40064.0,Unknown,27102375,8250000.0,3.0,28,269,100,0,0,6,66,10,0.5574225985710506,0.5294117647058822,0.5294117647058822,0.0386777995899989,0.0986842105263157,0.0131578947368421,0.0087521880470117,0.0247561890472618,0.0458068279674435,0.2857142857142857,0.13953488372093,0.375,206,21,21,30,1,6588,26,82,90,1100000,33333.333333333336,5000000.0,2000000.0,5000000.0,3000000.0,9,7025000,-0.45,-0.56
283227,Rasmus,Nicolaisen,2024,415,Denmark,Herning,Denmark,16-03-97,Centre-Back,Defender,Left,191.0,30-06-25,Boutique Transfers,https://img.a.transfermarkt.technology/portrait/header/283227-1626438001.jpg?lm=1,FR1,Toulouse Football Club,6000000.0,6000000.0,27,122,130,5,8,9,7,11,8,15,7,6,13,12,9,13,11,13,12,13,12,13,11,11,14,9,11,11,13,11,11,12,12,12,15,12,12,12,14,12,6,12,15,11,3,2,1,4,3,2,1,2,1,4,1,13,12,5,15,9,12,11,7,1,1,20,1,1,1,1,1,1,1,1,1,1,1,81,20,11,2000217,6100,5900,3750,Northern_European,121,0,0,8064.0,Unknown,27100972,538000.0,1.0,28,620,30,1,0,7,203,2,0.530960571579783,0.3957219251336898,0.5294117647058822,0.0077780470777041,0.0,0.0,0.0297574393598399,0.0297574393598399,0.0029611933664824,0.0,0.6511627906976742,0.375,237,17,9,31,0,8776,3,41,136,5000000,260526.31578947368,6000000.0,1000000.0,,200000.0,1,300000,-0.16666666666666666,-0.16666666666666666
283233,Jacob,Rasmussen,2024,206,Denmark,Odense,Denmark,28-05-97,Centre-Back,Defender,Left,190.0,30-06-27,GOLDBAEK SPORT GmbH,https://img.a.transfermarkt.technology/portrait/header/283233-1629616899.jpg?lm=1,DK1,BrÃ¸ndby IdrÃ¦tsforening,3000000.0,4000000.0,27,122,133,6,5,8,6,13,5,13,5,5,13,12,5,12,11,11,13,13,14,14,12,14,12,8,14,11,13,14,15,10,11,15,14,10,11,12,15,14,8,12,7,11,3,4,3,2,2,2,4,1,2,3,2,12,14,6,10,8,8,14,10,1,15,20,1,13,1,16,1,10,1,1,1,1,1,81,20,7,785880,6000,5700,4500,Northern_European,121,0,0,17787.0,Feyenoord Rotterdam,27102368,3666666.667,3.0,28,1070,30,1,0,7,45,2,0.5044985445885155,0.4759358288770053,0.5294117647058822,0.0171667437551117,0.0,0.0,0.0147536884221055,0.0197549387346836,0.0203431576821578,0.2857142857142857,0.6279069767441858,0.375,280,9,12,34,2,8149,6,28,74,3500000,186111.11111111112,4000000.0,700000.0,,200000.0,7,1850000,0.16666666666666666,0.16666666666666666
283735,Mattia,Zaccagni,2024,398,Italy,Cesena,Italy,16-06-95,Left Winger,Attack,Right,177.0,30-06-29,Unknown,https://img.a.transfermarkt.technology/portrait/header/283735-1695026445.jpg?lm=1,IT1,SocietÃ  Sportiva Lazio S.p.A.,20000000.0,30000000.0,29,147,152,12,14,17,13,15,12,7,11,3,3,15,12,8,15,13,16,12,12,12,15,14,17,16,13,14,6,15,14,14,15,14,10,14,14,12,10,13,12,14,3,10,3,1,1,1,1,3,1,2,1,2,4,14,16,8,16,13,16,13,10,1,1,1,1,1,1,11,11,11,8,20,18,12,12,63,14,20,21569229,7350,7150,5700,Mediterranean_Hispanic,147,0,0,71154.0,Unknown,43125343,3555000.0,2.0,52,343,54,0,1,3,185,7,0.696348240275205,0.6042780748663101,0.7205882352941175,0.0686988403902252,0.0,0.0,0.0997749437359339,0.1497874468617154,0.0197227700769465,0.1428571428571428,0.3255813953488373,0.4583333333333332,382,52,56,78,2,4948,19,86,205,20000000,687068.9655172414,30000000.0,5000000.0,75000.0,300000.0,6,1300000,0.0,-0.2
283994,Ludovic,Ajorque,2024,3911,RÃ©union,Saint-Joseph,France,25-02-94,Centre-Forward,Attack,Left,196.0,30-06-25,LÃ©andre Chouya,https://img.a.transfermarkt.technology/portrait/header/283994-1692000251.jpg?lm=1,FR1,Stade brestois 29,3000000.0,16000000.0,30,135,136,4,10,12,16,13,7,17,12,4,4,12,15,2,13,13,14,15,13,15,11,13,15,13,12,12,7,15,16,12,12,16,17,15,12,14,16,13,8,12,7,10,2,4,1,2,4,3,1,1,3,3,3,18,14,7,13,10,12,10,10,1,1,1,1,1,1,1,1,1,1,1,1,1,20,82,20,7,7963831,6750,6750,4015,Mixed_Race,134,0,0,22559.0,Unknown,85103818,3333333.333,3.0,79,1274,36,0,0,4,196,3,0.6434241862926701,0.4240641711229946,0.625,0.0217746693485076,0.0,0.0,0.0147536884221055,0.0797699424856214,0.018491254384844,0.2857142857142857,0.7674418604651163,0.5,349,103,33,55,1,4187,1,1,17,4000000,148076.92307692306,16000000.0,3000000.0,,150000.0,5,4100000,0.3333333333333333,-0.42857142857142855
284010,Robin,Hack,2024,18,Germany,Pforzheim,Germany,27-08-98,Left Winger,Attack,Right,178.0,30-06-27,CN Sports,https://img.a.transfermarkt.technology/portrait/header/284010-1722945425.jpg?lm=1,L1,Borussia Verein fÃ¼r LeibesÃ¼bungen 1900 MÃ¶nchengladbach,8000000.0,8000000.0,26,121,133,9,10,14,11,12,10,8,13,6,5,11,14,8,12,12,11,7,12,9,11,10,14,13,5,15,8,13,12,14,15,9,7,12,14,12,8,11,5,12,9,13,3,3,3,2,3,3,2,3,3,1,1,9,14,8,10,13,12,12,10,1,1,1,1,1,1,1,20,10,13,20,17,17,13,68,13,20,2423671,6057,6057,4255,Northern_European,111,0,0,3999.0,Unknown,91144396,933333.3333,3.0,38,1140,40,0,1,7,42,7,0.551733262767928,0.4497326203208556,0.4558823529411764,0.0038528128913767,0.0,0.0,0.0397599399849962,0.0397599399849962,0.0051575506725186,0.2857142857142857,0.3488372093023257,0.3333333333333332,286,87,52,35,2,1895,17,108,250,8000000,376190.4761904762,8000000.0,700000.0,100000.0,500000.0,3,1700000,0.0,1.6666666666666667
284595,Tommaso,Augello,2024,1390,Italy,Milano,Italy,30-08-94,Left-Back,Defender,Left,180.0,30-06-25,Unknown,https://img.a.transfermarkt.technology/portrait/header/284595-1663679538.jpg?lm=1,IT1,Cagliari Calcio,2000000.0,4000000.0,30,129,134,9,15,12,9,13,4,6,11,16,13,13,6,13,13,10,13,12,11,11,12,11,13,10,6,15,12,15,17,13,13,12,10,16,13,16,13,14,4,10,6,16,3,1,3,2,3,1,3,1,1,1,1,9,13,4,13,10,15,12,9,1,20,1,1,16,1,1,10,1,1,1,1,1,1,70,20,10,3293477,6450,6450,4700,Mediterranean_Hispanic,125,0,0,8846.0,Unknown,43096264,1193333.333,3.0,52,952,54,1,0,3,46,8,0.6037311458057687,0.4973262032085561,0.5588235294117647,0.0085331597797233,0.0,0.0,0.0097524381095273,0.0197549387346836,0.0066020352398677,0.2857142857142857,0.3953488372093026,0.5,434,10,34,22,1,4077,2,4,14,1800000,75000.0,4000000.0,1000000.0,,150000.0,3,25000,-0.1,-0.1
284701,Samuel,Portugal,2024,720,Brazil,Teixeira de Freitas,Brazil,29-03-94,Goalkeeper,Goalkeeper,Right,188.0,30-06-27,Unknown,https://img.a.transfermarkt.technology/portrait/header/284701-1669115006.png?lm=1,PO1,Futebol Clube do Porto,1500000.0,1500000.0,30,127,131,2,3,1,3,9,2,5,3,1,3,12,3,1,11,10,12,15,14,13,11,9,12,12,6,7,13,14,12,9,15,12,14,11,10,14,15,12,4,10,6,2,13,8,13,16,12,16,13,18,13,16,12,12,9,8,11,11,14,10,13,20,1,1,1,1,1,1,1,1,1,1,1,1,1,80,7,20,1020937,6350,6350,4350,Mixed_Race,127,0,0,8749.0,Unknown,19233479,9111392.0,2.0,10,1479,11,2,1,4,100,5,0.590500132310135,0.4598930481283422,0.5735294117647058,0.0084394949049204,0.0,0.0,0.0072518129532383,0.0072518129532383,0.0505924720131114,0.1428571428571428,0.581395348837209,0.5,0,0,0,0,0,0,1,3,17,1000000,67857.14285714286,1500000.0,500000.0,,100000.0,3,200000,-0.3333333333333333,-0.3333333333333333
284730,Manuel,Akanji,2024,281,Switzerland,Wiesendangen,Switzerland,19-07-95,Centre-Back,Defender,Right,188.0,30-06-27,Wasserman,https://img.a.transfermarkt.technology/portrait/header/284730-1684165752.jpg?lm=1,GB1,Manchester City Football Club,45000000.0,45000000.0,29,156,156,4,8,11,6,13,9,13,11,12,15,13,8,16,12,13,15,16,16,16,13,13,14,9,10,9,13,14,13,14,13,13,15,13,16,14,17,11,8,14,12,7,1,3,1,3,2,1,3,3,2,3,3,12,16,6,11,13,17,14,12,1,1,20,12,1,8,1,1,1,1,1,1,1,1,91,15,20,48855719,7800,7500,6250,Mixed_Race,156,41,0,104393.0,Unknown,98031331,14066666.67,3.0,92,1666,92,1,1,4,131,2,0.7426567875099233,0.6631016042780749,0.7867647058823528,0.1007949926951053,0.2697368421052631,0.0,0.2248062015503876,0.2248062015503876,0.0781225404594572,0.2857142857142857,0.581395348837209,0.4583333333333332,437,17,9,49,0,10587,19,143,302,40000000,1375862.0689655172,45000000.0,10000000.0,,750000.0,3,15250000,-0.1111111111111111,-0.047619047619047616
284732,Ramy,Bensebaini,2024,16,Algeria,Constantine,Algeria,16-04-95,Left-Back,Defender,Left,187.0,30-06-27,Unknown,https://img.a.transfermarkt.technology/portrait/header/284732-1692013397.jpg?lm=1,L1,Borussia Dortmund,7000000.0,22000000.0,29,141,145,4,13,11,10,12,12,16,9,12,13,13,16,15,13,16,13,16,13,12,12,12,16,13,12,14,13,12,12,12,11,13,14,13,15,16,13,13,14,15,9,14,3,2,1,3,1,1,4,2,3,1,1,13,15,13,11,12,10,7,8,1,20,18,1,18,1,12,12,10,1,10,1,1,1,85,20,12,15574033,7249,6849,6049,North_African__Middle_Eastern,137,48,6,57533.0,Unknown,12038706,5000000.0,2.0,1,381,1,1,0,6,41,8,0.6565228896533475,0.6416042780748663,0.6470588235294117,0.0555461676099138,0.3157894736842105,0.0789473684210526,0.0347586896724181,0.1097774443610902,0.0277507708547459,0.1428571428571428,0.5581395348837206,0.4583333333333332,319,36,16,79,3,5044,24,76,70,7000000,240740.74074074073,22000000.0,8000000.0,,2000000.0,4,13000000,0.0,-0.4166666666666667
284769,Florian,Müller,2024,60,Germany,Saarlouis,Germany,13-11-97,Goalkeeper,Goalkeeper,Left,190.0,Unknown,PRO Profil GmbH,https://img.a.transfermarkt.technology/portrait/header/284769-1691998669.jpg?lm=1,L1,Sport-Club Freiburg,1200000.0,10000000.0,27,127,137,2,3,3,3,12,7,8,1,3,2,12,6,2,11,10,12,13,14,12,11,12,16,3,11,2,11,16,13,12,14,12,15,14,11,12,12,12,5,16,6,11,13,12,12,13,12,13,13,15,17,9,14,10,13,6,10,16,12,14,17,20,1,1,1,1,1,1,1,1,1,1,1,1,1,88,20,5,4478545,6350,6350,5100,Northern_European,127,0,0,5999.0,Unknown,92082045,3250000.0,2.0,38,1266,40,2,0,7,189,5,0.590500132310135,0.5401069518716577,0.5735294117647058,0.0057840474233951,0.0,0.0,0.0057514378594648,0.0497624406101525,0.0180282785632934,0.1428571428571428,0.6279069767441858,0.375,0,0,0,0,0,0,12,42,126,1200000,38000.0,10000000.0,3500000.0,250000.0,4000000.0,3,800000,0.0,0.0
284854,Carles,Aleñá,2024,3709,Spain,MatarÃ³,Spain,05-01-98,Central Midfield,Midfield,Left,180.0,30-06-26,Unknown,https://img.a.transfermarkt.technology/portrait/header/284854-1669364902.jpg?lm=1,ES1,Getafe Club de FÃºtbol S.A.D. Team Dubai,3000000.0,30000000.0,26,137,156,14,13,15,12,17,13,7,12,8,5,17,14,7,17,10,14,11,14,12,16,14,13,18,11,14,9,13,12,12,12,12,10,14,13,12,11,12,10,17,6,9,2,1,2,1,2,3,2,1,3,3,3,18,16,7,17,14,13,11,12,1,1,1,1,1,1,6,10,20,9,9,18,11,8,73,20,9,8478633,6850,6850,5350,Mediterranean_Hispanic,134,0,0,76922.0,Unknown,67213011,5000000.0,1.0,89,928,89,3,0,3,105,1,0.6566551997883038,0.5668449197860962,0.625,0.0742685207805663,0.0,0.0,0.0147536884221055,0.1497874468617154,0.0277507708547459,0.0,0.3953488372093026,0.3333333333333332,297,34,30,62,1,6311,4,7,98,2500000,71428.57142857143,30000000.0,10000000.0,1000000.0,15000000.0,4,7000000,-0.16666666666666666,-0.16666666666666666
284857,Marc,Cucurella,2024,631,Spain,Alella,Spain,22-07-98,Left-Back,Defender,Left,173.0,30-06-28,EMG Mundial,https://img.a.transfermarkt.technology/portrait/header/284857-1659559729.jpg?lm=1,GB1,Chelsea Football Club,30000000.0,55000000.0,26,153,164,10,13,11,9,14,7,6,8,12,12,14,7,14,14,15,16,14,15,14,14,15,18,10,13,15,15,14,14,16,15,14,8,13,13,15,12,14,9,14,8,15,3,2,3,3,3,1,3,1,3,1,3,11,14,5,13,14,15,13,15,1,19,15,1,19,1,1,20,1,1,14,1,1,1,68,20,8,83672958,7650,7650,6000,Mediterranean_Hispanic,144,1,0,127591.0,Unknown,67215284,20220000.0,5.0,89,39,89,1,0,3,50,8,0.7625033077533738,0.6363636363636364,0.6985294117647058,0.123195382031987,0.006578947368421,0.0,0.1497874468617154,0.274818704676169,0.1123086752409789,0.5714285714285714,0.2325581395348837,0.3333333333333332,312,13,27,70,0,4884,5,25,78,30000000,1273913.043478261,55000000.0,15000000.0,700000.0,10000000.0,5,36300000,0.0,0.2
284876,Paolo,Fernandes,2024,2441,Spain,Zaragoza,Spain,09-08-98,Right Winger,Attack,Left,167.0,30-06-27,Goal Management,https://img.a.transfermarkt.technology/portrait/header/284876-1728416083.png?lm=1,GR1,Athlitiki Enosi Konstantinoupoleos,800000.0,1200000.0,26,120,130,15,13,16,12,13,15,7,14,5,6,13,12,5,15,8,9,9,12,9,13,13,9,16,6,13,7,10,9,14,15,12,7,12,12,12,7,9,8,10,8,10,1,3,1,3,4,1,1,3,1,2,3,12,12,3,12,8,10,11,9,1,1,1,1,1,1,1,14,14,14,16,17,20,1,69,20,9,2461374,6000,5750,2750,Mixed_Race,118,0,0,4847.0,NPS Volos,28100241,9111392.0,2.0,89,1699,89,0,0,4,34,10,0.5111140513363324,0.2887700534759358,0.5073529411764706,0.0046716563329525,0.0,0.0,0.0037509377344336,0.0057514378594648,0.0505924720131114,0.1428571428571428,0.0930232558139532,0.3333333333333332,199,32,22,17,0,6538,3,26,276,800000,36842.10526315789,1200000.0,300000.0,100000.0,500000.0,5,675000,0.0,-0.2
284883,Fran,Navarro,2024,720,Spain,Valencia,Spain,03-02-98,Centre-Forward,Attack,Right,179.0,30-06-28,JONATHAN SÃNCHEZ,https://img.a.transfermarkt.technology/portrait/header/284883-1693589967.png?lm=1,PO1,Futebol Clube do Porto,7000000.0,13000000.0,26,131,142,7,10,12,15,13,8,14,12,7,7,11,12,8,12,10,13,12,15,13,12,13,13,11,10,15,7,11,13,13,13,12,10,11,13,13,12,13,8,11,6,8,2,1,3,1,3,3,2,2,3,3,2,16,16,12,13,14,13,11,11,1,1,1,1,1,1,1,1,1,1,10,12,10,20,71,12,20,4603499,6550,5846,5069,Mediterranean_Hispanic,130,0,0,3149.0,Unknown,67225734,4550000.0,2.0,89,1556,89,0,1,3,100,3,0.5238158242921408,0.5367914438502673,0.5955882352941175,0.0030320382152689,0.0,0.0,0.0347586896724181,0.0647661915478869,0.0252507014083724,0.1428571428571428,0.3720930232558141,0.3333333333333332,236,75,14,26,0,5013,2,1,3,6000000,295000.0,13000000.0,3000000.0,,150000.0,4,6300000,-0.25,-0.4
285323,Baptiste,Santamaria,2024,273,France,Saint-Doulchard,France,09-03-95,Defensive Midfield,Midfield,Right,183.0,30-06-26,Scuderia,https://img.a.transfermarkt.technology/portrait/header/285323-1666698827.jpg?lm=1,FR1,Stade Rennais Football Club,10000000.0,16000000.0,29,138,142,11,11,13,10,14,10,12,10,5,11,14,9,12,13,15,13,13,12,13,15,13,15,14,13,14,10,15,13,14,14,14,11,15,13,16,13,13,10,12,6,15,3,1,3,3,3,1,1,2,4,3,1,12,15,8,13,12,16,13,11,1,1,1,1,1,1,19,12,20,12,12,15,14,1,81,8,20,17223332,6900,6900,4255,Northern_European,134,0,0,14999.0,Unknown,211515,8166666.667,3.0,34,1272,36,3,1,7,195,4,0.6632707065361206,0.4497326203208556,0.625,0.014474602817478,0.0,0.0,0.0497624406101525,0.0797699424856214,0.0453438521458929,0.2857142857142857,0.4651162790697669,0.4583333333333332,415,22,13,41,0,4908,3,24,123,7000000,232142.85714285713,16000000.0,3000000.0,,800000.0,3,4450000,-0.3,-0.4166666666666667
285548,Fabián,Balbuena,2024,121,Paraguay,Ciudad del Este,Paraguay,23-08-91,Centre-Back,Defender,Right,189.0,30-06-25,La Squadra Sports,https://img.a.transfermarkt.technology/portrait/header/285548-1721727706.png?lm=1,RU1,FK Dinamo Moskva,3000000.0,12000000.0,33,130,140,6,7,6,7,10,7,14,6,8,15,10,6,15,10,13,15,13,14,14,8,13,14,5,15,8,14,13,13,11,11,14,14,11,11,13,15,14,12,12,12,8,3,3,1,3,4,2,1,4,1,1,3,14,18,14,12,12,13,12,10,1,1,20,1,1,1,1,1,1,1,1,1,1,1,88,9,20,6123460,6496,6596,5505,Mediterranean_Hispanic,130,26,0,41379.0,COR,79013838,2700000.0,2.0,73,365,75,1,1,3,74,2,0.623048425509394,0.5834224598930481,0.5955882352941175,0.039947586294801,0.1710526315789473,0.0,0.0147536884221055,0.0597649412353088,0.0149726381288369,0.1428571428571428,0.6046511627906974,0.625,330,25,8,42,2,12342,5,18,71,2800000,97619.04761904762,12000000.0,3000000.0,,,4,3000000,-0.06666666666666667,-0.06666666666666667
285845,Ainsley,Maitland-Niles,2024,1041,England,London,England,29-08-97,Right-Back,Defender,Right,180.0,30-06-27,Tier One,https://img.a.transfermarkt.technology/portrait/header/285845-1702991138.jpg?lm=1,FR1,Olympique Lyonnais,9000000.0,18000000.0,27,136,148,10,11,14,8,13,8,6,10,8,10,13,17,11,14,10,11,10,12,10,12,12,10,14,7,14,10,13,10,16,15,14,8,13,14,13,10,12,9,12,9,20,1,3,2,1,3,3,1,3,3,2,3,19,14,12,13,13,10,12,13,1,18,8,18,19,20,14,12,15,12,10,8,13,1,73,9,20,19062192,6800,7050,5750,African_Caribbean,123,5,0,75395.0,Southampton,28095584,9111392.0,2.0,32,858,33,1,1,1,143,11,0.6831172267795713,0.6096256684491979,0.5441176470588236,0.0727940232153703,0.0328947368421052,0.0,0.0447611902975743,0.0897724431107777,0.0505924720131114,0.1428571428571428,0.3953488372093026,0.375,345,12,28,26,1,11695,4,23,71,10000000,423913.04347826086,18000000.0,4000000.0,750000.0,7000000.0,8,8750000,0.1111111111111111,1.0
286047,Guglielmo,Vicario,2024,148,Italy,Udine,Italy,07-10-96,Goalkeeper,Goalkeeper,Right,194.0,30-06-28,GG11 ,https://img.a.transfermarkt.technology/portrait/header/286047-1725874745.jpg?lm=1,GB1,Tottenham Hotspur Football Club,35000000.0,35000000.0,28,141,150,1,1,3,2,5,1,8,1,3,1,8,2,1,8,10,14,14,13,15,11,12,15,9,12,8,13,12,11,11,14,13,16,14,13,15,15,16,9,12,5,1,14,13,14,4,14,13,13,16,12,11,12,13,15,6,12,13,15,13,12,20,1,1,1,1,1,1,1,1,1,1,1,1,1,83,7,20,6126332,7050,7050,5000,Northern_European,139,0,0,21346.0,Unknown,43155241,5808900.0,5.0,52,1544,54,2,1,7,202,5,0.6831172267795713,0.5294117647058822,0.6617647058823528,0.0206033756048385,0.0,0.0,0.1747936984246061,0.1747936984246061,0.0322447845773493,0.5714285714285714,0.7209302325581395,0.4166666666666665,0,0,0,0,0,0,4,33,78,35000000,1456250.0,35000000.0,250000.0,,100000.0,6,7425000,0.0,0.16666666666666666
286297,Lorenzo,Pellegrini,2024,12,Italy,Roma,Italy,19-06-96,Attacking Midfield,Midfield,Right,186.0,30-06-26,Unknown,https://img.a.transfermarkt.technology/portrait/header/286297-1692962972.jpg?lm=1,IT1,Associazione Sportiva Roma,25000000.0,45000000.0,28,155,162,16,16,14,12,17,16,9,12,4,11,14,12,11,16,13,15,14,12,11,16,12,15,16,13,16,11,18,16,13,15,11,10,15,12,15,10,16,13,13,12,14,1,1,1,1,3,1,1,1,3,1,1,9,15,8,20,16,18,13,12,1,1,1,1,1,1,17,1,20,1,10,20,1,1,77,14,20,140095310,7750,7500,6750,Mediterranean_Hispanic,151,23,5,142499.0,Unknown,43094100,5625000.0,2.0,52,1244,54,3,1,3,29,0,0.7426567875099233,0.7165775401069518,0.75,0.1375908042336523,0.1513157894736842,0.0657894736842105,0.1247811952988247,0.2248062015503876,0.0312230895302647,0.1428571428571428,0.5348837209302322,0.4166666666666665,429,81,67,90,2,7239,32,104,37,14000000,460833.3333333333,45000000.0,10000000.0,250000.0,12000000.0,2,4750000,-0.44,-0.44
286384,Eric,Bailly,2024,1050,Cote d'Ivoire,Bingerville,Cote d'Ivoire,12-04-94,Centre-Back,Defender,Right,187.0,30-06-25,Rafaela Pimenta,https://img.a.transfermarkt.technology/portrait/header/286384-1696075364.png?lm=1,ES1,Villarreal Club de FÃºtbol S.A.D.,3000000.0,35000000.0,30,137,150,5,4,8,5,12,5,14,5,9,15,12,5,17,12,16,16,18,10,9,7,8,13,8,7,6,15,13,12,15,16,16,14,15,16,16,16,9,14,14,17,12,2,3,1,2,2,3,1,3,2,1,3,14,15,5,14,12,15,13,13,1,1,20,13,1,1,8,1,1,1,1,1,1,1,77,10,20,17798932,7050,7250,6250,African_Caribbean,137,46,2,115992.0,Olympique de Marseille,67191910,21850000.0,2.0,23,194,24,1,1,1,216,2,0.7095792537708389,0.6631016042780749,0.6470588235294117,0.1119951873635462,0.3026315789473684,0.0263157894736842,0.0147536884221055,0.1747936984246061,0.1213644823467318,0.1428571428571428,0.5581395348837206,0.5,242,2,2,50,3,11070,27,170,170,2500000,78125.0,35000000.0,5000000.0,,3000000.0,5,17100000,-0.16666666666666666,-0.2647058823529412
286415,Pau,López,2024,12321,Spain,Girona,Spain,13-12-94,Goalkeeper,Goalkeeper,Left,189.0,30-06-25,Goal Management,https://img.a.transfermarkt.technology/portrait/header/286415-1666815446.jpg?lm=1,ES1,Girona FÃºtbol Club S. A. D.,10000000.0,24000000.0,30,140,143,3,2,2,1,11,8,8,3,6,2,14,2,2,10,6,13,15,13,15,8,13,10,5,8,5,15,14,12,13,15,13,13,13,13,12,12,13,9,13,6,14,10,10,8,7,15,14,15,16,14,9,14,14,13,5,12,7,15,15,16,20,1,1,1,1,1,1,1,1,1,1,1,1,1,77,20,9,13420353,6992,6992,5992,Northern_European,140,2,0,74794.0,Unknown,67178152,17750000.0,2.0,89,540,89,2,0,7,107,5,0.6754432389521038,0.6355080213903743,0.6691176470588234,0.0722136872384987,0.0131578947368421,0.0,0.0497624406101525,0.1197799449862465,0.0985860718353287,0.1428571428571428,0.6046511627906974,0.5,0,0,0,0,0,0,8,22,121,3500000,106451.6129032258,24000000.0,5000000.0,,800000.0,6,13000000,-0.65,-0.7083333333333334
286949,Adam,Masina,2024,416,Morocco,Khouribga,Morocco,02-01-94,Centre-Back,Defender,Left,191.0,30-06-26,Unknown,https://img.a.transfermarkt.technology/portrait/header/286949-1658130450.jpg?lm=1,IT1,Torino Calcio,1500000.0,7000000.0,30,129,139,8,12,11,8,11,9,14,9,14,12,12,7,14,11,15,13,14,11,12,11,12,14,12,14,13,10,13,14,13,12,14,14,14,13,17,14,14,12,14,7,13,3,2,3,2,3,3,3,3,1,1,1,14,12,4,14,12,16,18,12,1,20,16,1,20,1,1,13,1,1,5,1,1,1,87,20,6,9891439,6450,6550,4750,North_African__Middle_Eastern,125,16,0,23846.0,Unknown,43111412,3666666.667,3.0,66,724,67,1,0,6,201,2,0.6169621593014025,0.5026737967914437,0.5588235294117647,0.0230174187698615,0.1052631578947368,0.0,0.0072518129532383,0.0347586896724181,0.0203431576821578,0.2857142857142857,0.6511627906976742,0.5,0,0,0,0,0,0,7,74,164,1500000,51851.851851851854,7000000.0,2000000.0,,75000.0,3,500000,0.0,0.0
287183,Fedor,Chalov,2024,1091,Russia,Moskau,Russia,10-04-98,Centre-Forward,Attack,Right,181.0,30-06-27,CAA Base Ltd,https://img.a.transfermarkt.technology/portrait/header/287183-1727967630.png?lm=1,GR1,Panthessalonikios Athlitikos Omilos Konstantinoupoliton,10000000.0,16000000.0,26,123,133,10,11,12,13,13,10,6,11,9,7,13,13,6,14,13,14,14,11,12,14,13,17,16,11,15,10,14,11,14,13,11,10,13,14,14,13,13,4,14,3,6,3,3,1,1,2,1,2,2,3,2,3,11,13,3,17,11,15,15,14,1,1,1,1,1,1,1,1,1,6,8,7,11,20,75,12,20,6032903,6024,6024,4861,Northern_European,126,3,0,18999.0,Unknown,58123846,3000000.0,1.0,78,985,81,0,1,7,153,3,0.5473670283143689,0.5145454545454545,0.5661764705882353,0.0183370718815149,0.0197368421052631,0.0,0.0497624406101525,0.0797699424856214,0.0166393510930859,0.0,0.418604651162791,0.3333333333333332,351,121,55,19,0,10642,6,10,17,9000000,340384.6153846154,16000000.0,2500000.0,400000.0,10000000.0,4,5800000,-0.18181818181818182,-0.25
287579,Sofyan,Amrabat,2024,36,Netherlands,Huizen,Morocco,21-08-96,Defensive Midfield,Midfield,Right,185.0,30-06-25,Unknown,https://img.a.transfermarkt.technology/portrait/header/287579-1728392547.jpg?lm=1,TR1,FenerbahÃ§e Spor KulÃ¼bÃ¼,22000000.0,30000000.0,28,139,145,10,8,14,7,13,8,7,10,3,12,14,13,14,13,16,14,14,14,14,13,13,15,12,12,12,14,15,17,14,13,13,9,15,14,14,14,11,14,10,6,14,2,3,3,1,3,1,3,1,1,1,2,16,15,11,12,13,15,12,10,1,1,14,1,1,1,20,10,18,10,1,11,1,1,70,11,20,10496805,6946,6946,5396,North_African__Middle_Eastern,139,36,0,36922.0,Unknown,37045879,8530000.0,5.0,67,640,67,3,1,6,84,4,0.6693569727441122,0.5717647058823528,0.6617647058823528,0.0356438301401979,0.2368421052631578,0.0,0.1097774443610902,0.1497874468617154,0.0473624267340759,0.5714285714285714,0.5116279069767438,0.4166666666666665,377,13,22,82,3,10636,15,32,41,22000000,731666.6666666666,30000000.0,6000000.0,350000.0,3000000.0,6,12700000,0.0,-0.21428571428571427
287792,Oleksandr,Tymchyk,2024,338,Ukraine,"Kryklyvets, Vinnytsia Oblast",Ukraine,20-01-97,Right-Back,Defender,Right,180.0,30-09-25,ProStar,https://img.a.transfermarkt.technology/portrait/header/287792-1726134692.png?lm=1,UKR1,Futbolniy Klub Dynamo Kyiv,4000000.0,4000000.0,27,126,129,6,12,12,5,10,5,11,6,15,11,13,4,14,11,11,11,12,10,12,11,11,14,8,5,13,13,13,14,16,15,12,12,12,16,14,12,11,13,10,6,6,4,1,2,2,2,2,1,3,3,1,1,11,10,5,9,10,10,12,10,1,6,1,20,4,15,1,1,1,10,1,1,1,1,67,8,20,6106366,6150,6150,4003,Northern_European,123,10,0,6010.0,Unknown,71085857,9111392.0,2.0,103,764,101,1,1,7,97,11,0.5640381053188674,0.4227807486631015,0.5441176470588236,0.0057946692133212,0.0657894736842105,0.0,0.0197549387346836,0.0197549387346836,0.0505924720131114,0.1428571428571428,0.3953488372093026,0.375,201,6,12,36,1,7315,7,34,124,5000000,276470.5882352941,5000000.0,500000.0,,300000.0,2,400000,0.25,0.6666666666666666
288225,Ludovic,Blas,2024,273,France,Colombes,France,31-12-97,Right Winger,Attack,Left,180.0,30-06-27,Sport Cover,https://img.a.transfermarkt.technology/portrait/header/288225-1596557793.jpg?lm=1,FR1,Stade Rennais Football Club,15000000.0,22000000.0,26,138,146,11,12,14,11,15,11,8,13,4,8,16,14,9,15,9,14,12,14,13,15,13,13,15,11,13,10,13,13,13,14,13,9,15,13,14,12,13,6,13,6,16,2,1,3,3,1,2,3,2,1,1,1,12,14,5,14,13,14,15,12,1,1,1,1,1,1,13,10,20,14,14,20,17,1,73,20,10,11700351,6900,6900,4008,African_Caribbean,136,0,0,18397.0,Unknown,85142865,11500000.0,2.0,34,375,36,0,0,1,195,10,0.6632707065361206,0.4233155080213903,0.6397058823529411,0.0177557702873773,0.0,0.0,0.0747686921730432,0.1097774443610902,0.0638628850801411,0.1428571428571428,0.3953488372093026,0.3333333333333332,350,65,38,45,1,5041,0,0,0,15000000,512068.9655172414,22000000.0,3000000.0,1750000.0,5000000.0,2,4000000,0.0,-0.25
288230,Ousmane,Dembélé,2024,583,France,Vernon,France,15-05-97,Right Winger,Attack,Left,178.0,30-06-28,Unknown,https://img.a.transfermarkt.technology/portrait/header/288230-1684148641.jpg?lm=1,FR1,Paris Saint-Germain Football Club,60000000.0,120000000.0,27,162,176,13,16,19,12,14,10,7,13,6,4,12,11,5,17,9,11,11,9,8,14,8,13,18,8,14,5,7,11,18,18,11,9,12,18,12,9,11,5,13,14,14,1,1,4,4,1,1,3,1,3,2,3,12,14,14,9,11,9,14,12,1,1,1,1,1,1,1,16,1,17,19,14,20,13,67,20,19,96249998,8000,8150,7600,African_Caribbean,153,27,4,230768.0,Unknown,85140178,73333333.33,3.0,34,1576,36,0,0,1,154,10,0.8286583752315428,0.8074866310160427,0.7647058823529411,0.2228248746870193,0.1776315789473684,0.0526315789473684,0.2998249562390597,0.5998999749937485,0.4073909460262784,0.2857142857142857,0.3488372093023257,0.375,335,91,85,37,1,8380,19,146,192,55000000,2105769.230769231,120000000.0,25000000.0,12000000.0,80000000.0,3,49000000,-0.08333333333333333,-0.08333333333333333
288253,Jerry,St. Juste,2024,336,Netherlands,Groningen,Netherlands,19-10-96,Centre-Back,Defender,Right,186.0,30-06-26,St. Juste Management,https://img.a.transfermarkt.technology/portrait/header/288253-1666099589.jpg?lm=1,PO1,Sporting Clube de Portugal,8000000.0,16000000.0,28,138,146,4,10,13,8,12,6,14,8,13,13,13,6,15,13,14,12,14,12,12,12,12,14,13,8,11,13,14,12,16,12,15,13,13,17,13,14,14,9,12,18,16,1,2,3,3,1,2,1,3,3,2,2,13,15,11,12,14,14,12,12,1,1,20,17,1,15,14,1,12,1,1,1,1,1,74,9,20,13373099,6900,6750,5750,African_Caribbean,133,0,0,27183.0,Unknown,37049949,7600000.0,3.0,67,565,68,1,1,1,193,2,0.6434241862926701,0.6096256684491979,0.6176470588235294,0.0262396835865342,0.0,0.0,0.0397599399849962,0.0797699424856214,0.042195616544904,0.2857142857142857,0.5348837209302322,0.4166666666666665,300,15,12,37,3,8829,29,124,182,8000000,283928.5714285714,16000000.0,3000000.0,550000.0,3500000.0,3,6000000,0.0,0.0
288255,Donny,Van De Beek,2024,12321,Netherlands,Nijkerkerveen,Netherlands,18-04-97,Central Midfield,Midfield,Right,184.0,30-06-28,PUM,https://img.a.transfermarkt.technology/portrait/header/288255-1642174403.jpg?lm=1,ES1,Girona FÃºtbol Club S. A. D.,5000000.0,55000000.0,27,142,160,13,13,13,14,15,13,11,13,8,10,15,11,11,15,10,13,12,14,14,15,12,15,13,13,15,9,16,17,11,14,13,13,15,12,15,10,12,6,11,3,15,3,3,3,3,3,1,2,1,2,1,3,8,14,4,14,13,15,15,11,1,1,1,1,1,1,14,1,19,1,1,20,1,1,67,12,20,33405620,7100,7300,6500,Northern_European,143,19,3,162388.0,Unknown,37048153,19750000.0,2.0,67,1046,68,3,1,7,107,1,0.7161947605186557,0.6898395721925134,0.6911764705882353,0.1567959660373095,0.125,0.0394736842105263,0.0247561890472618,0.274818704676169,0.1096974915969888,0.1428571428571428,0.4883720930232553,0.375,0,0,0,0,0,0,9,71,179,7500000,226515.15151515152,55000000.0,11000000.0,1000000.0,9000000.0,4,5250000,0.5,-0.16666666666666666
288318,Adrián,Embarba,2024,367,Spain,Madrid,Spain,07-05-92,Right Winger,Attack,Right,173.0,30-06-25,Unknown,https://img.a.transfermarkt.technology/portrait/header/288318-1583506487.jpg?lm=1,ES1,Rayo Vallecano de Madrid S.A.D.,1800000.0,8000000.0,32,136,142,11,15,14,12,12,10,8,12,10,5,13,10,5,13,13,15,12,14,14,13,14,12,13,11,14,8,10,13,14,15,13,7,13,14,13,10,13,7,14,11,12,1,3,1,3,1,2,2,2,2,3,3,12,13,8,14,13,12,11,14,1,1,1,1,1,1,1,15,1,19,18,11,20,1,64,12,20,11571050,6750,6750,5300,Mediterranean_Hispanic,136,0,0,14657.0,Unknown,67154683,5500000.0,2.0,89,892,89,0,1,3,163,10,0.6434241862926701,0.5614973262032085,0.6397058823529411,0.0141443617125029,0.0,0.0,0.0087521880470117,0.0397599399849962,0.0305286257951609,0.1428571428571428,0.2325581395348837,0.5833333333333333,381,53,68,55,0,2150,4,11,32,1500000,40625.0,8000000.0,1500000.0,,,4,4300000,-0.16666666666666666,-0.4
288340,Phillip,Tietz,2024,167,Germany,Braunschweig,Germany,09-07-97,Centre-Forward,Attack,Right,190.0,30-06-27,Unknown,https://img.a.transfermarkt.technology/portrait/header/288340-1723534293.jpg?lm=1,L1,FC Augsburg 1907,5000000.0,5000000.0,27,123,130,3,8,11,14,12,4,15,10,4,6,12,15,7,12,16,12,16,12,12,13,12,17,11,8,13,6,12,17,12,11,13,15,14,14,14,14,14,6,12,6,7,3,2,3,3,3,1,3,2,2,3,2,8,13,8,11,12,12,9,9,1,1,1,1,1,1,1,1,1,1,1,1,1,20,86,10,20,2569412,6250,6250,4755,Northern_European,123,0,0,7671.0,Unknown,91182877,2200000.0,1.0,38,246,40,0,1,7,67,3,0.5772691188145012,0.5032085561497326,0.5441176470588236,0.0073985594921625,0.0,0.0,0.0247561890472618,0.0247561890472618,0.0121947831884219,0.0,0.6279069767441858,0.375,336,104,54,27,1,3967,6,20,128,5000000,202083.33333333334,5000000.0,50000.0,300000.0,350000.0,6,800000,0.0,0.25
289059,Mykola,Matvienko,2024,660,Ukraine,"Saky, Krym",Ukraine,02-05-96,Centre-Back,Defender,Left,182.0,31-12-27,ProStar,https://img.a.transfermarkt.technology/portrait/header/289059-1723486392.png?lm=1,UKR1,FC Shakhtar Donetsk,18000000.0,20000000.0,28,135,136,13,11,11,6,12,12,14,7,13,14,15,7,13,12,12,12,17,12,13,14,13,15,8,9,14,12,15,14,13,13,13,12,15,14,14,13,14,7,15,8,15,2,2,2,1,3,4,3,3,2,2,2,13,15,5,20,13,19,14,13,1,18,20,1,14,1,1,1,1,1,1,1,1,1,75,20,10,48445419,7000,7000,5000,Northern_European,134,51,0,17500.0,Unknown,71075952,9111392.0,2.0,103,1281,101,1,0,7,72,2,0.6765017200317545,0.5294117647058822,0.625,0.016889611599767,0.3355263157894737,0.0,0.0897724431107777,0.0997749437359339,0.0505924720131114,0.1428571428571428,0.4418604651162785,0.4166666666666665,278,18,14,25,0,11274,5,17,21,18000000,885000.0,20000000.0,2000000.0,,,2,600000,0.0,-0.1
289075,Oleksandr,Zubkov,2024,660,Ukraine,"Makiivka, Donetsk Oblast",Ukraine,03-08-96,Right Winger,Attack,Left,182.0,30-06-27,ProStar,https://img.a.transfermarkt.technology/portrait/header/289075-1723486847.png?lm=1,UKR1,FC Shakhtar Donetsk,7000000.0,7000000.0,28,121,122,10,12,14,11,12,12,6,13,3,3,11,10,4,13,12,11,12,12,12,11,10,14,11,11,14,8,9,11,14,14,12,12,12,14,14,13,7,12,10,8,10,3,2,3,1,2,2,2,1,1,2,1,12,14,8,20,10,12,11,10,1,1,1,1,1,1,1,1,1,1,11,12,20,15,78,20,11,3590198,6200,6250,3750,Northern_European,120,12,1,6685.0,Unknown,71081398,1750000.0,2.0,103,898,101,0,0,7,72,10,0.5772691188145012,0.3957219251336898,0.5220588235294117,0.0064464608678774,0.0789473684210526,0.0131578947368421,0.0347586896724181,0.0347586896724181,0.0096947137420483,0.1428571428571428,0.4418604651162785,0.4166666666666665,0,0,0,0,0,0,7,28,40,8000000,411111.1111111111,8000000.0,250000.0,,600000.0,3,1000000,0.14285714285714285,0.6
289255,Andoni,Gorosabel,2024,621,Spain,Arrasate,Spain,04-08-96,Right-Back,Defender,Right,174.0,30-06-28,Unknown,https://img.a.transfermarkt.technology/portrait/header/289255-1604301901.jpg?lm=1,ES1,Athletic Club Bilbao,5000000.0,10000000.0,28,135,146,7,15,13,9,12,8,9,10,8,14,12,11,13,13,14,13,13,13,11,12,13,13,8,9,16,12,14,16,14,13,14,8,13,14,14,15,12,6,10,8,8,3,3,3,3,1,2,3,3,3,3,3,13,14,6,15,12,13,11,11,1,1,1,20,1,18,1,1,1,1,1,1,1,1,70,9,20,11101677,6700,6700,4500,Mediterranean_Hispanic,131,0,0,15871.0,Unknown,67202652,1500000.0,1.0,89,94,89,1,1,3,33,11,0.6368086795448531,0.4759358288770053,0.6029411764705883,0.015316621073438,0.0,0.0,0.0247561890472618,0.0497624406101525,0.0083057862718408,0.0,0.2558139534883721,0.4166666666666665,259,4,16,36,0,4909,4,30,122,5000000,225000.0,10000000.0,5000000.0,,200000.0,4,6550000,0.0,1.0
289257,Jon,Guridi,2024,1108,Spain,Azpeitia,Spain,28-02-95,Central Midfield,Midfield,Left,179.0,30-06-26,IDUB GLOBAL,https://img.a.transfermarkt.technology/portrait/header/289257-1604301765.jpg?lm=1,ES1,Deportivo AlavÃ©s S.A.D.,4000000.0,4000000.0,29,128,135,7,12,10,10,14,8,10,12,7,12,13,10,13,14,14,13,13,12,10,12,12,14,9,11,12,14,14,16,12,13,10,9,14,13,14,14,11,5,13,13,12,2,2,3,3,3,3,2,3,3,3,1,16,9,8,17,14,14,13,14,1,1,1,1,1,1,16,1,20,7,1,15,1,1,64,20,12,7056909,6400,6400,4300,Mediterranean_Hispanic,128,0,0,10502.0,Unknown,67157535,9111392.0,2.0,89,114,89,3,0,3,59,1,0.5971156390579518,0.4545454545454545,0.5808823529411764,0.0101322219722346,0.0,0.0,0.0197549387346836,0.0197549387346836,0.0505924720131114,0.1428571428571428,0.3720930232558141,0.4583333333333332,288,22,16,27,0,4859,9,75,216,4000000,153846.15384615384,5000000.0,1000000.0,,,4,975000,0.0,0.0
289446,Yerry,Mina,2024,1390,Colombia,GuachenÃ©,Colombia,23-09-94,Centre-Back,Defender,Right,195.0,30-06-25,Andrei MartÃ­nez,https://img.a.transfermarkt.technology/portrait/header/289446-1663316363.jpg?lm=1,IT1,Cagliari Calcio,3000000.0,30000000.0,30,139,154,6,8,12,7,12,6,16,8,9,14,12,9,15,11,13,12,13,14,13,9,14,15,9,17,10,14,13,14,10,12,8,17,11,13,12,16,12,13,12,15,5,1,3,1,3,2,2,3,1,2,3,4,15,14,9,12,14,13,12,11,1,1,20,1,1,1,1,1,1,1,1,1,1,7,79,9,20,33999787,6950,7300,6000,African_Caribbean,138,39,7,139190.0,Unknown,76037151,15283333.33,3.0,20,569,20,1,1,1,46,2,0.7161947605186557,0.6363636363636364,0.6544117647058822,0.1343955767004278,0.256578947368421,0.0921052631578947,0.0147536884221055,0.1497874468617154,0.0848819874440956,0.2857142857142857,0.7441860465116279,0.5,339,33,8,60,2,14663,22,109,87,3000000,97916.66666666667,30000000.0,6000000.0,,,5,17100000,0.0,-0.4
289510,Samuel,Bastien,2024,385,Belgium,Meux,DR Congo,26-09-96,Central Midfield,Midfield,Right,175.0,Unknown,Sport Cover,https://img.a.transfermarkt.technology/portrait/header/289510-1695905277.png?lm=1,NL1,Fortuna Sittardia Combinatie,1100000.0,7000000.0,28,124,135,12,12,13,10,14,10,10,12,8,12,14,10,12,14,14,13,12,14,12,13,12,11,11,11,12,12,13,11,14,14,13,10,14,14,13,12,11,6,12,4,14,3,1,1,2,4,2,2,3,3,2,2,8,11,3,13,12,13,12,13,1,1,1,1,1,1,19,1,20,1,1,12,1,1,73,8,20,5219583,6100,6150,4500,Mixed_Race,129,7,0,14499.0,Unknown,18072298,1337500.0,4.0,7,947,29,3,1,4,94,1,0.5640381053188674,0.4759358288770053,0.588235294117647,0.0139917941844734,0.0460526315789473,0.0,0.005251312828207,0.0347586896724181,0.007402983416206,0.4285714285714285,0.2790697674418605,0.4166666666666665,270,19,14,20,0,6816,5,47,141,850000,18965.51724137931,7000000.0,1500000.0,300000.0,1500000.0,6,1200000,-0.22727272727272727,-0.43333333333333335
289592,Orel,Mangala,2024,29,Belgium,Brussel,Belgium,18-03-98,Central Midfield,Midfield,Right,178.0,30-06-25,M-Soccermanagement,https://img.a.transfermarkt.technology/portrait/header/289592-1657181518.jpg?lm=1,GB1,Everton Football Club,20000000.0,22000000.0,26,126,134,8,10,15,9,13,8,10,10,8,11,13,10,13,14,11,12,15,14,13,13,12,13,12,9,12,13,11,10,13,14,16,10,17,13,12,15,10,10,15,8,12,1,1,3,2,1,2,1,3,3,1,2,13,13,13,8,12,12,12,8,1,1,1,1,1,1,18,10,20,1,10,12,1,1,82,10,20,11950706,6300,6300,5450,African_Caribbean,126,2,0,52196.0,Unknown,18087973,12733333.33,3.0,7,265,8,3,1,1,65,1,0.5838846255623181,0.5775401069518716,0.5661764705882353,0.0503926682612226,0.0131578947368421,0.0,0.0997749437359339,0.1097774443610902,0.0707149272479791,0.2857142857142857,0.3488372093023257,0.3333333333333332,271,13,23,40,2,4385,11,55,310,20000000,826086.9565217391,22000000.0,5000000.0,,5500000.0,5,8200000,0.0,-0.09090909090909091
289835,Jens,Stage,2024,86,Denmark,HÃ¸jbjerg,Denmark,08-11-96,Central Midfield,Midfield,Right,187.0,30-06-26,CMA Group,https://img.a.transfermarkt.technology/portrait/header/289835-1660208628.jpg?lm=1,L1,Sportverein Werder Bremen von 1899,9000000.0,9000000.0,28,130,133,5,9,10,12,11,7,14,11,11,13,12,10,14,10,16,14,15,13,13,11,13,16,8,15,14,13,15,18,13,11,11,15,14,13,16,14,13,7,15,8,20,1,1,4,4,2,3,4,1,3,1,1,10,13,1,14,15,16,15,15,1,10,1,10,1,1,14,12,20,15,1,1,13,1,83,9,20,7811012,6750,6350,2504,Northern_European,127,1,0,11474.0,Unknown,27104982,3000000.0,2.0,28,647,30,3,1,7,194,1,0.590500132310135,0.2624598930481283,0.5735294117647058,0.0110708019547955,0.006578947368421,0.0,0.0447611902975743,0.0447611902975743,0.0166393510930859,0.1428571428571428,0.5581395348837206,0.4166666666666665,298,47,28,51,1,8699,12,41,54,12000000,478000.0,12000000.0,1000000.0,,300000.0,3,1550000,0.6,1.0
290017,Hassane,Kamara,2024,410,France,Saint-Denis,Cote d'Ivoire,05-03-94,Left-Back,Defender,Left,170.0,30-06-26,Unknown,https://img.a.transfermarkt.technology/portrait/header/290017-1661251137.jpg?lm=1,IT1,Udinese Calcio,4500000.0,8000000.0,30,132,136,10,14,13,9,13,10,12,10,6,12,12,11,15,13,13,12,15,13,13,13,12,11,14,7,12,11,15,16,14,12,12,9,15,15,15,10,14,9,13,5,14,2,1,3,2,1,2,1,1,1,3,1,14,14,4,11,10,12,11,16,1,20,1,1,17,1,1,16,10,1,15,1,1,1,67,20,7,4306857,6600,6600,4750,African_Caribbean,128,7,0,22328.0,Watford,85057778,9000000.0,3.0,34,1271,24,1,0,1,205,8,0.6235776660492194,0.5026737967914437,0.5808823529411764,0.0215516117600595,0.0460526315789473,0.0,0.0222555638909727,0.0397599399849962,0.049973610378066,0.2857142857142857,0.1627906976744184,0.5,307,21,11,43,2,5573,3,15,82,3500000,135416.66666666666,8000000.0,3000000.0,,250000.0,6,6600000,-0.2222222222222222,-0.3
290249,Mauro,Arambarri,2024,3709,Uruguay,Salto,Uruguay,30-09-95,Central Midfield,Midfield,Right,175.0,30-06-28,Unknown,https://img.a.transfermarkt.technology/portrait/header/290249-1669365106.jpg?lm=1,ES1,Getafe Club de FÃºtbol S.A.D. Team Dubai,5000000.0,25000000.0,29,139,149,8,10,12,10,13,11,8,12,4,13,13,6,15,13,14,14,16,13,15,12,13,15,11,8,12,14,16,16,13,12,14,6,12,13,16,13,15,11,13,9,12,4,2,3,1,1,2,2,3,1,3,2,8,12,2,9,13,14,10,13,1,1,1,1,1,1,20,1,18,15,1,1,1,1,71,12,20,7343554,6950,6950,6200,Mediterranean_Hispanic,138,12,0,19137.0,Unknown,78064881,2050000.0,3.0,106,1288,103,3,1,3,105,1,0.6698862132839376,0.6577540106951871,0.6544117647058822,0.0184703270642241,0.0789473684210526,0.0,0.0247561890472618,0.1247811952988247,0.0113614267062973,0.2857142857142857,0.2790697674418605,0.4583333333333332,287,13,15,86,0,5350,14,94,213,5000000,152343.75,25000000.0,5000000.0,350000.0,2250000.0,2,2000000,0.0,-0.16666666666666666
290256,Unknown,Xeka,2024,1465,Portugal,Paredes,Portugal,10-11-94,Central Midfield,Midfield,Right,185.0,30-06-25,Promoesport,https://img.a.transfermarkt.technology/portrait/header/290256-1599421564.jpg?lm=1,PO1,Grupo Desportivo Estoril Praia,3000000.0,10000000.0,30,131,140,12,11,13,8,15,9,10,11,6,9,15,8,11,14,12,12,10,14,14,15,13,15,14,8,13,14,15,14,11,12,14,12,12,11,14,12,14,7,14,8,14,2,2,2,1,3,2,2,1,2,1,1,11,14,10,13,13,15,12,14,1,1,1,1,1,1,17,1,20,1,10,5,7,1,79,12,20,6172072,6550,6500,4750,Mediterranean_Hispanic,131,0,0,18429.0,Unknown,55068415,5000000.0,1.0,76,1120,79,3,1,3,109,1,0.6103466525535857,0.5026737967914437,0.6029411764705883,0.0177866700398896,0.0,0.0,0.0147536884221055,0.0497624406101525,0.0277507708547459,0.0,0.5116279069767438,0.5,269,14,16,65,0,7202,3,46,174,2000000,72916.66666666667,10000000.0,3000000.0,250000.0,150000.0,9,5650000,-0.3333333333333333,-0.6
290273,Álvaro,Tejero,2024,714,Spain,Madrid,Spain,20-07-96,Right-Back,Defender,Right,174.0,30-06-25,CAA Base Ltd,https://img.a.transfermarkt.technology/portrait/header/290273-1557741576.jpg?lm=1,ES1,Reial Club Deportiu Espanyol de Barcelona S.A.D.,2000000.0,3000000.0,28,123,137,10,13,11,5,12,11,11,14,13,13,12,9,13,11,10,13,12,11,12,10,11,9,8,10,11,14,13,13,13,12,11,8,14,13,13,9,12,9,14,5,15,1,2,1,1,1,4,1,3,1,1,3,11,12,5,12,12,12,13,15,1,18,13,20,15,18,1,1,1,1,1,1,1,1,65,14,20,1986947,6200,6200,3750,Mediterranean_Hispanic,119,0,0,7339.0,Unknown,67211897,9111392.0,2.0,89,892,89,1,1,3,170,11,0.5706536120666843,0.3957219251336898,0.5147058823529411,0.0070779745598475,0.0,0.0,0.0097524381095273,0.0147536884221055,0.0505924720131114,0.1428571428571428,0.2558139534883721,0.4166666666666665,336,14,41,59,1,2386,1,3,22,2000000,85000.0,3000000.0,600000.0,,300000.0,5,1000000,0.0,0.0
290336,Unknown,Rochinha,2024,3329,Portugal,Espinho,Portugal,03-05-95,Left Winger,Attack,Right,169.0,30-06-27,Universal Twenty Two,https://img.a.transfermarkt.technology/portrait/header/290336-1666099955.jpg?lm=1,PO1,Futebol Clube de FamalicÃ£o,1500000.0,3500000.0,29,135,139,14,14,16,13,15,12,6,14,7,5,14,12,8,16,10,12,12,13,11,15,12,12,14,8,14,8,8,12,13,15,12,6,12,13,13,7,11,6,5,7,13,2,3,3,2,4,4,2,1,3,3,3,13,16,7,10,12,14,8,14,1,1,1,1,1,1,1,7,14,14,20,18,18,14,67,12,20,7492499,6750,6750,5250,Mediterranean_Hispanic,133,0,0,16749.0,Unknown,55063244,1200000.0,2.0,76,472,79,0,1,3,99,7,0.6434241862926701,0.5561497326203209,0.6176470588235294,0.0161644330329941,0.0,0.0,0.0072518129532383,0.0172543135783946,0.0066390733075918,0.1428571428571428,0.13953488372093,0.4583333333333332,262,30,36,38,1,7585,1,6,37,1500000,46428.57142857143,3500000.0,1000000.0,,300000.0,6,1050000,0.0,-0.16666666666666666
290346,André,Ferreira,2024,366,Portugal,Vila Nova de Gaia,Portugal,29-05-96,Goalkeeper,Goalkeeper,Right,193.0,30-06-27,MadeinFootball,https://img.a.transfermarkt.technology/portrait/header/290346-1548259586.jpg?lm=1,ES1,Real Valladolid Club de FÃºtbol S.A.D.,800000.0,900000.0,28,122,127,3,2,3,1,10,8,7,3,3,2,11,1,2,10,11,11,13,10,13,11,11,12,3,7,2,13,14,13,12,14,10,15,13,11,12,11,10,10,12,12,10,15,8,12,13,14,13,12,16,9,10,12,12,11,6,14,7,14,15,13,20,1,1,1,1,1,1,1,1,1,1,1,1,1,79,7,20,1558388,6100,6100,4000,Mediterranean_Hispanic,123,0,0,1495.0,Unknown,55070267,875000.0,2.0,76,1589,79,2,1,3,169,5,0.5574225985710506,0.4224598930481283,0.5441176470588236,0.0014349072572896,0.0,0.0,0.0037509377344336,0.0042510627656914,0.0048334675963221,0.1428571428571428,0.6976744186046511,0.4166666666666665,0,0,0,0,0,0,3,21,107,800000,38750.0,900000.0,200000.0,,150000.0,6,500000,0.0,0.0
290391,Nuno,Santos,2024,336,Portugal,Trofa,Portugal,13-02-95,Left Winger,Attack,Left,177.0,30-06-27,Gestifute,https://img.a.transfermarkt.technology/portrait/header/290391-1602775224.jpg?lm=1,PO1,Sporting Clube de Portugal,14000000.0,14000000.0,29,141,145,15,16,14,14,14,14,7,14,10,6,15,10,7,15,16,12,16,14,12,15,13,16,14,10,14,8,11,15,15,13,16,7,13,15,12,8,12,17,12,12,12,2,1,1,3,2,4,2,4,1,2,2,7,13,12,12,12,16,9,8,1,12,1,1,17,1,1,19,1,6,20,1,15,1,72,20,6,18719999,7050,6500,5750,Mediterranean_Hispanic,138,0,0,16511.0,Unknown,55070264,4150000.0,1.0,76,1525,79,0,0,3,193,7,0.6103466525535857,0.6096256684491979,0.6544117647058822,0.0159346161236839,0.0,0.0,0.0697674418604651,0.0697674418604651,0.0230284174560404,0.0,0.3255813953488373,0.4583333333333332,363,58,73,39,1,8137,9,107,248,11000000,452173.9130434783,14000000.0,3000000.0,,600000.0,3,2200000,-0.21428571428571427,-0.08333333333333333
290532,Saïd,Benrahma,2024,1041,Algeria,AÃ¯n TÃ©mouchent,Algeria,10-08-95,Left Winger,Attack,Right,172.0,30-06-27,Unknown,https://img.a.transfermarkt.technology/portrait/header/290532-1686212081.jpg?lm=1,FR1,Olympique Lyonnais,15000000.0,25000000.0,29,140,148,10,13,17,13,17,13,8,11,6,5,13,12,6,17,10,11,11,13,11,13,12,14,18,6,14,6,10,13,14,15,13,7,14,14,14,9,11,4,11,5,12,3,2,2,4,3,2,3,3,1,2,1,13,13,6,12,14,14,13,12,1,1,1,1,1,1,1,1,1,1,20,18,18,13,67,12,20,31129862,6994,6994,5494,North_African__Middle_Eastern,138,17,1,69595.0,Unknown,48036788,13066666.67,3.0,1,116,1,0,1,6,143,7,0.6757078592220164,0.5822459893048127,0.6544117647058822,0.0671934430725168,0.1118421052631578,0.0131578947368421,0.0747686921730432,0.1247811952988247,0.0725668305786271,0.2857142857142857,0.2093023255813952,0.4583333333333332,380,82,68,18,2,8302,1,2,15,15000000,641304.3478260869,25000000.0,5000000.0,,800000.0,7,3050000,-0.25,-0.3181818181818182
290537,Jean,Butez,2024,1096,France,Lille,France,08-06-95,Goalkeeper,Goalkeeper,Right,189.0,30-06-26,YOU FIRST,https://img.a.transfermarkt.technology/portrait/header/290537-1704961364.jpg?lm=1,BE1,Royal Antwerp Football Club,6000000.0,8000000.0,29,126,126,3,3,1,2,9,5,2,1,2,3,12,4,3,8,9,12,9,12,13,10,16,8,3,7,2,11,12,11,12,13,12,14,14,13,12,13,15,8,5,7,11,12,12,12,6,15,14,11,15,8,12,13,13,12,7,14,12,12,10,18,20,1,1,1,1,1,1,1,1,1,1,1,1,1,83,7,20,3915337,6263,6259,3026,Northern_European,128,0,0,14999.0,Unknown,48030298,600000.0,2.0,34,834,36,2,1,7,173,5,0.5784599100291082,0.3182887700534759,0.5808823529411764,0.014474602817478,0.0,0.0,0.0297574393598399,0.0397599399849962,0.0033056473790938,0.1428571428571428,0.6046511627906974,0.4583333333333332,0,0,0,0,0,0,2,24,93,4000000,148076.92307692306,8000000.0,2000000.0,,150000.0,2,400000,-0.5,-0.5
290587,Ellyes,Skhiri,2024,24,France,Lunel,Tunisia,10-05-95,Defensive Midfield,Midfield,Right,185.0,30-06-27,CAA Stellar,https://img.a.transfermarkt.technology/portrait/header/290587-1696509403.jpg?lm=1,L1,Eintracht Frankfurt FuÃŸball AG,11000000.0,13000000.0,29,139,143,5,11,13,12,14,13,12,15,5,13,14,8,13,13,14,16,13,12,13,12,12,15,12,13,11,14,15,15,13,13,13,13,15,13,19,12,12,10,12,6,13,1,3,2,3,2,2,1,2,2,1,1,14,14,6,15,12,15,12,14,1,1,10,1,5,5,20,7,18,7,1,8,1,1,73,8,20,6174703,6748,6748,4998,North_African__Middle_Eastern,139,45,3,28846.0,Unknown,85126092,6000000.0,1.0,34,876,99,3,1,6,63,4,0.6431595660227574,0.5291978609625668,0.6617647058823528,0.0278455050999075,0.2960526315789473,0.0394736842105263,0.0547636909227306,0.0647661915478869,0.0333064807355759,0.0,0.5116279069767438,0.4583333333333332,0,0,0,0,0,0,9,28,39,9000000,384782.60869565216,13000000.0,3500000.0,,300000.0,2,3500000,-0.18181818181818182,-0.3076923076923077
291200,Moussa,Niakhaté,2024,1041,France,Roubaix,Senegal,08-03-96,Centre-Back,Defender,Left,190.0,30-06-28,CAA Stellar,https://img.a.transfermarkt.technology/portrait/header/291200-1700737208.jpg?lm=1,FR1,Olympique Lyonnais,15000000.0,18000000.0,28,138,146,4,9,11,7,12,4,14,6,18,13,12,15,14,12,16,12,16,12,12,12,12,16,12,16,11,13,13,12,13,11,14,16,16,16,13,16,13,13,15,4,15,1,3,3,3,2,1,2,2,1,3,3,16,17,11,12,16,16,12,12,1,17,20,10,14,8,1,1,1,1,1,1,1,1,82,20,10,24803673,6900,6600,5500,African_Caribbean,137,0,0,75395.0,Unknown,48037362,17233333.33,3.0,34,1255,84,1,0,1,143,2,0.6235776660492194,0.5828877005347594,0.6470588235294117,0.0727940232153703,0.0,0.0,0.0747686921730432,0.0897724431107777,0.0957156217117142,0.2857142857142857,0.6279069767441858,0.4166666666666665,315,11,9,48,1,2729,3,48,215,15000000,594000.0,18000000.0,3000000.0,,300000.0,4,4600000,-0.0625,-0.0625
291399,Unknown,Nanu,2024,152,Portugal,Coimbra,Guinea-Bissau,17-05-94,Right-Back,Defender,Right,177.0,30-06-25,YES SPORTS,https://img.a.transfermarkt.technology/portrait/header/291399-1727717954.png?lm=1,TR1,Samsunspor,500000.0,3000000.0,30,126,136,6,8,15,12,11,5,6,8,11,9,9,8,10,12,10,12,11,12,11,9,8,14,15,8,13,11,7,13,18,16,8,8,16,16,14,7,10,3,12,5,19,1,1,2,2,2,3,3,2,3,2,4,12,14,6,12,11,14,11,12,1,11,1,20,10,18,1,12,1,16,15,1,15,1,69,8,20,749460,6275,6457,4530,African_Caribbean,103,19,0,6028.0,FC Dallas,55067769,9111392.0,2.0,76,374,45,1,1,1,180,11,0.6046573167504631,0.4791443850267379,0.3970588235294117,0.0058120503241094,0.125,0.0,0.0022505626406601,0.0147536884221055,0.0505924720131114,0.1428571428571428,0.3255813953488373,0.5,154,3,16,11,0,3926,6,14,29,400000,11904.761904761905,3000000.0,1000000.0,,,8,3550000,-0.42857142857142855,-0.4666666666666667
291417,Ferland,Mendy,2024,418,France,Meulan-en-Yvelines,France,08-06-95,Left-Back,Defender,Left,180.0,30-06-25,FAIR SPORT MNG,https://img.a.transfermarkt.technology/portrait/header/291417-1701294025.jpg?lm=1,ES1,Real Madrid Club de FÃºtbol,22000000.0,50000000.0,29,156,160,5,13,13,7,14,5,9,11,13,13,12,7,12,13,14,15,17,13,12,11,11,15,13,6,13,13,15,17,17,15,16,11,15,16,16,16,13,8,13,7,15,1,1,3,3,1,1,1,2,1,3,1,12,16,9,12,12,14,10,12,1,20,12,12,19,9,1,1,1,1,1,1,1,1,73,20,14,51637502,7800,7500,7250,African_Caribbean,149,7,0,178081.0,Unknown,85133751,26500000.0,2.0,34,946,36,1,0,1,167,8,0.7426567875099233,0.7700534759358288,0.7352941176470587,0.171949397792792,0.0460526315789473,0.0,0.1097774443610902,0.2498124531132783,0.1471985332925914,0.1428571428571428,0.3953488372093026,0.4583333333333332,380,12,21,57,1,9009,15,72,126,18000000,615517.2413793104,50000000.0,10000000.0,,250000.0,2,12750000,-0.18181818181818182,-0.1
291739,Milot,Rashica,2024,114,Yugoslavia (Republic),Vushtrri,Kosovo,28-06-96,Right Winger,Attack,Right,178.0,30-06-27,ALF Sports GmbH,https://img.a.transfermarkt.technology/portrait/header/291739-1727356752.png?lm=1,TR1,Be?ikta? Jimnastik KulÃ¼bÃ¼,8000000.0,35000000.0,28,131,146,12,12,14,11,13,11,6,11,7,5,11,10,6,13,14,8,9,10,10,10,9,12,14,7,11,7,12,12,17,16,11,8,13,15,12,8,11,6,12,10,11,2,2,1,1,1,2,3,2,1,3,2,16,16,10,9,11,13,14,14,1,1,1,1,1,1,1,15,1,20,15,10,20,18,73,9,20,16283705,6646,6546,5096,Mediterranean_Hispanic,112,44,8,46397.0,Galatasaray A.Åž.,11024791,6162500.0,4.0,110,1633,59,0,1,3,37,10,0.6164329187615771,0.5396791443850267,0.463235294117647,0.0447930537356352,0.2894736842105263,0.1052631578947368,0.0397599399849962,0.1747936984246061,0.0342092835912108,0.4285714285714285,0.3488372093023257,0.4166666666666665,339,58,68,17,0,4883,15,59,42,7500000,248333.33333333334,35000000.0,7000000.0,,3500000.0,4,3000000,0.0,0.0
291750,Soner,Dikmen,2024,589,TÃ¼rkiye,Ankara,TÃ¼rkiye,01-09-93,Central Midfield,Midfield,Right,179.0,30-06-26,MEK Football,https://img.a.transfermarkt.technology/portrait/header/291750-1726736215.jpg?lm=1,TR1,Antalyaspor,1500000.0,2800000.0,31,120,125,12,9,10,6,11,12,12,11,6,12,12,12,14,11,12,12,14,12,12,12,12,10,11,12,11,12,14,14,12,12,12,13,14,12,13,13,11,10,12,5,13,2,2,1,4,2,3,1,3,1,1,3,13,10,5,13,8,13,13,15,1,1,8,12,1,1,20,1,16,1,1,12,1,1,77,12,20,2544290,5950,5950,4850,Mediterranean_Hispanic,120,0,0,2764.0,Unknown,70079631,9111392.0,2.0,100,71,100,3,1,3,19,1,0.5375760783275999,0.5133689839572192,0.5220588235294117,0.0026602755678553,0.0,0.0,0.0072518129532383,0.0137534383595899,0.0505924720131114,0.1428571428571428,0.3720930232558141,0.5416666666666665,374,40,7,68,3,4068,3,11,34,1300000,47826.086956521736,2800000.0,500000.0,,,5,650000,-0.23529411764705882,-0.4090909090909091
291927,Burak,Y?Lmaz,2024,7775,TÃ¼rkiye,Istanbul,TÃ¼rkiye,27-11-95,Centre-Back,Defender,Right,185.0,30-06-25,Do?an Ercan,https://img.a.transfermarkt.technology/portrait/header/291927-1728055498.jpg?lm=1,TR1,Hatayspor Futbol KulÃ¼bÃ¼,175000.0,450000.0,29,135,145,7,9,13,17,11,14,13,13,8,5,11,16,3,11,10,15,9,15,13,10,13,15,12,13,17,6,12,10,13,12,10,14,16,15,8,14,14,17,12,12,5,1,1,2,1,1,4,3,1,3,1,1,8,17,12,6,15,16,5,12,1,1,1,1,1,1,1,1,1,1,14,14,14,20,80,12,20,347975206,6750,6750,5300,Mediterranean_Hispanic,134,77,31,9588.0,Unknown,470884,9111392.0,2.0,100,667,100,1,1,3,111,2,0.6434241862926701,0.5614973262032085,0.625,0.0092496477911022,0.506578947368421,0.4078947368421052,0.0006251562890722,0.0020005001250312,0.0505924720131114,0.1428571428571428,0.5116279069767438,0.4583333333333332,223,11,3,59,0,5378,3,16,64,175000,6250.0,450000.0,100000.0,,100000.0,6,400000,-0.125,-0.125
291939,Unknown,Samu,2024,2420,Portugal,Mozelos,Portugal,21-04-96,Attacking Midfield,Midfield,Left,170.0,30-06-27,LEADERBROCK,https://img.a.transfermarkt.technology/portrait/header/291939-1478181309.jpg?lm=1,PO1,VitÃ³ria Sport Clube,1500000.0,1500000.0,28,125,132,13,13,12,10,14,13,11,13,8,7,14,11,13,15,12,13,14,13,13,14,12,16,13,11,11,14,16,15,11,11,15,6,14,13,15,13,14,8,12,5,10,2,2,2,1,3,4,3,1,2,2,1,17,12,8,15,14,14,11,10,1,1,1,1,1,1,14,1,20,1,10,18,12,1,71,20,7,1689135,6249,6249,4999,Mediterranean_Hispanic,128,0,0,2249.0,Unknown,55071333,9111392.0,2.0,76,989,79,3,0,3,217,0,0.5771368086795449,0.5293048128342246,0.5808823529411764,0.0021629826758606,0.0,0.0,0.0072518129532383,0.0072518129532383,0.0505924720131114,0.1428571428571428,0.1627906976744184,0.4166666666666665,221,31,25,35,0,2672,1,1,12,2000000,100000.0,2000000.0,125000.0,100000.0,150000.0,3,575000,0.3333333333333333,1.0
292199,U?Urcan,ÃÂ¡Ak?R,2024,449,TÃ¼rkiye,Antalya,TÃ¼rkiye,05-04-96,Goalkeeper,Goalkeeper,Right,191.0,30-06-27,DW Sports Management,https://img.a.transfermarkt.technology/portrait/header/292199-1723802510.jpg?lm=1,TR1,Trabzonspor KulÃ¼bÃ¼,8500000.0,19000000.0,28,145,160,1,3,1,1,11,1,8,3,3,3,11,3,3,12,10,14,13,13,14,9,13,17,5,14,1,14,13,13,8,16,13,14,14,10,14,13,17,1,15,1,2,14,14,14,5,14,12,16,17,6,10,13,20,13,7,17,15,15,13,13,20,1,1,1,1,1,1,1,1,1,1,1,1,1,78,8,20,7809349,7443,7443,6193,Mediterranean_Hispanic,145,20,0,35451.0,Unknown,70097314,9111392.0,2.0,100,73,100,2,1,3,204,5,0.735115109817412,0.6570053475935829,0.7058823529411764,0.0342234071418984,0.131578947368421,0.0,0.0422605651412853,0.0947736934233558,0.0505924720131114,0.1428571428571428,0.6511627906976742,0.4166666666666665,0,0,0,0,0,0,11,26,30,8000000,240909.0909090909,19000000.0,3000000.0,75000.0,400000.0,3,325000,0.0,-0.1111111111111111
292808,Wout,Faes,2024,1003,Belgium,Mol,Belgium,03-04-98,Centre-Back,Defender,Right,187.0,30-06-27,Claes Agency,https://img.a.transfermarkt.technology/portrait/header/292808-1668080038.jpg?lm=1,GB1,Leicester City Football Club,20000000.0,20000000.0,26,135,144,8,10,11,6,12,8,14,8,5,15,13,5,15,12,13,17,14,14,13,14,12,14,8,15,8,14,14,15,12,12,13,14,12,12,14,13,14,15,12,6,10,1,2,1,2,2,3,3,1,4,1,2,11,15,4,13,12,11,12,17,1,1,20,1,1,1,14,1,10,1,1,1,1,1,84,7,20,18501541,6600,6600,4500,Northern_European,135,1,0,69595.0,Unknown,18083577,6766666.667,3.0,7,964,8,1,1,7,127,2,0.6235776660492194,0.4759358288770053,0.6323529411764706,0.0671934430725168,0.006578947368421,0.0,0.0997749437359339,0.0997749437359339,0.0375658583127309,0.2857142857142857,0.5581395348837206,0.3333333333333332,304,12,4,46,3,5672,1,2,15,20000000,818750.0,20000000.0,300000.0,350000.0,2000000.0,5,5550000,0.0,0.0
292818,Jonathan,Bamba,2024,940,France,Alfortville,Cote d'Ivoire,26-03-96,Left Winger,Attack,Right,175.0,30-06-26,AMS CONSULTING,https://img.a.transfermarkt.technology/portrait/header/292818-1599420401.jpg?lm=1,ES1,Real Club Celta de Vigo S. A. D.,9000000.0,25000000.0,28,143,147,11,12,14,13,13,8,5,11,7,7,11,10,7,14,12,14,11,13,14,10,13,14,12,6,15,7,12,13,16,15,14,6,17,16,14,13,13,6,11,7,12,2,1,3,3,2,1,3,2,1,1,3,8,15,3,13,10,13,12,12,1,1,1,1,1,1,1,12,1,14,20,10,19,15,72,8,20,16059908,7147,6547,4497,African_Caribbean,136,0,0,27615.0,Unknown,29114989,9111392.0,2.0,34,41,24,0,1,1,165,7,0.6165652288965335,0.475614973262032,0.6397058823529411,0.0266568302454502,0.0,0.0,0.0447611902975743,0.1247811952988247,0.0505924720131114,0.1428571428571428,0.2790697674418605,0.4166666666666665,338,50,54,26,0,5917,3,15,43,4000000,132758.62068965516,25000000.0,6000000.0,150000.0,600000.0,6,16350000,-0.5555555555555556,-0.7142857142857143
293169,Josip,Brekalo,2024,10484,Croatia,Zagreb,Croatia,23-06-98,Left Winger,Attack,Right,175.0,30-06-25,Bola,https://img.a.transfermarkt.technology/portrait/header/293169-1727699429.jpg?lm=1,TR1,Kas?mpa?a Spor KulÃ¼bÃ¼,3200000.0,15000000.0,26,136,147,14,13,15,12,15,15,6,16,4,4,13,10,4,15,10,13,8,12,10,13,12,13,16,4,14,4,10,9,16,15,13,7,13,15,13,8,11,5,14,9,14,1,1,2,2,2,1,3,1,2,3,3,15,14,15,7,15,7,8,10,1,1,1,1,1,1,1,15,1,12,20,18,15,12,70,12,20,6456994,6800,6550,5800,Northern_European,134,33,4,34520.0,Unknown,24046837,9111392.0,2.0,24,1697,25,0,1,7,117,7,0.6169621593014025,0.6149732620320855,0.625,0.0333244174672438,0.2171052631578947,0.0526315789473684,0.0157539384846211,0.0747686921730432,0.0505924720131114,0.1428571428571428,0.2790697674418605,0.3333333333333332,0,0,0,0,0,0,10,18,24,3200000,84615.38461538461,15000000.0,5000000.0,3000000.0,10000000.0,8,14300000,-0.08571428571428572,-0.28888888888888886
293194,Borna,Sosa,2024,416,Croatia,Zagreb,Croatia,21-01-98,Left-Back,Defender,Left,187.0,30-06-25,SEG,https://img.a.transfermarkt.technology/portrait/header/293194-1716241200.jpg?lm=1,IT1,Torino Calcio,7500000.0,23000000.0,26,134,142,14,16,14,7,13,14,10,9,13,11,14,8,12,14,9,12,12,12,12,14,14,12,14,10,13,11,14,13,14,13,10,11,14,16,13,11,14,7,14,8,11,1,1,2,2,3,3,3,2,1,2,2,14,17,8,9,13,15,12,14,1,20,1,1,20,1,1,16,1,1,10,1,1,1,79,20,8,6320982,6650,6550,5750,Mediterranean_Hispanic,129,6,0,13461.0,Unknown,24048099,7000000.0,2.0,24,1697,25,1,0,3,201,8,0.6169621593014025,0.6096256684491979,0.588235294117647,0.0129894834623558,0.0394736842105263,0.0,0.0372593148287071,0.1147786946736684,0.038862190616406,0.1428571428571428,0.5581395348837206,0.3333333333333332,215,5,46,27,0,6413,31,82,145,6000000,239583.33333333334,23000000.0,5000000.0,500000.0,6000000.0,4,10000000,-0.2,-0.25
293200,Nikola,Vlaši?,2024,416,Croatia,Split,Croatia,04-10-97,Attacking Midfield,Midfield,Right,179.0,30-06-27,Unknown,https://img.a.transfermarkt.technology/portrait/header/293200-1695028630.jpg?lm=1,IT1,Torino Calcio,10000000.0,30000000.0,27,143,155,12,12,16,13,15,12,9,14,4,7,14,13,8,14,13,15,11,14,13,14,14,17,14,13,14,6,11,12,15,14,15,10,17,14,14,12,12,6,15,6,10,3,2,3,1,2,3,2,1,2,1,1,15,15,5,11,14,13,15,16,1,1,1,1,1,1,7,12,16,11,15,20,16,12,79,11,20,44210250,7150,6550,5750,Northern_European,143,39,7,81194.0,Torino,24039948,18600000.0,4.0,24,1409,25,3,1,7,201,0,0.6169621593014025,0.6096256684491979,0.6911764705882353,0.0783936377409577,0.256578947368421,0.0921052631578947,0.0497624406101525,0.1497874468617154,0.1033084252340342,0.4285714285714285,0.3720930232558141,0.375,370,60,57,22,0,8325,13,38,102,7000000,231481.4814814815,30000000.0,4500000.0,4500000.0,8000000.0,4,11000000,-0.3,-0.46153846153846156
293213,Amir,Hadziahmetovic,2024,126,Denmark,NexÃ¸,Bosnia-Herzegovina,08-03-97,Defensive Midfield,Midfield,Right,179.0,30-06-25,SC SPORT,https://img.a.transfermarkt.technology/portrait/header/293213-1696075883.png?lm=1,TR1,Ã‡aykur Rizespor KulÃ¼bÃ¼,6000000.0,8000000.0,27,130,140,11,11,13,10,14,10,10,14,5,10,15,10,10,13,10,12,12,14,14,15,13,12,13,8,14,14,15,15,12,11,11,9,13,12,13,13,16,12,10,13,12,1,1,3,2,4,1,2,3,2,3,4,11,11,1,12,10,11,11,10,1,1,1,1,1,1,18,10,20,8,1,13,1,1,71,10,20,7205799,6493,5999,6243,Northern_European,130,20,0,8000.0,Unknown,21026981,2052500.0,2.0,28,1039,10,3,1,7,225,4,0.5440592749404605,0.6623529411764705,0.5955882352941175,0.0077162475726795,0.131578947368421,0.0,0.0297574393598399,0.0397599399849962,0.0113753159809994,0.1428571428571428,0.3720930232558141,0.375,315,22,30,36,2,6201,9,78,211,5500000,176666.66666666666,8000000.0,1000000.0,700000.0,1500000.0,3,1000000,-0.15384615384615385,-0.3125
293279,Mark,Brink,2024,2778,Unknown,Unknown,Denmark,15-03-98,Defensive Midfield,Midfield,Right,177.0,30-06-27,CMA Group,https://img.a.transfermarkt.technology/portrait/header/293279-1662668806.jpg?lm=1,DK1,Fodbold Club NordsjÃ¦lland,1000000.0,1000000.0,26,121,125,10,12,12,11,13,11,9,11,7,12,14,10,12,14,8,13,12,14,13,12,11,8,9,12,9,12,14,14,12,11,12,10,10,12,10,12,12,4,14,6,15,2,3,2,2,4,3,2,1,3,3,1,19,16,4,15,8,8,15,14,1,1,1,1,1,1,15,13,20,13,12,15,14,1,0,12,20,509907,5100,5750,1960,Northern_European,118,0,0,1814.0,Unknown,27112254,1480000.0,1.0,105,1549,30,3,1,7,87,4,0.5111140513363324,0.2042780748663101,0.5073529411764706,0.0017429391651466,0.0,0.0,0.0047511877969492,0.0047511877969492,0.0081946720742242,0.0,0.3255813953488373,0.3333333333333332,298,13,22,36,1,11871,4,9,89,1700000,80000.0,1700000.0,100000.0,100000.0,350000.0,2,750000,0.7,1.4285714285714286
293281,Jacob,Bruun Larsen,2024,533,Denmark,Lyngby,Denmark,19-09-98,Left Winger,Attack,Right,183.0,30-06-25,Dirk Hebel,https://img.a.transfermarkt.technology/portrait/header/293281-1657201254.jpg?lm=1,L1,TSG 1899 Hoffenheim FuÃŸball-Spielbetriebs GmbH,6000000.0,20000000.0,26,131,145,12,11,12,10,11,11,9,11,10,7,12,10,7,12,15,13,9,12,10,12,11,11,12,7,16,9,15,16,14,13,11,10,16,14,14,10,12,4,11,11,17,1,2,3,2,2,1,3,2,1,1,2,14,17,5,12,10,13,15,17,1,10,1,10,13,14,1,19,1,20,19,12,20,10,75,15,20,4475230,6500,6500,5000,Northern_European,124,6,1,38329.0,Unknown,27112672,9000000.0,1.0,28,882,30,0,1,7,199,7,0.6103466525535857,0.5294117647058822,0.5514705882352942,0.0370024536334729,0.0394736842105263,0.0131578947368421,0.0297574393598399,0.0997749437359339,0.049973610378066,0.0,0.4651162790697669,0.3333333333333332,256,60,45,5,0,6870,15,70,190,6000000,273809.5238095238,20000000.0,5000000.0,250000.0,15000000.0,7,6600000,-0.25,1.0
293385,Dani,Olmo,2024,131,Spain,Terrassa,Spain,07-05-98,Attacking Midfield,Midfield,Right,179.0,30-06-30,Unknown,https://img.a.transfermarkt.technology/portrait/header/293385-1711546268.jpg?lm=1,ES1,Futbol Club Barcelona,60000000.0,60000000.0,26,152,163,14,13,17,13,16,14,8,13,4,8,15,13,10,16,12,15,13,14,14,17,14,14,17,8,16,10,16,14,13,14,15,8,13,12,15,10,13,7,16,5,14,4,2,2,3,3,3,3,3,2,3,3,13,16,2,12,15,17,13,10,1,1,1,1,1,1,1,13,18,13,16,20,16,10,72,11,20,56430002,7600,7600,6600,Northern_European,151,24,4,76922.0,Unknown,24048100,29000000.0,1.0,89,1485,89,3,1,7,96,0,0.755887801005557,0.7005347593582887,0.75,0.0742685207805663,0.1578947368421052,0.0526315789473684,0.2998249562390597,0.2998249562390597,0.1610878079946665,0.0,0.3720930232558141,0.3333333333333332,330,73,66,25,0,13098,11,77,54,60000000,2296153.846153846,60000000.0,5000000.0,950000.0,15000000.0,2,3500000,0.0,0.2
293829,Maksim,Osipenko,2024,1083,Russia,Omsk,Russia,16-05-94,Centre-Back,Defender,Right,190.0,30-06-27,Unknown,https://img.a.transfermarkt.technology/portrait/header/293829-1721922102.png?lm=1,RU1,FK Rostov,5000000.0,5000000.0,30,123,125,6,7,10,8,9,3,14,10,8,14,14,9,14,10,11,14,13,10,11,9,13,14,8,13,7,14,12,13,13,12,13,15,13,13,13,13,15,7,15,5,10,1,2,1,1,3,2,2,2,2,2,4,11,13,5,13,14,15,13,15,1,1,20,1,1,1,10,1,1,1,1,1,1,1,80,5,20,4564609,6019,6019,3517,Northern_European,125,3,0,27246.0,Unknown,58103708,250000.0,1.0,78,1084,81,1,1,7,81,2,0.5467054776395872,0.3708021390374331,0.5588235294117647,0.0263005174742928,0.0197368421052631,0.0,0.0247561890472618,0.0247561890472618,0.0013611489208033,0.0,0.6279069767441858,0.5,331,40,8,30,1,4534,4,9,45,5000000,245000.0,5000000.0,150000.0,,,2,300000,0.0,0.0
294057,James,Maddison,2024,148,England,Coventry,England,23-11-96,Attacking Midfield,Midfield,Right,175.0,30-06-28,CAA Base Ltd,https://img.a.transfermarkt.technology/portrait/header/294057-1687982662.jpg?lm=1,GB1,Tottenham Hotspur Football Club,70000000.0,70000000.0,28,153,163,12,13,16,14,15,16,5,14,4,7,16,15,11,16,8,12,12,15,12,16,15,14,16,13,14,10,12,14,13,16,17,8,15,12,13,8,13,9,13,7,8,1,1,3,3,1,2,2,1,2,1,2,12,16,12,13,14,15,9,13,1,1,1,1,1,1,1,16,18,12,16,20,18,8,73,13,20,70175000,7750,7400,6000,Northern_European,150,1,0,127591.0,Unknown,28093567,24650000.0,3.0,32,391,33,3,1,7,202,0,0.7294257740142895,0.6363636363636364,0.7426470588235294,0.123195382031987,0.006578947368421,0.0,0.3498374593648412,0.3498374593648412,0.1369204700130559,0.2857142857142857,0.2790697674418605,0.4166666666666665,378,93,80,56,0,5650,17,61,75,60000000,2067241.3793103448,70000000.0,12000000.0,150000.0,2000000.0,4,22000000,-0.14285714285714285,-0.14285714285714285
294321,Unknown,Ferro,2024,2431,Portugal,Oliveira de AzemÃ©is,Portugal,26-03-97,Centre-Back,Defender,Right,191.0,30-06-28,Unknown,https://img.a.transfermarkt.technology/portrait/header/294321-1694539096.jpg?lm=1,PO1,Club Football Estrela da Amadora,1000000.0,18000000.0,27,125,129,8,10,12,9,14,6,13,11,9,13,15,12,14,14,8,14,9,16,8,15,12,9,5,13,12,12,16,14,9,12,14,16,14,10,15,11,11,4,9,6,4,3,3,2,3,1,4,3,3,1,1,3,13,12,9,15,6,11,10,10,1,1,20,11,1,1,1,1,1,1,1,1,1,1,83,13,20,984553,6242,6242,4742,Northern_European,125,0,0,12184.0,Vitesse,83111371,550000.0,1.0,76,1081,79,1,1,7,55,2,0.5762106377348505,0.5018181818181817,0.5588235294117647,0.0117563902136621,0.0,0.0,0.0047511877969492,0.0897724431107777,0.0030278618850523,0.0,0.6511627906976742,0.375,220,12,6,28,4,6240,3,22,94,800000,30434.782608695652,18000000.0,3500000.0,,700000.0,7,5700000,-0.2,-0.4666666666666667
294730,Bogdan,Mykhaylichenko,2024,53646,Ukraine,"Boryspil, Kyiv Oblast",Ukraine,21-03-97,Left-Back,Defender,Left,178.0,30-06-26,ProStar,https://img.a.transfermarkt.technology/portrait/header/294730-1659873415.png?lm=1,UKR1,FK Polissya Zhytomyr,2500000.0,4000000.0,27,120,123,10,12,12,10,11,6,10,12,13,12,13,5,12,10,10,10,16,11,12,12,13,16,10,11,13,10,13,13,13,13,12,12,13,14,13,13,12,9,10,7,10,4,2,1,3,1,3,2,1,1,3,1,16,9,5,12,10,13,11,14,1,20,1,15,15,10,1,10,1,1,1,1,1,1,73,20,10,1721249,6000,5280,2765,Northern_European,120,6,0,7499.0,Shakhtar Donetsk,71080351,467500.0,4.0,103,230,101,1,0,7,80,8,0.4489282879068537,0.2903743315508021,0.5220588235294117,0.0072324733224089,0.0394736842105263,0.0,0.0122530632658164,0.0197549387346836,0.0025695158198838,0.4285714285714285,0.3488372093023257,0.375,222,9,18,50,0,7014,3,8,143,2000000,78947.36842105263,4000000.0,1500000.0,,500000.0,5,3200000,-0.2,-0.2
294746,Volodymyr,Shepelev,2024,338,Ukraine,"Altestove, Odesa Oblast",Ukraine,01-06-97,Central Midfield,Midfield,Right,184.0,31-12-25,Unknown,https://img.a.transfermarkt.technology/portrait/header/294746-1726135315.png?lm=1,UKR1,Futbolniy Klub Dynamo Kyiv,1500000.0,4000000.0,27,121,135,11,8,11,6,13,10,11,11,8,11,14,6,10,13,13,12,15,13,12,13,11,14,9,9,13,11,15,14,12,12,12,13,14,13,16,11,12,5,14,7,14,2,1,1,3,1,1,2,1,2,1,1,14,5,7,15,14,13,14,6,1,1,1,1,1,1,18,10,20,1,8,17,1,10,75,9,20,6403422,5999,5999,3499,Northern_European,119,7,0,5619.0,Unknown,71081872,9111392.0,2.0,103,53,101,3,1,7,97,1,0.5440592749404605,0.3688770053475935,0.5147058823529411,0.0054171128623116,0.0460526315789473,0.0,0.0072518129532383,0.0197549387346836,0.0505924720131114,0.1428571428571428,0.4883720930232553,0.375,236,7,19,41,2,9988,13,49,141,1000000,-11111.111111111111,4000000.0,800000.0,,1500000.0,0,0,-0.4444444444444444,-0.5
294780,Oleksandr,Pikhalyonok,2024,338,Ukraine,Donetsk,Ukraine,07-05-97,Central Midfield,Midfield,Left,179.0,30-06-29,ProStar,https://img.a.transfermarkt.technology/portrait/header/294780-1726135203.png?lm=1,UKR1,Futbolniy Klub Dynamo Kyiv,5000000.0,5000000.0,27,135,140,12,11,12,10,13,12,8,14,11,9,15,8,8,15,9,12,13,13,13,14,14,16,12,10,13,12,15,14,14,12,12,9,15,12,15,12,14,1,13,9,12,1,2,1,2,1,2,1,3,2,3,2,9,15,3,8,13,18,15,16,1,1,1,1,1,1,17,1,20,1,1,1,1,1,72,20,11,4734994,6000,6015,4010,Northern_European,133,2,0,5619.0,Unknown,71086742,1600000.0,2.0,103,422,101,3,0,7,97,1,0.5461762370997618,0.4235294117647058,0.6176470588235294,0.0054171128623116,0.0131578947368421,0.0,0.0247561890472618,0.0247561890472618,0.0088613572599238,0.1428571428571428,0.3720930232558141,0.375,179,34,36,19,1,5241,9,56,258,4000000,231250.0,5000000.0,1000000.0,,,3,1100000,-0.2,-0.2
294817,Thiago,Silva,2024,8024,Brazil,Rio de Janeiro,Brazil,12-06-96,Goalkeeper,Goalkeeper,Right,188.0,30-06-26,JC12 SPORTS,https://img.a.transfermarkt.technology/portrait/header/294817-1543584780.jpg?lm=1,PO1,Futebol Clube de Arouca,200000.0,300000.0,28,168,174,4,5,9,7,14,8,17,7,7,17,13,14,16,13,17,17,15,20,17,13,17,15,8,19,8,19,15,14,10,12,16,13,14,10,14,14,15,7,13,11,8,4,2,2,3,1,3,2,2,1,1,2,13,17,6,15,11,20,18,15,1,1,20,1,1,1,1,1,1,1,1,1,1,1,79,8,20,26674923,8400,8250,7750,Mixed_Race,164,107,7,114999.0,Unknown,8833628,9111392.0,2.0,10,1234,11,2,1,4,98,5,0.8418893887271766,0.8235294117647058,0.8455882352941175,0.111036329418399,0.7039473684210525,0.0921052631578947,0.0007501875468867,0.0012503125781445,0.0505924720131114,0.1428571428571428,0.581395348837209,0.4166666666666665,0,0,0,0,0,0,0,0,0,200000,6250.0,300000.0,100000.0,100000.0,100000.0,4,100000,0.0,0.0
295024,Samet,Akaydin,2024,36,TÃ¼rkiye,Trabzon,TÃ¼rkiye,13-03-94,Centre-Back,Defender,Right,190.0,30-06-26,The Goal,https://img.a.transfermarkt.technology/portrait/header/295024-1728391580.JPG?lm=1,TR1,FenerbahÃ§e Spor KulÃ¼bÃ¼,2200000.0,4200000.0,30,120,130,5,5,8,6,8,4,14,4,4,14,10,5,14,9,18,12,18,10,13,8,9,14,6,11,10,13,14,15,13,13,13,15,13,13,14,14,14,16,12,6,13,2,2,1,2,3,1,1,1,2,1,3,14,15,5,7,12,16,12,13,1,1,20,1,1,1,1,1,1,1,1,1,1,1,0,12,20,2465162,6050,6050,4062,Mediterranean_Hispanic,121,0,0,10605.0,Unknown,70079807,2085500.0,2.0,100,1515,100,1,1,3,84,2,0.5508070918232336,0.429090909090909,0.5294117647058822,0.0102316805506335,0.0,0.0,0.010752688172043,0.0207551887971993,0.0115586544070668,0.1428571428571428,0.6279069767441858,0.5,344,22,1,81,3,4597,8,15,21,2000000,100000.0,4200000.0,1100000.0,,0.0,6,2400000,-0.2,-0.2857142857142857
295060,Koji,Miyoshi,2024,80,Japan,"Kawasaki, Kanagawa",Japan,26-03-97,Right Midfield,Midfield,Left,167.0,30-06-28,UDN SPORTS,https://img.a.transfermarkt.technology/portrait/header/295060-1671479611.jpg?lm=1,L1,Verein fÃ¼r LeibesÃ¼bungen Bochum 1848 FuÃŸballgemeinschaft,2000000.0,3000000.0,27,122,130,11,12,13,10,12,10,5,10,11,6,10,8,6,12,6,11,13,14,14,12,11,11,13,3,11,8,11,12,14,12,12,4,12,15,10,11,12,11,13,8,17,3,2,1,1,3,2,1,3,1,2,2,8,8,7,12,13,10,13,16,1,1,1,1,1,1,1,1,1,1,15,20,18,12,61,20,10,3824999,6250,5750,2206,10,106,5,2,3000.0,Unknown,45092659,1200000.0,1.0,54,715,56,3,0,0,212,9,0.5111140513363324,0.2305882352941176,0.4191176470588235,0.0028881612426335,0.0328947368421052,0.0263157894736842,0.0097524381095273,0.0147536884221055,0.0066390733075918,0.0,0.0930232558139532,0.375,270,33,29,22,2,7874,5,65,201,1800000,83333.33333333333,3000000.0,300000.0,150000.0,250000.0,5,1450000,-0.1,-0.1
295183,R?Zvan,Marin,2024,1390,Romania,Bucharest,Romania,23-05-96,Defensive Midfield,Midfield,Right,178.0,30-06-25,Unknown,https://img.a.transfermarkt.technology/portrait/header/295183-1719665338.jpg?lm=1,IT1,Cagliari Calcio,3500000.0,15000000.0,28,130,136,11,13,11,11,11,14,11,15,5,12,15,14,12,13,10,13,13,14,13,15,14,15,14,10,14,12,13,13,12,13,14,10,14,12,13,11,14,7,14,6,13,2,1,1,1,1,1,1,1,3,3,1,13,16,6,11,15,15,14,15,1,1,1,1,1,1,17,10,20,10,1,15,1,1,70,8,20,8379890,6495,6595,5745,Mediterranean_Hispanic,130,41,2,35577.0,Empoli Football Club,57113505,9100000.0,3.0,77,270,80,3,1,3,46,4,0.6229161153744377,0.609090909090909,0.5955882352941175,0.0343450749174155,0.2697368421052631,0.0263157894736842,0.0172543135783946,0.0747686921730432,0.050529181366149,0.2857142857142857,0.3488372093023257,0.4166666666666665,376,40,57,62,1,8050,6,11,42,4000000,119696.9696969697,15000000.0,3000000.0,300000.0,2000000.0,5,7300000,0.14285714285714285,0.6
295313,Taiwo,Awoniyi,2024,703,Nigeria,Ilorin,Nigeria,12-08-97,Centre-Forward,Attack,Right,183.0,30-06-27,ROOF,https://img.a.transfermarkt.technology/portrait/header/295313-1628595124.jpg?lm=1,GB1,Nottingham Forest Football Club,28000000.0,30000000.0,27,138,145,7,9,15,16,14,8,14,11,5,4,11,12,4,14,14,14,13,9,11,11,10,13,13,5,15,5,11,13,16,15,16,11,13,16,13,16,11,5,13,5,5,1,2,2,1,2,2,3,1,2,2,2,12,14,10,9,10,11,10,12,1,1,1,1,1,1,1,1,1,1,13,1,13,20,74,9,20,39929041,6750,6600,5250,African_Caribbean,137,4,1,52196.0,Unknown,13136629,10050000.0,3.0,69,653,70,0,1,1,140,3,0.6235776660492194,0.5561497326203209,0.6470588235294117,0.0503926682612226,0.0263157894736842,0.0131578947368421,0.1397849462365591,0.1497874468617154,0.0558071057529375,0.2857142857142857,0.4651162790697669,0.375,0,0,0,0,0,0,7,74,156,22000000,904166.6666666666,30000000.0,6000000.0,300000.0,1500000.0,8,2750000,-0.21428571428571427,-0.21428571428571427
295330,Kelechi,Iheanacho,2024,368,Nigeria,Imo,Nigeria,03-10-96,Centre-Forward,Attack,Left,185.0,30-06-26,ROGON,https://img.a.transfermarkt.technology/portrait/header/295330-1617442598.jpg?lm=1,ES1,Sevilla FÃºtbol Club S.A.D.,12000000.0,20000000.0,28,143,155,6,7,13,17,15,4,13,14,5,5,14,14,7,15,11,13,11,16,12,12,13,14,12,6,16,6,14,15,15,15,13,13,14,14,15,14,12,10,4,5,7,3,2,1,2,1,4,1,3,1,2,1,18,14,5,13,13,14,8,11,1,1,1,1,1,1,1,1,1,1,12,16,12,20,82,20,6,52631250,7150,7500,5500,African_Caribbean,143,43,12,104393.0,Unknown,13136621,14400000.0,2.0,69,655,70,0,0,1,181,3,0.7426567875099233,0.5828877005347594,0.6911764705882353,0.1007949926951053,0.2828947368421052,0.1578947368421052,0.0597649412353088,0.0997749437359339,0.0799744437345481,0.1428571428571428,0.5116279069767438,0.4166666666666665,318,90,45,18,0,10542,4,8,24,5000000,181481.4814814815,20000000.0,4000000.0,100000.0,15000000.0,3,3650000,-0.5833333333333334,-0.6875
295414,Adrián,Marín,2024,1075,Spain,Torre-Pacheco,Spain,09-01-97,Left-Back,Defender,Left,181.0,30-06-26,LEADERBROCK,https://img.a.transfermarkt.technology/portrait/header/295414-1447254854.jpg?lm=1,PO1,Sporting Clube de Braga,2000000.0,2000000.0,27,126,136,12,14,12,10,14,10,10,10,11,10,13,11,12,14,10,13,11,13,9,13,12,12,12,8,12,11,13,12,13,13,15,11,12,13,13,14,13,7,8,11,15,1,1,1,1,3,1,1,2,2,1,3,12,10,7,9,13,14,13,10,1,19,12,1,20,1,1,14,1,1,10,1,1,1,70,20,10,2103748,6300,6300,4300,Mediterranean_Hispanic,126,0,0,3149.0,Unknown,67199947,500000.0,1.0,89,1508,89,1,0,3,192,8,0.5838846255623181,0.4545454545454545,0.5661764705882353,0.0030320382152689,0.0,0.0,0.0097524381095273,0.0097524381095273,0.0027500763910108,0.0,0.418604651162791,0.375,212,6,6,33,2,9354,5,44,169,2000000,76923.07692307692,2000000.0,1000000.0,300000.0,1000000.0,8,800000,0.3333333333333333,0.3333333333333333
295630,Dimitrios,Giannoulis,2024,167,Greece,Katerini,Greece,17-10-95,Left-Back,Defender,Left,178.0,30-06-28,Unknown,https://img.a.transfermarkt.technology/portrait/header/295630-1722850451.jpg?lm=1,L1,FC Augsburg 1907,2800000.0,7000000.0,29,127,140,10,13,13,7,13,10,6,8,11,11,12,8,10,14,14,12,10,14,10,13,11,14,9,6,12,9,14,16,16,14,14,9,16,16,16,8,12,13,10,4,15,2,3,2,1,2,2,3,2,4,4,1,12,16,6,13,14,16,9,8,1,19,1,1,20,1,1,16,1,1,7,1,1,1,71,20,4,7526549,6350,6350,4750,Mediterranean_Hispanic,124,19,0,34798.0,Unknown,36078574,3760000.0,2.0,40,714,42,1,0,3,67,8,0.590500132310135,0.5026737967914437,0.5514705882352942,0.0335928590671944,0.125,0.0,0.0137534383595899,0.0347586896724181,0.0208616906025167,0.1428571428571428,0.3488372093023257,0.4583333333333332,0,0,0,0,0,0,5,37,71,2800000,109000.0,7000000.0,2000000.0,,300000.0,9,2450000,0.0,-0.06666666666666667
296356,Souleyman,Doumbia,2024,3057,France,Paris,Cote d'Ivoire,24-09-96,Left-Back,Defender,Left,183.0,30-06-26,Qigsports,https://img.a.transfermarkt.technology/portrait/header/296356-1672670377.jpg?lm=1,BE1,Royal Standard Club de LiÃ¨ge,2000000.0,3000000.0,28,125,130,8,12,10,5,10,7,9,10,12,13,12,5,13,12,10,11,13,12,11,10,11,12,11,9,13,11,14,13,15,14,13,9,12,16,14,13,14,5,12,2,13,3,4,2,2,1,3,3,2,3,2,3,12,12,8,9,8,12,10,12,1,20,1,1,19,1,1,10,1,1,1,1,1,1,64,20,8,1946340,6250,6250,3800,African_Caribbean,119,4,0,13800.0,Unknown,48030646,2100000.0,3.0,34,1122,24,1,0,1,176,8,0.5772691188145012,0.4010695187165775,0.5147058823529411,0.013316827715533,0.0263157894736842,0.0,0.0097524381095273,0.0147536884221055,0.0116392122003388,0.2857142857142857,0.4651162790697669,0.4166666666666665,205,0,9,41,2,5200,5,32,188,1000000,42045.454545454544,3000000.0,1000000.0,,300000.0,7,3450000,-0.5,-0.5
296397,Arne,Maier,2024,167,Germany,Ludwigsfelde,Germany,08-01-99,Central Midfield,Midfield,Right,186.0,30-06-26,11WINS,https://img.a.transfermarkt.technology/portrait/header/296397-1723534223.jpg?lm=1,L1,FC Augsburg 1907,5000000.0,24000000.0,25,129,143,11,11,13,10,15,9,7,11,6,9,15,10,10,15,10,12,11,16,12,14,11,11,13,11,10,10,15,13,13,13,12,10,10,11,14,13,13,8,13,13,12,3,1,2,1,2,3,3,2,1,3,2,10,16,12,10,12,11,14,15,1,1,1,1,1,1,20,10,20,10,10,15,10,1,82,11,20,5656656,6496,6496,4996,Northern_European,120,0,0,19999.0,Unknown,91151073,5000000.0,1.0,38,872,40,3,1,7,67,1,0.6098174120137603,0.5289839572192513,0.5220588235294117,0.0193026891475241,0.0,0.0,0.0247561890472618,0.1197799449862465,0.0277507708547459,0.0,0.5348837209302322,0.2916666666666665,262,21,41,11,0,4669,24,74,95,4000000,158333.33333333334,24000000.0,5000000.0,2500000.0,20000000.0,2,5500000,-0.2,-0.1111111111111111
296622,Marco,Asensio,2024,583,Spain,Palma de Mallorca,Spain,21-01-96,Right Winger,Attack,Left,182.0,30-06-26,Gestifute,https://img.a.transfermarkt.technology/portrait/header/296622-1664970818.jpg?lm=1,FR1,Paris Saint-Germain Football Club,20000000.0,90000000.0,28,152,165,15,15,16,15,17,15,8,18,7,5,16,14,8,18,9,14,10,14,11,15,13,15,17,8,12,11,12,13,14,14,11,10,17,15,14,12,9,10,10,8,14,3,2,1,1,2,2,2,1,2,3,1,12,8,7,10,14,12,10,12,1,1,1,1,1,1,1,10,12,12,19,18,20,6,76,20,9,30099999,7600,7600,7000,Mediterranean_Hispanic,152,29,1,136985.0,Unknown,67197125,3900000.0,1.0,89,1112,89,0,0,3,154,10,0.755887801005557,0.7433155080213903,0.7573529411764706,0.1322663906288775,0.1907894736842105,0.0131578947368421,0.0997749437359339,0.4498624656164041,0.0216394899858329,0.0,0.4418604651162785,0.4166666666666665,428,79,67,23,0,5932,15,93,250,20000000,603030.303030303,90000000.0,20000000.0,3500000.0,15000000.0,5,10500000,0.0,0.0
296802,Walter,Benítez,2024,383,Argentina,General San MartÃ­n,Argentina,19-01-93,Goalkeeper,Goalkeeper,Right,191.0,30-06-25,CAA Stellar,https://img.a.transfermarkt.technology/portrait/header/296802-1682332928.jpg?lm=1,NL1,Eindhovense Voetbalvereniging Philips Sport Vereniging,13000000.0,14000000.0,31,145,154,5,3,2,3,11,6,6,1,3,2,11,3,1,8,2,15,15,12,16,10,12,15,15,15,12,15,15,15,8,12,16,16,15,8,13,17,16,4,16,6,12,14,16,14,6,15,14,14,15,10,9,12,8,15,6,18,15,16,14,15,20,1,1,1,1,1,1,1,1,1,1,1,1,1,91,8,20,19546315,7150,7150,5000,Native_American,147,0,0,25000.0,Unknown,14035968,9111392.0,2.0,4,529,4,2,1,5,62,5,0.696348240275205,0.5294117647058822,0.7205882352941175,0.0241317410948361,0.0,0.0,0.0647661915478869,0.0697674418604651,0.0505924720131114,0.1428571428571428,0.6511627906976742,0.5416666666666665,0,0,0,0,0,0,3,32,78,12000000,474000.0,14000000.0,2000000.0,,,2,2000000,-0.07692307692307693,0.0
297070,Hamari,Traoré,2024,681,Mali,Bamako,Mali,27-01-92,Right-Back,Defender,Right,175.0,30-06-25,LA PLAYERS,https://img.a.transfermarkt.technology/portrait/header/297070-1664981394.jpg?lm=1,ES1,Real Sociedad de FÃºtbol S.A.D.,6000000.0,10000000.0,32,136,138,10,13,11,7,12,8,12,7,15,13,12,5,12,12,15,13,13,11,12,11,13,12,12,9,13,13,14,16,15,13,12,10,16,15,17,12,15,13,12,5,13,1,3,1,1,2,3,2,2,2,2,2,14,10,8,12,13,14,13,18,1,1,1,20,1,15,1,1,1,10,1,1,10,1,71,10,20,6519267,6800,6800,4500,African_Caribbean,134,42,1,14564.0,Unknown,30035411,1650000.0,2.0,61,133,61,1,1,1,168,11,0.6500396930404869,0.4759358288770053,0.625,0.014054559306764,0.2763157894736842,0.0131578947368421,0.0297574393598399,0.0497624406101525,0.0091391427539653,0.1428571428571428,0.2790697674418605,0.5833333333333333,419,11,35,87,1,8584,4,59,242,3000000,94642.85714285714,10000000.0,3000000.0,,,3,3350000,-0.5,-0.6666666666666666
297194,Iván,Villar,2024,940,Spain,AldÃ¡n,Spain,09-07-97,Goalkeeper,Goalkeeper,Right,186.0,30-06-27,Promoesport,https://img.a.transfermarkt.technology/portrait/header/297194-1516876837.jpg?lm=1,ES1,Real Club Celta de Vigo S. A. D.,1200000.0,2500000.0,27,125,141,5,1,1,1,10,7,1,3,1,2,12,3,2,9,10,14,10,13,11,9,11,7,9,9,3,15,11,12,14,14,12,12,13,12,12,11,11,5,10,12,12,13,10,12,5,13,13,14,13,13,10,14,9,13,7,9,11,10,11,17,20,1,1,1,1,1,1,1,1,1,1,1,1,1,76,11,20,2186198,6241,6241,4004,Mediterranean_Hispanic,122,0,0,17260.0,Unknown,67191440,9111392.0,2.0,89,37,89,2,1,3,165,5,0.5760783275998942,0.4228877005347593,0.536764705882353,0.0166578634559248,0.0,0.0,0.0057514378594648,0.0122530632658164,0.0505924720131114,0.1428571428571428,0.5348837209302322,0.375,0,0,0,0,0,0,1,11,71,1200000,52173.913043478264,2500000.0,500000.0,,300000.0,6,500000,0.0,-0.4
297583,Woo-Yeong,Jeong,2024,89,"Korea, South","Yeonsu-gu, Incheon","Korea, South",20-09-99,Attacking Midfield,Midfield,Right,179.0,30-06-25,Apertura Sports GmbH,https://img.a.transfermarkt.technology/portrait/header/297583-1723707463.jpg?lm=1,L1,1. FC Union Berlin,3500000.0,5500000.0,25,139,155,10,11,14,12,15,12,9,13,5,6,13,10,8,14,16,12,10,11,11,13,11,14,14,5,16,6,15,15,15,14,10,9,15,15,14,7,13,6,12,6,14,2,1,3,3,3,1,2,1,3,2,3,10,18,4,12,10,16,13,16,1,1,1,1,1,1,1,17,10,18,18,14,20,13,70,15,20,32129998,6750,6055,5282,10,136,7,2,8500.0,Unknown,91187682,2166666.667,3.0,57,1684,58,3,1,0,0,0,0.5514686424980153,0.559572192513369,0.6397058823529411,0.0081990562056842,0.0460526315789473,0.0263157894736842,0.0172543135783946,0.0272568142035508,0.0120095928609128,0.2857142857142857,0.3720930232558141,0.2916666666666665,0,0,0,0,0,0,8,27,109,4000000,215277.77777777778,5500000.0,1500000.0,125000.0,1800000.0,5,1400000,0.14285714285714285,0.14285714285714285
298197,Antonio,Sivera,2024,1108,Spain,XÃ bia,Spain,11-08-96,Goalkeeper,Goalkeeper,Right,185.0,30-06-27,Wasserman,https://img.a.transfermarkt.technology/portrait/header/298197-1713856039.jpg?lm=1,ES1,Deportivo AlavÃ©s S.A.D.,6000000.0,6000000.0,28,122,146,4,3,1,3,5,6,1,1,2,2,12,3,3,6,9,12,15,10,10,9,14,10,1,11,3,12,10,9,14,12,10,13,15,14,8,9,14,13,11,14,12,12,8,11,5,14,14,9,14,5,8,9,7,12,2,10,12,8,13,10,20,1,1,1,1,1,1,1,1,1,1,1,1,1,75,12,20,1113134,6000,6000,4300,Mediterranean_Hispanic,115,0,0,4411.0,Unknown,67186869,2000000.0,1.0,89,1679,89,2,1,3,59,5,0.5441915850754168,0.4545454545454545,0.4852941176470588,0.0042506472049725,0.0,0.0,0.0297574393598399,0.0297574393598399,0.0110836412122558,0.0,0.5116279069767438,0.4166666666666665,0,0,0,0,0,0,3,5,62,6000000,252173.91304347827,6000000.0,300000.0,,300000.0,3,500000,0.0,2.0
298575,Kike,Barja,2024,331,Spain,NoÃ¡in,Spain,01-04-97,Right Winger,Attack,Right,179.0,30-06-26,YOU FIRST,https://img.a.transfermarkt.technology/portrait/header/298575-1583310743.jpg?lm=1,ES1,Club AtlÃ©tico Osasuna,2000000.0,4000000.0,27,130,142,13,13,14,12,13,8,8,11,6,6,13,13,7,14,11,10,14,10,12,12,13,11,14,11,13,12,14,13,14,13,11,8,11,14,13,11,12,11,11,12,14,1,2,2,3,3,1,1,3,3,1,2,16,13,6,10,11,12,10,20,1,5,1,8,10,10,1,18,1,18,20,1,20,1,0,13,20,3918237,6300,6300,3800,Mediterranean_Hispanic,129,0,0,7405.0,Unknown,67196202,9111392.0,2.0,89,1061,89,0,1,3,51,10,0.5838846255623181,0.4010695187165775,0.588235294117647,0.0071417052994041,0.0,0.0,0.0097524381095273,0.0197549387346836,0.0505924720131114,0.1428571428571428,0.3720930232558141,0.375,246,29,20,29,0,2789,7,62,215,1800000,65384.61538461538,4000000.0,1500000.0,100000.0,1000000.0,1,0,-0.1,-0.28
298583,Eray,Cömert,2024,366,Switzerland,Rheinfelden,Switzerland,04-02-98,Centre-Back,Defender,Right,183.0,30-06-25,Wasserman,https://img.a.transfermarkt.technology/portrait/header/298583-1704213027.jpg?lm=1,ES1,Real Valladolid Club de FÃºtbol S.A.D.,4000000.0,4000000.0,26,127,143,5,7,11,6,13,12,13,13,7,14,13,11,16,13,14,14,14,13,11,11,12,12,8,12,8,12,14,12,11,12,13,12,13,12,15,13,11,12,13,5,11,1,1,3,2,2,1,3,1,1,3,3,13,13,7,12,13,14,10,12,1,1,20,1,1,1,12,1,1,1,1,1,1,1,80,12,20,3205831,6350,6600,4550,Mediterranean_Hispanic,127,9,0,9182.0,Unknown,98033710,800000.0,1.0,92,1223,92,1,1,3,169,2,0.6235776660492194,0.481283422459893,0.5735294117647058,0.0088576071811024,0.0592105263157894,0.0,0.0197549387346836,0.0197549387346836,0.0044167893552598,0.0,0.4651162790697669,0.3333333333333332,301,19,5,55,3,9118,11,113,156,3000000,116000.0,4000000.0,1000000.0,100000.0,1500000.0,6,2550000,-0.25,-0.25
298635,Grigoris,Kastanos,2024,276,Cyprus,Sotira,Cyprus,30-01-98,Attacking Midfield,Midfield,Left,179.0,30-06-25,Unknown,https://img.a.transfermarkt.technology/portrait/header/298635-1725530400.jpg?lm=1,IT1,Verona Hellas Football Club,1800000.0,1800000.0,26,124,137,10,12,12,8,13,15,8,14,7,9,13,10,10,13,13,11,11,11,10,13,13,15,14,10,13,10,11,14,14,14,12,9,12,13,14,12,10,7,12,7,13,3,3,3,1,3,1,3,3,4,3,1,14,16,2,14,8,8,17,18,1,1,1,1,1,1,11,8,20,8,9,19,7,1,70,20,10,2381032,6200,6050,4500,North_African__Middle_Eastern,122,47,3,15902.0,Unknown,26030142,180000.0,2.0,25,1399,27,3,0,6,214,0,0.5508070918232336,0.4759358288770053,0.536764705882353,0.0153465552086843,0.3092105263157894,0.0394736842105263,0.0087521880470117,0.0087521880470117,0.0009722492291452,0.1428571428571428,0.3720930232558141,0.3333333333333332,283,28,19,50,2,5396,7,27,214,1800000,82142.85714285714,1800000.0,200000.0,500000.0,400000.0,7,1100000,0.0,0.0
298975,Pol,Lirola,2024,244,Spain,Mollet del VallÃ¨s,Spain,13-08-97,Right-Back,Defender,Right,183.0,30-06-26,Universal Twenty Two,https://img.a.transfermarkt.technology/portrait/header/298975-1673514557.jpg?lm=1,FR1,Olympique de Marseille,2500000.0,13000000.0,27,133,145,8,14,13,5,12,10,10,9,10,11,13,8,12,14,12,11,12,12,12,12,12,13,12,8,12,10,11,11,16,14,13,10,13,15,13,11,12,7,9,8,13,3,2,3,1,3,2,1,3,1,1,2,15,13,6,12,11,14,13,12,1,12,1,20,13,20,1,12,1,17,1,1,1,1,70,10,20,5828285,6650,6500,5000,Mediterranean_Hispanic,121,0,0,32218.0,Elche,67211095,7875000.0,4.0,89,966,89,1,1,3,144,11,0.6103466525535857,0.5294117647058822,0.5294117647058822,0.0311015665208906,0.0,0.0,0.0122530632658164,0.0647661915478869,0.0437234367621322,0.4285714285714285,0.4651162790697669,0.375,314,15,33,24,1,6571,10,28,83,4000000,146153.84615384616,13000000.0,3000000.0,500000.0,7500000.0,6,5700000,1.2222222222222223,1.0
298976,Borja,Mayoral,2024,3709,Spain,Parla,Spain,05-04-97,Centre-Forward,Attack,Right,182.0,30-06-27,Footfeel ISM  ,https://img.a.transfermarkt.technology/portrait/header/298976-1669365430.jpg?lm=1,ES1,Getafe Club de FÃºtbol S.A.D. Team Dubai,15000000.0,15000000.0,27,134,145,6,10,13,16,15,8,12,12,4,5,12,14,6,14,16,15,14,13,14,12,13,16,13,6,16,5,12,13,12,12,14,11,14,13,13,13,14,9,11,6,8,3,2,1,1,2,1,2,3,2,1,2,10,16,7,12,13,14,12,15,1,1,1,1,1,1,1,9,1,7,11,11,12,20,74,12,20,6332507,6700,6700,5750,Mediterranean_Hispanic,133,0,0,14096.0,Unknown,67211912,10000000.0,1.0,89,1124,89,0,1,3,105,3,0.6368086795448531,0.6096256684491979,0.6176470588235294,0.0136026504262717,0.0,0.0,0.0747686921730432,0.0747686921730432,0.055529320258896,0.0,0.4418604651162785,0.375,331,109,25,21,0,5631,3,16,195,9000000,309523.8095238095,15000000.0,6000000.0,,7500000.0,5,15300000,-0.4,-0.4
300168,Mikel,Vesga,2024,621,Spain,Vitoria-Gasteiz,Spain,08-04-93,Defensive Midfield,Midfield,Left,191.0,30-06-27,Unknown,https://img.a.transfermarkt.technology/portrait/header/300168-1709675412.png?lm=1,ES1,Athletic Club Bilbao,4000000.0,6000000.0,31,135,140,7,7,8,8,14,10,14,14,9,14,13,8,14,13,13,13,13,14,13,12,13,13,7,8,12,15,16,17,12,13,10,15,12,13,14,14,13,11,12,8,13,3,2,3,1,2,2,1,1,1,3,2,20,12,7,10,11,9,11,18,1,1,1,1,1,1,20,10,19,10,1,1,1,1,84,20,9,27141965,6750,6750,5250,Mediterranean_Hispanic,135,0,0,16783.0,Unknown,67195855,9111392.0,2.0,89,1617,89,3,0,3,33,4,0.6434241862926701,0.5561497326203209,0.6323529411764706,0.0161972640200384,0.0,0.0,0.0197549387346836,0.0297574393598399,0.0505924720131114,0.1428571428571428,0.6511627906976742,0.5416666666666665,355,16,18,56,0,5745,7,14,22,3000000,125000.0,6000000.0,2500000.0,,,5,5800000,-0.25,-0.4
300532,Pontus,Almqvist,2024,130,Sweden,NykÃ¶ping,Sweden,10-07-99,Right Winger,Attack,Left,183.0,30-06-27,A.M.A. Sports Agency,https://img.a.transfermarkt.technology/portrait/header/300532-1692964187.jpg?lm=1,IT1,Parma Calcio 1913,3000000.0,3000000.0,25,121,135,10,9,12,11,12,11,8,9,7,7,11,8,9,13,13,10,13,11,11,11,11,14,16,5,12,8,12,12,14,11,9,11,12,16,12,8,12,9,11,11,8,2,2,2,3,3,1,2,2,3,3,2,14,13,9,9,12,10,6,6,1,1,1,1,1,1,1,10,1,1,17,13,15,20,67,20,15,4891516,5900,5650,2750,Northern_European,108,0,0,25429.0,PogoÅ„ Szczecin,93087462,2125000.0,2.0,91,1064,91,0,0,7,155,10,0.4978830378406986,0.2887700534759358,0.4338235294117646,0.0245459909019541,0.0,0.0,0.0147536884221055,0.0147536884221055,0.0117781049473596,0.1428571428571428,0.4651162790697669,0.2916666666666665,209,32,19,17,0,4404,5,13,326,2500000,122500.0,3000000.0,500000.0,50000.0,100000.0,7,4690000,-0.16666666666666666,-0.16666666666666666
300538,Nikolay,Komlichenko,2024,1083,Russia,"Plastunovskaya, Krasnodar Region",Russia,29-06-95,Centre-Forward,Attack,Right,190.0,30-06-26,Unknown,https://img.a.transfermarkt.technology/portrait/header/300538-1721923239.png?lm=1,RU1,FK Rostov,4000000.0,6000000.0,29,121,124,6,7,8,16,9,11,14,7,8,11,10,14,10,11,13,13,14,13,13,8,10,12,9,7,16,11,11,13,11,11,10,16,15,12,13,17,13,13,8,8,3,4,2,3,1,3,1,3,3,3,3,3,14,10,9,13,6,11,12,11,1,1,1,1,1,1,1,1,1,1,7,9,7,20,91,9,20,4379281,5914,5914,3909,Northern_European,118,3,1,15342.0,Unknown,58076741,1800000.0,3.0,78,1152,81,0,1,7,81,3,0.5328129134691717,0.4127272727272726,0.5073529411764706,0.0148058095397192,0.0197368421052631,0.0131578947368421,0.0197549387346836,0.0297574393598399,0.0099724992360898,0.2857142857142857,0.6279069767441858,0.4583333333333332,0,0,0,0,0,0,5,15,36,4000000,126666.66666666667,6000000.0,1200000.0,200000.0,400000.0,5,1250000,0.0,-0.1111111111111111
300716,Kieran,Tierney,2024,11,Isle of Man,Douglas,Scotland,05-06-97,Left-Back,Defender,Left,180.0,30-06-26,CAA Stellar,https://img.a.transfermarkt.technology/portrait/header/300716-1662666488.jpg?lm=1,GB1,Arsenal Football Club,10000000.0,32000000.0,27,151,164,10,15,14,11,13,10,12,11,15,13,12,8,15,13,15,13,16,12,13,12,13,18,12,14,13,13,19,18,15,15,15,12,13,14,15,11,15,11,14,14,12,2,2,3,1,3,1,3,1,3,4,2,12,15,7,18,15,17,13,13,1,20,15,13,19,13,1,1,1,1,1,1,1,1,76,20,9,58707384,7541,7541,6741,Northern_European,148,32,1,127591.0,Unknown,61070563,27000000.0,1.0,50,427,83,1,0,7,21,8,0.7480815030431331,0.715614973262032,0.7279411764705881,0.123195382031987,0.2105263157894736,0.0131578947368421,0.0497624406101525,0.1597899474868717,0.1499763882330064,0.0,0.3953488372093026,0.375,328,13,52,21,0,10820,18,142,160,10000000,412500.0,32000000.0,7000000.0,500000.0,5000000.0,4,23000000,-0.16666666666666666,-0.4444444444444444
301238,Michele,Di Gregorio,2024,506,Italy,Milano,Italy,27-07-97,Goalkeeper,Goalkeeper,Right,187.0,30-06-29,Unknown,https://img.a.transfermarkt.technology/portrait/header/301238-1652094369.jpg?lm=1,IT1,Juventus Football Club,18000000.0,18000000.0,27,130,139,1,1,4,2,10,4,4,7,11,4,11,1,7,11,11,11,11,11,13,13,14,13,11,12,10,14,12,12,12,12,10,10,12,11,14,13,14,8,12,7,11,14,12,14,10,14,12,13,15,12,12,11,12,14,8,14,12,14,12,12,20,1,1,1,1,1,1,1,1,1,1,1,1,1,88,8,20,2111204,6500,6400,4450,Northern_European,129,0,0,15962.0,Unknown,43161669,10150000.0,2.0,52,952,54,2,1,7,116,5,0.5971156390579518,0.4705882352941176,0.588235294117647,0.0154044922446449,0.0,0.0,0.0897724431107777,0.0897724431107777,0.0563626767410205,0.1428571428571428,0.5581395348837206,0.375,0,0,0,0,0,0,4,8,23,18000000,746875.0,18000000.0,300000.0,50000.0,600000.0,5,1250000,0.0,0.5
302215,Naby,Keïta,2024,86,Guinea,Conakry,Guinea,10-02-95,Central Midfield,Midfield,Right,172.0,30-06-26,ROOF,https://img.a.transfermarkt.technology/portrait/header/302215-1691613796.jpg?lm=1,L1,Sportverein Werder Bremen von 1899,1000000.0,65000000.0,29,155,164,8,12,16,11,15,10,7,11,6,12,15,9,13,16,13,17,12,15,14,15,14,14,15,7,16,14,16,15,15,16,17,8,12,14,17,11,14,10,14,14,11,2,3,3,3,3,3,2,2,1,2,3,14,16,12,10,13,13,10,13,1,1,1,1,1,1,18,14,20,14,1,14,1,1,64,9,20,37465328,7750,7750,6750,African_Caribbean,156,50,11,150789.0,Unknown,85140676,30416666.67,3.0,43,378,44,3,1,1,194,1,0.7757343212490078,0.7165775401069518,0.7867647058823528,0.1455957713688687,0.3289473684210526,0.1447368421052631,0.0047511877969492,0.3248312078019504,0.1689583970110281,0.2857142857142857,0.2093023255813952,0.4583333333333332,310,52,42,43,1,6738,36,160,93,1000000,0.0,65000000.0,10000000.0,,7500000.0,3,10000000,-0.5,-0.8333333333333334
302371,Toni,Martínez,2024,1108,Spain,Barrio del Progreso,Spain,30-06-97,Centre-Forward,Attack,Right,187.0,30-06-28,LEADERBROCK,https://img.a.transfermarkt.technology/portrait/header/302371-1606396665.png?lm=1,ES1,Deportivo AlavÃ©s S.A.D.,5000000.0,7000000.0,27,138,148,7,9,11,15,13,9,16,12,8,6,11,12,7,12,16,14,15,13,11,10,12,16,13,10,15,7,13,13,13,13,15,14,16,14,14,13,13,14,14,4,8,1,2,2,1,2,1,3,2,2,1,2,13,14,9,13,14,16,13,10,1,1,1,1,1,1,1,1,1,1,1,1,1,20,84,13,20,10287000,6900,6500,5400,Northern_European,137,0,0,20715.0,Unknown,67216151,2733333.333,3.0,89,151,89,0,1,7,59,3,0.6103466525535857,0.5721925133689839,0.6470588235294117,0.0199940711099867,0.0,0.0,0.0247561890472618,0.0347586896724181,0.015157828456346,0.2857142857142857,0.5581395348837206,0.375,310,84,22,29,0,9732,0,0,0,4000000,190476.19047619047,7000000.0,2000000.0,,1500000.0,7,4300000,-0.2,-0.3333333333333333
303116,Gaetano,Castrovilli,2024,398,Italy,Canosa di Puglia,Italy,17-02-97,Central Midfield,Midfield,Right,187.0,30-06-27,World Soccer Agency,https://img.a.transfermarkt.technology/portrait/header/303116-1661511198.jpg?lm=1,IT1,SocietÃ  Sportiva Lazio S.p.A.,7000000.0,25000000.0,27,140,150,13,12,15,13,15,12,13,14,6,9,14,11,13,15,14,13,13,11,12,13,13,16,15,10,13,11,14,16,14,15,12,13,14,13,15,12,12,14,12,13,13,2,2,1,1,3,3,1,1,4,1,4,12,18,7,13,13,15,12,9,1,1,1,1,1,1,1,12,20,12,13,16,12,1,72,10,20,7601607,7000,7100,5600,Mediterranean_Hispanic,141,4,0,49807.0,Unknown,43206176,1900000.0,1.0,52,312,54,3,1,3,185,1,0.6897327335273882,0.5935828877005347,0.6764705882352942,0.0480858086127266,0.0263157894736842,0.0,0.0347586896724181,0.1247811952988247,0.0105280702241728,0.0,0.5581395348837206,0.375,292,42,34,53,3,5606,13,104,252,5000000,190384.61538461538,25000000.0,5000000.0,250000.0,700000.0,4,8500000,-0.2857142857142857,-0.375
303254,Fikayo,Tomori,2024,5,Canada,"Calgary, Alberta",England,19-12-97,Centre-Back,Defender,Right,185.0,30-06-27,SPORT INVEST,https://img.a.transfermarkt.technology/portrait/header/303254-1684856117.jpg?lm=1,IT1,Associazione Calcio Milan,40000000.0,50000000.0,27,153,167,4,7,9,8,11,6,15,6,3,16,13,6,15,12,17,16,15,14,15,11,13,14,5,12,6,14,14,14,16,13,14,14,15,17,14,15,15,9,14,6,8,2,2,3,1,3,1,1,2,1,4,1,14,16,5,10,14,16,15,12,1,12,20,14,1,13,1,1,1,1,1,1,1,1,79,12,20,97731565,7650,7100,6400,African_Caribbean,152,3,0,86345.0,Unknown,28097980,34400000.0,1.0,16,302,33,1,1,1,27,2,0.6897327335273882,0.6791443850267379,0.7573529411764706,0.0833675322781711,0.0197368421052631,0.0,0.1997999499874969,0.2498124531132783,0.1910886413511486,0.0,0.5116279069767438,0.375,347,18,7,53,1,10143,7,35,66,22000000,988636.3636363636,50000000.0,10000000.0,,2500000.0,4,7750000,-0.45,-0.45
303259,Dodi,Lukébakio,2024,368,Belgium,Brussels,Belgium,24-09-97,Right Winger,Attack,Left,187.0,30-06-28,Stirr Associates,https://img.a.transfermarkt.technology/portrait/header/303259-1657098989.jpg?lm=1,ES1,Sevilla FÃºtbol Club S.A.D.,12000000.0,21000000.0,27,135,145,12,11,16,13,14,11,12,12,4,6,11,14,7,16,12,12,9,12,8,11,8,10,15,6,12,7,8,9,16,13,12,13,14,16,11,12,8,8,10,4,11,1,1,3,1,1,2,1,2,3,3,3,10,13,14,7,10,7,11,9,1,1,1,1,10,10,1,12,1,15,15,10,20,18,77,20,11,9140005,6697,6397,5497,African_Caribbean,125,4,0,57533.0,Unknown,18083611,9400000.0,4.0,7,266,8,0,0,1,181,10,0.5967187086530829,0.582566844919786,0.5588235294117647,0.0555461676099138,0.0263157894736842,0.0,0.0597649412353088,0.1047761940485121,0.052195894330398,0.4285714285714285,0.5581395348837206,0.375,0,0,0,0,0,0,6,22,83,20000000,791666.6666666666,21000000.0,4000000.0,1000000.0,3000000.0,8,14100000,0.6666666666666666,0.3333333333333333
304892,Andrés,Roa,2024,6418,Colombia,Sabanalarga,Colombia,25-05-93,Attacking Midfield,Midfield,Right,175.0,30-06-25,Colombiagol SAS,https://img.a.transfermarkt.technology/portrait/header/304892-1635923403.JPG?lm=1,GR1,Panetolikos Agrinio,300000.0,3750000.0,31,125,132,14,12,12,12,14,15,13,14,8,3,14,12,2,16,5,12,12,13,11,15,13,12,13,10,13,6,13,8,13,14,11,9,14,12,13,12,8,7,13,9,13,1,2,3,3,3,2,3,1,3,3,2,11,11,9,11,12,12,11,10,1,1,1,1,1,1,1,1,18,1,1,20,1,1,67,10,20,1337965,6374,5734,3984,Mediterranean_Hispanic,125,2,0,10916.0,Unknown,76036528,800000.0,1.0,20,1267,20,3,1,3,151,0,0.508997089177031,0.4207486631016042,0.5588235294117647,0.0105319875203624,0.0131578947368421,0.0,0.0012503125781445,0.0185046261565391,0.0044167893552598,0.0,0.2790697674418605,0.5416666666666665,309,32,23,32,2,15985,3,10,21,250000,-2380.9523809523807,3750000.0,1250000.0,,,6,4250000,-0.16666666666666666,-0.5833333333333334
305947,Albert,Gudmundsson,2024,430,Iceland,ReykjavÃ­k,Iceland,15-06-97,Second Striker,Attack,Right,177.0,30-06-25,GG11 ,https://img.a.transfermarkt.technology/portrait/header/305947-1705389252.jpg?lm=1,IT1,Associazione Calcio Fiorentina,30000000.0,30000000.0,27,126,134,10,12,15,11,16,10,6,9,3,5,13,14,5,16,6,10,8,13,9,14,12,12,16,4,12,6,9,8,14,15,12,9,14,14,13,10,10,11,8,13,12,2,1,2,4,1,2,3,4,3,3,3,15,13,13,10,12,7,9,4,1,1,1,1,1,1,1,1,7,12,16,18,20,1,73,12,20,2880270,6292,5244,4162,Northern_European,124,33,6,18249.0,Unknown,37050603,1650000.0,2.0,46,1222,48,0,1,7,26,12,0.4441651230484255,0.4397860962566844,0.5514705882352942,0.0176128589320079,0.2171052631578947,0.0789473684210526,0.1497874468617154,0.1497874468617154,0.0091391427539653,0.1428571428571428,0.3255813953488373,0.375,328,102,46,29,2,8063,9,52,155,28000000,1075000.0,30000000.0,2000000.0,50000.0,1500000.0,4,3600000,-0.06666666666666667,0.75
306024,Dominic,Calvert-Lewin,2024,29,England,Sheffield,England,16-03-97,Centre-Forward,Attack,Right,189.0,30-06-25,Wasserman,https://img.a.transfermarkt.technology/portrait/header/306024-1685705768.jpg?lm=1,GB1,Everton Football Club,22000000.0,45000000.0,27,152,163,9,11,11,15,15,7,17,9,2,6,11,7,5,14,13,14,14,13,15,10,14,14,12,5,16,6,15,15,16,14,14,16,14,16,15,16,14,6,10,3,14,1,1,3,1,3,2,2,1,2,2,3,12,13,5,11,12,14,15,13,1,1,5,1,1,1,1,10,8,8,14,11,12,20,71,8,20,77192500,7600,7800,6250,Mixed_Race,150,11,4,97433.0,Unknown,29123128,1800000.0,1.0,32,1366,33,0,1,4,65,3,0.7823498279968246,0.6631016042780749,0.7426470588235294,0.0940742965236812,0.0723684210526315,0.0526315789473684,0.1097774443610902,0.2248062015503876,0.0099724992360898,0.0,0.6046511627906974,0.375,321,89,22,36,1,5340,16,104,126,22000000,912500.0,45000000.0,10000000.0,,12000000.0,1,900000,0.0,0.0
307052,Masaya,Okugawa,2024,167,Japan,"Koka, Shiga",Japan,14-04-96,Left Winger,Attack,Right,177.0,30-06-26,Yu Matoji,https://img.a.transfermarkt.technology/portrait/header/307052-1723533958.jpg?lm=1,L1,FC Augsburg 1907,900000.0,5000000.0,28,124,128,10,11,14,10,13,8,6,12,4,6,12,9,8,14,14,11,6,11,10,10,9,10,14,8,12,8,12,13,16,14,10,7,12,14,12,6,12,6,10,7,12,1,2,4,2,2,3,1,3,2,1,3,8,15,4,12,9,16,13,18,1,1,1,1,1,1,1,20,1,18,20,12,18,10,68,16,20,3254588,6250,6100,4350,10,115,0,0,8399.0,Unknown,45090076,875000.0,2.0,54,740,56,0,1,0,67,7,0.5574225985710506,0.4598930481283422,0.4852941176470588,0.0081015288618172,0.0,0.0,0.0042510627656914,0.0247561890472618,0.0048334675963221,0.1428571428571428,0.3255813953488373,0.4166666666666665,270,53,41,9,0,4231,14,44,104,900000,21153.846153846152,5000000.0,1500000.0,,350000.0,7,3100000,-0.4,-0.55
307058,Mehdi,Taremi,2024,46,Iran,Bushehr,Iran,18-07-92,Centre-Forward,Attack,Right,185.0,30-06-27,Unknown,https://img.a.transfermarkt.technology/portrait/header/307058-1716551799.jpg?lm=1,IT1,Football Club Internazionale Milano S.p.A.,10000000.0,20000000.0,32,153,155,5,11,15,14,15,8,12,11,8,6,15,17,8,16,15,16,15,15,16,16,16,14,15,12,16,7,16,15,12,14,15,13,16,13,14,14,15,14,14,3,12,2,3,3,1,3,2,1,2,3,3,2,16,12,14,15,18,15,3,11,1,1,1,1,1,1,1,1,1,1,17,15,10,20,82,13,20,36036002,7650,8150,6650,North_African__Middle_Eastern,153,58,27,35120.0,Unknown,23127918,2611000.0,2.0,48,282,50,0,1,6,89,3,0.8286583752315428,0.7058823529411764,0.7647058823529411,0.0339037878268493,0.381578947368421,0.3552631578947368,0.0497624406101525,0.0997749437359339,0.014478179949443,0.1428571428571428,0.5116279069767438,0.5833333333333333,433,203,97,57,5,10354,4,16,42,8000000,290740.74074074073,20000000.0,6000000.0,,,5,5325000,-0.2,-0.3333333333333333
307924,Mergim,Berisha,2024,533,Germany,Berchtesgaden,Germany,11-05-98,Centre-Forward,Attack,Right,188.0,30-06-27,ROGON,https://img.a.transfermarkt.technology/portrait/header/307924-1691251216.jpg?lm=1,L1,TSG 1899 Hoffenheim FuÃŸball-Spielbetriebs GmbH,10000000.0,14000000.0,26,120,130,9,9,11,13,13,15,13,12,4,7,12,11,5,14,9,10,13,12,11,13,10,13,15,8,15,7,12,11,12,13,14,13,14,12,13,12,11,8,14,10,7,3,1,2,2,3,4,3,1,3,2,1,10,17,15,11,16,11,8,10,1,1,1,1,1,1,1,10,1,10,18,15,10,20,79,12,20,2338383,5997,6497,4947,Northern_European,119,0,0,48076.0,FC Augsburg,16170434,7666666.667,3.0,38,175,40,0,1,7,199,3,0.6099497221487166,0.5237433155080213,0.5147058823529411,0.0464143251252647,0.0,0.0,0.0497624406101525,0.0697674418604651,0.0425659972054779,0.2857142857142857,0.581395348837209,0.3333333333333332,284,106,46,34,0,4819,11,75,252,7000000,276000.0,14000000.0,3000000.0,400000.0,750000.0,7,4800000,-0.3,-0.4166666666666667
308278,Rey,Manaj,2024,2381,Albania,LushnjÃ«,Albania,24-02-97,Centre-Forward,Attack,Right,182.0,30-06-26,Unknown,https://img.a.transfermarkt.technology/portrait/header/308278-1724077102.png?lm=1,TR1,Sivasspor KulÃ¼bÃ¼,5000000.0,5000000.0,27,123,132,8,8,13,13,13,11,13,12,8,6,11,13,7,14,15,12,14,12,11,9,11,15,12,10,13,6,11,12,11,13,14,12,12,13,12,13,13,11,12,7,11,3,1,1,2,2,3,1,3,3,1,1,11,16,14,12,11,10,8,5,1,1,1,1,1,1,1,1,1,1,7,1,7,20,76,15,20,4053641,6150,6250,4500,Northern_European,122,31,7,14941.0,Unknown,43130944,1500000.0,3.0,0,878,0,0,1,7,183,3,0.5772691188145012,0.4759358288770053,0.536764705882353,0.0144185970160495,0.2039473684210526,0.0921052631578947,0.0247561890472618,0.0247561890472618,0.0083057862718408,0.2857142857142857,0.4418604651162785,0.375,0,0,0,0,0,0,13,43,87,4000000,132758.62068965516,5000000.0,1000000.0,800000.0,900000.0,10,2600000,-0.2,1.8571428571428572
308279,Rolando,Mandragora,2024,430,Italy,Napoli,Italy,29-06-97,Defensive Midfield,Midfield,Left,183.0,30-06-26,LUCA DE SIMONE,https://img.a.transfermarkt.technology/portrait/header/308279-1663591807.jpg?lm=1,IT1,Associazione Calcio Fiorentina,8500000.0,15000000.0,27,135,145,13,10,11,10,14,13,7,11,8,12,14,11,14,14,14,14,14,12,13,14,13,14,14,13,14,14,15,14,13,13,14,10,13,13,13,13,15,10,15,7,13,2,3,2,1,3,2,1,2,1,3,3,12,14,3,13,11,14,14,12,1,1,13,1,1,1,20,1,20,1,1,10,1,1,75,20,9,10243832,6750,6700,5350,Mediterranean_Hispanic,136,1,0,56923.0,Unknown,43159580,13050000.0,4.0,52,1016,54,3,0,3,26,4,0.6368086795448531,0.5668449197860962,0.6397058823529411,0.0549571410776481,0.006578947368421,0.0,0.0422605651412853,0.0747686921730432,0.0724742353954276,0.4285714285714285,0.4651162790697669,0.375,326,24,22,69,1,5342,15,160,210,8000000,303846.1538461539,15000000.0,4000000.0,3000000.0,10000000.0,6,10200000,-0.058823529411764705,-0.058823529411764705
308371,Mikel,Villanueva,2024,2420,Venezuela,"San CristÃ³bal, TÃ¡chira",Venezuela,14-04-93,Centre-Back,Defender,Left,190.0,30-06-25,YOU FIRST,https://img.a.transfermarkt.technology/portrait/header/308371-1573486873.jpg?lm=1,PO1,VitÃ³ria Sport Clube,1500000.0,2000000.0,31,125,128,9,13,11,8,11,9,11,8,13,14,10,7,13,12,13,13,15,14,11,8,13,13,6,11,7,13,14,12,11,10,13,17,13,10,13,16,15,9,14,11,13,3,3,3,2,1,2,2,1,3,1,2,12,15,5,13,8,14,14,16,1,16,20,1,15,1,1,1,1,1,1,1,1,1,77,20,7,1593105,6247,5596,4523,Mediterranean_Hispanic,123,31,2,3950.0,Unknown,86031832,300000.0,1.0,108,1295,105,1,0,3,217,2,0.4907382905530564,0.4783957219251336,0.5441176470588236,0.0038054976453422,0.2039473684210526,0.0263157894736842,0.0072518129532383,0.0097524381095273,0.0016389344148448,0.0,0.6279069767441858,0.5416666666666665,206,4,6,45,0,5287,10,52,98,1500000,55000.0,2000000.0,500000.0,,,6,900000,0.0,-0.25
308552,Jordan,Larsson,2024,190,Netherlands,Rotterdam,Sweden,20-06-97,Centre-Forward,Attack,Left,175.0,30-06-27,Unknown,https://img.a.transfermarkt.technology/portrait/header/308552-1659600431.jpg?lm=1,DK1,Football Club KÃ¸benhavn,2500000.0,15000000.0,27,122,135,13,11,14,12,13,13,11,12,3,5,12,12,5,14,14,12,8,12,9,12,10,13,14,5,13,6,10,9,16,14,12,7,13,15,12,8,11,11,11,7,8,1,1,3,3,3,1,3,3,1,1,1,12,12,9,5,11,12,12,9,1,1,1,1,1,1,1,10,1,10,13,10,18,20,68,20,9,1245776,6100,6000,5100,Mixed_Race,112,3,1,28766.0,Unknown,93053655,1737500.0,4.0,67,1253,91,0,0,4,90,3,0.5441915850754168,0.5401069518716577,0.463235294117647,0.0277682557186268,0.0197368421052631,0.0131578947368421,0.0122530632658164,0.0747686921730432,0.009625267368538,0.4285714285714285,0.2790697674418605,0.375,0,0,0,0,0,0,9,31,64,2000000,69230.76923076923,15000000.0,3000000.0,700000.0,,6,8800000,-0.2,-0.2
309110,Brais,Méndez,2024,681,Spain,Mos,Spain,07-01-97,Attacking Midfield,Midfield,Left,184.0,30-06-28,InterStarDeporte,https://img.a.transfermarkt.technology/portrait/header/309110-1665057568.jpg?lm=1,ES1,Real Sociedad de FÃºtbol S.A.D.,40000000.0,40000000.0,27,148,155,15,15,13,15,16,13,10,13,10,6,15,11,10,15,9,15,10,16,15,15,15,7,14,11,15,11,16,15,13,15,10,12,13,13,14,11,13,3,12,7,14,2,1,3,2,2,3,3,4,2,3,2,8,12,1,11,13,13,10,11,1,1,1,1,1,1,1,1,15,12,1,18,20,1,76,20,9,28370924,7400,7400,3500,Mediterranean_Hispanic,149,4,1,38407.0,Unknown,67199158,14000000.0,1.0,89,983,89,3,0,3,168,0,0.7294257740142895,0.3689839572192513,0.7352941176470587,0.0370777717802216,0.0263157894736842,0.0131578947368421,0.1997999499874969,0.1997999499874969,0.0777521597822161,0.0,0.4883720930232553,0.375,353,56,39,64,1,5840,5,14,30,35000000,1342307.6923076923,40000000.0,5000000.0,,500000.0,2,6500000,-0.125,-0.125
309400,Kai,Havertz,2024,11,Germany,Aachen,Germany,11-06-99,Centre-Forward,Attack,Left,193.0,30-06-28,ROOF,https://img.a.transfermarkt.technology/portrait/header/309400-1683903902.jpg?lm=1,GB1,Arsenal Football Club,75000000.0,90000000.0,25,167,180,11,12,14,16,18,11,13,11,8,7,14,12,10,17,11,15,11,17,10,17,16,10,15,7,17,10,15,13,13,13,13,14,16,17,15,13,13,6,16,4,16,2,2,3,1,3,3,3,2,3,2,3,12,14,5,12,16,15,15,19,1,1,1,1,1,1,10,12,14,14,12,20,14,19,77,20,10,305612129,8350,7650,7250,Northern_European,160,28,8,173988.0,Unknown,91151081,77500000.0,2.0,38,8,40,0,0,7,21,3,0.7625033077533738,0.7700534759358288,0.8161764705882353,0.1679971263230163,0.1842105263157894,0.1052631578947368,0.3748437109277319,0.4498624656164041,0.4305397372149226,0.1428571428571428,0.6976744186046511,0.2916666666666665,439,135,59,55,0,8934,14,47,140,75000000,2774074.074074074,90000000.0,11000000.0,28000000.0,81000000.0,2,5000000,0.07142857142857142,0.36363636363636365
309944,Tyronne,Ebuehi,2024,749,Netherlands,Haarlem,Nigeria,16-12-95,Right-Back,Defender,Right,187.0,30-06-25,Unknown,https://img.a.transfermarkt.technology/portrait/header/309944-1663678158.jpg?lm=1,IT1,Empoli Football Club S.r.l.,2000000.0,2500000.0,29,120,126,7,10,12,5,13,6,10,4,9,8,12,5,12,13,10,10,9,12,12,10,12,13,13,5,14,13,13,14,14,14,13,10,12,14,14,10,10,8,12,12,9,1,2,3,2,3,3,3,1,2,1,2,9,13,6,12,14,14,15,5,1,15,1,20,15,18,1,12,1,16,1,1,1,1,76,8,20,1295512,6000,6300,4500,African_Caribbean,111,10,0,5999.0,Unknown,37047573,9111392.0,2.0,67,585,70,1,1,1,64,11,0.5838846255623181,0.4759358288770053,0.4558823529411764,0.0057840474233951,0.0657894736842105,0.0,0.0097524381095273,0.0122530632658164,0.0505924720131114,0.1428571428571428,0.5581395348837206,0.4583333333333332,0,0,0,0,0,0,10,157,356,1500000,55769.230769230766,2500000.0,500000.0,50000.0,450000.0,5,950000,-0.25,-0.4
310131,Mathieu,Maertens,2024,2727,Unknown,Unknown,Belgium,27-03-95,Attacking Midfield,Midfield,Left,185.0,30-06-26,Forza Sports Group,https://img.a.transfermarkt.technology/portrait/header/310131-1713337167.png?lm=1,BE1,Oud-Heverlee Leuven,2300000.0,3000000.0,29,122,122,10,10,11,12,12,11,11,10,8,12,12,8,11,12,12,14,13,13,14,12,14,13,13,15,12,12,15,14,13,11,9,11,11,14,14,10,15,8,15,6,13,1,3,2,3,2,1,1,3,1,2,2,13,14,8,12,11,11,10,16,1,1,1,1,1,1,14,1,16,1,15,20,1,1,71,20,8,2098799,6010,6010,4757,Northern_European,120,0,0,8000.0,Unknown,18083780,9111392.0,2.0,105,1549,8,3,0,7,146,0,0.5455146864249801,0.5034224598930481,0.5220588235294117,0.0077162475726795,0.0,0.0,0.0112528132033008,0.0147536884221055,0.0505924720131114,0.1428571428571428,0.5116279069767438,0.4583333333333332,288,55,25,58,2,6260,8,45,66,2200000,77777.77777777778,3000000.0,500000.0,,500000.0,1,100000,0.2222222222222222,0.1
310458,Giangiacomo,Magnani,2024,276,Italy,Correggio,Italy,04-10-95,Centre-Back,Defender,Right,192.0,30-06-25,TMP SOCCER srl ,https://img.a.transfermarkt.technology/portrait/header/310458-1725529511.jpg?lm=1,IT1,Verona Hellas Football Club,3000000.0,5000000.0,29,121,130,4,5,5,6,11,4,14,6,10,14,10,3,12,10,15,15,13,11,13,9,12,14,7,11,7,12,13,13,12,11,13,15,15,13,12,15,13,13,13,10,10,1,2,3,1,2,3,1,3,1,2,2,10,12,10,13,16,15,12,13,1,1,20,1,1,1,1,1,1,1,1,1,1,1,87,9,20,704149,6050,6050,5000,Northern_European,119,0,0,21346.0,Unknown,43125080,3625000.0,4.0,52,386,54,1,1,7,214,2,0.5508070918232336,0.5294117647058822,0.5147058823529411,0.0206033756048385,0.0,0.0,0.0147536884221055,0.0247561890472618,0.0201116697686046,0.4285714285714285,0.6744186046511627,0.4583333333333332,260,6,5,47,3,4122,11,35,78,2500000,95192.30769230769,5000000.0,1000000.0,25000.0,50000.0,10,4950000,-0.16666666666666666,-0.10714285714285714
311044,Alfonso,Espino,2024,367,Uruguay,San Jacinto,Uruguay,05-01-92,Left-Back,Defender,Left,172.0,30-06-26,Unknown,https://img.a.transfermarkt.technology/portrait/header/311044-1635328827.jpg?lm=1,ES1,Rayo Vallecano de Madrid S.A.D.,2400000.0,6000000.0,32,132,141,7,11,10,6,11,6,6,10,13,14,11,7,14,9,15,12,16,11,14,11,11,15,9,15,13,12,16,19,15,14,14,6,17,14,18,14,12,10,13,5,5,1,2,1,1,1,2,1,1,3,3,2,13,13,7,16,14,15,9,11,1,20,1,1,12,1,1,9,1,1,1,1,1,1,71,20,7,3271293,6600,6600,4800,Mediterranean_Hispanic,131,0,0,18509.0,Unknown,78066692,9111392.0,2.0,106,1300,103,1,0,3,163,8,0.6235776660492194,0.5080213903743315,0.6029411764705883,0.0178639194211703,0.0,0.0,0.0117529382345586,0.0297574393598399,0.0505924720131114,0.1428571428571428,0.2093023255813952,0.5833333333333333,359,9,29,65,1,9910,7,19,90,1500000,51851.851851851854,6000000.0,1000000.0,,,2,550000,-0.375,-0.5
311178,Georgios,Kyriakopoulos,2024,2919,Greece,Patras,Greece,05-02-96,Left Midfield,Midfield,Left,186.0,30-06-26,SPORTS CONNECTION,https://img.a.transfermarkt.technology/portrait/header/311178-1695030734.jpg?lm=1,IT1,Associazione Calcio Monza,3500000.0,5000000.0,28,133,139,12,12,13,10,13,11,8,10,13,11,13,8,13,13,14,12,15,10,12,13,12,15,12,10,14,13,13,14,14,13,14,11,13,14,14,13,13,10,13,4,12,3,2,1,3,2,2,3,3,1,1,3,16,15,8,13,13,15,15,13,1,20,1,1,18,1,1,17,1,1,16,1,1,1,74,20,8,5580955,6645,5937,5162,Mediterranean_Hispanic,128,5,0,9807.0,Unknown,36090959,1750000.0,2.0,40,1129,42,3,0,3,28,6,0.5358560465731675,0.5467379679144384,0.5808823529411764,0.0094611179723582,0.0328947368421052,0.0,0.0172543135783946,0.0247561890472618,0.0096947137420483,0.1428571428571428,0.5348837209302322,0.4166666666666665,0,0,0,0,0,0,3,8,25,3500000,143478.26086956522,5000000.0,1200000.0,200000.0,250000.0,3,1800000,0.0,-0.125
311489,Landry,Dimata,2024,152,DR Congo,Mbuji-Mayi,Belgium,01-09-97,Centre-Forward,Attack,Right,185.0,30-06-26,Unknown,https://img.a.transfermarkt.technology/portrait/header/311489-1727719641.png?lm=1,TR1,Samsunspor,1500000.0,8000000.0,27,125,134,7,9,11,12,12,12,14,14,7,6,10,16,6,12,15,11,16,12,13,10,11,16,11,8,14,6,13,16,15,11,16,14,16,16,12,16,11,6,13,5,9,2,2,1,3,3,1,2,2,4,1,1,9,15,10,7,13,12,10,12,1,1,1,1,1,1,1,14,1,10,14,1,10,20,81,7,20,1781016,6050,5950,5500,African_Caribbean,125,0,0,4418.0,N.E.C. Nijmegen,18084327,4140000.0,5.0,27,934,8,0,1,1,180,3,0.5375760783275999,0.5828877005347594,0.5588235294117647,0.0042574065258346,0.0,0.0,0.0072518129532383,0.0397599399849962,0.0229728603572321,0.5714285714285714,0.5116279069767438,0.375,210,49,17,19,0,5102,10,65,455,2200000,68518.51851851853,8000000.0,2000000.0,350000.0,6000000.0,5,3500000,0.2222222222222222,-0.12
312678,Léo,Duarte,2024,6890,Brazil,Mococa,Brazil,17-07-96,Right-Back,Defender,Right,183.0,30-06-26,Unknown,https://img.a.transfermarkt.technology/portrait/header/312678-1695642440.png?lm=1,TR1,?stanbul Ba?ak?ehir Futbol KulÃ¼bÃ¼,3300000.0,8000000.0,28,125,145,5,7,12,7,12,10,13,8,10,13,14,10,13,12,13,13,14,13,12,10,12,14,7,10,9,12,12,13,13,12,14,13,11,15,13,13,11,7,12,12,13,2,2,2,2,4,2,2,2,3,1,1,11,12,5,13,11,12,12,11,1,1,20,13,1,1,10,1,1,1,1,1,1,1,76,9,20,5384619,6395,6395,4995,Mixed_Race,124,0,0,29230.0,Unknown,19247744,4493333.333,3.0,10,960,11,1,1,4,4,11,0.5964540883831702,0.5288770053475935,0.5514705882352942,0.0282163021300551,0.0,0.0,0.0162540635158789,0.0397599399849962,0.0249358778466068,0.2857142857142857,0.4651162790697669,0.4166666666666665,261,3,4,29,0,8095,16,63,122,3000000,110000.0,8000000.0,2000000.0,,250000.0,2,4800000,0.0,0.0
313094,Jordan,Lotomba,2024,234,Switzerland,Yverdon-les-Bains,Switzerland,29-09-98,Right-Back,Defender,Right,177.0,30-06-27,Wasserman,https://img.a.transfermarkt.technology/portrait/header/313094-1649428183.jpg?lm=1,NL1,Feyenoord Rotterdam,8000000.0,8000000.0,26,126,138,8,11,14,8,14,7,7,6,13,12,11,7,13,13,14,13,12,12,12,9,10,13,14,7,12,12,15,14,14,14,8,9,15,13,14,8,12,8,12,10,18,1,1,2,1,3,2,3,3,3,1,4,13,14,6,12,11,14,11,13,1,15,1,20,13,18,1,10,1,16,1,1,12,1,67,14,20,3226354,6295,6295,4545,African_Caribbean,116,7,1,12660.0,Unknown,98034811,4600000.0,2.0,92,1690,92,1,1,1,85,11,0.5832230748875364,0.4807486631016042,0.4926470588235294,0.0122160240322825,0.0460526315789473,0.0131578947368421,0.0397599399849962,0.0397599399849962,0.0255284869024139,0.1428571428571428,0.3255813953488373,0.3333333333333332,320,13,16,30,0,5697,10,144,270,8000000,345652.17391304346,8000000.0,1000000.0,700000.0,4500000.0,3,2000000,0.0,0.0
314288,Lukas,Nmecha,2024,82,Germany,Hamburg,Germany,14-12-98,Centre-Forward,Attack,Right,185.0,30-06-25,Sports360 GmbH,https://img.a.transfermarkt.technology/portrait/header/314288-1657203640.jpg?lm=1,L1,Verein fÃ¼r LeibesÃ¼bungen Wolfsburg,5000000.0,18000000.0,26,138,152,4,8,13,15,13,12,13,9,3,5,12,17,6,15,11,13,12,13,12,12,13,13,15,7,15,6,12,12,14,13,15,13,13,16,12,13,12,6,16,8,14,2,1,2,1,1,1,2,3,4,2,3,16,16,12,8,13,11,14,14,1,1,1,1,1,1,1,10,1,10,15,14,15,20,80,12,20,14899890,6999,7099,5999,Mixed_Race,136,6,0,67122.0,Unknown,28106360,8000000.0,1.0,38,594,40,0,1,4,213,3,0.6896004233924319,0.6362566844919786,0.6397058823529411,0.0648054715736761,0.0394736842105263,0.0,0.0247561890472618,0.0897724431107777,0.044417900497236,0.0,0.5116279069767438,0.3333333333333332,242,92,19,26,0,8132,11,73,213,4000000,205882.35294117648,18000000.0,4000000.0,,1000000.0,4,9900000,-0.2,-0.5555555555555556
314295,Reece,Oxford,2024,167,England,London,England,16-12-98,Centre-Back,Defender,Right,190.0,30-06-25,CAA Base Ltd,https://img.a.transfermarkt.technology/portrait/header/314295-1658599514.jpg?lm=1,L1,FC Augsburg 1907,700000.0,12000000.0,26,128,142,4,7,8,9,11,6,11,7,12,14,13,9,15,12,12,14,15,13,12,10,12,11,8,12,8,13,14,12,13,11,13,16,13,13,12,13,13,9,16,9,15,2,2,3,2,2,1,3,3,3,1,2,10,13,10,12,15,11,16,12,1,1,20,12,1,8,16,1,14,1,1,1,1,1,78,9,20,4102136,6400,5632,4626,African_Caribbean,126,0,0,16781.0,Unknown,28101903,2000000.0,1.0,32,858,33,1,1,1,67,2,0.4955014554114845,0.4894117647058823,0.5661764705882353,0.0161953327855064,0.0,0.0,0.0032508127031757,0.0597649412353088,0.0110836412122558,0.0,0.6279069767441858,0.3333333333333332,155,8,5,22,2,4403,16,137,360,500000,-9259.25925925926,12000000.0,3500000.0,5000000.0,3000000.0,5,6000000,-0.6666666666666666,-0.75
314353,Trent,Alexander-Arnold,2024,31,England,Liverpool,England,07-10-98,Right-Back,Defender,Right,175.0,30-06-25,PLG,https://img.a.transfermarkt.technology/portrait/header/314353-1701680958.jpg?lm=1,GB1,Liverpool Football Club,70000000.0,110000000.0,26,160,174,15,18,12,10,17,14,11,12,14,11,16,12,13,17,12,13,11,15,12,16,15,15,14,12,15,11,16,14,14,14,14,11,15,14,14,13,13,10,14,7,14,2,2,3,1,1,1,2,1,3,2,2,15,16,7,19,14,17,12,14,1,10,1,19,12,20,13,1,15,14,1,1,1,1,70,12,20,210765335,8199,7749,6999,Northern_European,157,17,1,185587.0,Unknown,28104124,9111392.0,2.0,32,845,33,1,1,7,129,11,0.7756020111140514,0.7432085561497326,0.7941176470588234,0.1791973209914572,0.1118421052631578,0.0131578947368421,0.3498374593648412,0.549887471867967,0.0505924720131114,0.1428571428571428,0.2790697674418605,0.3333333333333332,362,25,91,48,0,7810,15,69,56,75000000,3239130.434782609,110000000.0,25000000.0,1500000.0,80000000.0,0,0,0.07142857142857142,0.07142857142857142
314367,Marcus,Edwards,2024,336,England,London,England,03-12-98,Right Winger,Attack,Left,168.0,30-06-26,ARETÃ‰,https://img.a.transfermarkt.technology/portrait/header/314367-1653379978.jpg?lm=1,PO1,Sporting Clube de Portugal,18000000.0,30000000.0,26,142,156,12,13,17,13,16,13,10,12,5,5,14,14,6,16,8,14,8,16,10,16,14,12,17,5,15,7,11,8,16,17,14,7,13,15,12,6,9,8,8,6,11,2,2,2,3,3,1,2,1,2,1,1,12,6,14,11,11,10,7,5,1,1,1,1,1,1,1,10,12,12,18,15,20,8,65,20,7,27033500,7100,6300,6136,Mixed_Race,141,0,0,26125.0,Unknown,28106878,7750000.0,1.0,32,858,33,0,0,4,193,10,0.5838846255623181,0.6509090909090909,0.6764705882352942,0.0252180605190965,0.0,0.0,0.0897724431107777,0.1497874468617154,0.0430289730270285,0.0,0.1162790697674416,0.3333333333333332,289,61,55,16,1,7623,7,34,109,15000000,725000.0,30000000.0,5000000.0,,1250000.0,3,4650000,-0.25,-0.4642857142857143
314678,Brahim,Díaz,2024,418,Spain,MÃ¡laga,Morocco,03-08-99,Attacking Midfield,Midfield,Right,170.0,30-06-27,Sports&Life,https://img.a.transfermarkt.technology/portrait/header/314678-1632307989.jpg?lm=1,ES1,Real Madrid Club de FÃºtbol,40000000.0,40000000.0,25,145,158,13,13,16,10,16,9,6,13,7,6,15,13,7,16,8,13,12,12,13,14,12,17,15,8,14,8,14,13,15,16,13,7,13,14,12,7,11,7,11,5,15,3,3,2,4,1,3,4,1,1,1,2,15,15,6,10,11,15,13,12,1,1,1,1,1,1,1,8,12,8,16,20,17,8,59,16,20,23700000,7250,6486,5870,Mediterranean_Hispanic,143,1,1,124642.0,AC Milan,28106999,8675000.0,2.0,89,997,67,3,1,3,167,0,0.6084943106641969,0.6224598930481283,0.6911764705882353,0.1203477767145258,0.006578947368421,0.0131578947368421,0.1997999499874969,0.1997999499874969,0.0481680046667962,0.1428571428571428,0.1627906976744184,0.2916666666666665,297,58,47,15,0,7279,8,32,42,35000000,1625000.0,40000000.0,5000000.0,5000000.0,13500000.0,3,12500000,-0.125,0.75
314875,Jarrod,Bowen,2024,379,England,Leominster,England,20-12-96,Right Winger,Attack,Left,176.0,30-06-30,PLG,https://img.a.transfermarkt.technology/portrait/header/314875-1662362005.jpg?lm=1,GB1,West Ham United Football Club,50000000.0,50000000.0,28,150,160,13,14,16,15,13,12,10,14,4,5,14,14,8,14,8,14,8,14,10,13,14,17,14,5,16,8,15,17,15,15,11,8,14,15,15,8,15,5,15,4,12,1,3,1,3,1,1,3,2,2,2,3,15,16,3,13,15,17,12,18,1,1,1,1,1,1,1,15,1,15,19,18,20,14,70,20,11,53588177,7500,7500,5500,Northern_European,147,4,0,92793.0,Unknown,29125842,21300000.0,1.0,32,822,33,0,0,7,220,10,0.7426567875099233,0.5828877005347594,0.7205882352941175,0.0895938324093985,0.0263157894736842,0.0,0.2498124531132783,0.2498124531132783,0.1183088419122753,0.0,0.3023255813953489,0.4166666666666665,0,0,0,0,0,0,3,8,34,45000000,2034090.9090909092,50000000.0,5000000.0,,750000.0,1,10000000,-0.1,-0.1
314944,Ricardo,Mangas,2024,232,Portugal,Lisboa,Portugal,19-03-98,Left-Back,Defender,Left,179.0,30-06-26,Team of Future,https://img.a.transfermarkt.technology/portrait/header/314944-1725985346.png?lm=1,RU1,FK Spartak Moskva,4000000.0,4000000.0,26,121,130,12,12,12,9,13,12,7,7,10,11,11,11,13,14,15,12,11,13,13,13,12,13,13,10,12,10,14,13,14,14,12,9,13,13,14,8,12,14,12,10,9,3,1,2,1,1,1,2,1,3,3,3,19,12,6,13,11,13,10,10,1,20,10,1,18,1,1,16,1,1,14,1,1,1,66,20,7,841497,6050,5950,3802,Mediterranean_Hispanic,117,0,0,3499.0,Unknown,55082268,1700000.0,2.0,76,843,79,1,0,3,82,8,0.5375760783275999,0.401283422459893,0.4999999999999999,0.0033700042583721,0.0,0.0,0.0197549387346836,0.0197549387346836,0.0094169282480068,0.1428571428571428,0.3720930232558141,0.3333333333333332,189,23,16,25,1,3029,2,15,91,3000000,178571.42857142858,4000000.0,1000000.0,,,5,2850000,-0.25,0.5
315121,Justin,Bijlow,2024,234,Netherlands,Rotterdam,Netherlands,22-01-98,Goalkeeper,Goalkeeper,Right,188.0,30-06-26,Forza Sports Group,https://img.a.transfermarkt.technology/portrait/header/315121-1676465549.jpg?lm=1,NL1,Feyenoord Rotterdam,13000000.0,15000000.0,26,138,153,7,1,3,1,6,9,5,3,3,2,14,2,1,11,9,13,11,12,14,12,13,15,7,12,2,15,14,14,11,14,13,14,10,11,12,11,15,5,12,15,13,14,14,12,8,14,15,15,14,12,9,12,13,13,7,15,13,15,12,16,20,1,1,1,1,1,1,1,1,1,1,1,1,1,84,6,20,12958482,6895,6895,5545,Northern_European,137,6,0,9588.0,Unknown,37050136,9111392.0,2.0,67,1253,68,2,1,7,85,5,0.662609155861339,0.5877005347593582,0.6470588235294117,0.0092496477911022,0.0394736842105263,0.0,0.0647661915478869,0.0747686921730432,0.0505924720131114,0.1428571428571428,0.581395348837209,0.3333333333333332,0,0,0,0,0,0,20,213,208,6500000,242307.6923076923,15000000.0,4500000.0,300000.0,3000000.0,0,0,-0.5,-0.5666666666666667
315145,Azor,Matusiwa,2024,273,Netherlands,Hilversum,Netherlands,28-04-98,Defensive Midfield,Midfield,Right,173.0,30-06-28,ER Sport Agency,https://img.a.transfermarkt.technology/portrait/header/315145-1639675049.png?lm=1,FR1,Stade Rennais Football Club,12000000.0,13000000.0,26,124,136,6,8,9,4,14,8,8,7,8,13,13,6,13,13,13,13,14,12,11,14,12,15,8,14,13,13,14,17,12,11,14,8,13,12,12,13,13,13,11,8,10,2,1,1,3,3,3,3,3,1,3,3,18,12,8,12,14,12,14,14,1,1,12,17,1,17,20,1,18,16,1,1,1,1,65,10,20,4636222,6200,6200,4500,African_Caribbean,118,0,0,9847.0,Unknown,37053977,6733333.333,3.0,67,627,68,3,1,1,195,4,0.5706536120666843,0.4759358288770053,0.5073529411764706,0.0094997426629986,0.0,0.0,0.0597649412353088,0.0647661915478869,0.0373806679796661,0.2857142857142857,0.2325581395348837,0.3333333333333332,0,0,0,0,0,0,6,43,121,12000000,520652.17391304346,13000000.0,1000000.0,50000.0,550000.0,5,3425000,0.0,0.2
315254,Mees,De Wit,2024,1090,Netherlands,Amsterdam,Netherlands,17-04-98,Left-Back,Defender,Left,181.0,30-06-27,PURE,https://img.a.transfermarkt.technology/portrait/header/315254-1658219075.jpg?lm=1,NL1,Alkmaar Zaanstreek,2500000.0,2500000.0,26,122,130,11,13,12,9,13,12,9,11,8,8,12,11,10,13,11,11,12,11,10,12,10,11,12,8,12,10,15,13,13,13,12,10,12,12,13,12,11,7,12,10,17,4,2,2,2,1,2,3,3,1,2,1,13,12,5,14,12,13,13,10,1,19,14,1,20,1,1,19,12,14,19,12,13,1,74,20,8,2371881,5889,5889,3489,Northern_European,111,0,0,3836.0,Unknown,37053976,2300000.0,1.0,67,64,68,1,0,7,16,8,0.5295051600952633,0.367807486631016,0.4558823529411764,0.0036954172770172,0.0,0.0,0.0122530632658164,0.0122530632658164,0.0127503541765049,0.0,0.418604651162791,0.3333333333333332,146,22,18,12,0,5551,7,43,131,2300000,187500.0,2500000.0,200000.0,,75000.0,4,300000,-0.08,0.5333333333333333
315332,Aymen,Barkok,2024,39,Germany,Frankfurt am Main,Morocco,21-05-98,Attacking Midfield,Midfield,Right,189.0,30-06-25,Unknown,https://img.a.transfermarkt.technology/portrait/header/315332-1657707404.jpg?lm=1,L1,1. FuÃŸball- und Sportverein Mainz 05,1000000.0,3500000.0,26,125,135,13,11,15,11,14,13,7,12,6,9,13,12,11,16,15,11,13,12,9,13,10,11,16,5,12,9,12,12,13,13,12,12,13,15,12,12,11,12,12,10,15,2,2,3,3,2,1,3,1,2,1,1,8,12,8,16,12,12,12,10,1,1,1,10,1,14,10,12,18,15,12,20,15,10,82,11,20,2773094,6242,6042,5242,North_African__Middle_Eastern,124,18,1,12466.0,Unknown,91143866,9111392.0,2.0,38,507,67,3,1,6,1,0,0.5497486107435829,0.5552941176470588,0.5514705882352942,0.0120286942826767,0.1184210526315789,0.0131578947368421,0.0047511877969492,0.0172543135783946,0.0505924720131114,0.1428571428571428,0.6046511627906974,0.3333333333333332,195,17,10,20,0,8244,11,51,101,700000,27272.727272727272,3500000.0,1500000.0,1250000.0,1500000.0,5,1700000,-0.3,-0.65
315604,Diadié,Samassékou,2024,533,Mali,Bamako,Mali,11-01-96,Defensive Midfield,Midfield,Right,177.0,30-06-25,Classico,https://img.a.transfermarkt.technology/portrait/header/315604-1657200749.jpg?lm=1,L1,TSG 1899 Hoffenheim FuÃŸball-Spielbetriebs GmbH,1000000.0,20000000.0,28,140,145,8,10,11,7,13,6,10,9,6,12,16,8,16,13,16,16,14,12,12,14,13,14,8,8,10,13,15,17,14,15,12,9,16,12,15,13,15,11,13,7,9,4,2,4,1,2,2,1,1,1,3,3,13,15,9,9,11,13,10,12,1,1,1,1,1,1,20,1,19,1,1,1,1,1,68,10,20,12410833,7000,6950,6000,African_Caribbean,139,27,1,59999.0,Olympiacos SF Piraeus,13162061,12500000.0,1.0,61,133,61,3,1,1,199,4,0.6698862132839376,0.6363636363636364,0.6617647058823528,0.0579273797878925,0.1776315789473684,0.0131578947368421,0.0047511877969492,0.0997749437359339,0.0694185949609711,0.0,0.3255813953488373,0.4166666666666665,0,0,0,0,0,0,11,31,53,1000000,25806.451612903227,20000000.0,4000000.0,,1000000.0,6,11950000,-0.5,-0.6
315779,Christian,Pulisic,2024,5,United States,"Hershey, Pennsylvania",United States,18-09-98,Right Winger,Attack,Right,177.0,30-06-27,Unknown,https://img.a.transfermarkt.technology/portrait/header/315779-1691696699.jpg?lm=1,IT1,Associazione Calcio Milan,40000000.0,60000000.0,26,154,170,12,11,16,13,15,10,8,10,5,6,11,10,8,15,13,15,14,12,10,14,14,14,15,12,15,8,14,16,17,17,8,7,13,15,14,9,12,4,15,14,14,2,1,2,2,2,2,2,2,3,2,2,15,17,6,9,13,14,16,14,1,1,1,1,1,13,1,16,8,16,20,17,17,8,73,12,20,73283578,7500,7800,6750,Northern_European,149,51,21,173988.0,Unknown,92074020,9111392.0,2.0,104,621,102,0,1,7,27,10,0.7823498279968246,0.7165775401069518,0.7352941176470587,0.1679971263230163,0.3355263157894737,0.2763157894736842,0.1997999499874969,0.2998249562390597,0.0505924720131114,0.1428571428571428,0.3255813953488373,0.3333333333333332,379,86,77,19,0,9927,31,101,157,50000000,1903846.1538461538,60000000.0,10000000.0,18000000.0,60000000.0,2,7000000,0.25,0.5625
315853,Alessandro,Bastoni,2024,46,Italy,Casalmaggiore,Italy,13-04-99,Centre-Back,Defender,Left,190.0,30-06-28,TMP SOCCER srl ,https://img.a.transfermarkt.technology/portrait/header/315853-1727024207.jpg?lm=1,IT1,Football Club Internazionale Milano S.p.A.,70000000.0,70000000.0,25,152,168,4,10,11,8,14,5,15,5,12,15,15,8,16,14,14,15,16,13,15,14,13,16,12,12,11,14,17,15,14,13,15,15,17,14,15,15,13,13,14,7,10,3,2,3,1,2,3,2,2,2,2,1,14,17,5,14,17,17,14,11,1,10,20,1,1,1,8,1,1,1,1,1,1,1,75,20,9,59167500,7600,7650,7150,Mediterranean_Hispanic,152,15,1,99807.0,Unknown,43252460,31100000.0,1.0,52,323,54,1,0,3,89,2,0.7625033077533738,0.7593582887700534,0.7573529411764706,0.0963666719131871,0.0986842105263157,0.0131578947368421,0.3498374593648412,0.3498374593648412,0.1727547987444095,0.0,0.6279069767441858,0.2916666666666665,324,18,23,50,1,7169,15,31,56,75000000,3121875.0,75000000.0,5000000.0,2500000.0,31500000.0,3,13725000,0.07142857142857142,0.25
315858,Gianluigi,Donnarumma,2024,583,Italy,Castellammare di Stabia,Italy,25-02-99,Goalkeeper,Goalkeeper,Right,196.0,30-06-26,Team Raiola,https://img.a.transfermarkt.technology/portrait/header/315858-1672304477.jpg?lm=1,FR1,Paris Saint-Germain Football Club,40000000.0,65000000.0,25,162,178,1,2,4,3,7,1,7,3,8,3,7,6,7,6,8,16,16,14,14,8,15,15,6,14,2,15,15,13,10,16,16,18,15,12,15,16,17,4,15,4,1,16,14,15,9,15,13,16,18,11,14,12,9,16,5,4,15,13,15,14,20,1,1,1,1,1,1,1,1,1,1,1,1,1,90,7,20,138933453,8100,8100,7800,Mediterranean_Hispanic,163,46,0,249315.0,Unknown,43252073,250000.0,1.0,52,328,54,2,1,3,154,5,0.8220428684837258,0.8288770053475936,0.838235294117647,0.2407341781196921,0.3026315789473684,0.0,0.1997999499874969,0.3248312078019504,0.0013611489208033,0.0,0.7674418604651163,0.2916666666666665,0,0,0,0,0,0,11,17,36,35000000,1285185.1851851852,65000000.0,15000000.0,40000000.0,55000000.0,2,6000000,-0.125,-0.125
315862,Filippo,Melegoni,2024,252,Italy,Bergamo,Italy,18-02-99,Central Midfield,Midfield,Right,186.0,30-06-25,GR Sports,https://img.a.transfermarkt.technology/portrait/header/315862-1697615947.jpg?lm=1,IT1,Genoa Cricket and Football Club,1200000.0,2000000.0,25,125,144,12,11,11,8,14,13,11,13,4,9,14,11,11,14,11,13,12,12,13,13,13,15,11,10,12,12,14,13,13,12,13,12,12,13,12,13,12,6,10,10,13,3,3,2,1,1,1,1,2,1,3,3,7,16,5,13,11,15,13,11,1,1,1,1,1,1,16,5,20,5,1,13,5,1,74,10,20,7760152,6248,6248,4748,Mediterranean_Hispanic,125,0,0,1068.0,R Standard de LiÃ¨ge,43252469,4000000.0,1.0,52,176,54,3,1,3,104,1,0.5770044985445886,0.5024598930481283,0.5588235294117647,0.0010225886847037,0.0,0.0,0.0057514378594648,0.0097524381095273,0.0221950609739159,0.0,0.5348837209302322,0.2916666666666665,203,16,7,24,1,5492,5,51,243,1000000,45000.0,2000000.0,300000.0,1000000.0,1000000.0,6,1200000,-0.16666666666666666,-0.23076923076923078
315865,Andrea,Pinamonti,2024,252,Italy,Cles,Italy,19-05-99,Centre-Forward,Attack,Right,185.0,30-06-25,Team Raiola,https://img.a.transfermarkt.technology/portrait/header/315865-1692883161.jpg?lm=1,IT1,Genoa Cricket and Football Club,15000000.0,20000000.0,25,136,153,5,7,11,14,13,7,14,13,5,5,11,14,6,14,5,12,13,14,11,11,13,12,12,8,15,5,13,14,14,13,14,14,14,14,14,15,12,5,11,5,9,1,2,2,1,1,3,3,2,2,2,1,12,13,5,12,11,14,12,10,1,1,1,1,1,1,1,1,1,1,1,1,1,20,75,12,20,20000000,6800,6750,5300,Northern_European,135,0,0,71154.0,U.S. Sassuolo,43252773,20166666.67,3.0,52,369,54,0,1,7,104,3,0.6434241862926701,0.5614973262032085,0.6323529411764706,0.0686988403902252,0.0,0.0,0.0747686921730432,0.0997749437359339,0.1120123707325203,0.2857142857142857,0.5116279069767438,0.2916666666666665,284,95,19,21,2,4472,10,45,62,16000000,692391.304347826,20000000.0,3000000.0,2000000.0,13500000.0,6,13500000,0.06666666666666667,0.06666666666666667
315867,Gianluca,Scamacca,2024,800,Italy,Roma,Italy,01-01-99,Centre-Forward,Attack,Right,195.0,30-06-27,CAA Stellar,https://img.a.transfermarkt.technology/portrait/header/315867-1659354755.jpg?lm=1,IT1,Atalanta Bergamasca Calcio S.p.a.,35000000.0,35000000.0,25,142,161,4,5,11,17,14,13,16,16,4,4,12,12,5,14,14,14,14,13,13,12,13,16,16,12,15,4,14,14,11,12,16,16,15,13,14,16,14,8,13,5,7,1,3,3,1,1,2,2,2,3,3,2,10,16,9,9,13,14,9,9,1,1,1,1,1,1,1,1,1,1,1,1,1,20,85,12,20,52126681,7100,7350,5250,Mediterranean_Hispanic,141,7,0,81194.0,Unknown,37053643,9111392.0,2.0,52,1244,54,0,1,3,31,3,0.7228102672664726,0.5561497326203209,0.6764705882352942,0.0783936377409577,0.0460526315789473,0.0,0.1747936984246061,0.1747936984246061,0.0505924720131114,0.1428571428571428,0.7441860465116279,0.2916666666666665,245,82,15,24,1,6750,14,114,177,30000000,1423809.5238095238,35000000.0,5000000.0,300000.0,3200000.0,10,14300000,-0.14285714285714285,0.2
315969,Scott,Mctominay,2024,6195,England,Lancaster,Scotland,08-12-96,Central Midfield,Midfield,Right,191.0,30-06-28,Unknown,https://img.a.transfermarkt.technology/portrait/header/315969-1718626681.jpg?lm=1,IT1,SocietÃ  Sportiva Calcio Napoli,32000000.0,35000000.0,28,139,148,5,12,12,12,13,4,14,13,10,11,13,7,15,13,17,11,16,11,13,9,11,18,6,14,11,11,18,15,13,14,15,17,17,14,19,15,13,17,14,4,16,3,1,1,3,1,2,1,1,3,3,3,12,15,2,16,15,18,14,16,1,1,15,1,1,1,18,1,20,1,1,10,1,7,88,12,20,34710527,7250,7300,6000,Northern_European,136,34,1,92793.0,Unknown,29125343,30500000.0,1.0,32,795,83,3,1,7,184,1,0.7161947605186557,0.6363636363636364,0.6397058823529411,0.0895938324093985,0.2236842105263157,0.0131578947368421,0.1597899474868717,0.1747936984246061,0.1694213728159115,0.0,0.6511627906976742,0.4166666666666665,309,39,12,49,0,7523,13,73,70,40000000,1857142.857142857,40000000.0,5500000.0,,,1,8000000,0.25,0.42857142857142855
316125,Ben,Chilwell,2024,631,England,Milton Keynes,England,21-12-96,Left-Back,Defender,Left,180.0,30-06-27,CAA Stellar,https://img.a.transfermarkt.technology/portrait/header/316125-1683899136.jpg?lm=1,GB1,Chelsea Football Club,22000000.0,50000000.0,28,158,165,13,15,15,7,15,11,14,7,11,14,13,11,13,13,12,14,13,14,13,12,14,14,11,12,11,15,14,16,15,14,15,13,14,16,17,13,13,5,10,4,10,4,2,2,3,1,1,1,2,2,2,2,13,17,7,13,12,15,12,15,1,20,10,1,17,1,1,10,1,1,10,1,1,1,77,20,12,176883481,7894,7844,6244,Northern_European,157,17,1,220384.0,Unknown,29128536,50200000.0,1.0,32,955,33,1,0,7,50,8,0.7881714739349035,0.6624598930481282,0.7941176470588234,0.2127979049967797,0.1118421052631578,0.0131578947368421,0.1097774443610902,0.2498124531132783,0.2788688574682629,0.0,0.3953488372093026,0.4166666666666665,274,15,27,26,1,8874,19,165,179,20000000,791666.6666666666,50000000.0,10000000.0,,2500000.0,1,10000000,-0.2857142857142857,-0.3333333333333333
316264,Martin,ÃËDegaard,2024,11,Norway,Drammen,Norway,17-12-98,Attacking Midfield,Midfield,Left,178.0,30-06-28,Nordic Sky,https://img.a.transfermarkt.technology/portrait/header/316264-1678877651.jpg?lm=1,GB1,Arsenal Football Club,110000000.0,110000000.0,26,160,178,14,14,16,12,17,15,9,13,7,10,16,10,8,17,7,18,10,15,12,17,16,15,16,14,16,9,17,14,14,16,15,9,13,13,15,11,11,4,12,7,13,1,1,3,2,1,3,1,1,3,1,2,13,16,6,12,14,18,13,14,1,1,1,1,1,1,13,10,18,13,10,20,14,8,68,20,10,272952661,7996,7996,7746,Northern_European,162,43,2,139190.0,Unknown,53095137,9111392.0,2.0,71,429,73,3,0,7,21,0,0.8082826144482667,0.8231016042780748,0.8308823529411764,0.1343955767004278,0.2828947368421052,0.0263157894736842,0.549887471867967,0.549887471867967,0.0505924720131114,0.1428571428571428,0.3488372093023257,0.3333333333333332,395,69,73,29,0,7158,14,56,90,110000000,3741379.3103448274,110000000.0,5000000.0,1500000.0,20000000.0,6,5000000,0.0,0.2222222222222222
316884,Dominik,Greif,2024,237,Slovakia,Bratislava,Slovakia,06-04-97,Goalkeeper,Goalkeeper,Right,197.0,30-06-26,Stars & Friends,https://img.a.transfermarkt.technology/portrait/header/316884-1581331466.png?lm=1,ES1,Real Club Deportivo Mallorca S.A.D.,2500000.0,2500000.0,27,125,145,3,3,2,2,8,6,1,3,2,3,11,3,3,6,7,14,16,12,10,11,12,15,3,6,1,16,12,10,11,8,12,19,13,10,11,16,11,15,13,11,12,15,12,12,5,13,12,14,14,11,10,9,18,14,6,8,10,12,14,15,20,1,1,1,1,1,1,1,1,1,1,1,1,1,82,12,20,1246710,6100,6100,4250,Northern_European,122,4,0,4790.0,Unknown,63029157,2500000.0,1.0,86,245,86,2,1,7,166,5,0.5574225985710506,0.4491978609625668,0.536764705882353,0.00461661614879,0.0263157894736842,0.0,0.0122530632658164,0.0122530632658164,0.0138614961526709,0.0,0.7906976744186047,0.375,0,0,0,0,0,0,5,10,21,6000000,258695.65217391305,6000000.0,500000.0,50000.0,225000.0,1,1000000,1.4,3.0
316889,Hirving,Lozano,2024,383,Mexico,Mexico City,Mexico,30-07-95,Left Winger,Attack,Right,175.0,30-06-28,Unique Sports Group,https://img.a.transfermarkt.technology/portrait/header/316889-1661508585.jpg?lm=1,NL1,Eindhovense Voetbalvereniging Philips Sport Vereniging,15000000.0,45000000.0,29,148,153,9,13,14,14,15,12,12,12,5,4,14,14,6,15,12,14,9,15,10,13,13,12,16,7,16,6,11,12,16,16,11,9,13,16,13,7,12,10,13,9,14,3,1,1,1,1,1,3,1,3,1,1,10,15,6,12,11,16,12,14,1,1,1,1,1,1,1,10,1,10,18,12,20,16,70,11,20,25772795,7400,7750,6500,Native_American,142,58,15,110961.0,Unknown,51042313,21125000.0,4.0,63,948,64,0,1,5,62,7,0.7757343212490078,0.6898395721925134,0.6838235294117647,0.1071371668982538,0.381578947368421,0.1973684210526315,0.0747686921730432,0.2248062015503876,0.11733659268313,0.4285714285714285,0.2790697674418605,0.4583333333333332,444,124,76,59,7,9625,20,73,81,12000000,354838.70967741933,45000000.0,7000000.0,,3200000.0,3,8000000,-0.2,-0.45454545454545453
316934,Nikola,Moro,2024,1025,Croatia,Split,Croatia,12-03-98,Defensive Midfield,Midfield,Right,184.0,30-06-27,Unknown,https://img.a.transfermarkt.technology/portrait/header/316934-1692964241.jpg?lm=1,IT1,Bologna Football Club 1909,5000000.0,9000000.0,26,126,139,8,12,11,10,12,12,12,12,4,10,14,10,12,13,13,15,12,13,13,13,11,13,9,10,11,12,16,14,12,11,12,12,14,11,14,13,14,11,11,9,12,2,4,1,1,4,2,2,4,1,1,3,12,8,8,9,11,12,10,10,1,1,1,1,1,1,20,1,20,1,1,13,1,1,78,15,20,6578815,6300,6550,5000,Northern_European,125,1,0,36410.0,Bologna FC 1909,24046418,5500000.0,2.0,24,1409,25,3,1,7,40,4,0.6169621593014025,0.5294117647058822,0.5588235294117647,0.0351494341000012,0.006578947368421,0.0,0.0247561890472618,0.0447611902975743,0.0305286257951609,0.1428571428571428,0.4883720930232553,0.3333333333333332,301,25,21,32,0,7533,3,49,181,5000000,226315.7894736842,9000000.0,2000000.0,,2500000.0,2,3000000,0.0,-0.23076923076923078
317740,Florian,Krüger,2024,41274,Germany,StaÃŸfurt,Germany,13-02-99,Centre-Forward,Attack,Right,186.0,Unknown,feel soccer GmbH,https://img.a.transfermarkt.technology/portrait/header/317740-1616364563.jpg?lm=1,BE1,Koninklijke Beerschot Voetbalclub Antwerpen,600000.0,4000000.0,25,120,132,6,7,10,14,13,8,13,10,4,6,12,12,6,11,12,13,13,14,11,11,10,13,13,10,13,7,12,12,13,11,12,13,14,14,11,13,13,5,13,7,9,2,3,2,1,1,2,3,2,4,1,3,10,14,6,10,15,13,14,16,1,1,1,1,1,1,1,14,10,12,18,12,16,20,83,10,20,2757999,5800,5800,4150,Northern_European,115,0,0,3999.0,Unknown,91151083,9111392.0,2.0,38,1422,40,0,1,7,121,3,0.5177295580841492,0.4385026737967914,0.4852941176470588,0.0038528128913767,0.0,0.0,0.0027506876719179,0.0197549387346836,0.0505924720131114,0.1428571428571428,0.5348837209302322,0.2916666666666665,270,101,55,9,0,3004,6,38,204,400000,14285.714285714286,4000000.0,1000000.0,,1000000.0,4,1300000,-0.3333333333333333,-0.5
317806,Cyriel,Dessers,2024,124,Belgium,Tongeren,Nigeria,08-12-94,Centre-Forward,Attack,Right,185.0,31-05-27,Stirr Associates,https://img.a.transfermarkt.technology/portrait/header/317806-1727380662.jpg?lm=1,SC1,Rangers Football Club,4500000.0,6000000.0,30,126,130,6,7,10,14,12,10,13,9,9,6,10,13,6,11,9,13,14,13,12,11,12,12,14,8,13,6,12,14,13,12,13,12,13,14,14,13,10,5,11,5,10,3,3,1,1,2,1,2,1,3,1,2,19,9,5,10,12,14,10,18,1,1,1,1,1,1,1,1,1,1,14,14,12,20,83,15,20,11917257,6500,6250,5000,Mixed_Race,125,3,1,29999.0,Unknown,18083867,3962500.0,4.0,7,1503,70,0,1,4,161,3,0.5772691188145012,0.5294117647058822,0.5588235294117647,0.0289588618076162,0.0197368421052631,0.0131578947368421,0.0222555638909727,0.0297574393598399,0.0219867218533848,0.4285714285714285,0.5116279069767438,0.5,373,151,55,29,0,8161,8,31,96,4000000,134482.75862068965,6000000.0,1000000.0,,900000.0,8,3600000,-0.1111111111111111,0.0
318077,Lucas,Torreira,2024,141,Uruguay,Fray Bentos,Uruguay,11-02-96,Defensive Midfield,Midfield,Right,166.0,30-06-26,Oscar Bentancourt,https://img.a.transfermarkt.technology/portrait/header/318077-1671110829.png?lm=1,TR1,Galatasaray Spor KulÃ¼bÃ¼,15000000.0,55000000.0,28,146,155,11,12,12,8,15,13,6,12,5,13,15,11,15,14,16,15,16,14,14,12,14,14,14,10,13,15,18,17,14,15,15,6,13,13,15,10,14,10,12,7,11,2,3,4,2,2,4,1,2,2,2,2,10,13,4,12,12,15,14,13,1,1,1,1,1,1,20,1,16,1,1,1,1,1,64,9,20,9722829,7350,7500,6700,Native_American,147,39,0,88141.0,Unknown,43201830,9506250.0,4.0,106,508,103,3,1,5,102,4,0.7426567875099233,0.7112299465240641,0.7205882352941175,0.0851017808879237,0.256578947368421,0.0,0.0747686921730432,0.274818704676169,0.0527861885052362,0.4285714285714285,0.0697674418604648,0.4166666666666665,0,0,0,0,0,0,14,25,123,15000000,453030.30303030304,55000000.0,10000000.0,50000.0,4500000.0,6,18750000,0.0,-0.0625
318204,David,Raum,2024,23826,Germany,NÃ¼rnberg,Germany,22-04-98,Left-Back,Defender,Left,180.0,30-06-27,ROOF,https://img.a.transfermarkt.technology/portrait/header/318204-1713945422.jpg?lm=1,L1,RasenBallsport Leipzig,25000000.0,26000000.0,26,143,150,15,16,12,11,11,13,7,11,15,11,13,9,11,11,15,13,13,12,13,13,14,16,13,10,15,11,16,17,15,13,12,9,17,15,16,12,13,10,15,4,12,1,1,4,2,1,2,2,3,1,4,1,6,14,10,13,14,14,8,10,1,20,1,10,19,10,1,17,1,10,13,1,10,1,75,20,8,51689341,7150,7150,6000,Northern_European,135,9,0,71917.0,Unknown,91175517,9111392.0,2.0,38,1067,40,1,0,7,162,8,0.696348240275205,0.6363636363636364,0.6323529411764706,0.0694356063641902,0.0592105263157894,0.0,0.1247811952988247,0.1297824456114028,0.0505924720131114,0.1428571428571428,0.3953488372093026,0.3333333333333332,332,41,74,56,1,5360,6,17,66,25000000,1036458.3333333334,26000000.0,6000000.0,125000.0,600000.0,2,9500000,0.25,0.47058823529411764
318470,Matvey,Safonov,2024,583,Russia,Krasnodar,Russia,25-02-99,Goalkeeper,Goalkeeper,Right,192.0,30-06-29,Unknown,https://img.a.transfermarkt.technology/portrait/header/318470-1666979915.png?lm=1,FR1,Paris Saint-Germain Football Club,20000000.0,20000000.0,25,130,150,5,3,2,1,10,7,2,2,1,2,10,5,3,9,10,13,13,15,13,12,14,11,8,13,1,13,10,10,11,13,12,16,12,12,10,15,15,12,14,5,16,14,12,11,10,7,13,13,17,13,11,15,12,13,8,9,11,12,12,13,20,1,1,1,1,1,1,1,1,1,1,1,1,1,87,11,20,6986690,6250,6250,4500,Northern_European,129,7,0,9588.0,Unknown,58123738,20000000.0,1.0,78,757,81,2,1,7,154,5,0.5772691188145012,0.4759358288770053,0.588235294117647,0.0092496477911022,0.0460526315789473,0.0,0.0997749437359339,0.0997749437359339,0.1110864190671963,0.0,0.6744186046511627,0.2916666666666665,0,0,0,0,0,0,6,19,100,22000000,990909.0909090909,22000000.0,1000000.0,300000.0,10000000.0,3,3700000,0.1,0.2222222222222222
318508,Olivier,Boscagli,2024,383,Monaco,Monaco,France,18-11-97,Centre-Back,Defender,Left,181.0,30-06-25,Unknown,https://img.a.transfermarkt.technology/portrait/header/318508-1701700523.jpg?lm=1,NL1,Eindhovense Voetbalvereniging Philips Sport Vereniging,27000000.0,27000000.0,27,133,142,10,13,10,8,14,14,12,8,5,12,13,6,13,13,10,12,13,13,14,13,12,14,9,11,13,13,14,15,13,12,15,12,13,13,15,11,15,12,8,8,10,3,3,2,3,2,1,2,1,3,1,1,15,15,6,14,12,16,14,13,1,20,19,12,17,1,17,10,10,1,1,1,1,1,68,20,8,8520187,6500,6050,5000,Northern_European,127,0,0,10000.0,Unknown,48031641,2000000.0,1.0,65,968,36,1,0,7,62,2,0.5508070918232336,0.5294117647058822,0.5735294117647058,0.009647482104698,0.0,0.0,0.134783695923981,0.134783695923981,0.0110836412122558,0.0,0.418604651162791,0.375,278,12,15,26,2,10353,6,54,303,27000000,1152173.9130434783,27000000.0,1000000.0,1000000.0,3000000.0,3,2200000,0.0,0.35
318523,Romain,Perraud,2024,150,France,Toulouse,France,22-09-97,Left-Back,Defender,Left,173.0,30-06-29,Unique Sports Group,https://img.a.transfermarkt.technology/portrait/header/318523-1582538263.jpg?lm=1,ES1,Real Betis BalompiÃ© S.A.D.,5000000.0,12000000.0,27,130,145,10,14,12,8,12,13,8,16,8,10,12,10,12,14,14,13,14,13,13,13,13,15,12,8,15,13,14,15,13,14,15,7,15,13,15,10,14,8,13,6,13,2,3,3,1,1,4,1,1,3,3,2,12,14,7,14,13,14,11,13,1,20,1,1,17,1,1,13,1,1,13,1,1,1,68,20,8,12762841,6490,6490,4990,Northern_European,127,0,0,46397.0,Unknown,48036809,9111392.0,2.0,34,1512,36,1,0,7,164,8,0.6090235512040222,0.5283422459893048,0.5735294117647058,0.0447930537356352,0.0,0.0,0.0247561890472618,0.0597649412353088,0.0505924720131114,0.1428571428571428,0.2325581395348837,0.375,268,23,13,34,1,3278,0,0,0,5000000,230952.38095238095,12000000.0,3000000.0,,150000.0,5,6650000,0.0,-0.4444444444444444
318528,Marcus,Thuram,2024,46,Italy,Parma,France,06-08-97,Centre-Forward,Attack,Right,192.0,30-06-28,Sport Cover,https://img.a.transfermarkt.technology/portrait/header/318528-1662966601.jpg?lm=1,IT1,Football Club Internazionale Milano S.p.A.,65000000.0,65000000.0,27,142,152,3,9,16,12,14,6,14,9,4,6,12,13,7,16,13,12,13,12,10,13,12,11,15,4,14,7,10,9,15,14,16,15,13,17,12,16,13,12,14,11,11,3,3,1,1,1,3,1,2,3,2,3,13,15,14,10,11,11,9,8,1,1,1,1,1,1,1,10,1,10,19,10,12,20,90,13,20,11734285,7100,6900,6100,African_Caribbean,140,4,0,95889.0,Unknown,48037335,4800000.0,2.0,52,1125,36,0,1,1,89,3,0.6632707065361206,0.6470588235294117,0.6691176470588234,0.092583383464963,0.0263157894736842,0.0,0.3248312078019504,0.3248312078019504,0.0266396288785799,0.1428571428571428,0.6744186046511627,0.375,338,92,53,28,3,6940,15,32,88,75000000,2409677.419354839,75000000.0,8000000.0,300000.0,2000000.0,3,12400000,0.15384615384615385,0.36363636363636365
319160,Jakub,Jankto,2024,1390,Czech Republic,Praha,Czech Republic,19-01-96,Left Midfield,Midfield,Left,184.0,30-06-25,GR Sports,https://img.a.transfermarkt.technology/portrait/header/319160-1692962488.jpg?lm=1,IT1,Cagliari Calcio,1200000.0,15000000.0,28,134,145,12,15,12,14,12,10,10,14,12,10,12,10,12,13,13,12,13,14,12,13,12,15,14,15,14,13,14,12,14,14,13,10,12,14,13,10,14,12,11,5,16,1,1,2,2,2,1,2,1,2,4,2,14,13,8,13,12,14,13,12,1,1,1,1,1,1,1,20,15,16,16,14,16,1,74,20,9,8824547,6949,6949,5951,Northern_European,133,45,4,28461.0,Sparta Prague,43207792,5305000.0,4.0,26,1180,28,3,0,7,46,6,0.6697539031489812,0.6311229946524064,0.6176470588235294,0.027473742452494,0.2960526315789473,0.0526315789473684,0.0057514378594648,0.0747686921730432,0.0294452623683991,0.4285714285714285,0.4883720930232553,0.4166666666666665,279,31,32,46,2,4420,16,105,81,1000000,36000.0,15000000.0,3000000.0,100000.0,1500000.0,6,4850000,-0.16666666666666666,-0.16666666666666666
319745,Dani,Ceballos,2024,418,Spain,Utrera,Spain,07-08-96,Central Midfield,Midfield,Right,179.0,30-06-27,Unknown,https://img.a.transfermarkt.technology/portrait/header/319745-1723666162.jpg?lm=1,ES1,Real Madrid Club de FÃºtbol,6000000.0,45000000.0,28,140,163,10,11,16,12,16,11,7,13,12,8,16,10,12,16,13,13,15,12,12,14,12,11,13,10,14,12,14,13,14,15,13,8,11,13,13,9,10,11,11,11,15,3,3,2,1,1,1,3,3,4,3,3,12,12,13,10,11,13,10,8,1,1,1,1,1,1,1,1,20,1,12,14,12,1,71,11,20,4882684,7000,7000,6500,Mediterranean_Hispanic,139,11,1,149999.0,Unknown,67202350,16500000.0,1.0,89,1552,89,3,1,3,167,1,0.6765017200317545,0.6898395721925134,0.6617647058823528,0.1448329337287214,0.0723684210526315,0.0131578947368421,0.0297574393598399,0.2248062015503876,0.0916414344842912,0.0,0.3720930232558141,0.4166666666666665,361,16,30,52,0,6632,12,77,150,4000000,62500.0,45000000.0,8000000.0,2500000.0,10000000.0,3,29000000,-0.3333333333333333,-0.5555555555555556
319859,Mathias,Jensen,2024,1148,Denmark,"Jerslev, West Zealand",Denmark,01-01-96,Central Midfield,Midfield,Right,180.0,30-06-26,CAA Stellar,https://img.a.transfermarkt.technology/portrait/header/319859-1684771732.jpg?lm=1,GB1,Brentford Football Club,28000000.0,30000000.0,28,133,145,13,13,13,10,14,12,9,11,5,9,14,10,12,14,9,13,11,13,13,16,14,12,14,12,13,11,13,14,11,12,12,10,13,11,13,11,12,8,12,12,13,3,4,2,2,2,3,2,3,2,3,1,15,15,4,14,13,13,13,14,1,1,1,1,1,1,13,10,20,12,1,14,1,1,71,15,20,15258581,6650,6650,5500,Northern_European,132,19,1,40597.0,Unknown,27088231,4400000.0,2.0,28,689,30,3,1,7,43,1,0.6301931727970362,0.5828877005347594,0.6102941176470589,0.0391924735927818,0.125,0.0131578947368421,0.1397849462365591,0.1497874468617154,0.0244173449262479,0.1428571428571428,0.3953488372093026,0.4166666666666665,300,28,44,29,0,5777,5,48,106,25000000,924074.074074074,30000000.0,3000000.0,,150000.0,2,4500000,-0.10714285714285714,-0.16666666666666666
320141,ÃÂ¡A?Lar,Söyüncü,2024,36,TÃ¼rkiye,Izmir,TÃ¼rkiye,23-05-96,Centre-Back,Defender,Right,185.0,30-06-27,Wasserman,https://img.a.transfermarkt.technology/portrait/header/320141-1728391611.JPG?lm=1,TR1,FenerbahÃ§e Spor KulÃ¼bÃ¼,9000000.0,45000000.0,28,139,162,4,7,12,7,12,5,14,8,8,15,10,8,16,10,12,14,17,12,11,13,10,16,9,12,7,14,13,15,14,12,15,16,13,12,13,16,10,13,15,9,7,2,1,3,1,1,1,3,2,1,3,2,12,15,5,9,14,12,11,7,1,1,20,1,1,1,10,1,10,1,1,1,1,1,82,14,20,30193113,7240,7490,5740,Northern_European,139,48,2,52196.0,Unknown,70093800,12510000.0,3.0,100,682,100,1,1,7,84,2,0.7413336861603599,0.6085561497326203,0.6617647058823528,0.0503926682612226,0.3157894736842105,0.0263157894736842,0.0447611902975743,0.2248062015503876,0.0694741520597794,0.2857142857142857,0.5116279069767438,0.4166666666666665,284,11,3,52,3,7379,19,105,93,8500000,272580.6451612903,45000000.0,12000000.0,250000.0,6000000.0,4,4250000,-0.15,-0.2916666666666667
320265,Mikkel,Duelund,2024,678,Denmark,Aarhus,Denmark,29-06-97,Attacking Midfield,Midfield,Right,178.0,30-06-25,Forza Sports Group,https://img.a.transfermarkt.technology/portrait/header/320265-1612461571.png?lm=1,DK1,Aarhus Gymnastik Forening,450000.0,4000000.0,27,125,132,13,12,13,11,14,13,10,12,7,7,14,13,7,15,7,13,10,11,10,14,9,13,14,8,13,8,8,8,14,12,12,9,13,12,12,9,8,13,12,14,12,1,1,2,1,2,2,2,2,3,1,4,9,17,13,12,11,8,8,9,1,1,1,1,1,1,1,15,18,14,18,20,15,10,70,16,20,2719777,6000,5583,4030,Northern_European,121,0,0,5619.0,N.E.C. Nijmegen,27100970,4000000.0,1.0,28,12,30,3,1,7,11,0,0.489018258798624,0.4256684491978609,0.5294117647058822,0.0054171128623116,0.0,0.0,0.0020005001250312,0.0197549387346836,0.0221950609739159,0.0,0.3488372093023257,0.375,0,0,0,0,0,0,10,56,98,400000,13043.478260869566,4000000.0,1000000.0,500000.0,1500000.0,3,2800000,-0.1111111111111111,-0.2727272727272727
320271,Toni,Lato,2024,237,Spain,La Pobla de Vallbona,Spain,21-11-97,Left-Back,Defender,Left,171.0,30-06-27,Unknown,https://img.a.transfermarkt.technology/portrait/header/320271-1496906352.jpg?lm=1,ES1,Real Club Deportivo Mallorca S.A.D.,3500000.0,8000000.0,27,126,148,7,12,13,10,12,7,8,6,10,12,13,10,13,12,12,12,12,10,12,12,12,12,12,8,12,12,13,15,15,14,12,7,14,14,14,9,12,8,7,7,10,2,1,3,3,1,3,3,3,3,2,2,10,10,5,16,10,12,14,10,1,20,1,1,18,1,1,1,1,1,1,1,1,1,69,20,8,2222776,6300,6300,4250,Mediterranean_Hispanic,118,0,0,8119.0,Unknown,67203459,9111392.0,2.0,89,785,89,1,0,3,166,8,0.5838846255623181,0.4491978609625668,0.5073529411764706,0.0078311560273346,0.0,0.0,0.0172543135783946,0.0397599399849962,0.0505924720131114,0.1428571428571428,0.1860465116279068,0.375,207,5,9,32,1,9073,7,22,43,2800000,113043.47826086957,8000000.0,3000000.0,250000.0,6000000.0,5,8500000,-0.2,0.12
320411,Philip,Billing,2024,989,Denmark,Copenhagen,Denmark,11-06-96,Central Midfield,Midfield,Left,193.0,30-06-27,ROOF,https://img.a.transfermarkt.technology/portrait/header/320411-1674468252.jpg?lm=1,GB1,Association Football Club Bournemouth,18000000.0,22000000.0,28,130,136,6,10,12,12,13,7,8,12,17,10,14,12,11,13,13,12,13,13,11,11,13,13,10,8,12,11,12,14,12,14,13,15,16,13,15,15,12,6,12,8,13,1,3,1,2,3,3,1,3,3,2,1,11,13,12,8,11,10,9,12,1,1,12,1,1,1,17,10,20,10,1,19,1,1,88,20,10,13037498,6495,6495,5595,Mixed_Race,127,3,0,52196.0,Unknown,29121437,16500000.0,1.0,28,382,30,3,0,4,22,1,0.6096851018788039,0.593048128342246,0.5735294117647058,0.0503926682612226,0.0197368421052631,0.0,0.0897724431107777,0.1097774443610902,0.0916414344842912,0.0,0.6976744186046511,0.4166666666666665,292,37,22,56,2,3810,7,31,92,14000000,556000.0,22000000.0,4500000.0,,350000.0,1,8000000,-0.36363636363636365,-0.36363636363636365
320701,Ercan,Kara,2024,152,Austria,Wien,Austria,03-01-96,Centre-Forward,Attack,Right,192.0,30-06-26,SBE Management AG,https://img.a.transfermarkt.technology/portrait/header/320701-1727719712.png?lm=1,TR1,Samsunspor,1500000.0,3500000.0,28,128,130,6,6,9,14,11,5,17,8,5,8,9,17,6,11,14,11,12,14,16,11,10,16,13,11,17,9,14,15,14,11,13,16,12,12,13,15,15,7,13,6,5,1,3,2,3,2,2,3,1,1,2,3,20,16,6,11,14,14,15,16,1,1,1,1,1,1,1,1,1,1,1,1,1,20,88,9,20,5962160,6486,6451,5364,North_African__Middle_Eastern,126,7,0,36064.0,Unknown,210541,346666.6667,3.0,6,1663,7,0,1,6,180,3,0.6038634559407251,0.5683422459893047,0.5661764705882353,0.034815330525962,0.0460526315789473,0.0,0.0072518129532383,0.0172543135783946,0.0018982008761354,0.2857142857142857,0.6744186046511627,0.4166666666666665,282,130,37,16,1,6823,5,17,35,1200000,60294.117647058825,3500000.0,500000.0,,,3,550000,-0.3333333333333333,-0.45454545454545453
320748,Sebastian,Szyma?Ski,2024,36,Poland,Bia?a Podlaska,Poland,10-05-99,Attacking Midfield,Midfield,Left,174.0,30-06-27,UNIDOS,https://img.a.transfermarkt.technology/portrait/header/320748-1728392667.JPG?lm=1,TR1,FenerbahÃ§e Spor KulÃ¼bÃ¼,19000000.0,20000000.0,25,136,146,15,12,13,9,12,13,6,14,6,11,11,12,10,14,13,15,14,13,11,11,13,17,14,13,15,11,16,16,14,14,10,6,11,14,16,8,12,6,14,2,18,3,2,4,3,2,2,1,3,3,1,3,13,15,4,15,13,16,11,14,1,1,1,1,1,1,11,14,18,14,17,20,17,1,60,20,9,12614352,6750,6200,5250,Northern_European,130,15,1,44840.0,Feyenoord Rotterdam,96088503,7625000.0,2.0,75,184,78,3,0,7,84,0,0.5706536120666843,0.5561497326203209,0.5955882352941175,0.0432895876524589,0.0986842105263157,0.0131578947368421,0.0947736934233558,0.0997749437359339,0.0423345092919247,0.1428571428571428,0.2558139534883721,0.2916666666666665,341,53,76,43,0,7761,5,15,37,17000000,765909.0909090909,20000000.0,2000000.0,550000.0,5400000.0,3,0,-0.10526315789473684,-0.15
321158,Simon,Olsson,2024,306,Sweden,LinkÃ¶ping,Sweden,14-09-97,Central Midfield,Midfield,Right,185.0,30-06-26,BHM Sports Agency,https://img.a.transfermarkt.technology/portrait/header/321158-1723713762.jpg?lm=1,NL1,Sportclub Heerenveen,3000000.0,3000000.0,27,124,139,12,13,13,9,14,11,9,11,7,11,14,9,11,14,13,13,13,13,13,14,13,13,12,9,11,13,12,12,10,10,15,11,11,12,12,13,14,12,12,7,9,1,1,1,1,2,3,2,1,2,2,3,12,12,5,13,13,12,14,15,1,1,1,1,1,1,17,1,20,1,1,17,1,1,81,13,20,4062957,6200,5900,2500,Northern_European,124,0,0,4999.0,Unknown,93060544,1300000.0,1.0,91,839,91,3,1,7,190,1,0.530960571579783,0.2620320855614972,0.5514705882352942,0.0048184301573859,0.0,0.0,0.0147536884221055,0.0147536884221055,0.0071946442956748,0.0,0.5116279069767438,0.375,325,19,25,37,0,6841,4,33,97,2000000,100000.0,3000000.0,1000000.0,,500000.0,1,0,-0.3333333333333333,0.0
321204,Michal,Sadílek,2024,317,Czech Republic,UherskÃ© HradiÅ¡t?,Czech Republic,31-05-99,Central Midfield,Midfield,Left,169.0,30-06-25,Nehoda Sport,https://img.a.transfermarkt.technology/portrait/header/321204-1658219516.jpg?lm=1,NL1,Football Club Twente,8000000.0,8000000.0,25,126,144,8,9,11,7,13,8,7,9,6,11,14,11,10,13,15,12,15,11,13,12,13,13,10,12,13,11,15,16,12,12,14,7,14,13,15,9,13,10,12,6,11,2,2,2,2,2,1,1,3,1,2,1,14,13,5,13,9,10,11,16,1,17,1,1,17,1,19,16,20,1,12,12,1,1,61,20,10,6876478,6348,6198,4998,Northern_European,118,14,0,3999.0,Unknown,37062676,1500000.0,1.0,26,1546,28,3,0,7,91,1,0.5703889917967716,0.5291978609625668,0.5073529411764706,0.0038528128913767,0.0921052631578947,0.0,0.0397599399849962,0.0397599399849962,0.0083057862718408,0.0,0.13953488372093,0.2916666666666665,260,17,25,50,1,8478,10,60,147,7000000,332142.85714285716,8000000.0,1000000.0,100000.0,3200000.0,2,900000,-0.125,0.16666666666666666
321247,Emiliano,Buendía,2024,405,Argentina,Mar del Plata,Argentina,25-12-96,Attacking Midfield,Midfield,Right,172.0,30-06-26,Universal Twenty Two,https://img.a.transfermarkt.technology/portrait/header/321247-1696604099.jpg?lm=1,GB1,Aston Villa Football Club,20000000.0,35000000.0,28,142,160,14,15,16,11,15,13,5,11,4,4,15,9,7,16,15,14,12,16,11,16,11,16,18,5,15,8,12,14,14,16,15,8,14,14,13,10,12,14,14,6,14,2,2,1,2,2,1,2,3,3,1,1,15,16,12,14,13,13,5,3,1,1,1,1,1,1,1,1,1,18,10,20,20,1,65,10,20,40829091,7100,7100,6000,Mediterranean_Hispanic,138,1,0,92793.0,Unknown,67201783,19950000.0,2.0,4,908,4,3,1,3,30,0,0.6897327335273882,0.6363636363636364,0.6544117647058822,0.0895938324093985,0.006578947368421,0.0,0.0997749437359339,0.1747936984246061,0.1108086335731548,0.1428571428571428,0.2093023255813952,0.4166666666666665,0,0,0,0,0,0,5,86,328,18000000,765217.3913043478,35000000.0,6000000.0,400000.0,500000.0,3,7500000,-0.18181818181818182,-0.18181818181818182
321528,Denzel,Dumfries,2024,46,Netherlands,Rotterdam,Netherlands,18-04-96,Right-Back,Defender,Right,188.0,30-06-25,Wasserman,https://img.a.transfermarkt.technology/portrait/header/321528-1725532091.jpg?lm=1,IT1,Football Club Internazionale Milano S.p.A.,24000000.0,30000000.0,28,153,159,11,13,13,12,12,5,16,11,11,10,13,11,14,12,14,13,13,12,11,11,12,16,11,9,17,11,12,14,17,14,14,15,15,18,15,15,13,12,11,5,13,1,1,3,2,1,2,2,3,2,1,4,14,15,7,13,13,17,12,12,1,10,12,20,10,20,8,1,1,18,1,1,9,1,80,9,20,68371876,7650,7100,6600,African_Caribbean,143,34,5,61731.0,Unknown,37052843,6833333.333,3.0,67,1253,68,1,1,1,89,11,0.6897327335273882,0.7005347593582887,0.6911764705882353,0.0595998288926204,0.2236842105263157,0.0657894736842105,0.1197799449862465,0.1497874468617154,0.037936238967749,0.2857142857142857,0.581395348837209,0.4166666666666665,415,41,54,67,1,8847,6,13,27,20000000,665833.3333333334,30000000.0,4000000.0,50000.0,800000.0,4,2500000,-0.16666666666666666,-0.3333333333333333
322293,Felix,Beijmo,2024,678,Sweden,Stockholm,Sweden,31-01-98,Right-Back,Defender,Right,185.0,30-06-26,Unknown,https://img.a.transfermarkt.technology/portrait/header/322293-1565343443.jpg?lm=1,DK1,Aarhus Gymnastik Forening,1500000.0,3000000.0,26,120,130,10,12,10,8,11,8,10,9,13,13,12,9,12,12,13,11,12,12,14,12,12,13,10,11,12,11,14,14,13,11,13,11,15,15,14,13,14,10,12,8,10,3,1,2,2,1,1,3,2,4,2,3,11,12,4,9,11,15,14,14,1,14,14,20,8,19,1,1,1,14,1,1,8,1,82,5,20,822116,5961,5861,3330,Northern_European,117,0,0,3727.0,Unknown,93059028,1634500.0,2.0,91,1426,91,1,1,7,11,11,0.5258004763164859,0.3508021390374331,0.4999999999999999,0.0035901649950222,0.0,0.0,0.0072518129532383,0.0147536884221055,0.0090530292508125,0.1428571428571428,0.5116279069767438,0.3333333333333332,270,22,25,31,0,10492,1,16,121,1700000,82500.0,3000000.0,1000000.0,0.0,2000000.0,6,3050000,0.13333333333333333,0.13333333333333333
322655,Flavius,Daniliuc,2024,276,Austria,Wien,Austria,27-04-01,Centre-Back,Defender,Right,188.0,30-06-25,Sports360 GmbH,https://img.a.transfermarkt.technology/portrait/header/322655-1727704012.jpg?lm=1,IT1,Verona Hellas Football Club,6000000.0,8000000.0,23,126,157,6,7,12,6,12,5,13,7,11,13,14,7,15,12,14,13,13,10,10,12,13,15,11,6,8,13,15,13,13,11,13,13,16,13,13,15,14,8,14,7,16,1,3,3,3,3,3,2,2,4,2,1,11,13,5,13,12,15,13,13,1,13,20,17,10,12,10,1,1,1,1,1,1,1,83,13,20,9339999,6300,5900,3250,Mediterranean_Hispanic,126,0,0,12466.0,Unknown,91172522,5800000.0,1.0,6,1663,7,1,1,3,214,2,0.530960571579783,0.3422459893048128,0.5661764705882353,0.0120286942826767,0.0,0.0,0.0297574393598399,0.0397599399849962,0.0321953387594099,0.0,0.581395348837209,0.2083333333333332,203,5,10,28,0,6382,12,60,60,4000000,269230.76923076925,8000000.0,1000000.0,,7000000.0,3,2000000,-0.3333333333333333,-0.42857142857142855
323167,Matteo,Gabbia,2024,5,Italy,Busto Arsizio,Italy,21-10-99,Centre-Back,Defender,Right,185.0,30-06-26,TMP SOCCER srl ,https://img.a.transfermarkt.technology/portrait/header/323167-1661351918.jpg?lm=1,IT1,Associazione Calcio Milan,8000000.0,9000000.0,25,130,159,3,7,7,6,11,7,13,8,12,14,13,8,14,12,12,13,12,13,14,11,13,14,6,11,9,13,14,16,13,12,15,14,14,12,14,14,14,12,10,8,12,1,3,3,1,3,2,2,1,2,1,4,12,14,3,14,13,14,16,13,1,1,20,1,1,1,11,1,10,1,1,1,1,1,78,9,20,13690000,6500,6250,4750,Mediterranean_Hispanic,130,0,0,28461.0,Unknown,43266774,9111392.0,2.0,52,285,54,1,1,3,27,2,0.5772691188145012,0.5026737967914437,0.5955882352941175,0.027473742452494,0.0,0.0,0.0397599399849962,0.0447611902975743,0.0505924720131114,0.1428571428571428,0.5116279069767438,0.2916666666666665,208,11,4,46,0,6017,8,28,52,20000000,948809.5238095238,20000000.0,2000000.0,500000.0,4500000.0,5,3300000,1.5,4.0
323910,Unknown,Mauro Júnior,2024,383,Brazil,SÃ£o Paulo,Brazil,06-05-99,Left-Back,Defender,Left,171.0,30-06-25,TFA,https://img.a.transfermarkt.technology/portrait/header/323910-1613232287.jpg?lm=1,NL1,Eindhovense Voetbalvereniging Philips Sport Vereniging,7000000.0,7000000.0,25,133,145,5,10,14,9,14,9,7,13,12,8,13,5,9,16,7,12,9,12,11,14,14,12,14,7,15,11,16,14,12,13,14,8,14,13,12,7,14,6,12,4,18,2,1,1,1,2,2,3,1,1,2,1,19,11,6,11,13,10,7,15,1,15,1,12,18,16,10,18,12,13,20,18,13,8,62,20,10,10934998,6600,5597,5088,Mediterranean_Hispanic,121,0,0,6942.0,Unknown,19250980,9111392.0,2.0,10,1456,11,1,0,3,62,8,0.4908706006880127,0.5388235294117647,0.5294117647058822,0.0066946245052418,0.0,0.0,0.0347586896724181,0.0347586896724181,0.0505924720131114,0.1428571428571428,0.1860465116279068,0.2916666666666665,212,21,31,14,2,4951,8,79,265,7000000,300000.0,7000000.0,1500000.0,2000000.0,2300000.0,2,1200000,0.0,0.4
324278,Christoph,Baumgartner,2024,23826,Austria,Horn,Austria,01-08-99,Attacking Midfield,Midfield,Right,180.0,30-06-28,YOU FIRST,https://img.a.transfermarkt.technology/portrait/header/324278-1716315718.jpg?lm=1,L1,RasenBallsport Leipzig,18000000.0,24000000.0,25,134,148,13,9,13,13,14,12,11,13,5,9,13,13,9,15,16,14,13,14,12,15,12,17,12,8,16,10,14,16,13,13,13,10,14,13,13,9,14,12,14,7,11,1,2,2,1,2,3,1,2,3,3,1,13,15,7,10,12,15,12,14,1,1,1,1,1,1,12,12,18,12,16,20,14,13,71,10,20,20987999,6749,6018,5409,Northern_European,134,21,6,28766.0,Unknown,16184707,25500000.0,1.0,6,634,7,3,1,7,162,0,0.5465731675046309,0.5731550802139037,0.625,0.0277682557186268,0.1381578947368421,0.0789473684210526,0.0897724431107777,0.1197799449862465,0.1416428234117614,0.0,0.3953488372093026,0.2916666666666665,299,93,43,52,0,3876,7,29,65,18000000,882500.0,24000000.0,4000000.0,350000.0,12000000.0,2,0,0.0,-0.25
324344,Dimitrios,Limnios,2024,265,Greece,Volos,Greece,27-05-98,Right Winger,Attack,Right,178.0,30-06-27,LIAN Sports Group,https://img.a.transfermarkt.technology/portrait/header/324344-1671722498.jpg?lm=1,GR1,Panathinaikos Athlitikos Omilos,900000.0,4500000.0,26,120,130,10,12,12,10,12,11,9,9,8,9,10,11,8,12,11,11,10,11,10,12,11,13,12,7,13,9,12,14,15,14,9,11,15,15,14,10,12,6,13,4,11,3,3,2,2,2,3,3,4,3,3,2,9,15,8,12,13,13,12,13,1,1,1,1,1,12,1,16,1,16,16,7,20,6,71,7,20,685175,5750,6250,4250,Mediterranean_Hispanic,118,23,3,10000.0,Unknown,36096206,2250000.0,2.0,40,1628,42,0,1,3,150,10,0.5772691188145012,0.4491978609625668,0.5073529411764706,0.009647482104698,0.1513157894736842,0.0394736842105263,0.0042510627656914,0.0222555638909727,0.0124725686824634,0.1428571428571428,0.3488372093023257,0.3333333333333332,275,33,21,20,0,6958,1,31,239,800000,31250.0,4500000.0,1500000.0,800000.0,3500000.0,5,600000,-0.1111111111111111,-0.1111111111111111
324358,Ollie,Watkins,2024,405,England,Torquay,England,30-12-95,Centre-Forward,Attack,Right,180.0,30-06-28,Two Touch Agency,https://img.a.transfermarkt.technology/portrait/header/324358-1708341279.jpg?lm=1,GB1,Aston Villa Football Club,65000000.0,65000000.0,28,141,150,8,11,13,15,12,7,13,11,5,6,13,11,7,12,10,13,15,10,12,12,9,15,13,9,14,5,16,19,15,15,11,12,17,14,17,14,14,4,13,5,12,1,4,3,3,4,2,2,3,2,1,2,13,13,6,10,12,16,11,13,1,1,1,1,1,1,1,1,1,1,18,12,17,20,70,11,20,40597107,7250,7250,6000,African_Caribbean,134,7,2,52196.0,Unknown,29110623,20610000.0,2.0,32,1506,33,0,1,1,30,3,0.7095792537708389,0.6363636363636364,0.625,0.0503926682612226,0.0460526315789473,0.0263157894736842,0.3248312078019504,0.3248312078019504,0.1144754020945026,0.1428571428571428,0.3953488372093026,0.4166666666666665,424,157,67,45,0,3637,2,1,13,55000000,2611904.761904762,65000000.0,10000000.0,,150000.0,2,18850000,-0.15384615384615385,-0.08333333333333333
324377,Youssef,Maleh,2024,749,Italy,Castel San Pietro Terme,Morocco,22-08-98,Central Midfield,Midfield,Left,179.0,30-06-25,Unknown,https://img.a.transfermarkt.technology/portrait/header/324377-1663592087.jpg?lm=1,IT1,Empoli Football Club S.r.l.,4500000.0,5000000.0,26,134,148,10,11,12,11,13,8,7,11,8,10,14,11,10,13,12,14,13,13,13,13,13,16,14,10,14,13,15,14,14,14,14,8,12,13,14,13,14,11,12,6,14,3,2,2,3,3,3,3,3,1,2,3,16,16,8,11,14,15,13,12,1,1,1,1,12,1,16,15,20,1,14,16,13,1,70,20,9,7400223,6700,6150,5000,North_African__Middle_Eastern,130,0,0,25000.0,Unknown,43193946,2900000.0,2.0,52,327,67,3,0,6,64,1,0.5640381053188674,0.5294117647058822,0.5955882352941175,0.0241317410948361,0.0,0.0,0.0222555638909727,0.0247561890472618,0.0160837801050029,0.1428571428571428,0.3720930232558141,0.3333333333333332,263,19,18,66,1,3376,8,32,84,4000000,196250.0,5000000.0,500000.0,100000.0,150000.0,6,575000,-0.1111111111111111,-0.1111111111111111
324503,Vangelis,Pavlidis,2024,294,Greece,Thessaloniki,Greece,21-11-98,Centre-Forward,Attack,Right,186.0,30-06-29,Sports360 GmbH,https://img.a.transfermarkt.technology/portrait/header/324503-1725535858.jpg?lm=1,PO1,Sport Lisboa e Benfica,25000000.0,25000000.0,26,129,140,7,8,12,15,13,8,13,11,3,6,12,12,7,13,11,14,13,13,13,12,13,14,12,10,13,5,14,15,11,13,14,13,11,12,13,13,14,7,12,7,11,4,3,1,1,2,2,2,2,4,2,3,11,12,10,11,10,13,11,11,1,1,1,1,1,1,1,12,10,10,17,14,12,20,82,13,20,6155823,5949,5999,4999,Mediterranean_Hispanic,127,27,6,3836.0,Unknown,91151156,6916666.667,3.0,40,1486,42,0,1,3,188,3,0.5440592749404605,0.5293048128342246,0.5735294117647058,0.0036954172770172,0.1776315789473684,0.0789473684210526,0.1247811952988247,0.1247811952988247,0.0383992147948554,0.2857142857142857,0.5348837209302322,0.3333333333333332,345,161,71,36,1,7889,3,26,61,23000000,844444.4444444445,25000000.0,3000000.0,200000.0,1750000.0,4,2550000,-0.08,-0.08
324690,Jonathan,Ikoné,2024,430,France,Bondy,France,02-05-98,Right Winger,Attack,Left,175.0,30-06-26,Unknown,https://img.a.transfermarkt.technology/portrait/header/324690-1697179025.jpg?lm=1,IT1,Associazione Calcio Fiorentina,10000000.0,40000000.0,26,137,148,7,11,16,12,14,13,7,12,5,6,12,12,5,14,8,11,6,11,10,12,11,11,16,9,14,7,11,12,16,15,12,9,14,16,12,9,11,6,14,6,11,3,1,3,3,2,1,3,2,3,2,2,13,15,7,11,12,14,13,13,1,1,1,1,1,1,1,1,1,14,16,17,20,16,67,20,9,20245622,6847,7047,5497,African_Caribbean,127,4,1,41923.0,Unknown,85145148,9111392.0,2.0,34,223,36,0,0,1,26,10,0.6827202963747023,0.582566844919786,0.5735294117647058,0.04047288208751,0.0263157894736842,0.0131578947368421,0.0497624406101525,0.1997999499874969,0.0505924720131114,0.1428571428571428,0.2790697674418605,0.3333333333333332,367,42,43,33,0,9357,5,15,50,8000000,322916.6666666667,40000000.0,8000000.0,250000.0,9000000.0,3,8750000,-0.2,-0.38461538461538464
324795,Mahdi,Camara,2024,3911,France,Martigues,France,30-06-98,Central Midfield,Midfield,Right,178.0,30-06-26,TTMA,https://img.a.transfermarkt.technology/portrait/header/324795-1710182811.jpg?lm=1,FR1,Stade brestois 29,10000000.0,10000000.0,26,120,135,8,9,10,11,13,8,5,10,4,10,13,9,8,13,12,13,12,13,12,12,13,13,5,12,13,10,13,14,14,14,14,10,13,14,15,13,12,8,8,10,13,2,1,3,2,1,2,2,1,4,4,2,12,11,2,12,10,13,11,12,1,1,1,1,1,1,15,1,20,1,1,1,1,1,69,8,20,3779825,6199,6199,3799,African_Caribbean,121,0,0,2300.0,Stade Brestois 29,85145396,3000000.0,1.0,34,921,36,3,1,1,196,1,0.570521301931728,0.4009625668449197,0.5294117647058822,0.0022122291564271,0.0,0.0,0.0497624406101525,0.0497624406101525,0.0166393510930859,0.0,0.3488372093023257,0.3333333333333332,231,25,16,42,0,4333,0,0,0,10000000,492500.0,10000000.0,2000000.0,,300000.0,3,3050000,0.0,0.6666666666666666
324804,Yann,Karamoh,2024,416,Cote d'Ivoire,Abidjan,France,08-07-98,Left Winger,Attack,Right,184.0,30-06-25,One Team Management,https://img.a.transfermarkt.technology/portrait/header/324804-1663596515.jpg?lm=1,IT1,Torino Calcio,2500000.0,10000000.0,26,123,135,6,13,15,12,13,8,10,11,4,4,12,10,4,14,8,10,8,12,8,11,9,12,14,6,13,6,11,7,17,14,12,11,14,15,10,10,10,6,13,8,14,2,2,3,1,2,1,3,1,1,1,3,11,13,10,10,10,12,12,10,1,1,1,1,1,1,1,1,1,1,15,9,20,18,77,10,20,1196349,6150,6400,4500,African_Caribbean,116,0,0,42692.0,Unknown,85144982,5166666.667,3.0,23,14,36,0,1,1,201,7,0.5971156390579518,0.4759358288770053,0.4926470588235294,0.0412154417650711,0.0,0.0,0.0122530632658164,0.0497624406101525,0.0286767225034028,0.2857142857142857,0.4883720930232553,0.3333333333333332,262,35,15,16,1,5010,11,38,93,1800000,63461.53846153846,10000000.0,1500000.0,3000000.0,10000000.0,7,4200000,-0.28,-0.4
324811,Arnaud,Nordin,2024,969,France,Paris,France,17-06-98,Right Winger,Attack,Left,170.0,30-06-25,One Team Football ,https://img.a.transfermarkt.technology/portrait/header/324811-1702663034.JPG?lm=1,FR1,Montpellier HÃ©rault Sport Club,8000000.0,8000000.0,26,127,136,6,11,14,12,13,6,6,12,5,3,12,11,4,13,8,11,12,12,9,10,10,12,13,10,13,10,12,12,15,14,12,6,12,14,14,11,11,8,8,10,12,2,2,2,3,1,2,2,2,3,2,1,16,14,7,10,11,10,10,15,1,1,1,1,1,1,1,15,1,1,20,1,12,1,70,20,8,3569411,6350,6250,3806,African_Caribbean,116,0,0,12520.0,Unknown,85145157,9111392.0,2.0,34,1122,36,0,0,1,133,10,0.5772691188145012,0.401711229946524,0.4926470588235294,0.0120808376150412,0.0,0.0,0.0397599399849962,0.0397599399849962,0.0505924720131114,0.1428571428571428,0.1627906976744184,0.3333333333333332,259,47,20,19,1,3703,4,10,49,8000000,375000.0,8000000.0,1000000.0,600000.0,3500000.0,3,200000,0.0,0.14285714285714285
325223,Mama,Baldé,2024,3911,Guinea-Bissau,Bissau,Guinea-Bissau,06-11-95,Centre-Forward,Attack,Right,176.0,30-06-27,Unknown,https://img.a.transfermarkt.technology/portrait/header/325223-1702991373.jpg?lm=1,FR1,Stade brestois 29,4000000.0,8000000.0,29,128,134,8,9,11,12,12,5,11,11,8,7,13,10,7,12,14,12,12,10,11,11,10,14,13,9,12,8,11,13,15,15,11,12,16,16,14,13,11,8,10,4,13,2,2,3,1,2,2,2,2,3,1,3,7,13,8,15,13,14,11,13,1,1,1,14,1,14,1,1,1,15,16,1,18,20,69,6,20,4222680,6400,6400,3756,African_Caribbean,114,17,1,5680.0,Unknown,55070279,3666250.0,4.0,44,202,45,0,1,1,196,3,0.5971156390579518,0.3963636363636363,0.4779411764705882,0.0054760155155382,0.1118421052631578,0.0131578947368421,0.0197549387346836,0.0397599399849962,0.0203408428011889,0.4285714285714285,0.3023255813953489,0.4583333333333332,288,46,28,39,2,3928,1,2,13,4500000,171153.84615384616,8000000.0,2000000.0,,400000.0,5,3000000,0.125,-0.25
325443,Viktor,Gyökeres,2024,336,Sweden,Stockholm,Sweden,04-06-98,Centre-Forward,Attack,Right,187.0,30-06-28,Unknown,https://img.a.transfermarkt.technology/portrait/header/325443-1693591840.jpg?lm=1,PO1,Sporting Clube de Portugal,70000000.0,70000000.0,26,125,137,6,6,13,14,11,7,11,12,6,6,10,13,6,12,17,12,13,11,12,8,11,16,11,7,12,9,14,19,13,12,12,13,15,14,16,15,10,14,11,6,11,1,2,2,1,3,1,1,1,1,2,2,17,12,4,10,12,12,9,8,1,1,1,1,1,1,1,14,1,14,19,14,16,20,86,8,20,5738731,6243,6243,4743,Northern_European,118,7,2,5800.0,Unknown,93070271,8733333.333,3.0,91,1426,91,0,1,7,193,3,0.5763429478698069,0.5019251336898395,0.5073529411764706,0.0055918895874593,0.0460526315789473,0.0263157894736842,0.3498374593648412,0.3498374593648412,0.0484920877413261,0.2857142857142857,0.5581395348837206,0.3333333333333332,379,200,60,32,1,7511,3,5,57,75000000,3557142.8571428573,75000000.0,200000.0,,,7,21100000,0.15384615384615385,0.6666666666666666
325994,Rasmus,Lauritsen,2024,206,Denmark,Brande,Denmark,27-02-96,Centre-Back,Defender,Right,188.0,30-06-27,BHM Sports Agency,https://img.a.transfermarkt.technology/portrait/header/325994-1605120613.jpg?lm=1,DK1,BrÃ¸ndby IdrÃ¦tsforening,2000000.0,6500000.0,28,123,124,2,8,5,8,10,3,15,5,10,14,13,6,14,8,15,13,16,11,14,11,13,15,4,14,10,14,15,13,10,8,14,16,12,10,13,14,13,7,12,8,11,1,1,3,1,1,4,1,3,3,1,2,15,14,8,15,13,14,11,11,1,7,20,13,1,1,8,1,1,1,1,1,1,6,78,9,20,1091639,5999,5351,5036,Northern_European,123,0,0,7671.0,Unknown,27069979,1516666.667,3.0,28,241,30,1,1,7,45,2,0.4583223074887537,0.5332620320855614,0.5441176470588236,0.0073985594921625,0.0,0.0,0.0097524381095273,0.032258064516129,0.0083983814383732,0.2857142857142857,0.581395348837209,0.4166666666666665,280,26,10,40,1,8799,2,9,23,2000000,88636.36363636363,6500000.0,1500000.0,,100000.0,5,2050000,0.0,0.0
326029,Donyell,Malen,2024,16,Netherlands,Wieringen,Netherlands,19-01-99,Right Winger,Attack,Right,176.0,30-06-26,SEG,https://img.a.transfermarkt.technology/portrait/header/326029-1711746104.jpg?lm=1,L1,Borussia Dortmund,40000000.0,40000000.0,25,137,157,8,8,13,14,14,9,12,11,4,5,11,14,6,14,11,12,12,13,13,10,11,14,14,5,14,5,12,12,16,15,14,10,12,16,14,12,12,10,11,7,12,3,1,1,1,2,2,3,3,2,3,2,12,13,7,9,11,13,11,12,1,1,1,1,1,1,1,13,10,13,15,13,16,20,74,10,20,20158525,7000,6850,6000,African_Caribbean,131,18,4,76711.0,Unknown,37055844,15300000.0,2.0,67,1664,68,0,1,1,41,10,0.6566551997883038,0.6363636363636364,0.6029411764705883,0.0740647755374384,0.1184210526315789,0.0526315789473684,0.1997999499874969,0.1997999499874969,0.0849745826272952,0.1428571428571428,0.3023255813953489,0.2916666666666665,335,127,56,26,0,9362,10,42,242,28000000,1208695.652173913,40000000.0,12000000.0,500000.0,28000000.0,1,0,-0.3,-0.2
326031,Matthijs,De Ligt,2024,985,Netherlands,Leiderdorp,Netherlands,12-08-99,Centre-Back,Defender,Right,189.0,30-06-29,Rafaela Pimenta,https://img.a.transfermarkt.technology/portrait/header/326031-1700659567.jpg?lm=1,GB1,Manchester United Football Club,55000000.0,75000000.0,25,158,176,6,7,11,8,13,10,16,10,5,15,14,8,16,14,16,14,17,15,13,12,14,16,10,17,8,15,15,15,12,12,15,16,13,13,15,18,14,9,14,7,12,1,2,3,1,2,1,1,1,1,2,1,15,15,3,14,15,19,15,12,1,7,20,9,1,1,12,1,8,1,1,1,1,5,89,11,20,131681715,8000,8000,8000,Northern_European,157,37,2,306848.0,Unknown,37055843,65833333.33,3.0,67,815,68,1,1,7,132,2,0.808811854988092,0.8502673796791443,0.7941176470588234,0.296289036285,0.2434210526315789,0.0263157894736842,0.274818704676169,0.3748437109277319,0.3657231219200533,0.2857142857142857,0.6046511627906974,0.2916666666666665,401,35,13,50,0,11564,17,67,102,45000000,1662962.962962963,75000000.0,10000000.0,40000000.0,67500000.0,4,10900000,-0.3076923076923077,-0.3076923076923077
326330,Frenkie,De Jong,2024,131,Netherlands,Arkel,Netherlands,12-05-97,Central Midfield,Midfield,Right,181.0,30-06-26,Unknown,https://img.a.transfermarkt.technology/portrait/header/326330-1656499973.png?lm=1,ES1,Futbol Club Barcelona,70000000.0,90000000.0,27,163,183,9,11,16,10,17,13,10,8,6,10,16,11,12,16,7,17,11,16,15,18,16,15,15,11,15,14,17,14,14,16,13,10,13,13,13,10,15,2,13,5,17,2,2,1,1,2,2,1,3,3,2,4,14,15,12,14,13,16,16,17,1,1,15,1,1,1,20,10,20,10,10,13,10,1,69,12,20,134021250,8100,8000,7450,Northern_European,155,43,1,269230.0,Unknown,37047745,46870000.0,2.0,67,85,68,3,1,7,96,1,0.808811854988092,0.7914438502673796,0.7794117647058822,0.2599644459722655,0.2828947368421052,0.0131578947368421,0.3498374593648412,0.4498624656164041,0.260368343565099,0.1428571428571428,0.418604651162791,0.375,404,39,48,38,0,11001,15,102,163,45000000,1404687.5,90000000.0,20000000.0,600000.0,7000000.0,3,5000000,-0.35714285714285715,-0.4375
327251,Ridle,Baku,2024,82,Germany,Mainz,Germany,08-04-98,Right-Back,Defender,Right,176.0,30-06-25,Sports360 GmbH,https://img.a.transfermarkt.technology/portrait/header/327251-1657203077.jpg?lm=1,L1,Verein fÃ¼r LeibesÃ¼bungen Wolfsburg,7000000.0,25000000.0,26,141,154,7,12,13,11,12,7,7,12,8,11,12,6,13,12,13,12,15,12,10,12,12,16,13,6,16,12,16,17,15,12,12,8,18,15,15,12,12,7,15,5,20,2,1,2,2,2,1,3,2,2,2,1,14,17,6,12,14,12,12,12,1,12,10,20,10,18,10,10,15,15,14,10,15,1,72,13,20,13342257,7050,7050,6500,African_Caribbean,127,4,1,38355.0,Unknown,92079338,10000000.0,1.0,38,894,40,1,1,1,213,11,0.6831172267795713,0.6898395721925134,0.5735294117647058,0.0370275596823891,0.0263157894736842,0.0131578947368421,0.0347586896724181,0.1247811952988247,0.055529320258896,0.0,0.3023255813953489,0.3333333333333332,326,45,32,44,1,3805,2,16,57,7000000,287500.0,25000000.0,5000000.0,,4000000.0,1,4000000,0.0,-0.3
327757,Krzysztof,Piatek,2024,6890,Poland,Dzier?oniÃ³w,Poland,01-07-95,Centre-Forward,Attack,Right,183.0,30-06-26,Fabryka Futbolu,https://img.a.transfermarkt.technology/portrait/header/327757-1695642720.png?lm=1,TR1,?stanbul Ba?ak?ehir Futbol KulÃ¼bÃ¼,6000000.0,40000000.0,29,135,145,6,8,11,16,13,9,14,12,7,6,9,17,9,12,11,17,14,16,15,9,12,13,10,12,15,7,11,11,12,13,16,13,14,12,13,14,12,8,10,4,7,2,1,1,2,1,1,1,3,2,3,2,12,15,9,8,13,15,10,14,1,1,1,1,1,1,1,1,1,1,1,10,1,20,77,10,20,11099860,6750,7350,5750,Northern_European,134,23,10,96154.0,U.S. Salernitana 1919,96054420,12842400.0,5.0,75,440,78,0,1,7,4,3,0.7228102672664726,0.6096256684491979,0.625,0.0928392720404555,0.1513157894736842,0.131578947368421,0.0297574393598399,0.1997999499874969,0.0713208700241673,0.5714285714285714,0.4651162790697669,0.4583333333333332,395,154,32,48,0,5480,5,19,131,6500000,211666.66666666666,40000000.0,8000000.0,,400000.0,7,37800000,0.08333333333333333,0.18181818181818182
327863,Akim,Zedadka,2024,1082,France,Pertuis,Algeria,30-05-95,Right-Back,Defender,Right,174.0,30-06-25,Unknown,https://img.a.transfermarkt.technology/portrait/header/327863-1625741792.jpg?lm=1,FR1,Lille Olympique Sporting Club Lille MÃ©tropole,2000000.0,4000000.0,29,125,129,11,14,13,8,13,10,10,11,10,13,12,11,9,13,8,11,11,12,11,12,12,8,12,6,12,12,11,13,13,13,12,8,13,14,14,13,13,10,11,8,13,3,1,1,2,1,3,1,1,4,2,3,11,12,10,11,9,11,12,12,1,17,1,20,1,18,1,1,1,17,1,1,14,1,72,8,20,2856825,6242,6242,3742,North_African__Middle_Eastern,116,0,0,11832.0,Unknown,49030855,9111392.0,2.0,34,1138,1,1,1,6,128,11,0.5762106377348505,0.3948663101604278,0.4926470588235294,0.0114164929360268,0.0,0.0,0.0097524381095273,0.0197549387346836,0.0505924720131114,0.1428571428571428,0.2558139534883721,0.4583333333333332,248,8,6,35,0,3620,0,0,0,1500000,72222.22222222222,4000000.0,1000000.0,,,7,2800000,-0.25,-0.25
328480,Unknown,Pepelu,2024,1049,Spain,DÃ©nia,Spain,11-08-98,Defensive Midfield,Midfield,Right,186.0,30-06-28,Wasserman,https://img.a.transfermarkt.technology/portrait/header/328480-1713971066.jpg?lm=1,ES1,Valencia Club de FÃºtbol S. A. D.,22000000.0,22000000.0,26,127,146,12,12,11,8,14,12,11,12,7,11,14,11,12,13,11,13,13,14,14,13,13,11,11,10,12,14,14,14,11,12,12,11,14,12,14,12,14,9,13,7,10,1,2,1,2,4,2,3,1,1,1,3,17,15,6,18,12,15,14,11,1,1,1,1,1,1,18,1,20,1,1,13,1,1,75,10,20,4875463,6300,6300,4350,Mediterranean_Hispanic,127,0,0,9588.0,Unknown,67207683,5000000.0,1.0,89,442,89,3,1,3,208,4,0.5838846255623181,0.4598930481283422,0.5735294117647058,0.0092496477911022,0.0,0.0,0.1097774443610902,0.1097774443610902,0.0277507708547459,0.0,0.5348837209302322,0.3333333333333332,334,28,10,73,1,2233,1,1,9,15000000,639130.4347826086,22000000.0,7000000.0,300000.0,300000.0,7,7000000,-0.3181818181818182,0.25
328658,Kristoffer,Ajer,2024,1148,Norway,RÃ¦lingen,Norway,17-04-98,Centre-Back,Defender,Right,198.0,30-06-28,Wasserman,https://img.a.transfermarkt.technology/portrait/header/328658-1700649482.jpg?lm=1,GB1,Brentford Football Club,15000000.0,18000000.0,26,141,151,6,8,12,11,12,7,15,10,10,14,13,11,14,13,16,14,15,14,13,14,12,18,7,15,11,13,16,15,13,11,13,16,15,14,13,14,16,10,14,4,15,2,1,1,3,1,3,3,2,1,2,2,16,16,8,15,16,16,14,13,1,1,20,14,1,1,18,1,15,1,1,1,1,1,92,9,20,37377754,7050,7050,6000,Northern_European,140,26,0,52196.0,Unknown,53110135,8150000.0,2.0,71,1262,73,1,1,7,43,2,0.6831172267795713,0.6363636363636364,0.6691176470588234,0.0503926682612226,0.1710526315789473,0.0,0.0747686921730432,0.0897724431107777,0.0452512569793605,0.1428571428571428,0.8139534883720931,0.3333333333333332,343,24,18,46,1,11435,15,69,54,18000000,804545.4545454546,18000000.0,3000000.0,800000.0,2000000.0,3,10000000,0.2,0.0
328784,Robin,Koch,2024,24,Germany,Kaiserslautern,Germany,17-07-96,Centre-Back,Defender,Right,191.0,30-06-27,11WINS,https://img.a.transfermarkt.technology/portrait/header/328784-1696508822.jpg?lm=1,L1,Eintracht Frankfurt FuÃŸball AG,18000000.0,18000000.0,28,140,143,5,8,7,7,11,5,15,6,12,16,12,6,15,10,10,15,15,16,16,8,15,11,4,8,6,16,18,13,10,9,13,14,16,10,14,15,17,6,13,8,12,3,1,2,2,2,2,1,2,3,2,1,5,10,3,16,13,15,16,18,1,1,20,10,1,1,12,1,10,1,1,1,1,1,78,11,20,6358887,6699,6699,5099,Northern_European,139,0,0,23014.0,Unknown,91100465,8250000.0,2.0,38,700,40,1,1,7,63,2,0.6366763694098968,0.5399999999999999,0.6617647058823528,0.0222140252045418,0.0,0.0,0.0897724431107777,0.0897724431107777,0.0458068279674435,0.1428571428571428,0.6511627906976742,0.4166666666666665,326,13,8,53,0,4157,13,69,102,18000000,719000.0,18000000.0,3500000.0,75000.0,800000.0,6,2700000,0.0,0.0
329145,Unknown,Diego Carlos,2024,405,Brazil,Barra Bonita,Brazil,15-03-93,Centre-Back,Defender,Right,185.0,30-06-26,Bertolucci Sports,https://img.a.transfermarkt.technology/portrait/header/329145-1695656525.jpg?lm=1,GB1,Aston Villa Football Club,12000000.0,50000000.0,31,150,153,3,5,7,5,11,9,15,8,10,16,12,10,15,12,16,15,19,13,14,8,14,15,9,9,8,15,13,14,13,12,15,14,18,14,15,18,15,12,13,6,8,2,2,1,1,1,1,1,2,1,4,3,13,15,11,11,12,16,12,10,1,1,20,1,1,1,14,1,1,1,1,1,1,1,79,9,20,35493471,7500,7500,6000,Mixed_Race,149,0,0,115992.0,Unknown,19188567,15766666.67,3.0,10,147,11,1,1,4,30,2,0.7426567875099233,0.6363636363636364,0.7352941176470587,0.1119951873635462,0.0,0.0,0.0597649412353088,0.2498124531132783,0.0875672472568682,0.2857142857142857,0.5116279069767438,0.5416666666666665,358,13,2,77,0,6597,6,54,214,11000000,375862.0689655172,50000000.0,10000000.0,,,3,13000000,-0.3125,-0.3125
329517,Georgios,Masouras,2024,683,Greece,Kechrinia,Greece,01-01-94,Left Winger,Attack,Right,184.0,30-06-27,Target Sport,https://img.a.transfermarkt.technology/portrait/header/329517-1728418099.png?lm=1,GR1,Olympiakos Syndesmos Filathlon Peiraios,4000000.0,10000000.0,30,120,125,12,12,11,12,12,11,11,11,7,10,11,11,10,12,13,12,15,11,8,10,10,15,12,8,13,9,14,14,13,13,12,9,14,14,14,10,11,9,13,6,12,1,2,3,2,1,2,3,2,2,2,2,12,13,3,15,12,16,10,14,1,1,1,1,1,1,1,16,6,16,20,10,19,8,75,12,20,2107214,6274,6274,4262,Mediterranean_Hispanic,119,26,3,10643.0,Unknown,36095783,400000.0,1.0,40,719,42,0,1,3,141,7,0.5804445620534533,0.4504812834224598,0.5147058823529411,0.0102683740067419,0.1710526315789473,0.0394736842105263,0.0197549387346836,0.0497624406101525,0.0021945054029278,0.0,0.4883720930232553,0.5,433,83,35,39,0,12297,5,18,27,3200000,117307.69230769231,10000000.0,2500000.0,,150000.0,1,500000,-0.2,-0.36
329722,André,Horta,2024,1075,Portugal,Almada,Portugal,07-11-96,Central Midfield,Midfield,Right,174.0,30-06-27,Proeleven S.A.,https://img.a.transfermarkt.technology/portrait/header/329722-1591775449.png?lm=1,PO1,Sporting Clube de Braga,4500000.0,6000000.0,28,132,147,13,12,16,9,15,11,7,13,5,5,15,11,7,16,12,10,9,12,10,16,10,14,14,9,12,11,12,13,14,15,11,8,14,14,13,9,10,5,11,7,10,1,2,2,2,1,4,1,1,2,1,3,8,14,6,14,15,16,12,14,1,1,1,1,1,1,1,11,19,1,17,20,7,1,67,12,20,6732179,6598,6598,5098,Mediterranean_Hispanic,131,0,0,8749.0,Unknown,55082342,2863333.333,3.0,76,46,79,3,1,3,192,1,0.6233130457793067,0.5398930481283422,0.6029411764705883,0.0084394949049204,0.0,0.0,0.0222555638909727,0.0297574393598399,0.0158800707408539,0.2857142857142857,0.2558139534883721,0.4166666666666665,340,16,39,32,2,9692,7,32,44,4500000,153571.42857142858,6000000.0,2000000.0,500000.0,2000000.0,6,3000000,-0.1,-0.25
329723,Gil,Dias,2024,3329,Portugal,Gafanha da NazarÃ©,Portugal,28-09-96,Right Winger,Attack,Left,186.0,30-06-27,Unknown,https://img.a.transfermarkt.technology/portrait/header/329723-1709021301.png?lm=1,PO1,Futebol Clube de FamalicÃ£o,1500000.0,4000000.0,28,124,130,10,10,15,8,13,11,9,12,8,7,12,12,13,14,11,13,12,9,8,13,8,12,12,8,11,8,11,13,13,14,11,11,13,14,12,11,12,8,11,5,16,1,3,3,1,1,1,1,1,2,3,3,12,13,7,11,12,13,8,13,1,16,1,1,19,1,1,15,13,14,17,16,20,1,78,20,7,989999,6200,6200,4450,Mediterranean_Hispanic,113,0,0,13844.0,Unknown,55082920,9111392.0,2.0,76,520,79,0,0,3,99,10,0.5706536120666843,0.4705882352941176,0.4705882352941176,0.0133593148752374,0.0,0.0,0.0072518129532383,0.0197549387346836,0.0505924720131114,0.1428571428571428,0.5348837209302322,0.4166666666666665,268,37,20,31,0,5261,5,18,30,1500000,45833.333333333336,4000000.0,1000000.0,400000.0,2000000.0,11,4800000,0.6666666666666666,0.25
329813,João,Virgínia,2024,29,Portugal,Faro,Portugal,10-10-99,Goalkeeper,Goalkeeper,Left,192.0,30-06-25,Wasserman,https://img.a.transfermarkt.technology/portrait/header/329813-1557498511.jpg?lm=1,GB1,Everton Football Club,800000.0,1000000.0,25,110,138,3,3,2,1,9,7,2,2,3,1,12,3,3,12,12,12,11,12,16,11,7,10,2,2,2,11,12,13,12,14,12,15,15,12,15,7,12,12,12,15,14,15,10,11,5,13,12,13,15,12,10,8,10,17,2,6,5,11,11,10,20,1,1,1,1,1,1,1,1,1,1,1,1,1,80,20,10,7504665,5490,5490,2740,Mediterranean_Hispanic,111,0,0,6960.0,SC Cambuur,28109598,9111392.0,2.0,76,485,79,2,0,3,65,5,0.4767134162476846,0.2877005347593582,0.4558823529411764,0.00671200561603,0.0,0.0,0.0037509377344336,0.0047511877969492,0.0505924720131114,0.1428571428571428,0.6744186046511627,0.2916666666666665,0,0,0,0,0,0,1,4,60,800000,21428.571428571428,1000000.0,350000.0,,150000.0,5,550000,0.0,0.0
330208,Alessandro,Vogliacco,2024,252,Italy,Acquaviva delle Fonti,Italy,14-09-98,Centre-Back,Defender,Right,186.0,30-06-27,MM-Management,https://img.a.transfermarkt.technology/portrait/header/330208-1613547642.jpg?lm=1,IT1,Genoa Cricket and Football Club,2000000.0,2000000.0,26,120,146,8,9,10,7,11,7,14,7,12,13,11,9,14,11,12,14,12,12,13,12,13,13,8,10,12,13,12,12,12,10,10,13,12,12,14,13,12,10,13,8,10,1,2,3,1,2,3,1,1,3,2,3,11,13,9,12,11,14,13,12,1,1,20,8,1,1,1,1,1,1,1,1,1,1,82,8,20,2374065,6000,6000,3950,Mediterranean_Hispanic,121,0,0,479.0,Unknown,43204399,816666.6667,3.0,52,22,54,1,1,3,104,2,0.5441915850754168,0.4171122994652406,0.5294117647058822,0.0004538401150243,0.0,0.0,0.0097524381095273,0.0097524381095273,0.0045093845201255,0.2857142857142857,0.5348837209302322,0.3333333333333332,247,2,7,46,2,4326,1,6,43,2000000,108333.33333333333,2000000.0,200000.0,50000.0,75000.0,4,400000,0.0,0.0
330659,Justin,Kluivert,2024,989,Netherlands,Zaandam,Netherlands,05-05-99,Left Winger,Attack,Right,172.0,30-06-28,Team Raiola,https://img.a.transfermarkt.technology/portrait/header/330659-1596107153.jpg?lm=1,GB1,Association Football Club Bournemouth,14000000.0,25000000.0,25,139,155,9,10,16,11,16,8,7,12,2,3,14,10,6,16,16,9,13,11,10,11,10,15,15,7,12,6,11,12,17,17,11,7,12,16,11,8,12,14,14,11,14,1,1,2,3,3,2,3,1,3,2,3,13,16,13,9,13,14,12,12,1,1,1,1,1,1,1,16,1,15,20,14,18,13,66,14,20,9869723,6950,6750,5750,African_Caribbean,132,2,0,64038.0,Valencia,37055841,9111392.0,2.0,67,1692,68,0,1,1,22,7,0.6434241862926701,0.6096256684491979,0.6102941176470589,0.0618275079253037,0.0131578947368421,0.0,0.0697674418604651,0.1247811952988247,0.0505924720131114,0.1428571428571428,0.2093023255813952,0.2916666666666665,313,76,57,45,1,6163,10,43,45,22000000,954545.4545454546,25000000.0,4000000.0,7500000.0,22500000.0,5,11000000,0.5714285714285714,1.0
331059,Luis,Chávez,2024,121,Mexico,CihuatlÃ¡n,Mexico,15-01-96,Defensive Midfield,Midfield,Left,178.0,30-06-27,Primotempo,https://img.a.transfermarkt.technology/portrait/header/331059-1693158645.png?lm=1,RU1,FK Dinamo Moskva,9000000.0,9000000.0,28,132,138,12,13,13,11,12,13,9,12,13,8,14,11,13,14,13,12,12,14,12,14,12,18,14,6,13,13,12,16,12,13,14,11,13,13,14,12,12,10,12,11,13,1,1,2,3,1,1,2,4,2,4,3,9,13,8,12,11,13,13,10,1,1,1,1,1,1,15,20,20,1,15,1,1,1,73,20,10,3317279,6605,6605,4006,Mediterranean_Hispanic,130,4,0,17334.0,Unknown,51049414,6500000.0,1.0,63,363,64,3,0,3,74,4,0.6242392167240011,0.4231016042780748,0.5955882352941175,0.0167293191336095,0.0263157894736842,0.0,0.0447611902975743,0.0447611902975743,0.0360843356759909,0.0,0.3488372093023257,0.4166666666666665,390,51,22,29,2,16139,2,6,28,9000000,370833.3333333333,9000000.0,250000.0,100000.0,300000.0,3,200000,0.0,0.125
331362,Benedikt,Pichler,2024,269,Austria,Salzburg,Austria,20-07-97,Centre-Forward,Attack,Right,188.0,30-06-27,ROGON,https://img.a.transfermarkt.technology/portrait/header/331362-1657792864.jpg?lm=1,L1,Kieler Sportvereinigung Holstein von 1900,2000000.0,2000000.0,27,123,129,7,12,12,11,11,9,12,9,7,7,11,10,7,13,7,12,12,10,11,12,12,5,10,8,15,7,13,13,14,13,13,13,12,13,14,13,12,6,8,5,6,3,1,1,3,3,1,1,2,2,2,2,8,9,5,8,12,9,12,18,1,1,1,1,1,1,1,20,1,12,16,1,12,18,87,12,20,2021098,6121,6129,4079,Northern_European,119,0,0,4999.0,Unknown,16045033,9111392.0,2.0,6,1291,7,0,1,7,119,3,0.5612595924847843,0.4309090909090908,0.5147058823529411,0.0048184301573859,0.0,0.0,0.0097524381095273,0.0097524381095273,0.0505924720131114,0.1428571428571428,0.581395348837209,0.375,233,66,34,19,1,5593,12,50,119,2000000,114062.5,2000000.0,200000.0,,175000.0,2,200000,0.3333333333333333,0.3333333333333333
331401,Manuel,Lazzari,2024,398,Italy,Valdagno,Italy,29-11-93,Right Midfield,Midfield,Right,174.0,30-06-27,Unknown,https://img.a.transfermarkt.technology/portrait/header/331401-1707947147.jpg?lm=1,IT1,SocietÃ  Sportiva Lazio S.p.A.,4000000.0,23000000.0,31,145,150,7,13,13,10,12,3,7,10,6,11,13,5,13,13,13,15,15,10,12,12,13,16,14,8,16,12,15,16,17,17,11,7,18,17,14,8,13,8,14,8,13,3,2,3,3,1,3,3,1,1,2,3,13,15,7,16,13,16,9,11,1,1,1,20,1,20,1,1,1,15,1,1,11,1,65,11,20,16074698,7250,7100,6000,Mediterranean_Hispanic,134,2,0,53462.0,Unknown,43096538,15000000.0,1.0,52,1554,54,3,1,3,185,9,0.6897327335273882,0.6363636363636364,0.625,0.0516151397199903,0.0131578947368421,0.0,0.0197549387346836,0.1147786946736684,0.0833078696630462,0.0,0.2558139534883721,0.5416666666666665,482,12,44,83,4,5183,18,59,28,4000000,137037.03703703705,23000000.0,7500000.0,,300000.0,1,0,0.0,-0.38461538461538464
331498,Jordi,Mboula,2024,2424,Spain,Granollers,Spain,16-03-99,Right Winger,Attack,Right,183.0,30-06-26,Universal Twenty Two,https://img.a.transfermarkt.technology/portrait/header/331498-1692278148.jpg?lm=1,PO1,Gil Vicente Futebol Clube,1200000.0,4000000.0,25,123,145,11,12,14,10,13,10,8,10,5,5,12,10,5,14,8,11,10,12,10,14,11,13,15,9,14,7,9,12,15,14,13,10,12,15,12,11,11,7,13,10,12,2,4,3,3,1,2,3,3,2,2,2,14,16,6,12,14,12,14,14,1,1,1,1,1,1,1,10,1,15,14,1,20,12,74,8,20,3141875,6150,6150,4151,Mixed_Race,121,0,0,11627.0,R. Santander,67231279,2350000.0,2.0,89,554,89,0,1,4,106,10,0.5640381053188674,0.4386096256684491,0.5294117647058822,0.011218541396495,0.0,0.0,0.0057514378594648,0.0197549387346836,0.0130281396705464,0.1428571428571428,0.4651162790697669,0.2916666666666665,206,28,19,16,0,6272,5,39,121,1000000,-55555.555555555555,4000000.0,1000000.0,4000000.0,2000000.0,8,1200000,-0.16666666666666666,-0.16666666666666666
331505,ÃÂScar,Mingueza,2024,940,Spain,Santa PerpÃ¨tua de Mogoda,Spain,13-05-99,Right-Back,Defender,Right,184.0,30-06-26,Unknown,https://img.a.transfermarkt.technology/portrait/header/331505-1698852962.jpg?lm=1,ES1,Real Club Celta de Vigo S. A. D.,8000000.0,15000000.0,25,130,146,5,11,11,8,12,6,14,8,11,13,12,5,14,13,13,14,15,14,11,12,12,15,7,13,10,12,15,16,13,12,14,13,15,14,14,13,14,8,12,7,15,3,3,3,2,1,1,4,2,3,3,3,10,14,5,15,13,15,13,15,1,13,20,19,9,14,10,1,1,1,1,1,1,1,75,10,20,5633644,6500,6500,4750,Mediterranean_Hispanic,129,1,0,21766.0,Unknown,67245413,9111392.0,2.0,89,1328,89,1,1,3,165,11,0.6103466525535857,0.5026737967914437,0.588235294117647,0.0210089348565623,0.006578947368421,0.0,0.0397599399849962,0.0747686921730432,0.0505924720131114,0.1428571428571428,0.4883720930232553,0.2916666666666665,208,6,17,32,0,5494,6,22,78,20000000,947619.0476190476,20000000.0,6000000.0,,200000.0,2,3800000,1.5,2.3333333333333335
331560,Takehiro,Tomiyasu,2024,11,Japan,"Fukuoka, Fukuoka",Japan,05-11-98,Right-Back,Defender,Right,188.0,30-06-26,UDN SPORTS,https://img.a.transfermarkt.technology/portrait/header/331560-1682591217.jpg?lm=1,GB1,Arsenal Football Club,35000000.0,35000000.0,26,148,160,7,11,13,9,12,7,12,9,11,13,12,7,15,13,13,15,15,14,14,12,13,15,13,7,12,14,16,17,13,14,13,14,16,13,16,13,15,10,12,6,16,2,1,3,1,1,3,2,2,3,2,1,18,14,4,15,14,17,17,14,1,17,15,20,15,16,10,1,1,1,1,1,1,1,78,13,20,114136796,7299,7099,5999,Asian,144,28,1,75395.0,Unknown,45095490,8800000.0,3.0,54,516,56,1,1,2,21,11,0.6896004233924319,0.6362566844919786,0.6985294117647058,0.0727940232153703,0.1842105263157894,0.0131578947368421,0.1747936984246061,0.1747936984246061,0.0488624684019,0.2857142857142857,0.581395348837209,0.3333333333333332,246,7,10,27,0,5016,14,118,225,32000000,1521428.5714285714,35000000.0,3000000.0,100000.0,9000000.0,3,6000000,-0.08571428571428572,0.06666666666666667
331726,Tammy,Abraham,2024,5,England,London,England,02-10-97,Centre-Forward,Attack,Right,194.0,30-06-25,ROOF,https://img.a.transfermarkt.technology/portrait/header/331726-1725531680.jpg?lm=1,IT1,Associazione Calcio Milan,30000000.0,50000000.0,27,153,163,4,9,14,15,14,10,15,12,4,6,13,14,8,14,14,15,15,12,13,12,12,16,16,12,15,8,16,16,15,15,17,16,14,16,13,14,14,8,16,6,6,1,3,2,2,3,3,2,3,3,3,1,16,15,14,11,15,13,15,10,1,1,1,1,1,1,1,1,1,1,1,1,1,20,87,12,20,104568749,7650,7250,6500,African_Caribbean,153,11,3,110961.0,Unknown,28097985,41000000.0,1.0,32,858,33,0,1,1,27,3,0.7095792537708389,0.6898395721925134,0.7647058823529411,0.1071371668982538,0.0723684210526315,0.0394736842105263,0.1497874468617154,0.2498124531132783,0.2277563265646268,0.0,0.7209302325581395,0.375,417,170,46,26,0,8968,17,78,286,20000000,791666.6666666666,50000000.0,10000000.0,1000000.0,10000000.0,6,20000000,-0.3333333333333333,-0.42857142857142855
332179,Matteo,Pessina,2024,2919,Italy,Monza,Italy,21-04-97,Central Midfield,Midfield,Left,187.0,30-06-27,GR Sports,https://img.a.transfermarkt.technology/portrait/header/332179-1661268524.jpg?lm=1,IT1,Associazione Calcio Monza,15000000.0,20000000.0,27,137,150,8,12,14,12,14,7,12,11,4,9,14,10,12,14,15,13,15,13,14,13,12,17,14,10,16,11,15,17,14,12,14,13,13,14,15,12,13,12,13,6,15,1,2,2,1,1,1,3,3,3,3,1,15,16,8,14,16,17,13,13,1,1,1,1,1,1,14,5,20,7,10,20,11,7,75,20,10,8488460,6850,7000,6100,Mediterranean_Hispanic,135,14,4,35577.0,Brianza,43155796,6343333.333,3.0,52,980,54,3,0,3,28,1,0.6765017200317545,0.6470588235294117,0.6323529411764706,0.0343450749174155,0.0921052631578947,0.0526315789473684,0.0747686921730432,0.0997749437359339,0.0352139411261423,0.2857142857142857,0.5581395348837206,0.375,328,42,18,33,1,4288,6,37,92,12000000,477000.0,20000000.0,3000000.0,225000.0,1200000.0,8,7250000,-0.2,-0.2
332560,Deiver,Machado,2024,826,Colombia,TadÃ³,Colombia,02-09-93,Left-Back,Defender,Left,180.0,30-06-26,Wasserman,https://img.a.transfermarkt.technology/portrait/header/332560-1704797088.jpg?lm=1,FR1,Racing Club de Lens,4000000.0,4000000.0,31,124,135,8,13,12,8,12,7,8,10,12,11,11,10,11,12,9,12,12,12,12,12,12,13,11,10,12,12,12,12,15,13,12,8,14,14,14,12,11,9,11,7,14,2,3,2,1,4,3,1,1,1,4,1,16,9,9,12,11,12,11,10,1,18,1,1,20,1,1,18,1,1,12,1,1,1,75,20,8,2996360,6186,6186,3736,African_Caribbean,121,3,0,10075.0,Unknown,76038733,1800000.0,1.0,20,1463,20,1,0,1,158,8,0.5688012701772955,0.3942245989304812,0.5294117647058822,0.0097199033996487,0.0197368421052631,0.0,0.0197549387346836,0.0197549387346836,0.0099724992360898,0.0,0.3953488372093026,0.5416666666666665,314,15,24,56,3,7106,7,33,95,3500000,114000.0,4000000.0,500000.0,,,5,1700000,-0.125,-0.125
332697,Weston,Mckennie,2024,506,United States,"Little Elm, Texas",United States,28-08-98,Central Midfield,Midfield,Right,185.0,30-06-26,Wasserman,https://img.a.transfermarkt.technology/portrait/header/332697-1642687384.jpg?lm=1,IT1,Juventus Football Club,28000000.0,28000000.0,26,146,156,7,11,12,15,12,7,15,10,17,10,13,8,15,13,17,15,17,14,10,11,12,17,12,13,17,11,15,15,14,15,16,12,18,14,17,16,12,12,16,11,16,1,1,3,1,1,1,3,2,3,2,3,17,14,13,10,13,10,15,12,1,1,8,8,1,8,14,14,20,15,12,15,14,1,84,12,20,17209941,7300,7450,5950,Mixed_Race,145,35,9,61731.0,Unknown,72048035,9111392.0,2.0,104,844,102,3,1,4,116,1,0.7360412807621064,0.6310160427807486,0.7058823529411764,0.0595998288926204,0.2302631578947368,0.1184210526315789,0.1397849462365591,0.1397849462365591,0.0505924720131114,0.1428571428571428,0.5116279069767438,0.3333333333333332,295,27,30,46,0,3969,21,74,88,24000000,1039130.4347826086,28000000.0,4000000.0,100000.0,20000000.0,4,8900000,-0.14285714285714285,0.043478260869565216
332705,Tyler,Adams,2024,989,United States,"Wappingers Falls, New York",United States,14-02-99,Defensive Midfield,Midfield,Right,175.0,30-06-28,YMU Management Ltd.,https://img.a.transfermarkt.technology/portrait/header/332705-1666472142.jpg?lm=1,GB1,Association Football Club Bournemouth,15000000.0,20000000.0,25,140,151,6,10,12,6,13,6,8,8,11,13,14,6,14,12,16,14,15,12,13,13,12,15,9,13,12,14,15,17,14,14,13,10,17,14,16,13,13,12,15,7,16,2,2,3,1,4,1,3,3,2,4,2,15,16,4,11,13,15,16,12,1,12,1,15,12,15,18,1,20,10,1,1,10,1,72,12,20,34031975,7000,7000,6000,Mixed_Race,135,30,1,69595.0,Unknown,72044918,15510000.0,3.0,104,1644,102,3,1,4,22,4,0.6765017200317545,0.6363636363636364,0.6323529411764706,0.0671934430725168,0.1973684210526315,0.0131578947368421,0.0747686921730432,0.0997749437359339,0.0861412817022694,0.2857142857142857,0.2790697674418605,0.2916666666666665,258,8,17,35,0,7922,14,107,159,15000000,622916.6666666666,20000000.0,3000000.0,800000.0,13000000.0,3,10500000,0.0,-0.16666666666666666
332798,Roland,Sallai,2024,141,Hungary,Budapest,Hungary,22-05-97,Right Winger,Attack,Right,183.0,30-06-28,Wasserman,https://img.a.transfermarkt.technology/portrait/header/332798-1658413418.jpg?lm=1,TR1,Galatasaray Spor KulÃ¼bÃ¼,14000000.0,16000000.0,27,140,150,12,12,15,14,14,13,10,14,6,5,14,10,7,14,10,12,12,13,9,15,11,12,15,8,14,7,12,10,14,13,12,11,12,13,11,10,12,9,11,4,15,1,2,4,2,3,1,3,2,1,3,3,15,16,7,8,10,14,10,13,1,1,1,1,1,1,1,18,10,18,18,20,15,15,78,15,20,8633224,6750,6450,5250,Northern_European,130,36,8,14383.0,Unknown,38039385,4166666.667,3.0,45,273,47,0,1,7,102,10,0.6037311458057687,0.5561497326203209,0.5955882352941175,0.0138797825816163,0.2368421052631578,0.1052631578947368,0.0697674418604651,0.0797699424856214,0.0231210126225728,0.2857142857142857,0.4651162790697669,0.375,298,43,36,55,0,5586,11,69,169,13000000,416129.03225806454,16000000.0,4000000.0,250000.0,2000000.0,5,4300000,-0.13333333333333333,0.08333333333333333
332889,Valentin,Rongier,2024,244,France,MÃ¢con,France,07-12-94,Central Midfield,Midfield,Right,172.0,30-06-26,CAA Base Ltd,https://img.a.transfermarkt.technology/portrait/header/332889-1703065877.jpg?lm=1,FR1,Olympique de Marseille,10000000.0,22000000.0,30,137,143,11,10,13,9,14,11,8,10,7,13,15,10,15,13,11,15,14,14,14,14,13,16,11,14,14,13,16,17,12,13,16,8,12,13,15,12,14,10,12,8,13,2,3,3,1,1,4,3,4,3,2,1,12,15,8,14,12,14,14,12,1,1,1,12,1,12,16,1,20,12,1,13,10,1,70,8,20,14141150,6845,6845,4995,Northern_European,139,0,0,55630.0,Unknown,85085142,13000000.0,1.0,34,998,36,3,1,7,144,1,0.6559936491135221,0.5288770053475935,0.6617647058823528,0.0537085979526982,0.0,0.0,0.0497624406101525,0.1097774443610902,0.0721964499013861,0.0,0.2093023255813952,0.5,321,15,23,38,0,7538,11,96,286,9000000,268181.8181818182,22000000.0,4000000.0,,800000.0,1,5000000,-0.25,-0.5
333014,Sander,Berge,2024,931,Norway,BÃ¦rum,Norway,14-02-98,Central Midfield,Midfield,Right,195.0,30-06-29,Keypass AS,https://img.a.transfermarkt.technology/portrait/header/333014-1679676693.jpg?lm=1,GB1,Fulham Football Club,20000000.0,22000000.0,26,130,165,9,11,12,10,12,9,11,10,6,11,13,12,12,14,12,14,12,13,14,13,13,14,11,11,13,12,14,14,13,13,14,11,14,13,14,15,12,7,12,9,12,1,1,1,1,2,3,3,1,1,2,2,18,16,5,15,12,14,14,16,1,1,1,1,1,1,15,1,20,1,1,18,1,1,88,10,20,13463878,6500,7100,6000,Northern_European,130,30,1,40597.0,Unknown,53101282,16112500.0,4.0,71,286,73,3,1,7,95,1,0.6897327335273882,0.6363636363636364,0.5955882352941175,0.0391924735927818,0.1973684210526315,0.0131578947368421,0.0997749437359339,0.1097774443610902,0.0894885969054695,0.4285714285714285,0.7441860465116279,0.3333333333333332,327,24,19,34,0,8038,10,110,205,20000000,792000.0,22000000.0,2000000.0,1500000.0,17000000.0,4,2700000,0.0,0.0
333241,Unknown,Joelinton,2024,762,Brazil,AlianÃ§a,Brazil,14-08-96,Central Midfield,Midfield,Right,186.0,30-06-28,ROGON,https://img.a.transfermarkt.technology/portrait/header/333241-1674210135.jpg?lm=1,GB1,Newcastle United Football Club,40000000.0,42000000.0,28,143,145,7,11,15,11,14,8,15,10,6,7,13,11,16,14,17,13,19,14,12,13,14,15,14,9,13,13,17,18,11,11,15,14,12,14,16,17,15,10,10,9,10,1,3,1,2,2,3,3,2,1,1,2,11,16,12,10,13,11,7,10,1,1,1,1,1,1,1,1,20,10,16,16,10,16,81,10,20,55999655,7150,6500,5750,Mixed_Race,141,0,0,92793.0,Unknown,19184436,22850000.0,2.0,10,42,11,3,1,4,137,1,0.6103466525535857,0.6096256684491979,0.6764705882352942,0.0895938324093985,0.0,0.0,0.1997999499874969,0.2098024506126531,0.1269201922275618,0.1428571428571428,0.5348837209302322,0.4166666666666665,356,66,38,75,1,6105,18,56,119,40000000,1353448.2758620689,42000000.0,5000000.0,1250000.0,1250000.0,4,6250000,0.0,-0.047619047619047616
333640,Joël,Drommel,2024,383,Netherlands,Bussum,Netherlands,16-11-96,Goalkeeper,Goalkeeper,Right,192.0,30-06-26,Unknown,https://img.a.transfermarkt.technology/portrait/header/333640-1687427245.jpg?lm=1,NL1,Eindhovense Voetbalvereniging Philips Sport Vereniging,2500000.0,4500000.0,28,128,136,3,2,8,1,9,4,2,2,2,1,12,4,3,9,9,12,12,13,13,11,12,15,8,13,2,13,12,14,10,13,14,14,14,10,13,11,11,6,11,5,13,13,14,14,13,12,14,13,14,8,11,13,11,10,4,11,11,14,14,13,20,1,1,1,1,1,1,1,1,1,1,1,1,1,87,7,20,4556249,6500,6500,5000,Northern_European,126,0,0,6711.0,Unknown,37048494,3500000.0,1.0,67,284,68,2,1,7,62,5,0.6103466525535857,0.5294117647058822,0.5661764705882353,0.0064715669167937,0.0,0.0,0.0122530632658164,0.0222555638909727,0.0194172060335009,0.0,0.6744186046511627,0.4166666666666665,0,0,0,0,0,0,1,12,77,2000000,70535.71428571429,4500000.0,1000000.0,500000.0,500000.0,2,500000,-0.2,-0.2
333647,Jonathan,Burkardt,2024,39,Germany,Darmstadt,Germany,11-07-00,Centre-Forward,Attack,Right,183.0,30-06-27,PRO Profil GmbH,https://img.a.transfermarkt.technology/portrait/header/333647-1698840239.jpg?lm=1,L1,1. FuÃŸball- und Sportverein Mainz 05,15000000.0,17000000.0,24,132,152,4,7,13,12,12,4,10,8,4,7,12,13,7,13,11,14,14,12,11,12,11,16,13,12,14,7,16,16,16,14,9,10,16,16,14,10,11,3,14,7,13,2,4,3,1,1,3,1,1,1,1,1,9,14,6,17,12,14,16,17,1,1,1,1,1,10,1,10,1,10,15,15,15,20,76,14,20,10962000,6600,6600,5600,Northern_European,126,0,0,28766.0,Unknown,91170086,9111392.0,2.0,38,404,40,0,1,7,1,3,0.6235776660492194,0.5935828877005347,0.5661764705882353,0.0277682557186268,0.0,0.0,0.0747686921730432,0.0847711927981995,0.0505924720131114,0.1428571428571428,0.4651162790697669,0.25,202,71,32,6,0,3532,12,103,312,25000000,1236842.105263158,25000000.0,3000000.0,1750000.0,4500000.0,0,0,1.0833333333333333,2.5714285714285716
334042,Orbelín,Pineda,2024,2441,Mexico,Coyuca de CatalÃ¡n,Mexico,24-03-96,Central Midfield,Midfield,Right,169.0,30-06-27,Kick Talent,https://img.a.transfermarkt.technology/portrait/header/334042-1728415616.png?lm=1,GR1,Athlitiki Enosi Konstantinoupoleos,7000000.0,9000000.0,28,135,140,9,13,14,13,13,10,9,13,8,10,14,12,11,16,9,12,12,12,13,14,13,12,14,7,12,12,13,12,15,16,12,4,16,13,15,8,13,7,12,6,12,1,1,1,1,1,3,3,1,2,2,1,13,13,10,13,11,10,11,10,1,1,1,1,1,1,10,14,20,7,16,16,10,1,60,10,20,8636080,6750,6800,4500,Mediterranean_Hispanic,133,48,6,15440.0,AEK Athens,51052239,7520000.0,3.0,63,392,64,3,1,3,34,1,0.6500396930404869,0.4759358288770053,0.6176470588235294,0.0149004400317881,0.3157894736842105,0.0789473684210526,0.0347586896724181,0.0447611902975743,0.0417511597544376,0.2857142857142857,0.13953488372093,0.4166666666666665,435,48,40,35,3,12250,2,4,17,7000000,268000.0,9000000.0,3000000.0,300000.0,4000000.0,4,6500000,0.0,0.07692307692307693
334207,Maxim,Leitsch,2024,39,Germany,Essen,Germany,18-05-98,Centre-Back,Defender,Left,189.0,30-06-26,Sports360 GmbH,https://img.a.transfermarkt.technology/portrait/header/334207-1676499456.jpg?lm=1,L1,1. FuÃŸball- und Sportverein Mainz 05,2000000.0,5000000.0,26,128,138,4,8,8,6,11,12,13,6,8,14,12,7,13,11,12,13,14,12,14,11,13,13,8,8,8,13,13,14,13,11,15,14,14,16,12,13,13,4,15,13,9,2,2,3,3,2,2,3,2,1,1,4,8,13,6,13,12,15,15,17,1,15,20,1,12,1,1,1,1,1,1,1,1,1,75,20,10,3531771,6400,6400,4900,Northern_European,128,0,0,19177.0,Unknown,92084880,9111392.0,2.0,38,475,40,1,0,7,1,2,0.5971156390579518,0.5187165775401069,0.5808823529411764,0.0185089517548645,0.0,0.0,0.0097524381095273,0.0247561890472618,0.0505924720131114,0.1428571428571428,0.6046511627906974,0.3333333333333332,180,5,4,21,0,5358,12,120,365,2000000,70370.37037037036,5000000.0,1500000.0,200000.0,850000.0,2,150000,0.3333333333333333,0.0
334221,Amos,Pieper,2024,86,Germany,LÃ¼dinghausen,Germany,17-01-98,Centre-Back,Defender,Right,192.0,30-06-26,Sports360 GmbH,https://img.a.transfermarkt.technology/portrait/header/334221-1660208427.jpg?lm=1,L1,Sportverein Werder Bremen von 1899,4000000.0,7000000.0,26,127,137,4,6,9,7,11,6,13,7,9,13,12,5,13,11,9,12,13,11,13,11,14,12,5,13,7,12,15,12,12,10,14,16,15,13,15,15,15,7,14,6,13,3,1,2,4,3,2,2,4,2,2,1,9,13,4,12,12,15,13,16,1,1,20,1,1,1,1,1,1,1,1,1,1,1,86,10,20,3042181,6240,6240,4490,Northern_European,126,0,0,4999.0,Unknown,91173279,50000.0,1.0,38,886,40,1,1,7,194,2,0.5759460174649378,0.4748663101604277,0.5661764705882353,0.0048184301573859,0.0,0.0,0.0197549387346836,0.0347586896724181,0.0002500069446373,0.0,0.6744186046511627,0.3333333333333332,274,10,16,32,2,4171,12,39,99,3000000,140476.19047619047,7000000.0,2000000.0,,100000.0,2,1025000,-0.25,-0.4
334526,Denis,Zakaria,2024,162,Switzerland,Genf,Switzerland,20-11-96,Defensive Midfield,Midfield,Right,190.0,30-06-28,Unknown,https://img.a.transfermarkt.technology/portrait/header/334526-1667990520.jpg?lm=1,FR1,Association sportive de Monaco Football Club,28000000.0,45000000.0,28,146,155,7,9,14,10,13,8,11,11,12,13,13,8,16,13,17,14,17,13,13,12,12,15,12,11,14,14,16,17,14,13,15,15,15,15,17,15,15,13,14,9,9,1,2,3,3,3,3,2,3,2,3,2,13,16,6,10,11,15,12,14,1,1,13,1,1,1,20,1,20,1,1,1,1,1,81,8,20,16647882,7300,7000,5750,African_Caribbean,145,40,3,57808.0,Chelsea,98034601,9111392.0,2.0,92,530,92,3,1,1,24,4,0.6765017200317545,0.6096256684491979,0.7058823529411764,0.0558117123580663,0.2631578947368421,0.0394736842105263,0.1397849462365591,0.2248062015503876,0.0505924720131114,0.1428571428571428,0.6279069767441858,0.4166666666666665,354,40,15,77,0,5648,20,92,247,30000000,964516.1290322581,45000000.0,9000000.0,1000000.0,12000000.0,5,17900000,0.2,0.36363636363636365
334557,Unknown,Chiquinho,2024,683,Portugal,Santo Tirso,Portugal,19-07-95,Attacking Midfield,Midfield,Right,175.0,30-06-27,Vision Players,https://img.a.transfermarkt.technology/portrait/header/334557-1728417990.png?lm=1,GR1,Olympiakos Syndesmos Filathlon Peiraios,4000000.0,9000000.0,29,129,150,10,14,16,12,14,7,8,11,8,7,11,11,11,15,15,12,12,10,9,13,10,13,16,8,13,6,8,14,16,15,11,10,14,14,12,11,10,11,12,5,10,1,1,2,1,1,2,3,3,3,3,3,19,12,6,8,12,13,9,11,1,1,1,1,1,1,1,14,1,14,20,1,20,10,72,7,20,24532252,6450,5721,5018,African_Caribbean,127,0,0,28998.0,Unknown,83169933,9111392.0,2.0,76,1339,79,3,1,1,141,0,0.5072770574225985,0.5313368983957218,0.5735294117647058,0.0279922789243409,0.0,0.0,0.0197549387346836,0.0447611902975743,0.0505924720131114,0.1428571428571428,0.2790697674418605,0.4583333333333332,331,44,35,33,0,7347,7,18,61,4500000,184375.0,9000000.0,2000000.0,,75000.0,9,6975000,0.125,-0.1
334802,Jan,Kuchta,2024,865,Czech Republic,Liberec,Czech Republic,08-01-97,Centre-Forward,Attack,Left,185.0,30-06-28,SEG,https://img.a.transfermarkt.technology/portrait/header/334802-1716966274.jpg?lm=1,DK1,Fodbold Club Midtjylland,5000000.0,5000000.0,27,127,130,7,9,12,15,14,7,8,8,7,4,12,11,6,13,13,11,15,13,13,9,13,14,15,13,14,8,17,17,15,16,10,10,14,15,13,13,12,8,14,7,9,2,2,3,3,2,3,1,1,2,3,1,10,12,9,11,12,12,11,7,1,1,1,1,1,1,1,1,1,1,13,11,13,20,80,20,9,7254833,6350,6350,3500,Northern_European,127,0,0,37652.0,Sparta Prague,25045605,2650000.0,4.0,26,827,28,0,0,7,86,3,0.590500132310135,0.3689839572192513,0.5735294117647058,0.0363487307443846,0.0,0.0,0.0247561890472618,0.0247561890472618,0.0146948526347954,0.4285714285714285,0.5116279069767438,0.375,304,109,54,52,4,11511,6,24,47,4000000,205263.15789473685,5000000.0,1000000.0,,150000.0,8,2800000,-0.2,-0.047619047619047616
334835,Toma,Baši?,2024,398,Croatia,Zagreb,Croatia,25-11-96,Central Midfield,Midfield,Left,190.0,30-06-26,Soccer11,https://img.a.transfermarkt.technology/portrait/header/334835-1695026432.jpg?lm=1,IT1,SocietÃ  Sportiva Lazio S.p.A.,2800000.0,10000000.0,28,133,141,14,11,12,12,13,17,14,13,3,12,13,10,12,14,12,15,13,12,12,14,12,14,14,7,15,13,16,14,11,12,11,14,14,12,14,14,13,7,13,5,14,2,4,3,3,2,2,3,3,2,3,1,15,13,7,12,8,16,13,14,1,1,1,8,1,8,14,10,20,10,10,16,10,1,80,20,11,3296040,6650,6250,5500,Northern_European,133,2,0,34423.0,Unknown,24047067,5450000.0,2.0,24,1697,25,3,0,7,185,1,0.5772691188145012,0.5828877005347594,0.6176470588235294,0.0332307525924409,0.0131578947368421,0.0,0.0137534383595899,0.0497624406101525,0.0302508403011194,0.1428571428571428,0.6279069767441858,0.4166666666666665,267,24,21,41,0,4890,2,5,20,1000000,38000.0,10000000.0,1500000.0,50000.0,1000000.0,4,3150000,-0.6428571428571429,-0.7142857142857143
334999,Finn Ole,Becker,2024,533,Germany,Elmshorn,Germany,08-06-00,Central Midfield,Midfield,Left,177.0,30-06-26,Sports360 GmbH,https://img.a.transfermarkt.technology/portrait/header/334999-1657200994.jpg?lm=1,L1,TSG 1899 Hoffenheim FuÃŸball-Spielbetriebs GmbH,2500000.0,3000000.0,24,123,140,11,11,14,9,13,11,6,9,6,9,14,9,10,15,13,12,11,14,12,14,13,13,14,8,13,11,14,13,13,15,12,8,13,12,13,9,13,9,12,10,9,2,1,1,3,1,1,3,2,3,1,3,9,12,6,13,11,14,14,16,1,1,1,1,1,1,15,12,20,12,10,15,10,1,71,20,10,3999999,6050,6050,4000,Northern_European,122,0,0,4999.0,Unknown,91184463,9111392.0,2.0,38,459,40,3,0,7,199,1,0.5508070918232336,0.4224598930481283,0.536764705882353,0.0048184301573859,0.0,0.0,0.0122530632658164,0.0147536884221055,0.0505924720131114,0.1428571428571428,0.3255813953488373,0.25,226,11,15,12,1,3644,8,34,111,2000000,87500.0,3000000.0,1000000.0,,2500000.0,1,500000,-0.2,-0.3333333333333333
335003,Jean Manuel,Mbom,2024,1063,Germany,GÃ¶ttingen,Germany,24-02-00,Central Midfield,Midfield,Right,185.0,30-06-26,SEG,https://img.a.transfermarkt.technology/portrait/header/335003-1660208269.jpg?lm=1,DK1,Viborg Fodsports Forening,850000.0,3000000.0,24,122,139,9,9,10,10,11,12,10,12,8,9,12,14,10,13,15,12,16,14,12,13,12,15,12,12,10,10,14,14,13,12,14,12,17,12,14,14,12,10,16,10,15,1,2,1,1,2,2,3,2,2,2,1,10,14,8,12,16,13,13,10,1,12,1,15,1,14,20,12,18,12,1,10,1,1,79,10,20,3549999,6100,6000,4250,Mixed_Race,117,0,0,3288.0,Unknown,92083876,9111392.0,2.0,38,583,40,3,1,4,215,1,0.5441915850754168,0.4491978609625668,0.4999999999999999,0.0031662590152442,0.0,0.0,0.0040010002500625,0.0147536884221055,0.0505924720131114,0.1428571428571428,0.5116279069767438,0.25,218,28,14,49,0,4657,11,95,246,1000000,42105.26315789474,3000000.0,500000.0,200000.0,3000000.0,3,400000,0.17647058823529413,0.42857142857142855
335147,Junior,Sambia,2024,749,France,Lyon,France,07-09-96,Right-Back,Defender,Right,185.0,30-06-25,Unknown,https://img.a.transfermarkt.technology/portrait/header/335147-1604256946.jpg?lm=1,IT1,Empoli Football Club S.r.l.,2000000.0,6500000.0,28,125,131,8,15,15,8,12,13,8,13,6,10,12,9,12,12,12,11,12,12,9,10,11,11,13,7,14,12,9,10,14,13,14,12,13,14,15,14,11,12,13,10,14,4,1,1,1,1,1,3,3,2,2,2,5,12,9,11,13,10,14,13,1,10,1,18,10,20,13,1,15,1,1,13,1,1,73,8,20,2292767,6247,6347,3697,African_Caribbean,122,0,0,17185.0,Unknown,36515152,2000000.0,1.0,34,884,36,1,1,1,64,11,0.590103201905266,0.3900534759358288,0.536764705882353,0.0165854421609741,0.0,0.0,0.0097524381095273,0.032258064516129,0.0110836412122558,0.0,0.5116279069767438,0.4166666666666665,306,14,23,38,1,5725,3,5,58,1400000,54347.82608695652,6500000.0,1000000.0,150000.0,900000.0,4,2050000,-0.3,-0.44
335209,Kevin,Diks,2024,190,Netherlands,Apeldoorn,Netherlands,06-10-96,Centre-Back,Defender,Right,186.0,30-06-25,Grand Stand,https://img.a.transfermarkt.technology/portrait/header/335209-1695237676.jpg?lm=1,DK1,Football Club KÃ¸benhavn,4000000.0,4000000.0,28,126,135,6,11,13,13,12,6,14,10,15,11,10,7,12,12,16,14,13,12,12,13,11,13,13,8,14,11,14,15,16,12,13,12,13,13,14,11,8,10,13,11,14,2,2,3,1,3,2,2,1,3,3,2,15,12,6,12,12,13,10,13,1,12,12,20,1,18,1,1,1,1,1,1,1,1,73,8,20,3342456,6500,5950,4000,Mediterranean_Hispanic,123,0,0,13443.0,Unknown,37046467,2900000.0,1.0,67,79,68,1,1,3,90,2,0.5375760783275999,0.4224598930481283,0.5441176470588236,0.0129721023515677,0.0,0.0,0.0197549387346836,0.0197549387346836,0.0160837801050029,0.0,0.5348837209302322,0.4166666666666665,355,35,31,55,0,15380,7,38,62,4500000,171153.84615384616,4500000.0,1000000.0,1000000.0,1500000.0,7,3450000,0.125,0.2857142857142857
335225,Manu,Morlanes,2024,237,Spain,Zaragoza,Spain,12-01-99,Central Midfield,Midfield,Right,178.0,30-06-28,Goal Management,https://img.a.transfermarkt.technology/portrait/header/335225-1552044533.jpg?lm=1,ES1,Real Club Deportivo Mallorca S.A.D.,2500000.0,5000000.0,25,134,156,11,13,12,11,15,11,10,11,8,10,14,10,12,15,15,12,13,13,14,15,14,14,14,12,13,12,13,14,12,13,11,10,15,13,14,12,11,9,2,8,17,3,2,2,3,1,3,2,3,2,2,1,12,11,5,11,9,14,12,13,1,1,1,1,1,1,18,1,20,1,1,16,1,1,75,9,20,9619445,6600,6600,5200,Mediterranean_Hispanic,133,0,0,14048.0,Unknown,67228802,3166666.667,3.0,89,1699,89,3,1,3,166,1,0.6235776660492194,0.5508021390374331,0.6176470588235294,0.0135563007975033,0.0,0.0,0.0122530632658164,0.0247561890472618,0.0175653027417428,0.2857142857142857,0.3488372093023257,0.2916666666666665,230,7,11,33,1,5517,7,35,122,2500000,128947.36842105263,5000000.0,1500000.0,100000.0,2000000.0,6,1500000,0.0,0.0
335457,Ermedin,Demirovic,2024,79,Germany,Hamburg,Bosnia-Herzegovina,25-03-98,Centre-Forward,Attack,Right,185.0,30-06-28,ROOF,https://img.a.transfermarkt.technology/portrait/header/335457-1723707508.jpg?lm=1,L1,Verein fÃ¼r Bewegungsspiele Stuttgart 1893,28000000.0,28000000.0,26,128,140,6,9,12,14,13,6,12,11,5,6,12,11,6,14,14,13,13,13,12,11,13,14,12,7,15,6,14,14,13,13,13,12,15,14,13,12,13,14,14,4,10,1,1,1,2,2,3,1,3,2,1,2,12,14,13,10,12,13,6,6,1,1,1,1,1,1,1,1,1,1,1,15,12,20,85,12,20,2834139,6150,6150,4750,Northern_European,127,13,0,12499.0,Unknown,91158071,6725000.0,4.0,38,594,10,0,1,7,211,3,0.5640381053188674,0.5026737967914437,0.5735294117647058,0.012060559652455,0.0855263157894736,0.0,0.1397849462365591,0.1397849462365591,0.0373343703991777,0.4285714285714285,0.5116279069767438,0.3333333333333332,318,105,54,59,2,4191,1,2,20,28000000,1227272.7272727273,28000000.0,3000000.0,,1000000.0,6,4000000,0.0,0.4
335997,Luca,Plogmann,2024,1435,Germany,Bremen,Germany,10-03-00,Goalkeeper,Goalkeeper,Left,188.0,30-06-26,Acorado Sports GmbH,https://img.a.transfermarkt.technology/portrait/header/335997-1690211751.jpg?lm=1,NL1,Go Ahead Eagles,500000.0,550000.0,24,103,-75,5,2,3,2,11,6,8,2,1,1,12,1,1,12,10,11,12,16,10,8,12,16,3,11,3,8,15,12,11,12,10,13,13,10,9,10,12,6,15,6,10,11,11,14,15,9,11,13,13,15,11,12,7,15,10,13,14,13,8,10,20,1,1,1,1,1,1,1,1,1,1,1,1,1,78,20,7,16128000,5150,5150,3250,Northern_European,104,0,0,994.0,Unknown,92083875,9111392.0,2.0,38,253,40,2,0,7,108,5,0.4317279703625297,0.3422459893048128,0.4044117647058823,0.000951133007019,0.0,0.0,0.0022505626406601,0.002500625156289,0.0505924720131114,0.1428571428571428,0.581395348837209,0.25,0,0,0,0,0,0,3,44,213,800000,35000.0,800000.0,150000.0,500000.0,550000.0,7,750000,0.6,1.2857142857142858
336012,Nicolas,Kühn,2024,371,Germany,Wunstorf,Germany,01-01-00,Right Winger,Attack,Left,174.0,30-06-29,CN Sports,https://img.a.transfermarkt.technology/portrait/header/336012-1727807335.jpg?lm=1,SC1,The Celtic Football Club,3000000.0,3000000.0,24,122,139,12,11,16,11,13,12,6,11,3,5,12,12,6,15,13,11,8,11,9,13,10,11,15,4,13,5,11,11,16,14,12,9,12,16,11,7,12,6,11,11,12,2,3,1,3,3,3,2,2,1,2,1,12,13,12,7,12,11,12,10,1,1,1,1,1,1,1,15,1,15,18,14,20,14,69,20,7,3775000,6152,6148,4006,Mixed_Race,118,0,0,7671.0,Unknown,91172582,2000000.0,3.0,38,1677,40,0,0,4,200,10,0.5637734850489547,0.4231016042780748,0.5073529411764706,0.0073985594921625,0.0,0.0,0.0147536884221055,0.0147536884221055,0.0110836412122558,0.2857142857142857,0.2558139534883721,0.25,281,81,52,28,0,6065,14,85,109,10000000,513157.8947368421,10000000.0,300000.0,250000.0,1000000.0,4,1900000,3.0,5.666666666666667
336077,Altay,Bayindir,2024,985,TÃ¼rkiye,Bursa,TÃ¼rkiye,14-04-98,Goalkeeper,Goalkeeper,Right,198.0,30-06-27,SEFA SEYREK,https://img.a.transfermarkt.technology/portrait/header/336077-1699471821.jpg?lm=1,GB1,Manchester United Football Club,10000000.0,16000000.0,26,140,150,5,1,3,2,12,7,8,2,1,3,14,4,1,12,13,15,12,14,8,10,11,12,4,15,2,14,10,12,10,16,10,18,10,10,11,15,15,11,12,9,13,16,10,12,10,16,14,17,17,6,13,10,13,12,5,17,12,17,15,13,20,1,1,1,1,1,1,1,1,1,1,1,1,1,88,8,20,9254854,7100,7100,7000,Mediterranean_Hispanic,139,4,0,31279.0,Unknown,70099201,3250000.0,2.0,100,280,100,2,1,3,132,5,0.6897327335273882,0.7433155080213903,0.6617647058823528,0.0301948519081079,0.0263157894736842,0.0,0.0497624406101525,0.0797699424856214,0.0180282785632934,0.1428571428571428,0.8139534883720931,0.3333333333333332,0,0,0,0,0,0,10,54,103,10000000,383653.8461538461,16000000.0,2000000.0,25000.0,250000.0,2,4400000,0.0,0.0
336125,Mërgim,Vojvoda,2024,416,Germany,Hof (Saale),Kosovo,01-02-95,Right-Back,Defender,Right,187.0,30-06-25,Soccer11,https://img.a.transfermarkt.technology/portrait/header/336125-1661351703.jpg?lm=1,IT1,Torino Calcio,3000000.0,5500000.0,29,134,140,7,14,13,8,13,8,12,9,13,11,12,8,13,14,14,13,14,13,12,11,12,14,13,11,12,12,14,14,13,13,12,13,12,14,12,13,13,12,11,5,15,3,3,2,3,1,3,1,2,1,3,3,15,13,5,11,12,13,14,11,1,17,17,20,15,18,1,10,1,14,1,1,1,1,78,10,20,6121293,6700,6300,5150,Northern_European,126,45,2,17307.0,Unknown,18086509,3200000.0,2.0,38,630,59,1,1,7,201,11,0.5838846255623181,0.5454545454545454,0.5661764705882353,0.0167032474674273,0.2960526315789473,0.0263157894736842,0.0147536884221055,0.0272568142035508,0.0177504930692519,0.1428571428571428,0.5581395348837206,0.4583333333333332,302,6,23,50,0,3772,12,31,33,3000000,116000.0,5500000.0,1000000.0,,100000.0,4,1525000,0.0,-0.14285714285714285
336307,Christian,Früchtl,2024,1005,Germany,Bischofsmais,Germany,28-01-00,Goalkeeper,Goalkeeper,Left,193.0,30-06-27,Unknown,https://img.a.transfermarkt.technology/portrait/header/336307-1695655759.jpg?lm=1,IT1,Unione Sportiva Lecce,1500000.0,1500000.0,24,116,141,2,2,1,1,11,3,6,2,3,3,11,3,2,11,7,11,12,15,12,10,10,12,8,11,1,12,12,12,11,14,13,16,12,11,12,11,12,5,13,8,1,14,12,10,12,11,11,14,14,15,8,12,7,14,8,12,12,16,14,18,20,1,1,1,1,1,1,1,1,1,1,1,1,1,84,20,8,2839998,5800,5800,3532,Northern_European,116,0,0,6711.0,Unknown,91172526,750000.0,2.0,38,201,40,2,0,7,206,5,0.5177295580841492,0.3724064171122994,0.4926470588235294,0.0064715669167937,0.0,0.0,0.0072518129532383,0.0072518129532383,0.0041390038612183,0.1428571428571428,0.6976744186046511,0.25,0,0,0,0,0,0,8,47,99,1500000,64285.71428571428,1500000.0,100000.0,500000.0,600000.0,4,500000,0.0,0.0
336869,Marc,Roca,2024,150,Spain,Vilafranca del PenedÃ¨s,Spain,26-11-96,Defensive Midfield,Midfield,Left,184.0,30-06-29,Promoesport,https://img.a.transfermarkt.technology/portrait/header/336869-1719579269.jpg?lm=1,ES1,Real Betis BalompiÃ© S.A.D.,9000000.0,30000000.0,28,141,145,12,11,11,8,15,12,11,9,5,12,16,10,13,15,13,15,13,15,14,15,15,13,11,12,12,13,15,14,11,12,15,11,13,10,15,13,13,9,13,6,12,2,3,1,3,1,1,3,2,1,1,1,7,13,8,14,11,18,13,12,1,8,14,1,8,1,20,14,18,14,1,14,1,1,77,20,12,30060418,7050,7000,6000,Mediterranean_Hispanic,140,0,0,75395.0,Unknown,67211094,8500000.0,3.0,89,1593,89,3,0,3,164,4,0.6765017200317545,0.6363636363636364,0.6691176470588234,0.0727940232153703,0.0,0.0,0.0447611902975743,0.1497874468617154,0.047195755437651,0.2857142857142857,0.4883720930232553,0.4166666666666665,286,16,13,49,0,5700,8,38,93,8000000,298076.92307692306,30000000.0,10000000.0,,2000000.0,3,5000000,-0.1111111111111111,-0.2
336960,Giuseppe,Pezzella,2024,749,Italy,Napoli,Italy,29-11-97,Left-Back,Defender,Left,187.0,30-06-26,Unknown,https://img.a.transfermarkt.technology/portrait/header/336960-1661521548.jpg?lm=1,IT1,Empoli Football Club S.r.l.,2200000.0,6000000.0,27,133,145,9,12,11,7,12,8,11,7,12,12,13,6,14,12,14,12,13,12,13,10,11,17,8,10,13,12,15,15,14,13,14,12,15,14,15,14,14,8,12,3,14,1,3,1,3,3,3,3,1,2,3,3,10,12,5,15,17,17,14,17,1,20,12,10,19,10,1,17,1,1,1,1,1,1,81,20,10,4783677,6645,6645,4895,Mediterranean_Hispanic,128,0,0,16009.0,Salento,43161921,3439000.0,3.0,52,1016,54,1,0,3,64,8,0.6295316221222546,0.5181818181818182,0.5808823529411764,0.0154498762561473,0.0,0.0,0.010752688172043,0.0297574393598399,0.0190783077307702,0.2857142857142857,0.5581395348837206,0.375,227,5,14,39,3,7192,13,50,123,2500000,94230.76923076923,6000000.0,1200000.0,500000.0,3000000.0,6,3000000,0.13636363636363635,0.13636363636363635
337333,Alex,Král,2024,714,Slovakia,KoÅ¡ice,Czech Republic,19-05-98,Defensive Midfield,Midfield,Right,186.0,30-06-25,Unknown,https://img.a.transfermarkt.technology/portrait/header/337333-1691614545.jpg?lm=1,ES1,Reial Club Deportiu Espanyol de Barcelona S.A.D.,5000000.0,10000000.0,26,127,145,4,8,13,7,12,4,12,9,4,12,14,6,13,13,12,16,14,14,12,13,12,14,12,7,11,13,15,14,12,12,13,13,13,13,16,13,12,7,13,5,13,1,1,4,1,3,2,4,2,4,2,2,7,13,5,11,11,14,14,10,1,8,14,10,8,10,20,1,18,1,1,1,1,1,80,12,20,6242754,6346,6246,5346,Northern_European,127,31,2,29120.0,FC Schalke 04,25045644,6450000.0,2.0,86,753,28,3,1,7,170,4,0.5767398782746759,0.5664171122994652,0.5735294117647058,0.0281100842307941,0.2039473684210526,0.0263157894736842,0.0247561890472618,0.0497624406101525,0.0358065501819495,0.1428571428571428,0.5348837209302322,0.3333333333333332,263,4,18,20,0,5445,3,20,32,6000000,204310.3448275862,10000000.0,2500000.0,100000.0,1500000.0,7,10725000,0.2,-0.2
337715,Umar,Sadiq,2024,681,Nigeria,Kaduna,Nigeria,02-02-97,Centre-Forward,Attack,Right,191.0,30-06-28,CAA Base Ltd,https://img.a.transfermarkt.technology/portrait/header/337715-1728040426.jpg?lm=1,ES1,Real Sociedad de FÃºtbol S.A.D.,10000000.0,18000000.0,27,142,159,6,6,14,14,11,8,13,12,7,6,11,11,5,13,16,14,12,12,12,12,12,14,16,11,15,5,10,12,16,13,12,16,16,16,14,14,13,8,14,8,4,1,3,4,2,2,2,2,2,2,1,1,12,13,11,9,11,12,12,7,1,1,1,1,1,1,1,1,1,1,1,1,1,20,75,14,20,39711316,7000,6750,5750,African_Caribbean,140,7,1,22683.0,Unknown,43195181,8375000.0,4.0,69,698,70,0,1,1,168,3,0.6434241862926701,0.6096256684491979,0.6691176470588234,0.0218944058894928,0.0460526315789473,0.0131578947368421,0.0497624406101525,0.0897724431107777,0.0465012917025472,0.4285714285714285,0.6511627906976742,0.375,297,131,55,48,1,8084,7,75,292,5000000,165000.0,18000000.0,4000000.0,900000.0,1800000.0,8,3200000,-0.5,-0.6875
337725,Christian,Kouamé,2024,430,Cote d'Ivoire,Abidjan,Cote d'Ivoire,06-12-97,Left Winger,Attack,Right,185.0,30-06-25,MM-Management,https://img.a.transfermarkt.technology/portrait/header/337725-1663591953.jpg?lm=1,IT1,Associazione Calcio Fiorentina,7500000.0,22000000.0,27,136,144,5,8,15,14,13,10,13,10,4,4,11,12,4,13,12,13,14,12,11,11,13,14,14,7,13,10,12,12,17,15,13,13,14,16,13,10,12,9,12,10,11,1,1,2,2,1,1,2,3,2,3,2,14,14,6,13,11,14,14,12,1,1,1,1,1,1,1,1,1,1,17,1,17,20,70,9,20,7143604,6798,6248,5398,African_Caribbean,132,14,1,42692.0,Unknown,43201838,7326666.667,3.0,23,14,24,0,1,1,26,7,0.5770044985445886,0.5719786096256684,0.6102941176470589,0.0412154417650711,0.0921052631578947,0.0131578947368421,0.0372593148287071,0.1097774443610902,0.0406770558459957,0.2857142857142857,0.5116279069767438,0.375,360,55,55,39,1,10296,5,48,230,7500000,286538.46153846156,22000000.0,4500000.0,150000.0,5000000.0,7,11425000,0.0,-0.16666666666666666
337800,Gedson,Fernandes,2024,114,Sao Tome and Principe,SÃ£o TomÃ©,Portugal,09-01-99,Central Midfield,Midfield,Right,183.0,30-06-27,Gestifute,https://img.a.transfermarkt.technology/portrait/header/337800-1727354898.png?lm=1,TR1,Be?ikta? Jimnastik KulÃ¼bÃ¼,17000000.0,22000000.0,25,135,145,12,8,13,8,14,11,6,12,5,12,13,11,13,14,14,13,15,14,14,12,13,14,14,10,12,12,14,16,13,14,14,12,18,13,18,14,14,3,13,4,14,2,2,3,3,1,3,2,2,4,3,1,14,13,5,16,12,18,14,13,1,1,1,1,1,1,13,1,20,1,1,10,13,1,69,7,20,8198385,6850,6600,6050,African_Caribbean,135,2,0,38462.0,Unknown,83111338,6000000.0,1.0,80,1459,79,3,1,1,37,1,0.6235776660492194,0.641711229946524,0.6323529411764706,0.0371308807298521,0.0131578947368421,0.0,0.0847711927981995,0.1097774443610902,0.0333064807355759,0.0,0.4651162790697669,0.2916666666666665,275,27,37,46,1,8047,7,28,65,17000000,702083.3333333334,22000000.0,5000000.0,450000.0,15000000.0,7,22900000,0.13333333333333333,0.0
338285,Unai,Núñez,2024,621,Spain,Portugalete,Spain,30-01-97,Centre-Back,Defender,Right,186.0,30-06-25,LEADERBROCK,https://img.a.transfermarkt.technology/portrait/header/338285-1620308088.jpg?lm=1,ES1,Athletic Club Bilbao,7000000.0,20000000.0,27,132,152,7,7,7,8,11,8,14,10,10,15,11,9,15,10,14,12,15,12,12,10,13,13,7,11,8,14,15,14,12,12,11,14,14,12,14,14,13,12,10,5,11,3,1,2,1,4,1,3,3,1,1,1,17,13,7,15,14,14,12,12,1,1,20,13,1,10,1,1,1,1,1,1,1,1,81,10,20,15628426,6600,6600,5850,Mediterranean_Hispanic,131,1,0,13421.0,Vigo,67214595,9111392.0,2.0,89,1174,89,1,1,3,33,2,0.6235776660492194,0.6203208556149732,0.6029411764705883,0.0129508587717155,0.006578947368421,0.0,0.0347586896724181,0.0997749437359339,0.0505924720131114,0.1428571428571428,0.5348837209302322,0.375,237,7,5,55,0,3422,4,7,27,4000000,162500.0,20000000.0,5000000.0,,10000000.0,3,15700000,-0.42857142857142855,-0.3333333333333333
338424,Mikel,Merino,2024,11,Spain,Pamplona,Spain,22-06-96,Central Midfield,Midfield,Left,189.0,30-06-28,BahÃ­a Internacional,https://img.a.transfermarkt.technology/portrait/header/338424-1716803831.jpg?lm=1,GB1,Arsenal Football Club,50000000.0,50000000.0,28,153,159,8,11,14,10,14,10,14,12,8,14,16,10,13,15,15,13,15,13,15,16,14,16,13,12,14,14,15,15,12,13,13,14,16,13,17,16,14,9,15,9,15,3,2,2,3,1,1,1,2,1,3,2,11,17,9,12,14,15,12,10,1,1,12,1,1,1,14,8,20,1,8,14,1,1,79,20,10,32062500,7650,7650,5500,Mediterranean_Hispanic,152,11,0,47794.0,Unknown,67211760,13687500.0,4.0,89,1115,89,3,0,3,21,1,0.7625033077533738,0.5828877005347594,0.7573529411764706,0.0461420210562501,0.0723684210526315,0.0,0.2498124531132783,0.2498124531132783,0.0760160004444567,0.4285714285714285,0.6046511627906974,0.4166666666666665,370,40,37,86,3,6311,15,69,62,45000000,1629629.6296296297,50000000.0,6000000.0,1000000.0,2500000.0,4,12500000,-0.1,-0.1
338425,Álex,Berenguer,2024,621,Spain,BaraÃ±ain,Spain,04-07-95,Left Winger,Attack,Right,175.0,30-06-27,YOU FIRST,https://img.a.transfermarkt.technology/portrait/header/338425-1709676212.png?lm=1,ES1,Athletic Club Bilbao,12000000.0,15000000.0,29,144,153,14,12,15,13,13,12,6,10,5,8,13,8,7,14,9,11,11,12,11,12,12,14,14,8,14,9,11,13,15,16,14,7,13,14,12,8,12,10,12,7,18,1,2,4,1,3,2,2,1,1,1,1,7,13,2,11,12,12,13,12,1,14,1,8,17,12,1,19,1,17,20,15,15,14,73,12,20,60000001,7200,7200,6450,Mediterranean_Hispanic,129,0,0,24903.0,Unknown,67157520,9500000.0,2.0,89,138,89,0,1,3,33,7,0.702963747023022,0.6844919786096256,0.588235294117647,0.0240380762200332,0.0,0.0,0.0597649412353088,0.0747686921730432,0.052751465318481,0.1428571428571428,0.2790697674418605,0.4583333333333332,384,48,53,48,2,4195,9,15,45,12000000,487500.0,15000000.0,3000000.0,,300000.0,2,4000000,0.0,0.0
338629,Sebastiaan,Bornauw,2024,82,Belgium,Wemmel,Belgium,22-03-99,Centre-Back,Defender,Right,191.0,30-06-26,CAA Stellar,https://img.a.transfermarkt.technology/portrait/header/338629-1657202272.jpg?lm=1,L1,Verein fÃ¼r LeibesÃ¼bungen Wolfsburg,7000000.0,14000000.0,25,132,148,3,7,8,8,11,4,16,7,8,14,12,7,13,11,12,12,16,12,12,10,12,16,7,14,8,14,12,16,11,9,15,17,13,15,13,16,11,7,15,10,6,1,3,2,1,1,3,3,4,3,1,2,13,14,6,9,12,16,12,16,1,1,20,14,1,1,1,1,1,1,1,1,1,1,83,9,20,5607681,6594,6244,5594,Northern_European,131,2,0,57533.0,Unknown,18087987,10875000.0,2.0,7,1655,8,1,1,7,213,2,0.5764752580047632,0.5929411764705882,0.6029411764705883,0.0555461676099138,0.0131578947368421,0.0,0.0347586896724181,0.0697674418604651,0.0603905664046223,0.1428571428571428,0.6511627906976742,0.2916666666666665,184,12,5,39,2,3008,10,58,124,7000000,320000.0,14000000.0,3000000.0,,12000000.0,2,4500000,0.0,0.0
338637,Daam,Foulon,2024,354,Belgium,Mechelen,Belgium,23-03-99,Left-Back,Defender,Left,180.0,30-06-25,Stirr Associates,https://img.a.transfermarkt.technology/portrait/header/338637-1693901217.jpg?lm=1,BE1,Yellow-Red Koninklijke Voetbalclub Mechelen,1700000.0,1700000.0,25,118,140,8,12,12,9,12,8,11,9,9,12,13,7,14,12,16,11,10,11,11,11,12,14,11,10,12,13,14,14,13,12,13,10,15,13,13,13,12,13,12,6,9,3,3,1,2,3,2,3,4,3,1,2,15,14,5,10,11,14,13,13,1,20,1,1,19,1,1,1,1,1,1,1,1,1,70,20,9,1790243,5899,6249,4299,Northern_European,117,0,0,10230.0,Unknown,18097136,500000.0,1.0,7,936,8,1,0,7,223,8,0.5771368086795449,0.4544385026737967,0.4999999999999999,0.0098695740758801,0.0,0.0,0.0082520630157539,0.0082520630157539,0.0027500763910108,0.0,0.3953488372093026,0.2916666666666665,201,8,24,37,0,3988,5,27,71,3000000,170588.23529411765,3000000.0,200000.0,100000.0,700000.0,2,475000,0.7647058823529411,2.3333333333333335
338670,Mile,Svilar,2024,12,Belgium,Antwerpen,Serbia,27-08-99,Goalkeeper,Goalkeeper,Right,189.0,30-06-27,Universal Twenty Two,https://img.a.transfermarkt.technology/portrait/header/338670-1725532174.jpg?lm=1,IT1,Associazione Sportiva Roma,9000000.0,9000000.0,25,122,146,1,3,2,1,12,1,9,2,2,2,12,1,3,12,14,11,15,13,10,9,12,15,8,5,5,10,10,8,14,13,11,15,12,13,11,13,12,5,11,5,1,13,11,8,12,14,14,13,16,16,6,11,13,18,12,7,7,11,8,17,20,1,1,1,1,1,1,1,1,1,1,1,1,1,83,5,20,5379999,6091,5991,3941,Northern_European,121,1,0,24615.0,Unknown,18087914,2500000.0,1.0,7,74,85,2,1,7,29,5,0.5430007938608098,0.4161497326203208,0.5294117647058822,0.0237599784474226,0.006578947368421,0.0,0.0447611902975743,0.0447611902975743,0.0138614961526709,0.0,0.6046511627906974,0.2916666666666665,0,0,0,0,0,0,6,14,32,14000000,620454.5454545454,14000000.0,500000.0,2500000.0,2000000.0,2,2350000,0.5555555555555556,8.333333333333334
338672,Zinho,Vanheusden,2024,354,Belgium,Hasselt,Belgium,29-07-99,Centre-Back,Defender,Right,187.0,30-06-25,Stirr Associates,https://img.a.transfermarkt.technology/portrait/header/338672-1705488169.jpg?lm=1,BE1,Yellow-Red Koninklijke Voetbalclub Mechelen,3500000.0,18000000.0,25,131,150,9,9,10,10,11,12,14,8,4,14,13,11,14,12,11,13,14,14,14,12,14,15,13,14,10,14,14,14,11,12,12,14,13,11,12,13,13,11,14,15,12,1,2,1,1,1,1,2,3,1,4,1,12,13,7,12,14,16,12,14,1,1,20,1,1,1,1,1,1,1,1,1,1,1,78,8,20,8750000,6300,6500,5350,Northern_European,132,1,0,40000.0,AZ Alkmaar,18091405,9111392.0,2.0,7,600,8,1,1,7,223,2,0.6103466525535857,0.5668449197860962,0.6102941176470589,0.0386160000849743,0.006578947368421,0.0,0.0172543135783946,0.0897724431107777,0.0505924720131114,0.1428571428571428,0.5581395348837206,0.2916666666666665,176,11,1,32,2,5726,18,199,193,2500000,109090.90909090909,18000000.0,3000000.0,1000000.0,13500000.0,5,7600000,-0.5,-0.5833333333333334
338794,Fatih,Aksoy,2024,11282,TÃ¼rkiye,Istanbul,TÃ¼rkiye,06-11-97,Centre-Back,Defender,Right,189.0,30-06-25,DW Sports Management,https://img.a.transfermarkt.technology/portrait/header/338794-1724671174.jpg?lm=1,TR1,Alanyaspor,1800000.0,3800000.0,27,120,136,6,12,10,9,11,7,14,8,10,13,14,7,13,12,14,15,14,10,12,13,13,12,9,7,9,13,15,14,11,10,12,13,10,13,13,14,11,8,11,11,13,3,3,1,2,3,3,3,3,2,3,3,10,12,10,14,10,13,15,16,1,1,20,15,1,1,20,1,1,1,1,1,1,1,75,5,20,3443401,6100,6100,5000,Mediterranean_Hispanic,120,0,0,2488.0,Unknown,70102606,9111392.0,2.0,100,667,100,1,1,3,15,2,0.5574225985710506,0.5294117647058822,0.5220588235294117,0.0023937652024368,0.0,0.0,0.0087521880470117,0.018754688672168,0.0505924720131114,0.1428571428571428,0.6046511627906974,0.375,201,6,7,35,1,5545,2,6,16,1400000,52000.0,3800000.0,600000.0,,250000.0,4,950000,-0.391304347826087,-0.36363636363636365
339314,Deniz,Undav,2024,79,Germany,Varel,Germany,19-07-96,Centre-Forward,Attack,Right,179.0,30-06-27,Tenet Football,https://img.a.transfermarkt.technology/portrait/header/339314-1691999036.jpg?lm=1,L1,Verein fÃ¼r Bewegungsspiele Stuttgart 1893,28000000.0,28000000.0,28,130,135,7,9,13,17,13,8,14,9,4,5,10,11,7,12,10,11,16,13,11,12,9,15,10,6,13,12,12,11,13,12,16,11,9,13,13,15,15,10,10,10,11,2,2,1,3,1,3,1,3,1,4,1,6,14,14,7,13,8,7,10,1,1,1,1,1,1,1,12,1,14,19,14,15,20,86,9,20,5970952,6243,6243,4993,North_African__Middle_Eastern,123,0,0,25000.0,Unknown,91157307,16850000.0,2.0,38,1564,40,0,1,6,211,3,0.5763429478698069,0.528663101604278,0.5441176470588236,0.0241317410948361,0.0,0.0,0.1397849462365591,0.1397849462365591,0.0935859329425817,0.1428571428571428,0.3720930232558141,0.4166666666666665,322,152,66,47,1,3245,6,33,97,28000000,964655.1724137932,28000000.0,2000000.0,25000.0,175000.0,6,9250000,0.12,0.6470588235294118
339328,Owen,Wijndal,2024,610,Netherlands,Zaandam,Netherlands,28-11-99,Left-Back,Defender,Left,176.0,30-06-27,Team Raiola,https://img.a.transfermarkt.technology/portrait/header/339328-1696421801.jpg?lm=1,NL1,AFC Ajax Amsterdam,5500000.0,17500000.0,25,135,154,11,14,13,6,12,9,8,8,11,12,13,11,15,13,15,13,16,12,11,13,12,15,15,14,14,12,12,12,14,13,13,12,15,14,15,12,13,12,15,6,10,3,1,2,3,1,1,1,2,2,1,1,8,17,5,10,16,14,10,15,1,20,12,1,19,1,8,17,8,1,14,1,1,1,65,20,9,18832501,6500,6500,5250,African_Caribbean,130,11,0,27999.0,Unknown,37058888,10000000.0,1.0,67,1692,68,1,0,1,6,8,0.6103466525535857,0.5561497326203209,0.5955882352941175,0.0270276272755977,0.0723684210526315,0.0,0.0272568142035508,0.0872718179544886,0.055529320258896,0.0,0.3023255813953489,0.2916666666666665,297,7,40,47,1,8104,8,33,63,4000000,162500.0,17500000.0,3000000.0,750000.0,11000000.0,4,2350000,-0.2727272727272727,-0.2727272727272727
339332,Noa,Lang,2024,383,Netherlands,Capelle aan de IJssel,Netherlands,17-06-99,Left Winger,Attack,Right,170.0,30-06-28,Unknown,https://img.a.transfermarkt.technology/portrait/header/339332-1642424716.jpg?lm=1,NL1,Eindhovense Voetbalvereniging Philips Sport Vereniging,18000000.0,25000000.0,25,135,145,11,14,15,13,15,11,9,12,5,6,14,11,6,15,16,12,16,14,11,14,13,10,16,7,14,8,13,14,14,14,10,10,14,13,12,9,11,9,8,4,14,3,1,2,2,3,3,2,2,2,3,1,14,14,16,12,8,6,4,13,1,1,1,1,1,1,1,12,1,12,20,1,19,12,68,12,20,17445600,6744,6744,5494,Northern_European,134,5,1,29999.0,Unknown,37055842,9250000.0,2.0,67,313,68,0,1,7,62,7,0.642630325482932,0.5822459893048127,0.625,0.0289588618076162,0.0328947368421052,0.0131578947368421,0.0897724431107777,0.1247811952988247,0.0513625378482735,0.1428571428571428,0.1627906976744184,0.2916666666666665,299,87,69,37,1,9809,16,97,197,20000000,865217.3913043478,25000000.0,4000000.0,250000.0,2700000.0,6,9150000,0.1111111111111111,0.0
339337,Armando,Obispo,2024,383,Netherlands,'s-Hertogenbosch,Netherlands,05-03-99,Centre-Back,Defender,Left,185.0,30-06-25,Unknown,https://img.a.transfermarkt.technology/portrait/header/339337-1613229330.jpg?lm=1,NL1,Eindhovense Voetbalvereniging Philips Sport Vereniging,3500000.0,5500000.0,25,128,140,10,11,9,5,11,11,15,11,8,13,12,11,13,12,12,12,14,14,13,13,11,14,8,12,12,12,14,15,12,12,13,13,14,12,16,13,13,7,12,7,10,4,2,2,2,2,4,1,3,2,1,1,10,13,7,10,15,15,15,15,1,13,20,1,12,1,17,1,1,1,1,1,1,1,0,20,10,5152835,6191,6191,4241,African_Caribbean,126,0,0,3999.0,Unknown,37056071,9111392.0,2.0,67,0,68,1,0,1,62,2,0.5694628208520773,0.448235294117647,0.5661764705882353,0.0038528128913767,0.0,0.0,0.0172543135783946,0.0272568142035508,0.0505924720131114,0.1428571428571428,0.5116279069767438,0.2916666666666665,197,7,5,19,1,6131,7,88,246,3500000,150000.0,5500000.0,1000000.0,500000.0,900000.0,2,350000,0.0,-0.2222222222222222
339340,Tyrell,Malacia,2024,985,Netherlands,Rotterdam,Netherlands,17-08-99,Left-Back,Defender,Left,169.0,30-06-26,Darren Dein,https://img.a.transfermarkt.technology/portrait/header/339340-1657096025.jpg?lm=1,GB1,Manchester United Football Club,18000000.0,22000000.0,25,139,150,7,13,12,7,13,9,9,8,12,14,12,7,13,13,15,13,16,14,14,11,14,16,10,9,13,13,15,17,15,17,13,8,16,14,15,7,14,5,14,6,8,2,1,1,1,4,2,3,1,1,2,2,12,15,7,14,15,14,16,16,1,20,1,1,19,1,1,14,1,1,10,1,1,1,67,20,10,37268142,7300,6650,5500,African_Caribbean,138,5,0,57996.0,Unknown,37058363,15000000.0,1.0,67,1253,68,1,0,1,132,8,0.6301931727970362,0.5828877005347594,0.6544117647058822,0.055993248404076,0.0328947368421052,0.0,0.0897724431107777,0.1097774443610902,0.0833078696630462,0.0,0.13953488372093,0.2916666666666665,251,7,12,40,2,10179,9,105,500,15000000,592000.0,22000000.0,4000000.0,2000000.0,3200000.0,1,5000000,-0.16666666666666666,-0.16666666666666666
339556,Rico,Henry,2024,1148,England,Birmingham,England,08-07-97,Left-Back,Defender,Left,170.0,30-06-26,Unknown,https://img.a.transfermarkt.technology/portrait/header/339556-1684771012.jpg?lm=1,GB1,Brentford Football Club,20000000.0,28000000.0,27,137,145,7,13,14,9,14,7,12,8,8,12,13,7,13,13,12,13,13,14,13,13,14,15,13,9,12,13,13,14,16,13,13,8,14,16,13,12,15,4,13,11,11,1,3,2,2,4,4,2,3,2,4,1,13,14,7,12,14,14,15,14,1,20,1,1,19,1,1,14,1,1,12,1,1,1,66,20,7,29038095,6850,6850,6000,Mixed_Race,133,0,0,46397.0,Unknown,29129073,1800000.0,1.0,32,199,33,1,0,4,43,8,0.6566551997883038,0.6363636363636364,0.6176470588235294,0.0447930537356352,0.0,0.0,0.0997749437359339,0.1397849462365591,0.0099724992360898,0.0,0.1627906976744184,0.375,262,8,15,20,1,3722,6,174,420,20000000,798000.0,28000000.0,5000000.0,500000.0,1500000.0,1,750000,0.0,-0.2
339699,Giovanni,González,2024,16704,Uruguay,Montevideo,Uruguay,20-09-94,Right-Back,Defender,Right,173.0,30-06-27,Promoesport,https://img.a.transfermarkt.technology/portrait/header/339699-1723878108.png?lm=1,RU1,FK Krasnodar,3000000.0,3000000.0,30,129,132,7,12,12,13,11,11,9,10,13,12,11,6,11,12,13,11,12,10,12,10,12,12,11,13,15,11,13,16,15,14,9,8,15,13,14,10,13,11,10,8,16,1,2,2,2,3,3,2,3,4,1,1,11,13,8,13,11,12,10,12,1,15,1,18,10,20,8,1,1,19,1,1,1,1,73,10,20,4878009,6650,6650,5800,Mediterranean_Hispanic,121,16,0,12637.0,Unknown,78071163,2083500.0,2.0,106,975,103,1,1,3,78,11,0.6301931727970362,0.6149732620320855,0.5294117647058822,0.0121938148351643,0.1052631578947368,0.0,0.0147536884221055,0.0147536884221055,0.0115475429873052,0.1428571428571428,0.2325581395348837,0.5,298,13,31,54,1,12364,5,24,47,2800000,142105.26315789475,3000000.0,500000.0,,100000.0,3,775000,-0.06666666666666667,0.12
339808,Theo,Hernández,2024,5,France,Marseille,France,06-10-97,Left-Back,Defender,Left,184.0,30-06-26,Unknown,https://img.a.transfermarkt.technology/portrait/header/339808-1725532072.jpg?lm=1,IT1,Associazione Calcio Milan,60000000.0,60000000.0,27,159,167,8,15,16,13,14,12,13,15,11,12,13,15,14,13,18,13,14,12,11,12,12,16,13,13,17,11,12,13,17,14,17,12,16,18,16,13,14,16,14,6,11,1,2,1,1,1,1,3,2,1,1,3,17,15,14,10,15,14,6,9,1,20,10,1,20,1,1,15,1,1,10,1,1,1,81,20,8,179870630,7950,7900,7250,Mediterranean_Hispanic,149,7,1,98653.0,Unknown,67211695,9111392.0,2.0,34,919,36,1,0,3,27,8,0.7955808414924583,0.7700534759358288,0.7352941176470587,0.0952523495882125,0.0460526315789473,0.0131578947368421,0.2998249562390597,0.2998249562390597,0.0505924720131114,0.1428571428571428,0.4883720930232553,0.375,346,38,54,77,6,8974,16,33,54,50000000,1884615.3846153845,60000000.0,10000000.0,1000000.0,15000000.0,3,8000000,-0.16666666666666666,-0.09090909090909091
339816,Unknown,Tete Morente,2024,1005,Spain,La LÃ­nea de la ConcepciÃ³n,Spain,04-12-96,Left Winger,Attack,Right,184.0,30-06-27,Unknown,https://img.a.transfermarkt.technology/portrait/header/339816-1601023490.jpg?lm=1,IT1,Unione Sportiva Lecce,2500000.0,3000000.0,28,129,137,8,13,15,13,12,13,11,13,6,8,12,11,5,14,12,11,6,11,9,12,11,13,12,7,12,9,3,14,14,13,9,11,15,15,13,11,13,4,8,10,11,1,1,1,3,3,4,2,3,2,1,1,11,14,9,11,10,14,10,13,1,1,1,1,1,1,1,19,7,15,20,9,16,8,78,10,20,2374688,6250,6250,4600,Mediterranean_Hispanic,120,0,0,6639.0,Unknown,67211699,500000.0,1.0,89,783,89,0,1,3,206,7,0.5772691188145012,0.4866310160427807,0.5220588235294117,0.006402042473641,0.0,0.0,0.0122530632658164,0.0147536884221055,0.0027500763910108,0.0,0.4883720930232553,0.4166666666666665,277,30,22,42,0,2076,0,0,0,2000000,86956.52173913043,3000000.0,500000.0,,200000.0,6,800000,-0.2,-0.2
339820,Amath,Ndiaye,2024,366,Senegal,Dakar,Senegal,16-07-96,Right Winger,Attack,Right,173.0,30-06-27,EF11 SL,https://img.a.transfermarkt.technology/portrait/header/339820-1510233284.jpg?lm=1,ES1,Real Valladolid Club de FÃºtbol S.A.D.,1500000.0,5000000.0,28,130,145,9,12,13,13,12,7,7,11,9,4,9,6,4,13,11,12,13,10,9,11,8,10,14,9,14,4,10,12,16,15,11,9,13,17,14,11,11,7,11,6,12,3,3,1,1,3,1,2,2,1,2,1,9,10,4,12,11,11,14,15,1,1,1,1,1,1,1,10,1,10,17,14,20,19,67,8,20,3430108,6400,6350,4256,African_Caribbean,120,4,0,8491.0,Unknown,67213756,2666666.667,3.0,83,402,84,0,1,1,169,10,0.590500132310135,0.4498395721925133,0.5220588235294117,0.0081903656502901,0.0263157894736842,0.0,0.0072518129532383,0.0247561890472618,0.0147874478013278,0.2857142857142857,0.2325581395348837,0.4166666666666665,233,36,18,38,1,4061,5,71,375,1200000,50000.0,5000000.0,1000000.0,,1000000.0,4,2700000,-0.2,-0.2
340166,Alessio,Castro-Montes,2024,3948,Belgium,Sint-Truiden,Belgium,17-05-97,Right Midfield,Midfield,Right,175.0,30-06-26,CM FC,https://img.a.transfermarkt.technology/portrait/header/340166-1714468225.png?lm=1,BE1,Royale Union Saint-Gilloise,6000000.0,6000000.0,27,124,127,11,13,12,8,12,10,8,8,8,10,10,12,7,12,11,12,13,12,14,14,14,12,13,12,14,11,14,14,14,11,7,7,14,13,14,7,14,13,12,13,17,2,3,1,2,3,1,4,2,1,1,2,14,14,2,11,12,11,12,18,1,1,1,20,1,19,11,14,12,18,14,12,17,1,66,8,20,4700925,6243,6243,3269,Northern_European,109,0,0,5999.0,Unknown,18089340,1600000.0,2.0,7,1376,8,3,1,7,177,9,0.5763429478698069,0.3442780748663101,0.4411764705882353,0.0057840474233951,0.0,0.0,0.0297574393598399,0.0297574393598399,0.0088613572599238,0.1428571428571428,0.2790697674418605,0.375,290,22,28,36,0,9302,7,36,53,6000000,270454.54545454547,6000000.0,800000.0,,200000.0,3,900000,0.0,0.5
340251,Burak,Kapacak,2024,36,TÃ¼rkiye,Bursa,TÃ¼rkiye,08-12-99,Right Winger,Attack,Right,180.0,30-06-26,Unknown,https://img.a.transfermarkt.technology/portrait/header/340251-1706883569.png?lm=1,TR1,FenerbahÃ§e Spor KulÃ¼bÃ¼,275000.0,2000000.0,25,115,135,13,13,15,10,11,5,8,11,5,7,11,4,8,13,11,10,10,10,11,11,8,12,13,6,13,9,12,14,16,13,9,8,12,15,12,9,12,5,5,7,10,3,2,1,3,3,2,1,2,1,1,2,12,10,5,8,10,12,12,5,1,1,1,14,1,10,1,13,1,17,18,1,20,1,70,7,20,3188336,5800,5800,3803,Mediterranean_Hispanic,112,0,0,3545.0,Fatih KaragÃ¼mrÃ¼k A.Åž.,70116131,1350000.0,1.0,100,280,100,0,1,3,84,10,0.5177295580841492,0.4013903743315508,0.463235294117647,0.0034144226526085,0.0,0.0,0.00112528132033,0.0097524381095273,0.0074724297897163,0.0,0.3953488372093026,0.2916666666666665,128,8,20,17,0,2443,9,62,242,200000,6521.739130434783,2000000.0,600000.0,300000.0,1000000.0,5,525000,-0.5,-0.6666666666666666
340321,Josh,Dasilva,2024,1148,England,London,England,23-10-98,Central Midfield,Midfield,Left,184.0,30-06-25,CAA Base Ltd,https://img.a.transfermarkt.technology/portrait/header/340321-1596444356.jpg?lm=1,GB1,Brentford Football Club,10000000.0,16000000.0,26,129,146,8,12,13,13,13,9,10,14,8,11,14,10,12,13,12,14,11,14,13,13,13,15,14,9,13,11,14,13,13,12,12,11,14,13,13,13,14,8,11,9,15,2,1,1,1,1,1,4,2,4,2,2,14,13,5,13,13,15,13,14,1,10,8,1,1,1,12,1,20,1,11,14,11,1,71,20,10,14452211,6450,6450,5000,African_Caribbean,129,0,0,40597.0,Unknown,28106685,9111392.0,2.0,32,858,33,3,0,1,43,1,0.6037311458057687,0.5294117647058822,0.588235294117647,0.0391924735927818,0.0,0.0,0.0497624406101525,0.0797699424856214,0.0505924720131114,0.1428571428571428,0.4883720930232553,0.3333333333333332,217,26,20,10,2,3472,4,133,405,10000000,650000.0,16000000.0,4000000.0,,750000.0,0,0,0.0,-0.16666666666666666
340322,Nathan,Tella,2024,15,England,Stevenage,Nigeria,05-07-99,Right Midfield,Midfield,Right,173.0,30-06-28,CAA Stellar,https://img.a.transfermarkt.technology/portrait/header/340322-1727377772.jpg?lm=1,L1,Bayer 04 Leverkusen FuÃŸball,23000000.0,23000000.0,25,126,144,4,11,14,11,11,7,7,8,4,7,11,8,9,11,7,10,10,11,10,11,10,16,11,7,12,7,14,16,16,13,6,7,15,16,15,7,11,3,10,7,10,1,1,3,2,3,2,2,1,4,2,2,7,11,8,11,10,10,10,10,1,1,1,1,1,1,1,12,1,14,14,12,20,20,0,9,20,11912733,6300,6300,4600,African_Caribbean,115,0,0,23198.0,Burnley,28106683,23300000.0,1.0,32,1423,70,3,1,1,36,9,0.5838846255623181,0.4866310160427807,0.4852941176470588,0.0223916987814875,0.0,0.0,0.1147786946736684,0.1147786946736684,0.1294202616739354,0.0,0.2325581395348837,0.2916666666666665,217,45,27,19,0,8925,5,29,55,18000000,1326923.076923077,23000000.0,5000000.0,,,3,12200000,-0.21739130434782608,-0.21739130434782608
340324,Eddie,Nketiah,2024,873,England,London,England,30-05-99,Centre-Forward,Attack,Right,175.0,30-06-29,Unknown,https://img.a.transfermarkt.technology/portrait/header/340324-1675331055.jpg?lm=1,GB1,Crystal Palace Football Club,30000000.0,35000000.0,25,138,155,2,7,14,14,13,5,12,9,1,3,11,8,4,14,11,13,10,14,11,11,12,14,13,4,15,4,15,14,17,16,13,9,14,17,14,10,14,6,12,8,10,1,3,2,3,2,1,2,2,2,1,3,8,14,4,13,14,13,13,14,1,1,1,1,1,1,1,8,1,12,15,12,15,20,0,12,20,30273843,6900,6900,5500,African_Caribbean,132,0,0,86994.0,Unknown,28106687,29700000.0,1.0,32,858,33,0,1,1,58,3,0.6632707065361206,0.5828877005347594,0.6102941176470589,0.0839942178838111,0.0,0.0,0.1497874468617154,0.1747936984246061,0.1649768049112475,0.0,0.2790697674418605,0.2916666666666665,269,91,19,20,1,8576,2,10,43,25000000,944444.4444444445,35000000.0,5000000.0,,11000000.0,1,5000000,-0.16666666666666666,-0.2857142857142857
340325,Reiss,Nelson,2024,931,England,London,England,10-12-99,Right Winger,Attack,Right,175.0,30-06-25,Unknown,https://img.a.transfermarkt.technology/portrait/header/340325-1667418642.jpg?lm=1,GB1,Fulham Football Club,15000000.0,17000000.0,25,134,155,12,12,15,8,11,12,6,12,8,5,13,10,5,15,12,11,13,10,9,12,11,12,16,5,12,5,12,14,16,16,14,7,14,16,13,8,12,6,13,6,16,1,1,1,2,1,2,2,2,2,2,2,8,14,11,12,15,10,15,13,1,1,1,1,10,12,1,15,1,16,18,14,20,12,71,10,20,28533967,6749,6749,5749,Mixed_Race,128,0,0,46397.0,Unknown,28107919,9111392.0,2.0,32,858,33,0,1,4,95,10,0.6432918761577137,0.6095187165775401,0.5808823529411764,0.0447930537356352,0.0,0.0,0.0747686921730432,0.0847711927981995,0.0505924720131114,0.1428571428571428,0.2790697674418605,0.2916666666666665,231,46,30,16,0,10310,13,82,78,18000000,1035294.1176470588,18000000.0,3000000.0,7500000.0,12500000.0,4,8500000,0.2,0.2
340328,Stephy,Mavididi,2024,1003,England,Derby,England,31-05-98,Left Winger,Attack,Right,182.0,30-06-28,Unknown,https://img.a.transfermarkt.technology/portrait/header/340328-1707385825.jpg?lm=1,GB1,Leicester City Football Club,11000000.0,11000000.0,26,129,140,4,7,14,14,12,4,14,11,1,3,11,9,5,13,12,13,12,13,12,10,12,13,9,5,14,8,13,14,15,12,14,14,13,15,15,14,13,6,13,10,7,2,4,3,1,1,4,1,1,2,3,2,7,14,9,8,12,12,12,12,1,1,1,1,1,1,1,1,1,1,15,10,12,20,71,8,20,4108191,6450,6050,4256,African_Caribbean,128,0,0,6898.0,Unknown,28099981,5100000.0,3.0,32,410,33,0,1,1,127,7,0.5508070918232336,0.4498395721925133,0.5808823529411764,0.0066521373455374,0.0,0.0,0.0547636909227306,0.0547636909227306,0.0283063418428289,0.2857142857142857,0.4418604651162785,0.3333333333333332,332,84,20,21,1,5964,5,37,90,11000000,467391.3043478261,11000000.0,2000000.0,,600000.0,5,5600000,0.0,0.2222222222222222
340329,Joe,Willock,2024,762,England,London,England,20-08-99,Central Midfield,Midfield,Right,186.0,30-06-27,Unknown,https://img.a.transfermarkt.technology/portrait/header/340329-1683890024.jpg?lm=1,GB1,Newcastle United Football Club,30000000.0,38000000.0,25,135,155,7,11,14,13,14,10,7,11,4,7,14,9,10,14,10,12,12,14,12,13,13,13,15,4,14,9,14,14,17,17,12,8,13,14,14,12,13,6,13,8,14,3,2,4,2,3,3,3,3,2,1,2,17,16,8,12,13,13,13,14,1,1,1,1,1,1,12,12,20,12,13,12,13,1,71,10,20,49505273,6750,6750,5500,African_Caribbean,133,0,0,92793.0,Unknown,28106684,29400000.0,1.0,32,858,33,3,1,1,137,1,0.6434241862926701,0.5828877005347594,0.6176470588235294,0.0895938324093985,0.0,0.0,0.1497874468617154,0.1897974493623406,0.1633100919469985,0.0,0.5348837209302322,0.2916666666666665,265,47,28,16,1,7715,10,51,92,28000000,1375000.0,38000000.0,5000000.0,,16000000.0,3,6000000,-0.06666666666666667,-0.2
340353,Maduka,Okoye,2024,410,Germany,DÃ¼sseldorf,Nigeria,28-08-99,Goalkeeper,Goalkeeper,Right,197.0,30-06-28,GG11 ,https://img.a.transfermarkt.technology/portrait/header/340353-1708096758.jpeg?lm=1,IT1,Udinese Calcio,4000000.0,4000000.0,25,119,135,3,1,2,3,7,8,6,2,3,2,7,4,1,8,8,11,13,10,11,6,11,13,10,8,3,11,8,7,10,15,14,16,13,9,12,16,13,7,5,11,15,17,11,10,10,13,15,14,15,11,8,10,14,12,7,12,15,14,15,14,20,1,1,1,1,1,1,1,1,1,1,1,1,1,92,6,20,5706793,5950,6000,4500,African_Caribbean,118,16,0,10000.0,Unknown,91184334,3916666.667,3.0,38,443,70,2,1,1,205,5,0.5441915850754168,0.4759358288770053,0.5073529411764706,0.009647482104698,0.1052631578947368,0.0,0.0197549387346836,0.0197549387346836,0.0217320851523653,0.2857142857142857,0.7906976744186047,0.2916666666666665,0,0,0,0,0,0,9,52,133,7500000,354761.90476190473,7500000.0,1000000.0,50000.0,150000.0,3,1000000,0.875,2.75
340376,Abel,Ruiz,2024,12321,Spain,Almussafes,Spain,28-01-00,Centre-Forward,Attack,Right,182.0,30-06-29,DV7 Management,https://img.a.transfermarkt.technology/portrait/header/340376-1694617385.jpg?lm=1,ES1,Girona FÃºtbol Club S. A. D.,12000000.0,14000000.0,24,128,150,8,10,14,13,15,9,13,12,3,4,13,15,6,15,10,12,13,11,10,13,12,14,15,11,13,6,7,8,13,13,14,12,15,14,13,14,10,6,15,5,12,3,3,2,3,1,4,2,3,1,3,2,11,12,5,15,14,15,11,12,1,1,1,1,1,1,1,1,1,1,14,9,14,20,73,12,20,8215000,6397,6497,4897,Mediterranean_Hispanic,127,2,0,8150.0,Unknown,67245418,8500000.0,2.0,89,51,89,0,1,3,107,3,0.6099497221487166,0.5183957219251336,0.5735294117647058,0.0078610901625809,0.0131578947368421,0.0,0.0597649412353088,0.0697674418604651,0.047195755437651,0.1428571428571428,0.4418604651162785,0.25,295,54,25,26,1,5436,5,22,64,7500000,331818.1818181818,14000000.0,4500000.0,3000000.0,5000000.0,2,6500000,-0.375,-0.375
340456,Noussair,Mazraoui,2024,985,Netherlands,Leiderdorp,Morocco,14-11-97,Right-Back,Defender,Right,183.0,30-06-28,Rafaela Pimenta,https://img.a.transfermarkt.technology/portrait/header/340456-1700207898.jpg?lm=1,GB1,Manchester United Football Club,30000000.0,30000000.0,27,145,153,8,12,13,11,15,7,11,12,12,13,14,9,14,13,13,12,14,13,13,14,13,12,14,11,16,13,16,16,14,13,13,11,12,13,15,10,13,6,12,8,17,3,3,2,3,2,1,3,4,3,3,1,10,12,4,11,10,12,13,10,1,12,10,20,12,18,18,1,16,16,1,10,16,1,65,8,20,15118068,7241,6511,5753,North_African__Middle_Eastern,136,12,2,153425.0,Unknown,37052470,15000000.0,1.0,67,815,67,1,1,6,132,11,0.6118020640381053,0.609946524064171,0.6397058823529411,0.1481411384820689,0.0789473684210526,0.0263157894736842,0.1497874468617154,0.1497874468617154,0.0833078696630462,0.0,0.4651162790697669,0.375,330,23,33,27,1,9884,24,103,62,32000000,1279000.0,32000000.0,3000000.0,25000.0,6000000.0,3,7900000,0.06666666666666667,0.06666666666666667
340459,Dani,De Wit,2024,80,Netherlands,Hoorn,Netherlands,28-01-98,Attacking Midfield,Midfield,Right,184.0,30-06-28,PUM,https://img.a.transfermarkt.technology/portrait/header/340459-1721851359.jpg?lm=1,L1,Verein fÃ¼r LeibesÃ¼bungen Bochum 1848 FuÃŸballgemeinschaft,5000000.0,5000000.0,26,126,133,7,8,7,13,11,7,14,10,7,9,11,14,9,11,16,15,17,13,15,10,13,15,10,14,15,9,17,18,11,11,15,12,15,12,17,16,16,12,14,4,10,1,2,1,3,4,1,3,3,4,2,3,11,8,4,12,10,12,12,10,1,1,1,1,1,1,10,13,19,13,10,20,10,13,78,12,20,6727499,6250,6250,4755,Northern_European,124,0,0,7191.0,Unknown,37055853,2000000.0,1.0,67,633,68,3,1,7,212,0,0.5772691188145012,0.5032085561497326,0.5514705882352942,0.0069350632044781,0.0,0.0,0.0247561890472618,0.0247561890472618,0.0110836412122558,0.0,0.4883720930232553,0.3333333333333332,351,86,38,53,2,10205,4,36,111,4000000,171739.13043478262,5000000.0,1000000.0,,1000000.0,4,2225000,-0.2,-0.1111111111111111
340853,Javi,Sánchez,2024,366,Spain,Getafe,Spain,14-03-97,Centre-Back,Defender,Right,189.0,30-06-26,LEADERBROCK,https://img.a.transfermarkt.technology/portrait/header/340853-1448530734.jpg?lm=1,ES1,Real Valladolid Club de FÃºtbol S.A.D.,1500000.0,3000000.0,27,132,142,6,2,3,6,7,9,16,5,11,13,7,5,14,8,8,11,12,13,14,8,13,11,3,11,8,14,13,14,11,11,13,15,16,13,14,15,13,11,11,11,5,2,3,3,2,1,1,1,2,1,2,3,18,10,8,10,11,11,11,19,1,1,20,1,1,1,1,1,1,1,1,1,1,1,76,17,20,4630645,6600,6600,4500,Mediterranean_Hispanic,129,0,0,11664.0,Unknown,67216745,3000000.0,1.0,89,536,89,1,1,3,169,2,0.6235776660492194,0.4759358288770053,0.588235294117647,0.0112542692353373,0.0,0.0,0.0072518129532383,0.0147536884221055,0.0166393510930859,0.0,0.6046511627906974,0.375,195,13,3,51,1,3477,8,68,241,2000000,82608.69565217392,3000000.0,500000.0,,300000.0,1,500000,0.3333333333333333,0.0
340918,Caoimhín,Kelleher,2024,31,Ireland,Cork,Ireland,23-11-98,Goalkeeper,Goalkeeper,Right,188.0,30-06-26,Unknown,https://img.a.transfermarkt.technology/portrait/header/340918-1708933663.jpg?lm=1,GB1,Liverpool Football Club,20000000.0,20000000.0,26,138,154,2,3,1,3,14,5,11,1,1,2,12,5,1,13,7,13,13,14,14,8,13,15,2,15,2,14,13,12,13,14,13,13,13,12,10,11,13,14,14,11,14,14,11,10,8,14,12,14,16,13,11,12,15,14,4,14,16,15,13,17,20,1,1,1,1,1,1,1,1,1,1,1,1,1,0,8,20,25967650,6900,6900,5500,Northern_European,138,8,0,34798.0,Unknown,28104130,9111392.0,2.0,49,384,52,2,1,7,129,5,0.6632707065361206,0.5828877005347594,0.6544117647058822,0.0335928590671944,0.0526315789473684,0.0,0.0997749437359339,0.0997749437359339,0.0505924720131114,0.1428571428571428,0.581395348837209,0.3333333333333332,0,0,0,0,0,0,3,15,106,22000000,1264705.8823529412,22000000.0,100000.0,,500000.0,0,0,0.1,0.4666666666666667
340950,Unknown,Diogo Jota,2024,31,Portugal,Porto,Portugal,04-12-96,Centre-Forward,Attack,Right,178.0,30-06-27,Gestifute,https://img.a.transfermarkt.technology/portrait/header/340950-1716296423.jpg?lm=1,GB1,Liverpool Football Club,50000000.0,60000000.0,28,158,166,7,12,16,15,14,10,15,12,4,8,13,11,8,15,14,14,12,14,13,13,14,17,16,5,15,9,14,14,16,16,13,11,14,15,13,11,14,12,14,8,12,2,2,3,3,1,3,3,3,1,3,1,14,16,11,12,15,15,11,12,1,1,1,1,1,1,1,1,1,1,20,14,18,19,73,14,20,87689752,7900,8250,6750,Mediterranean_Hispanic,152,27,9,162388.0,Unknown,55083779,21900000.0,3.0,76,1170,79,0,1,3,129,3,0.8418893887271766,0.7165775401069518,0.7573529411764706,0.1567959660373095,0.1776315789473684,0.1184210526315789,0.2498124531132783,0.2998249562390597,0.1216422678407733,0.2857142857142857,0.3488372093023257,0.4166666666666665,384,135,61,50,1,6524,17,129,117,50000000,2169565.217391304,60000000.0,7000000.0,700000.0,8000000.0,5,21150000,0.0,0.0
341019,Güven,Yalç?N,2024,8024,Germany,DÃ¼sseldorf,TÃ¼rkiye,18-01-99,Centre-Forward,Attack,Right,184.0,30-06-25,EMG Mundial,https://img.a.transfermarkt.technology/portrait/header/341019-1699272429.png?lm=1,PO1,Futebol Clube de Arouca,1700000.0,4000000.0,25,125,135,7,10,13,14,14,6,13,13,4,4,13,10,6,14,12,13,12,13,12,13,13,10,15,6,14,6,14,12,13,13,13,12,15,13,13,12,10,9,11,9,10,2,1,2,3,1,2,2,2,3,3,2,9,15,10,10,12,12,12,10,1,1,1,1,1,1,1,1,1,1,20,16,12,12,80,13,20,2553957,6100,6100,5000,North_African__Middle_Eastern,125,3,0,13180.0,Unknown,92090147,150000.0,1.0,38,443,100,0,1,6,98,3,0.5574225985710506,0.5294117647058822,0.5588235294117647,0.0127181450106073,0.0197368421052631,0.0,0.0082520630157539,0.0197549387346836,0.0008055779327203,0.0,0.4883720930232553,0.2916666666666665,290,74,26,29,0,5310,3,4,9,1200000,54761.90476190476,4000000.0,900000.0,,3500000.0,5,2000000,-0.29411764705882354,-0.2
341049,Cameron,Carter-Vickers,2024,371,England,Southend,United States,31-12-97,Centre-Back,Defender,Right,183.0,31-05-29,Unknown,https://img.a.transfermarkt.technology/portrait/header/341049-1700296714.jpg?lm=1,SC1,The Celtic Football Club,14000000.0,14000000.0,26,132,142,3,6,12,4,12,5,16,6,10,14,14,7,14,13,14,12,17,14,13,10,12,15,5,7,9,15,12,15,14,12,13,12,12,14,15,17,18,7,11,10,8,3,1,3,1,4,2,2,2,1,1,2,8,14,4,13,9,14,14,13,1,1,20,1,1,1,1,1,1,1,1,1,1,1,92,10,20,12937370,6600,6300,4500,Mixed_Race,137,11,0,25518.0,Unknown,28100767,7000000.0,1.0,32,1404,102,1,1,4,200,2,0.5838846255623181,0.4759358288770053,0.6470588235294117,0.0246319308386289,0.0723684210526315,0.0,0.0697674418604651,0.0697674418604651,0.038862190616406,0.0,0.4651162790697669,0.3333333333333332,304,10,6,30,0,7032,7,42,85,14000000,675000.0,14000000.0,500000.0,500000.0,1500000.0,11,9500000,0.0,0.07692307692307693
341051,Kyle,Walker-Peters,2024,180,England,London,England,13-04-97,Right-Back,Defender,Right,173.0,30-06-25,CAA Base Ltd,https://img.a.transfermarkt.technology/portrait/header/341051-1693826850.jpg?lm=1,GB1,Southampton Football Club,20000000.0,25000000.0,27,145,150,10,14,15,10,14,6,10,8,5,11,12,8,14,13,12,13,12,13,11,12,13,14,11,8,14,14,15,16,14,14,14,6,18,14,17,11,13,5,5,9,15,3,1,1,1,2,1,3,3,2,1,2,10,12,5,14,14,14,12,14,1,18,1,20,13,18,1,1,1,10,1,1,1,1,64,12,20,43479502,7250,7250,5850,African_Caribbean,135,2,0,57996.0,Unknown,29126231,13300000.0,1.0,32,858,33,1,1,1,186,11,0.7095792537708389,0.6203208556149732,0.6323529411764706,0.055993248404076,0.0131578947368421,0.0,0.0997749437359339,0.1247811952988247,0.0738631628656351,0.0,0.2325581395348837,0.375,274,11,19,33,0,5858,7,24,47,20000000,897727.2727272727,25000000.0,3000000.0,,2500000.0,1,2000000,0.0,0.0
341092,Federico,Chiesa,2024,31,Italy,Genova,Italy,25-10-97,Right Winger,Attack,Right,175.0,30-06-28,LIAN Sports Group,https://img.a.transfermarkt.technology/portrait/header/341092-1663576975.jpg?lm=1,GB1,Liverpool Football Club,30000000.0,70000000.0,27,156,167,10,14,15,13,14,6,9,13,4,6,13,10,5,14,17,12,13,15,10,13,10,18,15,13,15,7,11,16,16,15,13,8,16,17,14,13,16,14,15,11,18,2,3,1,4,3,1,2,1,2,3,2,13,15,11,11,17,17,8,9,1,1,1,1,12,12,1,19,1,18,20,12,20,14,70,15,20,99000004,7800,7800,6850,Mediterranean_Hispanic,150,37,4,178076.0,Unknown,43161651,28300000.0,2.0,52,531,54,0,1,3,129,10,0.7823498279968246,0.7272727272727272,0.7426470588235294,0.171944569706462,0.2434210526315789,0.0526315789473684,0.1497874468617154,0.3498374593648412,0.1571988110780855,0.1428571428571428,0.2790697674418605,0.375,334,78,55,45,1,6539,23,114,270,22000000,685937.5,70000000.0,12000000.0,500000.0,50000000.0,2,5000000,-0.37142857142857144,-0.56
341110,Franco,Cervi,2024,940,Argentina,San Lorenzo,Argentina,26-05-94,Left Winger,Attack,Left,166.0,30-06-26,Wasserman,https://img.a.transfermarkt.technology/portrait/header/341110-1603798993.jpg?lm=1,ES1,Real Club Celta de Vigo S. A. D.,1500000.0,18000000.0,30,135,143,12,10,13,11,12,12,4,13,8,11,13,12,13,13,16,14,14,10,14,13,11,18,13,9,15,13,14,18,15,15,16,7,17,15,15,8,12,14,10,11,12,3,1,3,3,1,3,3,2,2,3,3,7,13,6,14,12,14,7,11,1,10,1,1,14,1,1,19,1,1,20,14,10,1,60,20,7,5698861,6498,5907,5091,Mediterranean_Hispanic,135,4,1,47944.0,Unknown,14078688,5350000.0,2.0,4,1302,4,0,0,3,165,7,0.5318867425244774,0.5391443850267379,0.6323529411764706,0.0462868636461514,0.0263157894736842,0.0131578947368421,0.0072518129532383,0.0897724431107777,0.0296952693130364,0.1428571428571428,0.0697674418604648,0.5,332,35,49,35,1,8051,4,13,29,900000,26724.137931034482,18000000.0,4000000.0,,500000.0,2,1000000,-0.4,-0.55
341227,Juan,Miranda,2024,1025,Spain,Olivares,Spain,19-01-00,Left-Back,Defender,Left,185.0,30-06-27,AC Talent,https://img.a.transfermarkt.technology/portrait/header/341227-1689338510.jpg?lm=1,IT1,Bologna Football Club 1909,9000000.0,9000000.0,24,130,148,8,12,12,9,14,13,12,8,13,12,13,12,15,13,11,13,14,13,11,11,12,14,12,9,13,13,12,13,13,13,13,13,15,13,14,13,11,8,12,6,13,3,3,3,2,1,1,3,3,3,3,2,14,13,5,11,13,14,13,14,1,20,11,1,19,1,1,17,1,1,14,1,1,1,76,20,8,8879999,6500,6500,4250,Mediterranean_Hispanic,128,1,1,7955.0,Unknown,67258411,9111392.0,2.0,89,1080,89,1,0,3,40,8,0.6103466525535857,0.4491978609625668,0.5808823529411764,0.0076727947957091,0.006578947368421,0.0131578947368421,0.0447611902975743,0.0447611902975743,0.0505924720131114,0.1428571428571428,0.5116279069767438,0.25,192,10,24,36,1,5815,4,9,35,11000000,500000.0,11000000.0,1500000.0,5000000.0,5000000.0,4,6500000,0.2222222222222222,0.2222222222222222
341264,Fran,García,2024,418,Spain,BolaÃ±os de Calatrava,Spain,14-08-99,Left-Back,Defender,Left,169.0,30-06-27,Unknown,https://img.a.transfermarkt.technology/portrait/header/341264-1688119965.jpg?lm=1,ES1,Real Madrid Club de FÃºtbol,15000000.0,15000000.0,25,137,153,11,13,13,8,10,12,5,11,14,11,12,7,11,12,14,13,15,12,14,13,11,14,11,12,13,13,15,16,16,13,17,5,14,15,14,11,13,9,11,9,11,1,2,2,1,3,2,2,1,2,3,1,13,14,6,13,14,16,14,14,1,20,1,1,18,1,1,15,1,1,15,1,1,1,64,20,8,10000000,6841,6841,4841,Mediterranean_Hispanic,127,0,0,3068.0,Unknown,67245235,3500000.0,2.0,89,219,89,1,0,3,167,8,0.6554644085736967,0.5124064171122994,0.5735294117647058,0.0029538232167221,0.0,0.0,0.0747686921730432,0.0747686921730432,0.0194172060335009,0.1428571428571428,0.13953488372093,0.2916666666666665,258,10,22,17,0,3115,2,3,123,15000000,781578.947368421,15000000.0,0.0,,250000.0,2,3050000,0.0,0.0
341278,Iván,Martín,2024,12321,Spain,Bilbao,Spain,14-02-99,Attacking Midfield,Midfield,Left,178.0,30-06-26,Universal Twenty Two,https://img.a.transfermarkt.technology/portrait/header/341278-1703177977.jpg?lm=1,ES1,Girona FÃºtbol Club S. A. D.,15000000.0,15000000.0,25,126,144,12,14,15,12,14,12,10,10,8,11,12,12,12,15,10,12,13,12,11,14,13,16,12,11,12,13,8,13,13,12,11,9,12,13,12,12,20,11,9,9,15,3,3,2,1,2,2,2,1,2,1,2,7,11,2,12,10,13,11,19,1,1,1,1,1,1,1,13,19,10,18,20,15,1,0,20,8,4372600,6300,6300,3900,Mediterranean_Hispanic,123,0,0,8741.0,Girona,67258832,2000000.0,1.0,89,191,89,3,0,3,107,0,0.5838846255623181,0.4117647058823529,0.5441176470588236,0.0084317699667924,0.0,0.0,0.0747686921730432,0.0747686921730432,0.0110836412122558,0.0,0.3488372093023257,0.2916666666666665,217,13,21,17,2,2292,3,25,105,10000000,544444.4444444445,15000000.0,5000000.0,,300000.0,3,100000,-0.3333333333333333,0.0
341429,Davinson,Sánchez,2024,141,Colombia,Caloto,Colombia,12-06-96,Centre-Back,Defender,Right,187.0,30-06-27,Villarreal & Schena,https://img.a.transfermarkt.technology/portrait/header/341429-1464272554.jpg?lm=1,TR1,Galatasaray Spor KulÃ¼bÃ¼,18000000.0,60000000.0,28,140,150,7,7,11,10,13,10,13,9,8,13,13,7,15,14,15,12,15,13,11,10,13,14,10,9,10,13,14,14,15,14,13,14,15,15,15,16,13,11,13,8,10,1,4,1,3,1,1,3,2,1,1,3,16,16,12,8,16,14,12,14,1,1,20,11,1,1,12,1,7,1,1,1,1,1,83,11,20,28016876,6994,7594,6136,African_Caribbean,140,50,0,75393.0,Unknown,76023027,19000000.0,3.0,20,305,20,1,1,1,102,2,0.755093940195819,0.6509090909090909,0.6691176470588234,0.0727920919808382,0.3289473684210526,0.0,0.0897724431107777,0.2998249562390597,0.1055307091863662,0.2857142857142857,0.5581395348837206,0.4166666666666665,358,20,6,50,1,10161,12,37,51,19000000,620000.0,60000000.0,12000000.0,,12000000.0,3,15950000,0.05555555555555555,0.1875
341501,Hamza,Choudhury,2024,1003,England,Loughborough,England,01-10-97,Defensive Midfield,Midfield,Right,178.0,30-06-27,Wasserman,https://img.a.transfermarkt.technology/portrait/header/341501-1559900777.jpg?lm=1,GB1,Leicester City Football Club,4500000.0,10000000.0,27,133,158,6,9,11,6,12,7,10,9,11,12,13,8,16,12,17,15,14,12,12,12,11,14,11,11,8,10,15,17,14,13,13,11,14,12,17,12,11,15,15,5,12,2,1,2,3,3,2,3,2,3,2,1,10,12,11,12,12,13,11,8,1,1,12,7,1,1,19,10,20,1,1,1,1,1,64,14,20,17310153,6650,6650,5250,African_Caribbean,127,0,0,69595.0,Watford,28100205,9111392.0,2.0,32,865,33,3,1,1,127,4,0.6301931727970362,0.5561497326203209,0.5735294117647058,0.0671934430725168,0.0,0.0,0.0222555638909727,0.0497624406101525,0.0505924720131114,0.1428571428571428,0.3488372093023257,0.375,259,3,8,43,0,9691,2,7,29,4500000,236111.11111111112,10000000.0,2000000.0,250000.0,1000000.0,3,1750000,0.0,0.0
341647,Cengiz,ÃÅNder,2024,36,TÃ¼rkiye,Balikesir,TÃ¼rkiye,14-07-97,Right Winger,Attack,Left,173.0,30-06-27,FutureBall,https://img.a.transfermarkt.technology/portrait/header/341647-1728392057.JPG?lm=1,TR1,FenerbahÃ§e Spor KulÃ¼bÃ¼,10000000.0,35000000.0,27,138,144,13,14,15,12,14,14,7,14,3,3,12,9,4,15,7,11,8,13,12,12,11,12,15,5,13,4,11,11,17,16,13,7,12,16,11,9,13,10,14,12,13,2,2,3,1,2,2,2,2,3,2,1,12,14,5,13,12,13,11,12,1,1,1,1,1,1,1,14,1,18,15,15,20,10,66,20,10,16011006,6900,6900,5000,Mediterranean_Hispanic,133,42,13,60941.0,Unknown,70096289,11362500.0,4.0,100,131,100,0,0,3,84,10,0.6632707065361206,0.5294117647058822,0.6176470588235294,0.0588369912524731,0.2763157894736842,0.1710526315789473,0.0497624406101525,0.1747936984246061,0.0630989749715269,0.4285714285714285,0.2325581395348837,0.375,343,66,46,25,0,6262,23,78,55,7500000,248333.33333333334,35000000.0,6000000.0,1500000.0,27000000.0,6,3300000,-0.4642857142857143,-0.53125
342046,Axel,Tuanzebe,2024,677,DR Congo,Bunia,DR Congo,14-11-97,Centre-Back,Defender,Right,185.0,30-06-25,Unique Sports Group,https://img.a.transfermarkt.technology/portrait/header/342046-1641553669.jpg?lm=1,GB1,Ipswich Town Football Club,3000000.0,10000000.0,27,133,147,4,5,12,5,13,5,12,4,7,14,13,9,13,13,14,15,13,12,12,8,12,14,7,12,6,14,13,13,14,15,13,13,12,16,13,14,11,9,12,12,12,3,2,3,3,2,2,2,3,3,3,2,20,14,2,12,15,18,15,15,1,10,20,14,1,1,14,1,1,1,1,1,1,1,75,10,20,2753428,6650,6900,5500,African_Caribbean,132,0,0,52196.0,Unknown,28100269,9111392.0,2.0,27,277,29,1,1,1,115,2,0.6632707065361206,0.5828877005347594,0.6102941176470589,0.0503926682612226,0.0,0.0,0.0147536884221055,0.0497624406101525,0.0505924720131114,0.1428571428571428,0.5116279069767438,0.375,163,3,2,22,0,5651,8,126,195,5000000,200000.0,10000000.0,2000000.0,,1500000.0,6,5000000,1.2727272727272727,1.0
342226,Irvin,Cardona,2024,714,France,NÃ®mes,France,08-08-97,Centre-Forward,Attack,Right,185.0,30-06-25,Wasserman,https://img.a.transfermarkt.technology/portrait/header/342226-1723534120.jpg?lm=1,ES1,Reial Club Deportiu Espanyol de Barcelona S.A.D.,2500000.0,8000000.0,27,125,136,7,12,13,12,13,10,13,12,3,5,13,15,6,14,10,12,14,13,11,12,12,14,14,10,14,8,12,15,13,12,14,14,14,13,14,12,12,9,13,7,12,1,3,1,1,3,3,1,2,2,3,4,12,14,7,12,12,13,12,13,1,1,1,1,1,1,1,12,1,12,20,12,15,18,76,8,20,2289811,6250,6250,3905,Northern_European,123,0,0,6898.0,Unknown,85141637,1000000.0,2.0,34,1066,36,0,1,7,170,3,0.5772691188145012,0.4122994652406416,0.5441176470588236,0.0066521373455374,0.0,0.0,0.0122530632658164,0.0397599399849962,0.0055279313314258,0.1428571428571428,0.5116279069767438,0.375,245,73,27,19,0,4165,10,50,96,2000000,79545.45454545454,8000000.0,1500000.0,,1000000.0,4,2800000,-0.2,0.3333333333333333
342229,Kylian,Mbappé,2024,418,France,Paris,France,20-12-98,Centre-Forward,Attack,Right,178.0,30-06-29,Unknown,https://img.a.transfermarkt.technology/portrait/header/342229-1682683695.jpg?lm=1,ES1,Real Madrid Club de FÃºtbol,180000000.0,200000000.0,26,188,197,13,13,18,17,18,12,7,13,4,4,15,18,4,17,6,17,12,18,14,15,15,15,18,13,18,3,10,10,20,16,15,8,15,20,14,11,15,7,16,7,14,2,2,2,1,1,2,1,3,2,1,2,15,20,8,14,16,16,12,13,1,1,1,1,1,1,1,10,1,10,19,1,17,20,73,10,20,347975206,9398,9398,9248,African_Caribbean,172,57,27,1035616.0,Unknown,85139014,180000000.0,1.0,34,1122,36,0,1,1,167,3,0.993781423657052,0.9837433155080212,0.9044117647058822,1.0000000000000002,0.375,0.3552631578947368,0.8999749937484371,1.0,1.0,0.0,0.3488372093023257,0.3333333333333332,420,315,127,48,3,11311,21,50,36,160000000,5924074.074074074,200000000.0,20000000.0,90000000.0,200000000.0,3,75200000,-0.1111111111111111,-0.1111111111111111
342385,Guido,Rodríguez,2024,379,Argentina,SÃ¡enz PeÃ±a,Argentina,12-04-94,Defensive Midfield,Midfield,Right,185.0,Unknown,Interplayers,https://img.a.transfermarkt.technology/portrait/header/342385-1668181269.jpg?lm=1,GB1,West Ham United Football Club,20000000.0,28000000.0,30,155,162,10,11,12,6,15,8,11,10,4,14,14,4,18,12,12,16,12,14,14,13,15,16,12,11,13,18,17,16,12,13,15,10,13,11,13,12,16,10,10,7,12,1,2,2,2,1,2,3,4,3,2,1,14,13,5,10,13,15,14,12,1,1,10,1,1,1,20,1,20,10,1,1,1,1,80,12,20,23388425,7250,7250,6050,Mediterranean_Hispanic,148,24,1,31008.0,Unknown,14043255,4010000.0,3.0,4,1447,4,3,1,3,220,4,0.7095792537708389,0.641711229946524,0.7279411764705881,0.0299331696290195,0.1578947368421052,0.0131578947368421,0.0997749437359339,0.1397849462365591,0.0222506180727242,0.2857142857142857,0.5116279069767438,0.5,392,27,6,96,2,9730,3,21,94,15000000,612500.0,28000000.0,5000000.0,,300000.0,5,10050000,-0.25,-0.375
342389,Anders,Dreyer,2024,58,Denmark,Bramming,Denmark,02-05-98,Right Winger,Attack,Left,174.0,30-06-27,Elite Consulting,https://img.a.transfermarkt.technology/portrait/header/342389-1706611827.jpg?lm=1,BE1,Royal Sporting Club Anderlecht,12000000.0,15000000.0,26,126,140,13,13,14,13,12,11,8,14,6,5,13,13,4,14,9,12,10,12,11,13,13,9,14,5,14,4,13,12,14,12,11,8,12,12,13,6,10,5,7,7,11,2,3,1,3,2,1,1,2,1,3,3,9,14,5,15,11,12,15,14,1,1,1,1,1,1,1,11,12,14,16,15,20,17,70,20,14,9716094,6300,6350,4750,Northern_European,121,2,0,14788.0,Unknown,27111934,3880000.0,5.0,28,239,30,0,0,7,175,10,0.590500132310135,0.5026737967914437,0.5294117647058822,0.0142708575743501,0.0131578947368421,0.0,0.0597649412353088,0.0747686921730432,0.0215283757882163,0.5714285714285714,0.2558139534883721,0.3333333333333332,323,129,73,15,1,11024,4,8,13,10000000,544444.4444444445,15000000.0,3000000.0,,600000.0,6,3175000,-0.3333333333333333,0.0
342405,Mattias,Svanberg,2024,82,Sweden,MalmÃ¶,Sweden,05-01-99,Central Midfield,Midfield,Right,185.0,30-06-27,Unknown,https://img.a.transfermarkt.technology/portrait/header/342405-1689866072.jpg?lm=1,L1,Verein fÃ¼r LeibesÃ¼bungen Wolfsburg,12000000.0,18000000.0,25,135,155,14,11,13,11,14,14,11,15,4,11,13,11,12,14,13,12,13,13,13,14,13,14,14,8,14,12,12,14,13,12,14,11,15,14,14,12,12,11,12,6,14,3,3,3,3,4,2,4,1,3,3,3,11,14,6,12,12,14,12,12,1,1,1,1,1,1,15,10,20,12,10,15,12,8,77,11,20,19135911,6747,6397,5747,Northern_European,135,21,1,57533.0,Unknown,93065023,7000000.0,2.0,91,902,91,3,1,7,213,1,0.5967187086530829,0.6093048128342246,0.6323529411764706,0.0555461676099138,0.1381578947368421,0.0131578947368421,0.0597649412353088,0.0897724431107777,0.038862190616406,0.1428571428571428,0.5116279069767438,0.2916666666666665,309,40,33,56,0,7162,7,15,55,12000000,496875.0,18000000.0,3000000.0,400000.0,5500000.0,2,1750000,0.0,-0.3333333333333333
342702,Michel,Vlap,2024,317,Netherlands,Sneek,Netherlands,02-06-97,Attacking Midfield,Midfield,Right,190.0,30-06-25,Muy Manero,https://img.a.transfermarkt.technology/portrait/header/342702-1723459961.jpg?lm=1,NL1,Football Club Twente,3000000.0,8000000.0,27,124,130,10,9,12,12,13,10,12,12,5,6,13,13,6,12,12,14,12,13,12,14,13,14,12,10,15,8,15,15,12,11,13,14,13,12,13,10,12,8,12,6,11,1,1,2,1,2,3,3,4,4,3,1,12,14,8,14,10,14,14,14,1,1,1,1,1,1,8,12,18,1,12,20,1,11,81,13,20,4157996,6000,6000,5000,Northern_European,124,0,0,10000.0,Unknown,215665,4450000.0,2.0,67,1387,68,3,1,7,91,0,0.5441915850754168,0.5294117647058822,0.5514705882352942,0.009647482104698,0.0,0.0,0.0147536884221055,0.0397599399849962,0.0246951304202894,0.1428571428571428,0.6279069767441858,0.375,346,74,35,24,0,7267,5,8,14,4000000,156000.0,8000000.0,2000000.0,100000.0,1500000.0,3,3500000,0.3333333333333333,0.0
342877,Enzo,Ebosse,2024,410,France,Amiens,Cameroon,11-03-99,Centre-Back,Defender,Left,185.0,30-06-27,KTM,https://img.a.transfermarkt.technology/portrait/header/342877-1659337327.jpg?lm=1,IT1,Udinese Calcio,2500000.0,4500000.0,25,125,142,5,11,10,5,12,4,13,6,11,13,12,6,14,12,10,12,13,11,11,11,11,11,10,7,12,14,13,13,13,13,11,13,14,13,15,15,11,8,10,8,12,3,3,3,2,1,3,2,2,2,4,3,16,11,7,9,7,9,11,17,1,20,18,1,17,1,1,14,1,1,1,1,1,1,77,20,9,2998645,6250,6150,2500,North_African__Middle_Eastern,120,0,0,17799.0,Unknown,48036572,2250000.0,2.0,34,62,15,1,0,6,205,2,0.5640381053188674,0.2620320855614972,0.5220588235294117,0.0171783311623038,0.0,0.0,0.0122530632658164,0.0222555638909727,0.0124725686824634,0.1428571428571428,0.5116279069767438,0.2916666666666665,166,1,4,16,0,4014,3,101,349,2000000,123076.92307692308,4500000.0,2000000.0,,500000.0,2,2550000,-0.2,-0.2
343052,Nicolas,Pépé,2024,1050,France,Mantes-la-Jolie,Cote d'Ivoire,29-05-95,Right Winger,Attack,Left,183.0,30-06-26,BS Group - BS Law,https://img.a.transfermarkt.technology/portrait/header/343052-1695671686.png?lm=1,ES1,Villarreal Club de FÃºtbol S.A.D.,8500000.0,75000000.0,29,146,159,12,12,17,13,14,14,8,16,2,4,12,15,4,16,6,12,8,13,8,12,11,8,18,7,16,6,11,11,17,18,13,9,14,16,13,10,8,7,11,7,7,1,1,3,1,2,4,2,2,1,2,1,9,11,5,14,12,13,12,14,1,1,1,1,1,1,1,12,1,12,16,1,20,12,73,20,8,54284132,7300,7500,6500,African_Caribbean,140,32,9,121791.0,OGC Nice,85136376,49000000.0,2.0,34,907,24,0,0,1,216,10,0.7426567875099233,0.6898395721925134,0.6691176470588234,0.1175948018891336,0.2105263157894736,0.1184210526315789,0.0422605651412853,0.3748437109277319,0.2722020056112669,0.1428571428571428,0.4651162790697669,0.4583333333333332,340,94,49,23,1,5769,11,46,123,7500000,257142.85714285713,75000000.0,13000000.0,,,5,20500000,-0.11764705882352941,-0.3181818181818182
343273,Joni,Montiel,2024,367,Spain,Madrid,Spain,03-09-98,Attacking Midfield,Midfield,Left,173.0,30-06-25,Promoesport,https://img.a.transfermarkt.technology/portrait/header/343273-1712141506.jpg?lm=1,ES1,Rayo Vallecano de Madrid S.A.D.,1200000.0,2000000.0,26,120,132,12,11,14,11,13,13,7,12,12,6,13,11,8,14,11,14,13,13,11,14,12,10,14,7,13,8,10,11,13,14,14,7,12,11,11,8,12,7,12,7,9,3,3,3,1,3,3,3,1,3,1,1,12,11,5,12,12,8,9,12,1,1,1,1,1,1,1,8,18,8,15,20,12,1,67,20,12,1333672,6000,6000,4002,Mediterranean_Hispanic,119,0,0,3567.0,Levante,67213141,9111392.0,2.0,89,892,89,3,0,3,163,0,0.5441915850754168,0.4226737967914438,0.5147058823529411,0.0034356662324607,0.0,0.0,0.0057514378594648,0.0097524381095273,0.0505924720131114,0.1428571428571428,0.2325581395348837,0.3333333333333332,221,21,18,45,3,5542,0,0,0,900000,17391.304347826088,2000000.0,500000.0,0.0,200000.0,9,1800000,-0.25,-0.55
343463,Cyle,Larin,2024,237,Canada,"Brampton, Ontario",Canada,17-04-95,Centre-Forward,Attack,Right,188.0,30-06-28,Unknown,https://img.a.transfermarkt.technology/portrait/header/343463-1720430112.jpg?lm=1,ES1,Real Club Deportivo Mallorca S.A.D.,4000000.0,11500000.0,29,120,130,2,6,11,13,12,2,14,9,4,7,10,11,7,11,14,13,14,12,10,7,11,7,10,5,13,5,13,13,11,11,13,15,15,11,13,13,11,10,12,7,2,4,3,3,2,2,3,2,3,1,3,2,12,8,8,6,12,6,16,15,1,1,1,1,1,1,1,1,1,1,18,1,15,20,90,13,20,5939999,6600,6660,5695,African_Caribbean,110,52,24,7499.0,Unknown,72044151,3616666.667,3.0,16,240,16,0,1,1,166,3,0.6315162741465996,0.6037433155080213,0.4485294117647059,0.0072324733224089,0.3421052631578947,0.3157894736842105,0.0197549387346836,0.0572643160790197,0.0200653721881163,0.2857142857142857,0.581395348837209,0.4583333333333332,327,113,36,36,2,3616,7,14,22,3500000,117241.37931034483,11500000.0,3000000.0,,1000000.0,6,9300000,-0.125,-0.3
343475,Ben,Godfrey,2024,800,England,York,England,15-01-98,Centre-Back,Defender,Right,184.0,30-06-29,Unknown,https://img.a.transfermarkt.technology/portrait/header/343475-1700739275.jpg?lm=1,IT1,Atalanta Bergamasca Calcio S.p.a.,10000000.0,25000000.0,26,134,155,5,8,8,9,13,5,13,12,7,13,13,7,15,13,14,11,14,12,13,12,9,15,7,12,11,12,14,17,16,14,15,13,15,17,16,16,11,7,13,5,14,2,1,1,4,1,2,3,1,3,2,1,13,16,1,15,12,17,11,15,1,13,20,16,1,14,15,1,12,1,1,1,1,1,77,5,20,33849938,6700,6950,5500,Mixed_Race,130,2,0,75395.0,Unknown,29142372,9111392.0,2.0,32,1688,33,1,1,4,31,2,0.6698862132839376,0.5828877005347594,0.5955882352941175,0.0727940232153703,0.0131578947368421,0.0,0.0497624406101525,0.1247811952988247,0.0505924720131114,0.1428571428571428,0.4883720930232553,0.3333333333333332,271,7,5,32,3,6263,9,32,92,8000000,395000.0,25000000.0,5000000.0,,1500000.0,3,12400000,-0.2,0.0
343537,Artem,Dovbyk,2024,12,Ukraine,Cherkasy,Ukraine,21-06-97,Centre-Forward,Attack,Left,189.0,30-06-29,Unknown,https://img.a.transfermarkt.technology/portrait/header/343537-1719215184.jpg?lm=1,IT1,Associazione Sportiva Roma,35000000.0,35000000.0,27,128,128,6,8,8,14,13,10,16,10,8,7,9,11,10,10,12,12,15,10,13,11,11,17,10,11,11,9,16,16,14,13,14,16,18,15,12,16,12,8,13,3,9,1,2,1,3,3,3,2,1,1,3,3,7,13,3,10,11,18,12,12,1,1,1,1,1,1,1,1,1,1,10,13,10,20,88,20,10,3045904,6000,6000,4950,Northern_European,127,11,4,5619.0,Unknown,71099066,13483333.33,3.0,103,353,101,0,0,7,29,3,0.5441915850754168,0.5240641711229946,0.5735294117647058,0.0054171128623116,0.0723684210526315,0.0526315789473684,0.1747936984246061,0.1747936984246061,0.0748817096586016,0.2857142857142857,0.6046511627906974,0.375,245,115,31,13,0,4695,12,45,232,30000000,1198000.0,35000000.0,5000000.0,50000.0,350000.0,7,18575000,-0.14285714285714285,0.07142857142857142
344069,Anton,Stach,2024,533,Germany,Buchholz in der Nordheide,Germany,15-11-98,Central Midfield,Midfield,Right,194.0,30-06-27,ROOF,https://img.a.transfermarkt.technology/portrait/header/344069-1723921116.jpg?lm=1,L1,TSG 1899 Hoffenheim FuÃŸball-Spielbetriebs GmbH,15000000.0,15000000.0,26,135,148,14,9,12,10,12,13,12,13,3,13,13,7,13,13,16,13,15,13,12,13,12,19,13,11,12,13,16,17,12,11,13,16,17,15,14,14,15,12,14,6,17,1,1,1,1,3,2,2,1,3,3,1,15,17,4,8,16,18,10,10,1,1,10,1,1,1,18,10,20,10,10,16,10,8,86,12,20,13109780,6750,6750,5500,Northern_European,134,2,0,16300.0,Unknown,91194540,7750000.0,2.0,38,271,40,3,1,7,199,1,0.6434241862926701,0.5828877005347594,0.625,0.015730870880556,0.0131578947368421,0.0,0.0747686921730432,0.0747686921730432,0.0430289730270285,0.1428571428571428,0.7209302325581395,0.3333333333333332,262,26,32,42,1,3284,8,36,88,12000000,598750.0,15000000.0,3000000.0,50000.0,75000.0,4,1100000,-0.2,-0.2
344072,Kelvin,Amian,2024,995,France,Toulouse,France,08-02-98,Right-Back,Defender,Right,180.0,30-06-28,Unknown,https://img.a.transfermarkt.technology/portrait/header/344072-1638174640.jpg?lm=1,FR1,Football Club de Nantes,2500000.0,7000000.0,26,126,140,10,11,10,7,13,3,14,10,13,14,12,5,13,12,14,14,13,13,13,12,13,12,10,11,13,12,13,13,13,13,14,10,16,13,14,13,13,12,12,7,11,1,1,3,1,2,1,2,2,2,1,3,13,14,6,12,12,13,13,15,1,14,20,19,1,1,1,1,1,1,1,1,1,1,78,8,20,2621506,6300,6100,3900,African_Caribbean,126,0,0,13653.0,Unknown,48031443,3450000.0,2.0,34,1512,36,1,1,1,93,11,0.5574225985710506,0.4117647058823529,0.5661764705882353,0.0131748819774296,0.0,0.0,0.0122530632658164,0.0347586896724181,0.0191394205394594,0.1428571428571428,0.3953488372093026,0.3333333333333332,275,7,9,38,2,2371,5,27,121,2500000,97826.08695652174,7000000.0,1400000.0,800000.0,5000000.0,2,600000,0.0,0.13636363636363635
344152,Odsonne,Edouard,2024,1003,French Guiana,Kourou,France,16-01-98,Centre-Forward,Attack,Right,187.0,30-06-25,Unknown,https://img.a.transfermarkt.technology/portrait/header/344152-1598301744.jpg?lm=1,GB1,Leicester City Football Club,18000000.0,20000000.0,26,139,158,6,10,14,15,13,11,11,11,4,8,11,15,8,15,9,13,12,13,12,12,12,13,12,6,14,8,12,13,15,13,14,14,14,14,14,14,13,6,14,7,12,1,1,1,1,1,1,3,1,1,1,1,13,17,15,12,15,13,14,13,1,1,1,1,1,1,1,1,1,1,17,13,12,20,83,11,20,26446116,6950,6950,5950,African_Caribbean,137,0,0,98593.0,Unknown,48036880,13300000.0,2.0,35,752,36,0,1,1,127,3,0.6698862132839376,0.6310160427807486,0.6470588235294117,0.0951944125522519,0.0,0.0,0.0897724431107777,0.0997749437359339,0.0738631628656351,0.1428571428571428,0.5581395348837206,0.3333333333333332,330,117,44,24,0,9423,10,28,29,14000000,597826.0869565217,20000000.0,4000000.0,800000.0,3000000.0,5,4550000,-0.2222222222222222,-0.3
344381,Christopher,Nkunku,2024,631,France,Lagny-sur-Marne,France,14-11-97,Centre-Forward,Attack,Right,177.0,30-06-29,Gol International,https://img.a.transfermarkt.technology/portrait/header/344381-1663686834.jpg?lm=1,GB1,Chelsea Football Club,65000000.0,80000000.0,27,158,163,14,13,14,14,14,14,6,13,7,7,16,11,7,15,14,15,12,16,15,15,16,11,15,6,15,7,16,15,15,15,13,9,14,15,16,11,15,11,13,4,18,3,3,2,3,2,1,2,1,2,2,2,8,12,8,12,10,13,14,14,1,1,1,1,1,10,1,15,17,15,16,20,17,14,73,12,20,65000001,7850,6981,6718,African_Caribbean,157,6,0,143836.0,Unknown,85140301,39750000.0,2.0,34,788,36,0,1,1,50,3,0.673987827467584,0.7131550802139037,0.7941176470588234,0.1388818345183066,0.0394736842105263,0.0,0.3248312078019504,0.3998499624906226,0.2208116892135892,0.1428571428571428,0.3255813953488373,0.375,340,111,68,27,0,10267,12,80,110,50000000,1776785.7142857143,80000000.0,15000000.0,500000.0,12000000.0,2,8000000,-0.23076923076923078,-0.3333333333333333
344395,Jorge,Fernandes,2024,2420,Portugal,Braga,Portugal,02-04-97,Centre-Back,Defender,Left,191.0,30-06-25,SoccerSoul,https://img.a.transfermarkt.technology/portrait/header/344395-1631004204.jpg?lm=1,PO1,VitÃ³ria Sport Clube,2500000.0,3000000.0,27,90,-8,10,10,14,10,12,9,8,11,5,3,9,8,5,13,6,10,7,6,6,9,6,12,17,3,9,3,6,8,15,15,8,6,13,15,8,4,5,4,18,13,7,1,3,2,2,2,3,1,2,2,1,3,16,13,3,12,14,11,6,12,1,1,1,1,1,1,1,12,1,12,18,1,20,10,65,20,8,12719999,4500,4500,1500,African_Caribbean,83,0,0,104.0,Unknown,2000107424,250000.0,1.0,76,237,79,1,0,1,217,2,0.3457263826409102,0.1550802139037433,0.2499999999999999,9.173364027087496e-05,0.0,0.0,0.0122530632658164,0.0147536884221055,0.0013611489208033,0.0,0.6511627906976742,0.375,226,6,2,55,2,5109,8,60,98,2500000,117857.14285714286,3000000.0,1000000.0,25000.0,400000.0,3,300000,0.0,0.3888888888888889
344474,Ilija,Vukoti?,2024,2503,Yugoslavia (Republic),Podgorica,Montenegro,07-01-99,Central Midfield,Midfield,Left,191.0,30-06-25,Universal Twenty Two,https://img.a.transfermarkt.technology/portrait/header/344474-1537444574.jpg?lm=1,PO1,Boavista Futebol Clube,400000.0,500000.0,25,110,138,10,10,12,8,13,10,10,9,8,11,14,12,11,14,13,12,11,13,10,14,11,12,12,12,11,13,14,13,10,12,13,14,13,13,12,12,14,10,10,10,13,1,3,3,1,2,3,3,2,1,3,2,13,13,7,10,12,12,11,12,1,1,1,1,1,1,20,1,16,1,1,1,1,1,76,20,7,466479,5449,5899,3449,Northern_European,111,3,1,2768.0,Unknown,62178166,500000.0,1.0,110,1156,66,3,0,7,38,1,0.5308282614448266,0.3635294117647058,0.4558823529411764,0.0026641380369194,0.0197368421052631,0.0131578947368421,0.0017504376094023,0.0022505626406601,0.0027500763910108,0.0,0.6511627906976742,0.2916666666666665,168,9,8,22,0,5183,0,0,0,600000,37500.0,600000.0,100000.0,,350000.0,1,100000,0.5,0.7142857142857143
344519,Bruno,Costa,2024,982,Portugal,SÃ£o Roque,Portugal,19-04-97,Central Midfield,Midfield,Right,174.0,30-06-26,MadeinFootball,https://img.a.transfermarkt.technology/portrait/header/344519-1542106011.png?lm=1,PO1,Clube Desportivo Nacional,800000.0,2500000.0,27,127,143,14,14,12,10,13,12,7,13,7,7,14,13,12,14,12,12,13,13,11,14,12,14,13,8,13,10,10,14,13,14,10,8,13,13,12,9,14,6,10,6,13,1,3,3,1,1,3,3,1,1,1,2,9,12,7,17,16,15,11,12,1,1,1,10,1,5,10,13,20,13,15,18,15,1,67,13,20,968126,6349,6349,4849,Mediterranean_Hispanic,124,0,0,8749.0,Unknown,55070310,2500000.0,1.0,76,1458,79,3,1,3,56,1,0.5903678221751786,0.5132620320855614,0.5514705882352942,0.0084394949049204,0.0,0.0,0.0037509377344336,0.0122530632658164,0.0138614961526709,0.0,0.2558139534883721,0.375,220,17,20,41,1,7169,3,12,35,500000,23750.0,2500000.0,600000.0,,250000.0,8,2750000,-0.375,-0.5833333333333334
344596,Malang,Sarr,2024,826,France,Nice,France,23-01-99,Centre-Back,Defender,Left,183.0,30-06-26,Unknown,https://img.a.transfermarkt.technology/portrait/header/344596-1606395203.png?lm=1,FR1,Racing Club de Lens,4000000.0,18000000.0,25,130,150,5,11,12,7,13,6,13,7,8,13,13,9,14,13,12,12,15,13,12,12,13,15,12,10,10,12,14,14,14,14,15,11,16,15,15,13,13,8,12,6,8,2,2,1,3,3,3,1,4,3,1,1,7,15,6,14,12,16,13,14,1,16,20,1,1,1,1,1,1,1,1,1,1,1,73,20,8,13169507,6500,6600,5500,African_Caribbean,129,0,0,40597.0,AS Monaco,48036830,9111392.0,2.0,34,1041,36,1,0,1,158,2,0.6235776660492194,0.5828877005347594,0.588235294117647,0.0391924735927818,0.0,0.0,0.0197549387346836,0.0897724431107777,0.0505924720131114,0.1428571428571428,0.4651162790697669,0.2916666666666665,210,5,3,24,0,8277,4,20,92,3000000,43478.260869565216,18000000.0,4000000.0,8000000.0,18000000.0,5,5500000,-0.25,-0.25
344598,Dan-Axel,Zagadou,2024,79,France,CrÃ©teil,France,03-06-99,Centre-Back,Defender,Left,196.0,30-06-26,Unknown,https://img.a.transfermarkt.technology/portrait/header/344598-1691999093.jpg?lm=1,L1,Verein fÃ¼r Bewegungsspiele Stuttgart 1893,10000000.0,35000000.0,25,136,153,3,8,9,6,14,4,13,5,10,14,14,7,14,14,11,13,15,13,13,12,15,12,8,9,8,15,15,10,11,8,15,17,11,13,11,17,14,7,16,16,8,3,2,3,2,2,1,1,3,2,3,2,11,13,8,10,14,14,13,17,1,16,20,1,12,1,12,1,1,1,1,1,1,1,90,20,9,15923083,6500,6024,5019,African_Caribbean,134,0,0,14999.0,Unknown,48043086,9111392.0,2.0,34,395,36,1,0,1,211,2,0.5473670283143689,0.5314438502673796,0.625,0.014474602817478,0.0,0.0,0.0497624406101525,0.1747936984246061,0.0505924720131114,0.1428571428571428,0.7674418604651163,0.2916666666666665,153,5,1,20,1,6198,19,144,197,6000000,225961.53846153847,35000000.0,9500000.0,5000000.0,31500000.0,2,6375000,-0.4,-0.4
344605,Boubakary,Soumaré,2024,1003,France,Noisy-le-Sec,France,27-02-99,Defensive Midfield,Midfield,Right,188.0,30-06-26,Unknown,https://img.a.transfermarkt.technology/portrait/header/344605-1591172562.jpg?lm=1,GB1,Leicester City Football Club,14000000.0,28000000.0,25,137,154,10,13,14,10,14,8,10,10,8,13,15,8,14,14,8,14,14,14,13,14,14,12,14,13,14,13,15,12,11,13,15,14,13,12,15,16,14,11,12,11,12,2,3,2,1,2,2,2,2,2,3,4,9,15,3,13,13,14,15,16,1,1,1,1,1,1,18,1,20,1,1,1,1,1,82,8,20,35077931,6850,6850,5250,African_Caribbean,139,0,0,92793.0,Unknown,48044576,20000000.0,1.0,34,1052,36,3,1,1,127,4,0.6566551997883038,0.5561497326203209,0.6617647058823528,0.0895938324093985,0.0,0.0,0.0697674418604651,0.1397849462365591,0.1110864190671963,0.0,0.581395348837209,0.2916666666666665,251,2,5,43,1,6114,1,3,12,14000000,325000.0,28000000.0,5000000.0,7500000.0,27000000.0,3,5000000,0.0,0.0
344695,Dayot,Upamecano,2024,27,France,Ã‰vreux,France,27-10-98,Centre-Back,Defender,Right,186.0,30-06-26,Unknown,https://img.a.transfermarkt.technology/portrait/header/344695-1701245272.jpg?lm=1,L1,FC Bayern MÃ¼nchen,45000000.0,60000000.0,26,154,170,3,7,12,7,12,4,14,6,5,15,15,6,17,12,16,13,17,14,13,14,14,16,13,8,10,14,12,15,15,12,16,15,15,17,14,17,14,10,14,7,10,1,4,3,3,2,3,2,3,1,1,2,15,17,10,10,12,10,12,10,1,1,20,1,1,1,12,1,10,1,1,1,1,1,90,12,20,76007700,7700,7250,7200,African_Caribbean,153,6,1,230137.0,Unknown,16182894,21066666.67,3.0,34,1723,36,1,1,1,68,2,0.7095792537708389,0.7647058823529411,0.7647058823529411,0.2222155701921675,0.0394736842105263,0.0131578947368421,0.2248062015503876,0.2998249562390597,0.1170125096252673,0.2857142857142857,0.5348837209302322,0.3333333333333332,339,10,13,68,4,8419,23,72,111,50000000,1822222.2222222222,60000000.0,10000000.0,12000000.0,40000000.0,2,7500000,0.1111111111111111,-0.16666666666666666
344864,Jean-Kévin,Duverne,2024,995,France,Paris,Haiti,12-07-97,Centre-Back,Defender,Right,186.0,30-06-27,Concept Sport Agency,https://img.a.transfermarkt.technology/portrait/header/344864-1704213124.jpg?lm=1,FR1,Football Club de Nantes,3500000.0,4000000.0,27,128,140,5,10,10,6,12,5,14,6,10,13,13,7,14,12,12,13,15,13,12,10,12,14,10,12,9,13,14,14,12,13,14,14,15,13,15,15,12,8,11,10,11,3,3,3,1,2,1,3,3,1,3,1,9,14,12,10,14,12,13,12,1,19,20,15,1,1,1,1,1,1,1,1,1,1,71,8,20,2835154,6391,6391,3802,African_Caribbean,129,0,0,6898.0,Unknown,29132976,9111392.0,2.0,34,1122,46,1,1,1,93,2,0.5959248478433448,0.401283422459893,0.588235294117647,0.0066521373455374,0.0,0.0,0.0172543135783946,0.0197549387346836,0.0505924720131114,0.1428571428571428,0.5348837209302322,0.375,297,6,5,31,2,3601,3,33,233,3000000,150000.0,4000000.0,500000.0,150000.0,2500000.0,3,2100000,-0.14285714285714285,-0.14285714285714285
344869,Simon,Banza,2024,449,France,Creil,DR Congo,13-08-96,Centre-Forward,Attack,Right,189.0,30-06-25,LIAN Sports Group,https://img.a.transfermarkt.technology/portrait/header/344869-1726586877.jpg?lm=1,TR1,Trabzonspor KulÃ¼bÃ¼,16000000.0,18000000.0,28,131,137,8,10,12,15,13,7,16,10,8,4,9,12,5,12,15,15,16,12,11,12,12,14,12,7,16,6,11,13,12,12,11,15,15,13,13,13,13,5,11,6,10,3,3,1,3,3,2,1,2,2,2,3,18,13,7,8,14,12,10,10,1,1,1,1,1,1,1,1,1,1,1,1,1,20,75,12,20,3691979,6546,5690,5144,African_Caribbean,130,0,0,7829.0,Unknown,29132973,2960000.0,1.0,34,394,29,0,1,1,204,3,0.5031754432389521,0.5448128342245989,0.5955882352941175,0.007551127020192,0.0,0.0,0.0797699424856214,0.0897724431107777,0.0164171226978527,0.0,0.6046511627906974,0.4166666666666665,335,115,34,40,3,5686,4,39,231,15000000,612500.0,18000000.0,2000000.0,,200000.0,6,5625000,-0.16666666666666666,0.25
345105,Gökdeniz,Bayrakdar,2024,44006,TÃ¼rkiye,Kocaeli,TÃ¼rkiye,23-11-01,Centre-Forward,Attack,Left,181.0,30-06-27,Unknown,https://img.a.transfermarkt.technology/portrait/header/345105-1717099642.png?lm=1,TR1,Bodrumspor Spor Faaliyetleri Anonim ?irketi,2500000.0,4000000.0,23,105,-75,6,8,11,12,10,5,12,12,7,6,9,10,8,10,15,12,14,11,13,10,9,14,11,4,14,7,12,15,12,12,13,11,14,13,13,13,10,5,12,10,14,3,1,3,3,3,1,2,2,1,2,1,18,15,5,10,8,14,13,14,1,1,1,8,1,1,1,10,1,12,16,1,18,20,75,20,9,6662655,5398,5398,3402,Mediterranean_Hispanic,104,0,0,829.0,Unknown,70111999,429000.0,2.0,100,739,100,0,0,3,39,3,0.4645408838317015,0.3585026737967914,0.4044117647058823,0.0007918061581275,0.0,0.0,0.0122530632658164,0.0197549387346836,0.0023556209894719,0.1428571428571428,0.418604651162791,0.2083333333333332,255,59,19,32,0,4521,3,10,24,2200000,115277.77777777778,4000000.0,700000.0,200000.0,2700000.0,1,500000,-0.12,0.4666666666666667
345458,Sebastian,Walukiewicz,2024,416,Poland,GorzÃ³w Wielkopolski,Poland,05-04-00,Centre-Back,Defender,Right,188.0,30-06-27,Unknown,https://img.a.transfermarkt.technology/portrait/header/345458-1716985042.jpg?lm=1,IT1,Torino Calcio,2500000.0,10000000.0,24,123,153,4,7,10,7,10,4,13,6,10,12,11,8,13,10,13,14,14,13,14,10,12,14,10,6,11,14,14,15,12,11,15,14,15,13,15,15,13,13,12,10,2,2,2,2,4,3,3,3,2,1,1,3,8,12,2,9,13,11,12,11,1,1,20,1,1,1,12,1,6,1,1,1,1,1,85,8,20,8573248,6150,5900,5450,Northern_European,123,3,0,8769.0,Empoli Football Club,96105337,1838333.333,3.0,75,551,78,1,1,7,201,2,0.530960571579783,0.5775401069518716,0.5441176470588236,0.0084588072502406,0.0197368421052631,0.0,0.0122530632658164,0.0497624406101525,0.0101854681130031,0.2857142857142857,0.581395348837209,0.25,171,3,3,27,0,3076,11,60,184,5000000,246250.0,10000000.0,2500000.0,4000000.0,10000000.0,3,4000000,1.0,1.0
345468,Andi,Zeqiri,2024,3057,Switzerland,Lausanne,Switzerland,22-06-99,Centre-Forward,Attack,Left,185.0,30-06-25,Unknown,https://img.a.transfermarkt.technology/portrait/header/345468-1714038450.png?lm=1,BE1,Royal Standard Club de LiÃ¨ge,3500000.0,4500000.0,25,127,147,7,10,14,13,14,9,12,11,6,7,12,13,6,14,9,13,8,13,12,13,12,14,14,6,14,6,14,14,13,12,13,12,16,14,13,12,8,8,12,9,14,3,2,1,2,3,3,2,2,3,3,3,12,14,6,14,8,16,10,12,1,1,1,1,10,1,1,15,1,10,18,10,15,20,81,20,12,12216003,6362,6612,4758,Northern_European,127,7,0,23198.0,FC Basel 1893,98034815,3375000.0,2.0,92,805,92,0,0,7,176,3,0.6251653876686954,0.5035294117647058,0.5735294117647058,0.0223916987814875,0.0460526315789473,0.0,0.0172543135783946,0.0222555638909727,0.0187227422983971,0.1428571428571428,0.5116279069767438,0.2916666666666665,306,99,23,38,0,8944,10,35,55,4000000,150000.0,4500000.0,1000000.0,800000.0,1300000.0,7,2000000,0.14285714285714285,-0.1111111111111111
345577,Carlo,Holse,2024,152,Denmark,Kopenhagen,Denmark,02-06-99,Attacking Midfield,Midfield,Left,177.0,30-06-27,Nine Group ,https://img.a.transfermarkt.technology/portrait/header/345577-1727640141.png?lm=1,TR1,Samsunspor,3200000.0,3300000.0,25,127,137,14,16,12,12,14,11,7,12,4,7,14,13,7,14,12,12,13,12,13,12,10,14,14,5,13,6,13,10,12,13,12,6,12,11,12,9,10,6,10,5,14,2,2,3,4,3,2,1,1,3,1,2,15,14,6,14,13,16,14,13,1,1,1,1,16,1,1,18,20,18,18,18,20,16,68,20,8,2402212,5765,5699,4016,Northern_European,104,0,0,2775.0,Unknown,27132704,9111392.0,2.0,28,745,30,3,0,7,180,0,0.5043662344535591,0.4241711229946523,0.4044117647058823,0.0026708973577814,0.0,0.0,0.0157539384846211,0.0162540635158789,0.0505924720131114,0.1428571428571428,0.3255813953488373,0.2916666666666665,288,59,51,13,0,6930,4,13,91,3400000,173684.2105263158,3400000.0,300000.0,250000.0,1100000.0,4,1600000,0.0625,0.13333333333333333
345590,Jens,Odgaard,2024,1025,Denmark,HillerÃ¸d,Denmark,31-03-99,Centre-Forward,Attack,Left,188.0,30-06-27,Nine Group ,https://img.a.transfermarkt.technology/portrait/header/345590-1706697621.jpg?lm=1,IT1,Bologna Football Club 1909,4500000.0,6000000.0,25,130,136,6,8,12,13,13,12,12,14,5,5,13,12,5,13,11,13,13,15,11,14,12,15,14,5,15,5,11,12,11,12,15,13,12,13,13,15,12,7,11,6,12,4,3,1,2,3,1,3,1,2,1,3,5,11,4,15,12,12,16,15,1,1,1,1,1,1,1,1,1,1,17,18,18,20,82,20,11,7400247,6250,5816,4028,Northern_European,125,0,0,6232.0,Unknown,27119480,3682500.0,4.0,28,626,30,0,0,7,40,3,0.5198465202434507,0.4254545454545454,0.5588235294117647,0.0060090362463753,0.0,0.0,0.0222555638909727,0.0297574393598399,0.0204311230867524,0.4285714285714285,0.581395348837209,0.2916666666666665,264,66,28,16,0,5573,7,24,68,7000000,300000.0,7000000.0,1500000.0,300000.0,2500000.0,9,5700000,0.5555555555555556,0.75
345886,Rubén,Vargas,2024,167,Switzerland,Adligenswil,Switzerland,05-08-98,Left Winger,Attack,Right,179.0,30-06-25,ROOF,https://img.a.transfermarkt.technology/portrait/header/345886-1722850174.jpg?lm=1,L1,FC Augsburg 1907,9000000.0,13000000.0,26,134,143,10,13,15,12,14,11,10,13,5,6,12,10,9,14,15,10,14,11,9,12,12,14,15,7,14,8,12,15,14,16,12,9,14,14,12,8,12,9,13,10,11,1,2,3,1,2,3,3,1,2,2,2,12,14,9,11,8,12,10,10,1,1,1,1,1,1,1,20,12,18,20,13,18,12,68,12,20,9860753,6650,6650,5500,Mediterranean_Hispanic,127,24,4,11538.0,Unknown,98041215,4000000.0,1.0,92,24,92,0,1,3,67,7,0.6301931727970362,0.5828877005347594,0.5735294117647058,0.0111326014598201,0.1578947368421052,0.0526315789473684,0.0447611902975743,0.0647661915478869,0.0221950609739159,0.0,0.3720930232558141,0.3333333333333332,269,54,34,40,1,5583,18,58,92,7000000,259259.25925925927,13000000.0,2000000.0,100000.0,4000000.0,2,3100000,-0.2222222222222222,0.07692307692307693
345911,Ladislav,Krejci,2024,12321,Czech Republic,Rosice,Czech Republic,20-04-99,Centre-Back,Defender,Left,191.0,30-06-29,Unknown,https://img.a.transfermarkt.technology/portrait/header/345911-1716965804.jpg?lm=1,ES1,Girona FÃºtbol Club S. A. D.,10000000.0,10000000.0,25,129,140,13,13,14,9,12,13,8,9,4,6,13,13,10,14,8,11,11,11,12,13,10,12,14,10,14,7,15,15,14,13,12,8,10,14,14,10,10,8,12,11,16,3,3,1,3,1,2,1,3,2,1,1,12,10,1,16,10,16,15,15,1,15,1,1,15,5,1,18,5,10,20,10,14,8,61,20,9,3665688,6450,6450,5000,Northern_European,124,41,5,4507.0,Unknown,25018650,4155000.0,2.0,26,1249,28,1,0,7,107,2,0.6037311458057687,0.5294117647058822,0.5514705882352942,0.0043433464625094,0.2697368421052631,0.0657894736842105,0.0497624406101525,0.0497624406101525,0.0230561960054445,0.1428571428571428,0.6511627906976742,0.2916666666666665,242,53,16,72,4,8768,12,104,96,12000000,540909.0909090909,12000000.0,500000.0,250000.0,1300000.0,2,2600000,0.2,1.4
346289,Mouctar,Diakhaby,2024,1049,France,VendÃ´me,Guinea,19-12-96,Centre-Back,Defender,Right,192.0,30-06-27,VV Consulting,https://img.a.transfermarkt.technology/portrait/header/346289-1709636432.jpg?lm=1,ES1,Valencia Club de FÃºtbol S. A. D.,2000000.0,30000000.0,28,140,149,6,6,12,7,11,6,16,6,6,14,13,10,13,9,14,13,15,14,13,12,13,15,8,11,8,15,14,15,13,12,14,16,15,13,15,16,12,12,13,5,8,1,1,1,1,2,3,2,2,2,3,2,15,14,3,12,13,16,15,12,1,1,20,1,1,1,12,1,1,1,1,1,1,1,80,8,20,9131129,6950,6950,5000,African_Caribbean,140,0,0,15332.0,Unknown,48036643,15000000.0,1.0,34,1572,44,1,1,1,208,2,0.6698862132839376,0.5294117647058822,0.6691176470588234,0.0147961533670591,0.0,0.0,0.0097524381095273,0.1497874468617154,0.0833078696630462,0.0,0.6744186046511627,0.4166666666666665,267,21,4,66,2,6779,10,107,326,2000000,41379.31034482759,30000000.0,8000000.0,,6000000.0,1,5000000,0.0,-0.6666666666666666
346314,Trevoh,Chalobah,2024,873,Sierra Leone,Freetown,England,05-07-99,Centre-Back,Defender,Right,192.0,31-05-25,CAA Base Ltd,https://img.a.transfermarkt.technology/portrait/header/346314-1698937171.jpg?lm=1,GB1,Crystal Palace Football Club,13000000.0,22000000.0,25,144,155,6,10,11,8,14,10,13,9,6,13,12,6,14,13,10,13,13,15,14,12,14,13,12,8,8,14,15,15,15,11,14,15,15,15,14,14,15,3,15,5,16,3,3,2,4,1,2,1,4,2,2,3,11,12,7,12,9,14,15,17,1,8,20,12,5,10,19,1,17,6,1,1,1,1,83,13,20,34124769,7200,7150,5850,African_Caribbean,142,0,0,52196.0,Unknown,28103591,9111392.0,2.0,85,510,33,1,1,1,58,2,0.696348240275205,0.6203208556149732,0.6838235294117647,0.0503926682612226,0.0,0.0,0.0647661915478869,0.1097774443610902,0.0505924720131114,0.1428571428571428,0.6744186046511627,0.2916666666666665,285,17,10,42,2,6951,10,65,163,13000000,705882.3529411765,22000000.0,5000000.0,,2700000.0,5,8500000,0.0,-0.2777777777777778
346315,Dujon,Sterling,2024,124,England,London,England,24-10-99,Right-Back,Defender,Right,186.0,31-05-27,Unknown,https://img.a.transfermarkt.technology/portrait/header/346315-1560934968.jpg?lm=1,SC1,Rangers Football Club,4000000.0,4000000.0,25,112,-75,9,10,11,7,7,9,12,7,9,9,9,9,12,11,11,11,11,10,10,10,10,16,12,6,11,11,10,13,15,11,11,11,13,14,13,13,9,6,10,13,14,1,3,1,3,3,1,1,3,2,2,4,7,13,2,12,12,12,10,13,1,14,17,20,1,18,1,1,1,15,1,1,13,11,73,10,20,117275,5588,5588,3489,African_Caribbean,101,0,0,23198.0,Stoke City,28108034,9111392.0,2.0,32,858,33,1,1,1,161,11,0.4896798094734057,0.367807486631016,0.3823529411764706,0.0223916987814875,0.0,0.0,0.0197549387346836,0.0197549387346836,0.0505924720131114,0.1428571428571428,0.5348837209302322,0.2916666666666665,256,14,18,30,1,6698,1,9,71,4000000,250000.0,4000000.0,300000.0,,900000.0,4,2700000,0.0,0.6
346483,Mason,Mount,2024,985,England,Portsmouth,England,10-01-99,Attacking Midfield,Midfield,Right,181.0,30-06-28,Unknown,https://img.a.transfermarkt.technology/portrait/header/346483-1683291495.jpg?lm=1,GB1,Manchester United Football Club,35000000.0,75000000.0,25,165,170,14,12,11,14,15,14,9,12,5,7,15,15,11,15,14,14,15,15,12,12,16,18,13,12,17,14,18,20,15,13,10,9,15,15,20,11,12,6,14,8,12,1,3,2,2,1,3,4,3,2,3,3,16,18,6,13,14,16,16,17,1,1,1,1,1,1,14,1,15,1,16,20,15,1,70,12,20,126331239,8244,8244,6894,Northern_European,162,31,4,89314.0,Unknown,28103590,64200000.0,1.0,32,1173,33,3,1,7,132,0,0.8410955279174386,0.7319786096256684,0.8308823529411764,0.0862344499409525,0.2039473684210526,0.0526315789473684,0.1747936984246061,0.3748437109277319,0.3566487957998833,0.0,0.418604651162791,0.2916666666666665,356,66,61,40,0,8724,14,85,111,32000000,1436363.6363636365,75000000.0,15000000.0,750000.0,45000000.0,4,46000000,-0.08571428571428572,-0.28888888888888886
346546,Radoslaw,Majecki,2024,162,Poland,Starachowice,Poland,16-11-99,Goalkeeper,Goalkeeper,Right,193.0,30-06-28,ROOF,https://img.a.transfermarkt.technology/portrait/header/346546-1672484869.jpg?lm=1,FR1,Association sportive de Monaco Football Club,5000000.0,5000000.0,25,120,145,4,2,1,1,12,8,9,2,1,3,11,3,1,10,4,13,12,15,14,8,11,14,6,8,8,13,12,14,7,13,14,16,14,8,12,14,14,3,12,2,10,15,12,13,7,14,12,13,12,12,13,12,15,15,8,11,17,15,12,13,20,1,1,1,1,1,1,1,1,1,1,1,1,1,78,8,20,6339999,5963,5473,3773,Northern_European,121,1,0,11506.0,KSV Cercle Brugge,96093498,7000000.0,1.0,75,1419,78,2,1,7,24,5,0.4744641439534268,0.3981818181818181,0.5294117647058822,0.0111017017073078,0.006578947368421,0.0,0.0247561890472618,0.0247561890472618,0.038862190616406,0.0,0.6976744186046511,0.2916666666666665,0,0,0,0,0,0,6,36,62,7000000,328571.4285714286,7000000.0,1000000.0,250000.0,4500000.0,6,600000,0.4,2.5
346551,Kamil,Grabara,2024,82,Poland,Ruda ?l?ska,Poland,08-01-99,Goalkeeper,Goalkeeper,Right,195.0,Unknown,BMG-SPORT,https://img.a.transfermarkt.technology/portrait/header/346551-1724770843.jpg?lm=1,L1,Verein fÃ¼r LeibesÃ¼bungen Wolfsburg,14000000.0,14000000.0,25,134,150,3,3,4,3,5,7,7,3,1,3,5,2,3,7,17,13,17,15,13,9,13,18,1,7,2,14,13,10,11,13,13,16,12,10,11,14,11,14,14,5,10,16,14,14,13,12,8,15,16,14,14,13,16,20,15,12,16,14,5,5,20,1,1,1,1,1,1,1,1,1,1,1,1,1,93,7,20,6196107,6750,6006,3003,Northern_European,133,1,0,12099.0,Unknown,96085886,6676666.667,3.0,75,1258,78,2,1,7,213,5,0.5449854458851549,0.3158288770053475,0.6176470588235294,0.0116743127460513,0.006578947368421,0.0,0.0697674418604651,0.0697674418604651,0.0370658444234562,0.2857142857142857,0.7441860465116279,0.2916666666666665,0,0,0,0,0,0,4,21,53,14000000,817647.0588235294,14000000.0,2000000.0,,5000000.0,5,9400000,0.16666666666666666,0.2727272727272727
346561,Luca,Ranieri,2024,430,Italy,La Spezia,Italy,23-04-99,Centre-Back,Defender,Left,187.0,30-06-28,Unknown,https://img.a.transfermarkt.technology/portrait/header/346561-1692962464.jpg?lm=1,IT1,Associazione Calcio Fiorentina,8000000.0,8000000.0,25,126,143,6,12,12,7,12,8,11,8,11,12,12,7,13,12,12,13,13,12,11,11,13,14,10,10,13,13,14,15,14,13,13,11,14,13,14,12,12,12,10,9,13,2,2,1,4,2,2,3,3,4,3,1,11,13,10,13,12,13,9,9,1,20,17,1,20,1,1,15,1,1,1,1,1,1,74,20,7,3812675,6300,6100,3653,Mediterranean_Hispanic,122,0,0,21346.0,Unknown,43270506,9111392.0,2.0,52,787,54,1,0,3,26,2,0.5574225985710506,0.3853475935828876,0.536764705882353,0.0206033756048385,0.0,0.0,0.0397599399849962,0.0397599399849962,0.0505924720131114,0.1428571428571428,0.5581395348837206,0.2916666666666665,329,8,12,70,0,8058,4,10,31,12000000,658333.3333333334,12000000.0,200000.0,,1800000.0,6,1300000,0.5,1.4
346567,Luca,Pellegrini,2024,398,Italy,Roma,Italy,07-03-99,Left-Back,Defender,Left,178.0,30-06-25,Team Raiola,https://img.a.transfermarkt.technology/portrait/header/346567-1663065246.jpg?lm=1,IT1,SocietÃ  Sportiva Lazio S.p.A.,3500000.0,15000000.0,25,138,155,10,14,13,7,13,5,11,9,11,12,14,6,14,14,17,13,14,11,14,12,13,13,13,8,15,13,14,16,14,14,15,10,14,14,13,13,13,15,12,11,13,2,1,1,3,1,3,3,1,1,3,2,10,16,13,13,12,15,12,13,1,20,5,1,19,1,1,17,5,1,7,1,1,1,72,20,11,10557494,6900,6850,5500,Mediterranean_Hispanic,136,1,0,35577.0,Eintracht Frankfurt,43252226,22800000.0,1.0,52,1244,54,1,0,3,185,8,0.6566551997883038,0.5828877005347594,0.6397058823529411,0.0343450749174155,0.006578947368421,0.0,0.0172543135783946,0.0747686921730432,0.1266424067335203,0.0,0.3488372093023257,0.2916666666666665,202,3,22,57,0,7900,25,127,141,3500000,148913.04347826086,15000000.0,2500000.0,250000.0,15000000.0,6,9750000,0.0,-0.125
346707,Sean,Longstaff,2024,762,England,Newcastle upon Tyne,England,30-10-97,Central Midfield,Midfield,Right,187.0,30-06-25,Gol International,https://img.a.transfermarkt.technology/portrait/header/346707-1682341336.jpg?lm=1,GB1,Newcastle United Football Club,25000000.0,25000000.0,27,128,157,11,11,13,13,14,11,10,13,7,11,13,5,14,13,11,13,15,14,12,13,12,6,11,10,14,13,16,16,11,11,13,11,11,12,15,12,13,7,13,10,8,1,3,1,3,3,4,1,3,3,3,1,17,10,4,10,13,10,10,14,1,1,1,1,1,1,18,1,20,10,1,14,10,1,65,8,20,8982296,6400,6400,5000,Northern_European,127,0,0,34798.0,Unknown,28100360,9111392.0,2.0,32,1037,33,3,1,7,137,1,0.5971156390579518,0.5294117647058822,0.5735294117647058,0.0335928590671944,0.0,0.0,0.1247811952988247,0.1247811952988247,0.0505924720131114,0.1428571428571428,0.5581395348837206,0.375,318,37,26,28,1,7693,6,29,121,25000000,1384722.2222222222,25000000.0,4500000.0,,,2,2425000,0.0,0.0
346779,Ché,Adams,2024,416,England,Leicester,Scotland,13-07-96,Centre-Forward,Attack,Right,179.0,30-06-27,Unique Sports Group,https://img.a.transfermarkt.technology/portrait/header/346779-1716381473.jpg?lm=1,IT1,Torino Calcio,15000000.0,22000000.0,28,140,145,6,10,14,15,13,6,11,13,4,7,15,9,8,14,11,13,13,14,10,15,12,14,11,4,13,9,14,14,15,14,13,11,16,15,14,16,13,5,7,5,12,4,1,2,2,3,3,3,2,1,2,1,10,11,12,14,13,15,15,12,1,1,1,1,1,1,1,10,1,10,14,14,14,20,70,11,20,40191136,7000,6750,5500,Mixed_Race,139,19,5,57996.0,Unknown,90055302,9111392.0,2.0,32,813,83,0,1,4,201,3,0.6434241862926701,0.5828877005347594,0.6617647058823528,0.055993248404076,0.125,0.0657894736842105,0.0747686921730432,0.1097774443610902,0.0505924720131114,0.1428571428571428,0.3720930232558141,0.4166666666666665,396,110,42,26,3,2848,3,4,19,15000000,553703.7037037037,22000000.0,3000000.0,50000.0,2000000.0,3,6150000,0.0,0.0
346853,Romano,Schmid,2024,86,Austria,Graz,Austria,27-01-00,Attacking Midfield,Midfield,Right,168.0,Unknown,SEG,https://img.a.transfermarkt.technology/portrait/header/346853-1660208556.jpg?lm=1,L1,Sportverein Werder Bremen von 1899,13000000.0,13000000.0,24,116,137,9,13,13,8,13,9,4,11,5,6,14,9,7,14,6,12,11,11,11,12,12,15,13,7,14,11,13,13,14,14,10,7,12,13,11,6,10,6,12,8,11,3,2,2,3,2,1,2,4,3,2,3,14,17,6,13,10,13,13,12,1,1,1,1,1,1,1,12,14,12,12,20,12,10,69,12,20,2874999,5800,5800,4400,Northern_European,114,0,0,5794.0,Unknown,16184737,800000.0,2.0,6,557,7,3,1,7,194,0,0.5177295580841492,0.4652406417112299,0.4779411764705882,0.0055860958838632,0.0,0.0,0.0647661915478869,0.0647661915478869,0.0044167893552598,0.1428571428571428,0.1162790697674416,0.25,274,32,53,52,0,4593,6,15,35,15000000,647826.0869565217,15000000.0,1000000.0,800000.0,2000000.0,3,1150000,0.5,1.3076923076923077
346890,Noah,Okafor,2024,5,Switzerland,Binningen,Switzerland,24-05-00,Left Winger,Attack,Right,185.0,30-06-28,Sports360 GmbH,https://img.a.transfermarkt.technology/portrait/header/346890-1692879855.jpg?lm=1,IT1,Associazione Calcio Milan,20000000.0,25000000.0,24,134,154,8,11,13,14,14,8,7,11,7,7,11,8,7,15,12,12,12,9,9,12,10,11,11,7,14,7,12,13,17,11,11,12,12,15,13,12,14,7,11,7,9,2,3,3,2,3,3,3,3,3,1,1,18,13,7,13,7,12,10,11,1,1,1,1,1,1,1,14,1,12,20,12,17,13,80,14,20,15443999,7000,6900,4300,Mixed_Race,128,8,2,15683.0,Unknown,98040226,13350000.0,2.0,92,196,92,0,1,4,27,7,0.6632707065361206,0.4545454545454545,0.5808823529411764,0.0151350850274283,0.0526315789473684,0.0263157894736842,0.0997749437359339,0.1247811952988247,0.0741409483596766,0.1428571428571428,0.5116279069767438,0.25,274,63,37,21,0,10295,27,94,98,15000000,695238.0952380953,25000000.0,5000000.0,4000000.0,7500000.0,3,800000,-0.25,-0.25
346903,Christopher,Lungoyi,2024,2832,DR Congo,Kinshasa,Switzerland,04-07-00,Left Winger,Attack,Left,182.0,30-06-26,Unknown,https://img.a.transfermarkt.technology/portrait/header/346903-1725444576.jpg?lm=1,TR1,Gaziantep Futbol KulÃ¼bÃ¼ A.?.,600000.0,900000.0,24,110,135,10,10,15,10,13,9,7,9,5,5,11,12,5,13,10,10,8,11,10,9,8,15,15,8,12,5,10,11,15,14,8,8,12,14,11,8,9,7,8,10,12,3,2,3,2,2,3,2,3,3,2,3,20,13,5,5,11,8,11,17,1,1,1,1,1,1,1,13,1,1,18,15,15,20,74,20,7,71972,5500,5500,2750,African_Caribbean,92,0,0,5476.0,Ascoli Calcio 1898,98041794,3400000.0,1.0,27,729,92,0,0,1,103,7,0.4780365175972479,0.2887700534759358,0.3161764705882353,0.0052790295932723,0.0,0.0,0.0027506876719179,0.0042510627656914,0.0188616350454179,0.0,0.4418604651162785,0.25,187,34,10,38,1,4944,2,3,8,750000,43750.0,900000.0,200000.0,,600000.0,7,350000,0.25,-0.0625
347253,Dany,Mota,2024,2919,Luxembourg,Niederkorn,Portugal,02-05-98,Second Striker,Attack,Right,180.0,30-06-27,VV Consulting,https://img.a.transfermarkt.technology/portrait/header/347253-1652095197.jpg?lm=1,IT1,Associazione Calcio Monza,5000000.0,6000000.0,26,127,136,12,12,13,15,15,14,14,14,5,4,14,14,10,13,12,14,12,11,13,12,12,14,12,13,15,6,13,13,13,13,13,10,14,12,14,13,16,5,12,8,13,1,2,1,3,3,3,3,4,1,3,2,15,14,5,12,13,16,14,16,1,1,1,1,1,1,1,1,1,1,18,1,19,20,76,5,20,3116002,6350,5900,5450,Mediterranean_Hispanic,127,0,0,8462.0,Unknown,43257364,3330000.0,2.0,59,1042,79,0,1,3,28,12,0.530960571579783,0.5775401069518716,0.5735294117647058,0.0081623627495758,0.0,0.0,0.0247561890472618,0.0297574393598399,0.0184727353537598,0.1428571428571428,0.3953488372093026,0.3333333333333332,301,89,40,25,2,5798,11,21,27,5000000,234523.80952380953,6000000.0,1000000.0,200000.0,275000.0,3,150000,0.0,0.0
347900,Jerdy,Schouten,2024,383,Netherlands,Spijkenisse,Netherlands,12-01-97,Defensive Midfield,Midfield,Right,185.0,30-06-28,Key United,https://img.a.transfermarkt.technology/portrait/header/347900-1718013852.jpg?lm=1,NL1,Eindhovense Voetbalvereniging Philips Sport Vereniging,28000000.0,28000000.0,27,133,142,9,10,15,8,15,9,12,12,8,12,15,10,15,16,13,14,12,12,11,13,13,14,12,10,12,13,16,14,11,12,15,10,12,11,14,11,13,16,10,11,13,2,2,2,1,3,3,2,3,3,3,2,14,16,2,15,10,16,14,12,1,1,10,1,1,1,20,1,20,1,1,5,1,1,77,11,20,5273663,6650,6550,5250,Northern_European,133,1,0,35221.0,Unknown,37057744,4933333.333,3.0,67,1408,68,3,1,7,62,4,0.6169621593014025,0.5561497326203209,0.6176470588235294,0.0340013151707163,0.006578947368421,0.0,0.1397849462365591,0.1397849462365591,0.027380390194172,0.2857142857142857,0.5116279069767438,0.375,274,18,11,35,2,4468,17,58,81,32000000,1278000.0,35000000.0,3000000.0,,75000.0,4,4275000,0.14285714285714285,0.45454545454545453
348026,Nordi,Mukiele,2024,15,France,Montreuil,France,01-11-97,Right-Back,Defender,Right,187.0,30-06-25,Sport Cover,https://img.a.transfermarkt.technology/portrait/header/348026-1727378130.jpg?lm=1,L1,Bayer 04 Leverkusen FuÃŸball,10000000.0,25000000.0,27,140,152,7,12,12,6,11,6,13,6,13,14,13,9,15,13,13,15,17,13,11,12,11,15,8,9,8,12,15,14,14,13,15,15,16,16,15,14,13,7,15,4,15,3,3,2,3,3,1,3,2,2,3,2,11,17,6,12,12,10,14,14,1,1,20,18,1,18,10,1,10,14,1,1,1,1,84,10,20,9962507,7000,6400,5750,African_Caribbean,137,1,0,57533.0,Unknown,48034615,9833333.333,3.0,34,979,36,1,1,1,36,11,0.5971156390579518,0.6096256684491979,0.6470588235294117,0.0555461676099138,0.006578947368421,0.0,0.0497624406101525,0.1247811952988247,0.0546033686102391,0.2857142857142857,0.5581395348837206,0.375,306,13,19,37,0,6787,6,29,99,10000000,380769.23076923075,25000000.0,5000000.0,800000.0,14000000.0,4,700000,0.0,-0.16666666666666666
348795,Giovani,Lo Celso,2024,150,Argentina,Rosario,Argentina,09-04-96,Central Midfield,Midfield,Left,177.0,30-06-28,DCGLOBALSL,https://img.a.transfermarkt.technology/portrait/header/348795-1726734706.jpg?lm=1,ES1,Real Betis BalompiÃ© S.A.D.,16000000.0,50000000.0,28,145,151,11,14,16,11,15,13,10,13,8,9,16,14,14,16,12,13,14,15,11,14,14,15,15,10,14,12,16,14,13,14,15,9,11,12,13,11,12,11,13,15,14,1,1,1,1,1,2,2,2,3,3,1,12,13,6,15,13,14,12,14,1,1,1,1,1,1,16,18,20,7,1,20,1,1,69,20,8,34710527,7250,7250,6250,Mediterranean_Hispanic,141,39,2,115992.0,Villarreal,14108651,17250000.0,4.0,4,1248,4,3,0,3,164,1,0.7095792537708389,0.6631016042780749,0.6764705882352942,0.1119951873635462,0.256578947368421,0.0263157894736842,0.0797699424856214,0.2498124531132783,0.0958082168949137,0.4285714285714285,0.3255813953488373,0.4166666666666665,332,46,42,52,2,11068,16,85,85,20000000,520833.3333333333,50000000.0,10000000.0,,10000000.0,6,6000000,0.25,0.25
349066,Alexander,Isak,2024,762,Sweden,Solna,Sweden,21-09-99,Centre-Forward,Attack,Right,192.0,30-06-28,Universal Twenty Two,https://img.a.transfermarkt.technology/portrait/header/349066-1680791339.jpg?lm=1,GB1,Newcastle United Football Club,75000000.0,75000000.0,25,151,166,7,9,15,14,15,8,12,9,6,5,13,14,6,16,11,15,13,13,11,15,14,14,16,7,16,6,12,12,17,15,15,16,14,16,14,12,12,7,15,5,8,2,3,3,3,1,1,3,2,3,3,2,13,15,5,10,13,12,14,14,1,1,1,1,1,1,1,12,1,12,12,10,12,20,74,10,20,140433523,7450,6759,5507,African_Caribbean,150,37,9,139190.0,Unknown,93070286,31200000.0,3.0,91,1393,91,0,1,1,137,3,0.644614977507277,0.5836363636363636,0.7426470588235294,0.1343955767004278,0.2434210526315789,0.1184210526315789,0.3748437109277319,0.3748437109277319,0.1733103697324925,0.2857142857142857,0.6744186046511627,0.2916666666666665,311,136,28,27,0,5980,14,66,107,75000000,3108333.3333333335,75000000.0,10000000.0,6000000.0,22500000.0,4,31250000,0.0,0.07142857142857142
349536,Nico,Mantl,2024,8024,Germany,MÃ¼nchen,Germany,06-02-00,Goalkeeper,Goalkeeper,Right,193.0,30-06-28,ROOF,https://img.a.transfermarkt.technology/portrait/header/349536-1692996965.png?lm=1,PO1,Futebol Clube de Arouca,1500000.0,1500000.0,24,122,147,3,4,5,4,8,4,7,9,13,7,12,6,9,8,8,11,15,10,9,11,9,14,7,8,5,17,13,13,10,12,14,16,14,12,15,14,10,6,14,5,1,16,13,12,7,12,11,13,13,13,11,13,9,16,7,12,13,12,14,13,20,1,1,1,1,1,1,1,1,1,1,1,1,1,88,11,20,5349999,6090,6090,4040,Northern_European,121,0,0,4524.0,Unknown,92091333,1250000.0,2.0,38,1006,40,2,1,7,98,5,0.5560994972214872,0.4267379679144384,0.5294117647058822,0.0043597619560315,0.0,0.0,0.0072518129532383,0.0072518129532383,0.0069168588016333,0.1428571428571428,0.6976744186046511,0.25,0,0,0,0,0,0,5,8,12,1500000,63636.36363636364,1500000.0,300000.0,100000.0,1300000.0,6,1100000,0.25,0.875
349599,Pervis,Estupiñán,2024,1237,Ecuador,Esmeraldas,Ecuador,21-01-98,Left-Back,Defender,Left,175.0,30-06-27,LINK SPORTS,https://img.a.transfermarkt.technology/portrait/header/349599-1668498118.jpg?lm=1,GB1,Brighton and Hove Albion Football Club,30000000.0,35000000.0,26,140,156,6,14,13,7,14,7,10,7,14,11,11,12,13,13,5,11,12,13,10,11,11,13,12,10,16,11,14,13,15,12,13,10,16,15,18,11,12,12,10,5,14,3,1,3,4,1,2,1,3,3,1,1,18,12,8,10,11,10,11,13,1,20,10,1,18,1,1,16,1,1,14,1,1,1,73,20,10,35789250,7000,7000,4750,African_Caribbean,126,28,3,69595.0,Unknown,86045976,11566666.67,3.0,30,471,31,1,0,1,44,8,0.6765017200317545,0.5026737967914437,0.5661764705882353,0.0671934430725168,0.1842105263157894,0.0394736842105263,0.1497874468617154,0.1747936984246061,0.0642332657573821,0.2857142857142857,0.2790697674418605,0.3333333333333332,323,10,28,51,1,4777,12,87,140,30000000,1069642.857142857,35000000.0,5000000.0,400000.0,800000.0,8,5800000,0.0,-0.14285714285714285
349701,Antonee,Robinson,2024,931,England,Milton Keynes,United States,08-08-97,Left-Back,Defender,Left,183.0,30-06-28,Wasserman,https://img.a.transfermarkt.technology/portrait/header/349701-1703926612.jpg?lm=1,GB1,Fulham Football Club,25000000.0,25000000.0,27,139,142,3,11,13,7,12,7,10,7,4,12,12,8,13,13,13,11,14,11,11,13,11,12,11,9,13,12,14,16,17,13,13,12,14,17,16,13,11,2,13,11,11,3,3,2,2,1,2,3,2,3,3,1,14,12,4,12,12,12,15,15,1,20,1,1,19,1,1,1,1,1,1,1,1,1,70,20,8,32454341,6950,6950,5500,African_Caribbean,129,28,2,34798.0,Unknown,29125265,2150000.0,2.0,32,955,102,1,0,1,95,8,0.6698862132839376,0.5828877005347594,0.588235294117647,0.0335928590671944,0.1842105263157894,0.0263157894736842,0.1247811952988247,0.1247811952988247,0.0119169976943803,0.1428571428571428,0.4651162790697669,0.375,302,4,29,46,1,2342,9,47,112,28000000,1550000.0,28000000.0,1000000.0,,500000.0,2,500000,0.12,0.4
351478,Mikel,Oyarzabal,2024,681,Spain,Eibar,Spain,21-04-97,Centre-Forward,Attack,Left,181.0,30-06-28,Unknown,https://img.a.transfermarkt.technology/portrait/header/351478-1599987229.jpg?lm=1,ES1,Real Sociedad de FÃºtbol S.A.D.,45000000.0,70000000.0,27,158,167,14,12,15,15,14,13,12,12,12,13,15,19,12,16,13,14,13,14,14,16,14,16,14,17,15,13,14,16,13,14,14,13,14,13,14,14,14,7,14,5,17,3,2,2,1,2,2,2,1,4,1,3,12,14,8,20,13,18,16,13,1,1,1,1,1,1,1,1,11,1,20,17,17,15,77,20,10,70125008,7900,7900,6400,Mediterranean_Hispanic,153,21,6,43121.0,Unknown,67220143,9111392.0,2.0,89,448,89,0,0,3,168,3,0.7955808414924583,0.6791443850267379,0.7647058823529411,0.041629691572189,0.1381578947368421,0.0789473684210526,0.2248062015503876,0.3498374593648412,0.0505924720131114,0.1428571428571428,0.418604651162791,0.375,392,108,61,28,2,6494,10,75,281,35000000,1300000.0,70000000.0,12000000.0,2500000.0,35000000.0,0,0,-0.2222222222222222,-0.3
351749,Kalvin,Phillips,2024,677,England,Leeds,England,02-12-95,Defensive Midfield,Midfield,Right,179.0,30-06-25,CAA Stellar,https://img.a.transfermarkt.technology/portrait/header/351749-1661978510.jpg?lm=1,GB1,Ipswich Town Football Club,22000000.0,50000000.0,29,152,156,13,12,11,9,13,13,11,11,5,13,15,10,16,13,16,15,16,13,14,14,13,16,10,10,11,15,15,18,13,13,14,11,18,14,17,14,14,13,13,10,13,2,2,4,3,1,1,3,2,2,2,3,16,13,1,17,15,16,11,18,1,1,12,1,1,1,20,1,17,1,1,9,1,1,72,11,20,48341458,7593,7593,6743,Northern_European,151,23,0,185587.0,Unknown,29113879,49000000.0,1.0,32,810,33,3,1,7,115,4,0.7549616300608626,0.7158288770053476,0.75,0.1791973209914572,0.1513157894736842,0.0,0.1097774443610902,0.2498124531132783,0.2722020056112669,0.0,0.3720930232558141,0.4583333333333332,293,16,14,60,3,4586,5,54,103,20000000,759615.3846153846,50000000.0,10000000.0,,250000.0,3,11000000,-0.2,-0.2857142857142857
351809,Robin,Le Normand,2024,13,France,Pabu,Spain,11-11-96,Centre-Back,Defender,Right,187.0,30-06-29,AC Talent,https://img.a.transfermarkt.technology/portrait/header/351809-1707948228.jpg?lm=1,ES1,Club AtlÃ©tico de Madrid S.A.D.,40000000.0,40000000.0,28,149,152,8,7,9,7,12,10,15,10,10,14,14,11,16,14,14,15,14,14,15,8,15,14,8,14,7,14,15,14,13,13,13,16,16,14,15,16,14,9,12,8,18,3,3,2,3,3,1,2,3,3,2,1,7,8,5,12,9,16,14,12,1,1,20,1,1,1,1,1,1,1,1,1,1,1,80,5,20,40428563,7450,7450,5750,Northern_European,150,0,0,40376.0,Unknown,48037162,34500000.0,1.0,34,1108,89,1,1,7,52,2,0.7360412807621064,0.6096256684491979,0.7426470588235294,0.0389790721769937,0.0,0.0,0.1997999499874969,0.1997999499874969,0.1916442123392316,0.0,0.5581395348837206,0.4166666666666665,327,10,7,74,1,5914,7,22,61,40000000,1736956.5217391304,40000000.0,3000000.0,,150000.0,2,1000000,0.0,0.0
351816,Ismaël,Bennacer,2024,5,France,Arles,Algeria,01-12-97,Defensive Midfield,Midfield,Left,175.0,30-06-27,Team Raiola,https://img.a.transfermarkt.technology/portrait/header/351816-1663575089.jpg?lm=1,IT1,Associazione Calcio Milan,30000000.0,40000000.0,27,152,163,13,12,15,9,16,13,7,14,6,13,15,12,15,15,13,14,16,14,14,15,14,15,14,11,13,15,16,14,15,15,16,8,13,13,14,12,15,13,13,12,12,2,4,2,2,1,2,1,1,2,1,2,17,16,6,12,14,15,14,12,1,1,1,1,1,1,20,8,20,10,1,13,1,1,70,20,9,50000001,7596,7496,6396,North_African__Middle_Eastern,154,40,2,53462.0,Unknown,48032338,6166666.667,3.0,34,86,1,3,0,6,27,4,0.7421275469700979,0.678716577540107,0.7720588235294117,0.0516151397199903,0.2631578947368421,0.0263157894736842,0.1497874468617154,0.1997999499874969,0.0342324323842328,0.2857142857142857,0.2790697674418605,0.375,313,14,22,48,0,4915,17,100,205,14000000,556000.0,40000000.0,12000000.0,,3000000.0,3,5600000,-0.5333333333333333,-0.6
351843,Yoann,Salmier,2024,738,France,Villiers-le-Bel,French Guiana,21-11-92,Centre-Back,Defender,Right,188.0,30-06-25,S.O.M FOOTBALL,https://img.a.transfermarkt.technology/portrait/header/351843-1551180384.jpg?lm=1,FR1,Le Havre Athletic Club,1500000.0,2000000.0,32,124,130,4,9,9,7,12,6,14,8,9,13,11,8,13,11,14,13,13,11,13,10,12,13,8,10,9,13,13,13,11,12,14,14,15,12,14,17,12,10,12,7,10,1,4,2,1,2,2,2,2,1,2,3,10,12,9,14,12,12,11,11,1,1,20,12,1,1,1,1,1,1,1,1,1,1,85,8,20,2733631,6200,6200,3509,African_Caribbean,124,2,0,9541.0,Unknown,49031215,500000.0,1.0,34,1608,37,1,1,1,126,2,0.5706536120666843,0.369946524064171,0.5514705882352942,0.0092042637795997,0.0131578947368421,0.0,0.0072518129532383,0.0097524381095273,0.0027500763910108,0.0,0.581395348837209,0.5833333333333333,284,7,2,42,2,3804,3,10,25,1200000,57894.73684210526,2000000.0,500000.0,,,2,400000,-0.2,-0.4
351955,Federico,Baschirotto,2024,1005,Italy,Isola della Scala,Italy,20-09-96,Centre-Back,Defender,Right,187.0,30-06-26,Guido Gallovich,https://img.a.transfermarkt.technology/portrait/header/351955-1657630979.jpg?lm=1,IT1,Unione Sportiva Lecce,6000000.0,8000000.0,28,123,129,6,13,10,12,10,7,15,9,13,13,10,6,13,9,10,12,11,10,11,9,12,14,8,13,11,13,13,13,12,10,12,14,15,12,13,15,13,8,10,7,9,1,3,1,3,2,1,2,1,3,2,2,11,14,7,10,10,14,11,10,1,14,20,20,12,15,1,1,1,1,1,1,1,1,77,8,20,2043555,6142,6142,2192,Mediterranean_Hispanic,119,0,0,14621.0,Unknown,43155683,240000.0,2.0,52,664,54,1,1,3,206,2,0.5629796242392168,0.2290909090909091,0.5147058823529411,0.0141095994909265,0.0,0.0,0.0297574393598399,0.0397599399849962,0.001305591821995,0.1428571428571428,0.5581395348837206,0.4166666666666665,331,17,8,41,2,1839,2,2,7,5000000,246250.0,8000000.0,1000000.0,,75000.0,6,675000,-0.16666666666666666,-0.2857142857142857
352015,Miguel,Carvalho,2024,4294,Portugal,Faro,Portugal,20-06-96,Goalkeeper,Goalkeeper,Left,189.0,30-06-25,Brave11 ,https://img.a.transfermarkt.technology/portrait/header/352015-1563990045.jpg?lm=1,PO1,Sporting Clube Farense,200000.0,200000.0,28,80,-8,6,7,13,7,13,6,2,8,6,6,13,2,8,13,5,10,8,7,5,13,13,7,13,1,8,6,7,12,13,10,3,8,7,12,7,4,8,9,5,12,14,2,1,2,1,3,3,2,3,4,2,2,12,9,3,10,11,10,13,19,1,1,1,1,1,1,1,1,15,1,1,20,14,1,0,20,10,9090000,4000,3900,2500,Mediterranean_Hispanic,75,0,0,277.0,Unknown,2000108512,9111392.0,2.0,76,485,79,2,0,3,191,5,0.2663403016671077,0.2620320855614972,0.1911764705882353,0.0002587854272904,0.0,0.0,0.0007501875468867,0.0007501875468867,0.0505924720131114,0.1428571428571428,0.6046511627906974,0.4166666666666665,0,0,0,0,0,0,0,0,0,100000,5000.0,200000.0,100000.0,,,2,150000,-0.5,0.0
353032,Omar,Alderete,2024,3709,Paraguay,AsunciÃ³n,Paraguay,26-12-96,Centre-Back,Defender,Left,188.0,30-06-28,La Squadra Sports,https://img.a.transfermarkt.technology/portrait/header/353032-1669365021.jpg?lm=1,ES1,Getafe Club de FÃºtbol S.A.D. Team Dubai,5000000.0,10000000.0,27,140,149,3,8,10,6,12,6,16,4,12,15,13,12,16,11,16,13,18,13,14,8,13,14,6,8,10,15,13,13,11,10,16,15,15,13,14,15,13,14,12,6,11,1,1,3,1,1,2,3,2,1,1,1,12,11,5,11,10,14,15,13,1,14,20,1,1,1,1,1,1,1,1,1,1,1,92,20,10,7325905,6600,6600,5250,Native_American,139,11,0,28846.0,Getafe,79027217,2770000.0,4.0,73,103,75,1,0,5,105,2,0.6235776660492194,0.5561497326203209,0.6617647058823528,0.0278455050999075,0.0723684210526315,0.0,0.0247561890472618,0.0497624406101525,0.015361537820495,0.4285714285714285,0.581395348837209,0.375,235,8,4,72,2,5289,5,15,39,5000000,209523.80952380953,10000000.0,3000000.0,,600000.0,5,8000000,0.0,0.6666666666666666
353037,Jesús,Medina,2024,232,Paraguay,Limpio,Paraguay,30-04-97,Right Winger,Attack,Left,178.0,30-06-26,Ultimate Sports,https://img.a.transfermarkt.technology/portrait/header/353037-1689010173.png?lm=1,RU1,FK Spartak Moskva,5000000.0,7000000.0,27,121,129,14,13,13,13,13,12,8,13,6,7,13,14,7,14,6,11,11,14,12,12,11,10,12,7,13,9,12,14,14,14,11,10,12,12,12,7,12,7,13,8,13,3,1,2,1,3,2,1,1,3,2,3,9,11,7,12,14,13,10,12,1,1,1,1,1,1,1,14,7,14,20,14,19,13,71,20,10,4316925,6050,6050,3500,Mediterranean_Hispanic,121,3,0,30748.0,Unknown,79024135,9111392.0,2.0,73,838,75,0,0,3,82,10,0.5508070918232336,0.3689839572192513,0.5294117647058822,0.0296821091398571,0.0197368421052631,0.0,0.0247561890472618,0.0347586896724181,0.0505924720131114,0.1428571428571428,0.3488372093023257,0.375,237,48,28,31,0,6319,3,10,40,4000000,197368.42105263157,7000000.0,1000000.0,,250000.0,3,1250000,-0.2,-0.2
353365,Marcus,Coco,2024,995,Guadeloupe,Les Abymes,Guadeloupe,24-06-96,Right Winger,Attack,Right,184.0,30-06-25,Unknown,https://img.a.transfermarkt.technology/portrait/header/353365-1704213736.jpg?lm=1,FR1,Football Club de Nantes,1500000.0,3000000.0,28,121,131,9,10,13,10,12,6,10,11,6,8,11,12,7,13,9,11,12,12,11,10,10,12,12,9,12,9,12,13,15,13,13,13,15,14,13,13,12,6,14,8,13,3,2,3,1,2,1,1,2,1,1,4,13,14,8,12,12,13,14,16,1,1,1,1,1,12,1,15,1,17,16,1,20,7,78,10,20,1655534,6049,6049,3520,African_Caribbean,118,0,0,5680.0,Unknown,85142872,3000000.0,1.0,41,823,43,0,1,1,93,10,0.5506747816882773,0.3711229946524064,0.5073529411764706,0.0054760155155382,0.0,0.0,0.0072518129532383,0.0147536884221055,0.0166393510930859,0.0,0.4883720930232553,0.4166666666666665,297,14,15,41,2,4971,2,49,204,1500000,64285.71428571428,3000000.0,600000.0,,3000000.0,1,0,0.0,0.0
353366,Benjamin,Pavard,2024,46,France,Maubeuge,France,28-03-96,Centre-Back,Defender,Right,186.0,30-06-28,Unknown,https://img.a.transfermarkt.technology/portrait/header/353366-1713819215.jpg?lm=1,IT1,Football Club Internazionale Milano S.p.A.,50000000.0,50000000.0,28,152,156,4,12,11,8,14,6,14,9,12,15,15,7,15,14,11,16,14,17,16,13,15,13,11,8,12,15,17,15,12,12,16,15,15,14,16,12,15,8,16,7,16,2,3,1,3,4,1,4,2,2,1,2,13,15,8,13,15,18,14,17,1,12,20,20,10,16,12,1,10,1,1,1,1,1,76,8,20,30739499,7599,7549,7099,Northern_European,151,45,2,134247.0,Unknown,85120944,23800000.0,3.0,34,930,36,1,1,7,89,2,0.7491399841227838,0.7539037433155079,0.75,0.1296225305545443,0.2960526315789473,0.0263157894736842,0.2498124531132783,0.2498124531132783,0.1321981166143504,0.2857142857142857,0.5348837209302322,0.4166666666666665,346,15,18,51,1,7148,13,43,50,40000000,1325000.0,50000000.0,10000000.0,,3000000.0,3,7200000,-0.2,0.0
353399,Romain,Del Castillo,2024,3911,France,Lyon,France,29-03-96,Right Winger,Attack,Left,172.0,30-06-27,score agencies,https://img.a.transfermarkt.technology/portrait/header/353399-1593964996.jpg?lm=1,FR1,Stade brestois 29,10000000.0,10000000.0,28,124,131,12,14,13,11,13,10,7,11,8,5,14,12,5,13,8,12,12,12,11,14,13,14,12,7,13,7,14,13,13,15,14,6,14,13,13,7,12,7,11,7,12,2,1,3,3,1,1,2,4,1,1,2,11,12,7,13,12,14,10,14,1,1,1,1,1,1,1,12,1,13,19,10,20,15,65,20,9,2761244,6200,6200,3705,Mediterranean_Hispanic,121,0,0,9693.0,Unknown,48036653,1750000.0,2.0,34,884,36,0,0,3,196,10,0.5706536120666843,0.3909090909090909,0.5294117647058822,0.0093510376040331,0.0,0.0,0.0497624406101525,0.0497624406101525,0.0096947137420483,0.1428571428571428,0.2093023255813952,0.4166666666666665,321,37,58,28,1,4931,5,16,29,10000000,410416.6666666667,10000000.0,1200000.0,,600000.0,4,2700000,0.0,0.42857142857142855
353403,Samuel,Moutoussamy,2024,2381,France,Paris,DR Congo,12-08-96,Central Midfield,Midfield,Left,176.0,30-06-26,Wasserman,https://img.a.transfermarkt.technology/portrait/header/353403-1726065611.jpg?lm=1,TR1,Sivasspor KulÃ¼bÃ¼,2500000.0,5000000.0,28,124,127,5,10,12,7,13,6,11,9,5,13,13,7,12,12,11,13,13,12,11,13,12,13,9,10,15,13,15,15,12,13,15,11,15,12,15,13,13,11,10,6,13,1,3,3,2,1,3,2,3,3,1,3,11,13,8,13,10,14,14,12,1,13,1,1,7,1,15,13,20,13,13,1,13,1,72,20,10,2951078,6200,6200,3002,African_Caribbean,123,15,0,10228.0,Unknown,85125689,9111392.0,2.0,34,1122,29,3,0,1,183,1,0.5706536120666843,0.3157219251336898,0.5441176470588236,0.0098676428413481,0.0986842105263157,0.0,0.0122530632658164,0.0247561890472618,0.0505924720131114,0.1428571428571428,0.3023255813953489,0.4166666666666665,263,8,10,28,0,3182,3,9,37,2200000,83333.33333333333,5000000.0,1000000.0,,,3,750000,-0.26666666666666666,-0.45
353634,Robert,Ljubicic,2024,2441,Austria,Wien,Croatia,14-07-99,Central Midfield,Midfield,Left,178.0,30-06-29,SEG,https://img.a.transfermarkt.technology/portrait/header/353634-1728415678.png?lm=1,GR1,Athlitiki Enosi Konstantinoupoleos,4000000.0,4000000.0,25,124,141,7,12,11,8,13,9,11,11,7,13,11,9,11,12,12,14,13,10,13,11,12,17,12,12,12,10,14,18,15,13,12,11,17,10,16,11,11,5,8,7,14,2,2,2,2,1,1,1,1,2,1,1,16,15,8,13,12,12,9,9,1,14,1,1,14,1,18,10,20,1,1,1,1,1,75,20,11,2968825,6345,6195,5195,Northern_European,121,0,0,2784.0,Unknown,16184704,3500000.0,2.0,6,1663,25,3,0,7,34,1,0.5699920613919026,0.5502673796791443,0.5294117647058822,0.0026795879131755,0.0,0.0,0.0197549387346836,0.0197549387346836,0.0194172060335009,0.1428571428571428,0.3488372093023257,0.2916666666666665,316,35,36,32,2,8139,6,11,13,4000000,211764.70588235295,4000000.0,500000.0,400000.0,625000.0,3,2400000,0.0,0.3333333333333333
353892,Hiroki,Ito,2024,27,Japan,"Hamamatsu, Shizuoka",Japan,12-05-99,Centre-Back,Defender,Left,188.0,30-06-28,Unknown,https://img.a.transfermarkt.technology/portrait/header/353892-1657181215.jpg?lm=1,L1,FC Bayern MÃ¼nchen,30000000.0,30000000.0,25,127,140,7,9,11,7,12,7,12,8,8,13,14,8,12,12,12,14,13,15,13,12,13,13,10,11,12,14,14,13,12,12,12,13,12,14,13,12,13,6,12,4,12,2,1,2,4,2,3,2,3,1,2,3,14,12,6,14,13,14,16,16,1,15,20,1,15,1,14,1,10,1,1,1,1,1,78,20,10,3945143,6349,6449,4799,10,127,3,0,16127.0,Unknown,45109024,11950000.0,2.0,54,593,56,1,0,0,68,2,0.6035988356708124,0.5079144385026737,0.5735294117647058,0.0155638190935364,0.0197368421052631,0.0,0.1497874468617154,0.1497874468617154,0.0663629545265146,0.1428571428571428,0.581395348837209,0.2916666666666665,171,6,7,15,0,2000,8,42,192,30000000,1761764.705882353,30000000.0,0.0,50000.0,150000.0,5,750000,0.0,0.36363636363636365
353922,Mert,Müldür,2024,36,Austria,Wien,TÃ¼rkiye,03-04-99,Right-Back,Defender,Right,184.0,30-06-27,SEG,https://img.a.transfermarkt.technology/portrait/header/353922-1728391929.JPG?lm=1,TR1,FenerbahÃ§e Spor KulÃ¼bÃ¼,7000000.0,10000000.0,25,126,142,4,10,12,7,13,5,12,7,10,11,12,5,13,13,14,11,12,11,9,11,12,16,10,9,12,13,13,13,14,13,14,12,13,15,13,13,11,9,12,7,14,2,3,1,3,1,3,2,1,3,1,3,14,14,8,12,11,15,13,13,1,15,12,20,1,17,1,1,1,14,1,1,1,1,74,14,20,3677675,6300,6400,5300,North_African__Middle_Eastern,122,18,1,9807.0,Unknown,16184687,3990000.0,2.0,6,1663,100,1,1,6,84,11,0.5971156390579518,0.5614973262032085,0.536764705882353,0.0094611179723582,0.1184210526315789,0.0131578947368421,0.0347586896724181,0.0497624406101525,0.0221395038751076,0.1428571428571428,0.4883720930232553,0.2916666666666665,258,11,28,42,1,3174,5,46,152,6500000,284090.9090909091,10000000.0,2000000.0,,5000000.0,2,2500000,0.08333333333333333,0.625
353948,Lucas,Tousart,2024,89,France,Arras,France,29-04-97,Defensive Midfield,Midfield,Right,184.0,Unknown,Hexagon,https://img.a.transfermarkt.technology/portrait/header/353948-1691614305.jpg?lm=1,L1,1. FC Union Berlin,5500000.0,25000000.0,27,138,139,7,7,10,8,12,7,14,8,7,14,12,7,15,12,15,14,17,13,15,11,13,15,8,14,12,15,17,17,13,12,15,13,16,13,18,15,15,12,13,4,11,3,1,1,3,1,2,2,2,1,2,1,12,14,5,13,11,17,13,13,1,1,1,1,1,1,20,1,20,1,1,1,1,1,83,8,20,8374540,6597,6597,5497,Northern_European,137,0,0,92307.0,Unknown,48034210,10133333.33,3.0,34,93,36,3,1,7,0,4,0.6231807356443504,0.582566844919786,0.6470588235294117,0.089124542418118,0.0,0.0,0.0272568142035508,0.1247811952988247,0.056270081557821,0.2857142857142857,0.4883720930232553,0.375,339,16,14,51,0,5996,5,12,45,4000000,142592.59259259258,25000000.0,5000000.0,2000000.0,25000000.0,3,7600000,-0.42857142857142855,-0.42857142857142855
354145,Jorge,Carrascal,2024,121,Colombia,Cartagena,Colombia,25-05-98,Attacking Midfield,Midfield,Right,180.0,30-06-27,Unknown,https://img.a.transfermarkt.technology/portrait/header/354145-1693158631.png?lm=1,RU1,FK Dinamo Moskva,8000000.0,9000000.0,26,128,136,12,12,16,11,15,12,7,12,4,4,14,12,5,15,9,11,10,10,11,14,11,13,16,8,14,8,9,7,14,16,10,7,12,13,13,7,8,14,12,10,11,1,2,1,1,1,1,3,3,1,2,3,14,10,9,12,9,11,13,11,1,1,1,1,1,1,1,12,12,1,18,20,14,15,70,12,20,9388412,6345,5672,4051,Mediterranean_Hispanic,121,2,0,38336.0,Unknown,76040911,2380000.0,5.0,20,320,20,3,1,3,74,0,0.5007938608097381,0.4279144385026737,0.5294117647058822,0.0370092129543349,0.0131578947368421,0.0,0.0397599399849962,0.0447611902975743,0.0131948109669713,0.5714285714285714,0.3953488372093026,0.3333333333333332,223,27,28,48,2,7468,4,51,315,7000000,289583.3333333333,9000000.0,1000000.0,600000.0,2000000.0,5,3400000,-0.125,0.16666666666666666
354340,Rick,Van Drongelen,2024,152,Netherlands,Axel,Netherlands,20-12-98,Centre-Back,Defender,Left,188.0,30-06-26,SEG,https://img.a.transfermarkt.technology/portrait/header/354340-1727716657.png?lm=1,TR1,Samsunspor,1700000.0,8000000.0,26,125,142,4,8,13,7,10,5,10,8,12,13,12,8,16,11,14,13,17,12,9,11,12,17,9,14,8,11,10,15,12,13,15,12,15,15,14,16,14,10,10,8,10,2,1,3,1,2,2,3,2,2,1,3,13,16,10,13,8,14,11,8,1,16,20,1,12,1,10,1,1,1,1,1,1,1,82,20,9,3794296,6500,6253,5004,Northern_European,124,0,0,10000.0,F.C. Hansa Rostock,37058873,1233333.333,3.0,67,112,68,1,0,7,180,2,0.5776660492193703,0.5298395721925133,0.5514705882352942,0.009647482104698,0.0,0.0,0.0082520630157539,0.0397599399849962,0.0068242636351009,0.2857142857142857,0.581395348837209,0.3333333333333332,242,11,5,37,0,2906,10,48,158,2000000,69642.85714285714,8000000.0,2200000.0,2500000.0,8000000.0,6,3300000,0.42857142857142855,1.6666666666666667
354352,Frédéric,Guilbert,2024,1005,France,Valognes,France,24-12-94,Right-Back,Defender,Right,178.0,30-06-26,Wasserman,https://img.a.transfermarkt.technology/portrait/header/354352-1673963895.jpg?lm=1,IT1,Unione Sportiva Lecce,4000000.0,9000000.0,30,131,136,5,14,12,11,12,8,12,11,16,11,12,8,12,12,13,13,13,12,14,12,12,15,13,12,13,10,14,16,13,14,13,11,14,14,15,13,12,14,12,1,14,1,3,3,1,1,3,1,4,3,1,3,13,14,5,16,12,14,12,12,1,1,10,20,1,17,1,1,1,1,1,1,1,1,78,10,20,6051070,6550,6550,4750,Northern_European,130,0,0,28998.0,Unknown,85096693,3250000.0,2.0,34,1560,36,1,1,7,206,11,0.6169621593014025,0.5026737967914437,0.5955882352941175,0.0279922789243409,0.0,0.0,0.0197549387346836,0.0447611902975743,0.0180282785632934,0.1428571428571428,0.3488372093023257,0.5,315,8,19,55,3,4209,6,19,71,2500000,97916.66666666667,9000000.0,2000000.0,,600000.0,6,7500000,-0.375,-0.375
354362,Rodrigo,Bentancur,2024,148,Uruguay,Nueva Helvecia,Uruguay,25-06-97,Defensive Midfield,Midfield,Right,187.0,30-06-26,Back Sports S.A.,https://img.a.transfermarkt.technology/portrait/header/354362-1596001806.jpg?lm=1,GB1,Tottenham Hotspur Football Club,35000000.0,50000000.0,27,149,164,12,12,14,10,15,12,12,11,7,14,14,8,16,14,16,15,13,13,11,11,13,12,11,10,10,16,15,16,12,14,15,13,14,13,15,14,12,15,11,7,16,1,2,2,3,3,2,1,1,3,1,1,16,12,5,15,17,18,15,11,1,1,1,1,1,1,18,7,20,7,1,8,1,1,77,12,20,57897159,7446,7846,6496,Mediterranean_Hispanic,144,49,1,86994.0,Unknown,14094572,20350000.0,2.0,106,1062,103,3,1,3,202,4,0.7884360942048161,0.6894117647058823,0.6985294117647058,0.0839942178838111,0.3223684210526316,0.0131578947368421,0.1747936984246061,0.2498124531132783,0.1130309175254868,0.1428571428571428,0.5581395348837206,0.375,343,13,29,74,0,8596,12,73,255,35000000,1269230.7692307692,50000000.0,10000000.0,5800000.0,15000000.0,2,6000000,0.0,0.0
354482,Amir,Murillo,2024,244,Panama,ColÃ³n,Panama,11-02-96,Right-Back,Defender,Right,184.0,30-06-26,SEG,https://img.a.transfermarkt.technology/portrait/header/354482-1719228286.jpg?lm=1,FR1,Olympique de Marseille,5000000.0,5000000.0,28,125,128,7,13,10,11,13,4,13,10,13,12,12,5,13,11,11,12,14,13,12,10,11,10,13,8,13,11,10,13,14,13,14,13,14,14,14,13,8,8,6,7,9,2,3,1,3,3,3,3,3,3,3,1,14,14,6,7,8,6,9,7,1,10,10,20,9,19,1,1,1,10,1,1,1,1,75,8,20,4207499,6200,6200,5500,Mediterranean_Hispanic,121,59,2,7499.0,Unknown,80028885,1137666.667,3.0,72,376,74,1,1,3,144,11,0.5706536120666843,0.5828877005347594,0.5294117647058822,0.0072324733224089,0.3881578947368421,0.0263157894736842,0.0247561890472618,0.0247561890472618,0.0062927673935387,0.2857142857142857,0.4883720930232553,0.4166666666666665,267,22,29,43,2,7616,5,30,81,7000000,290625.0,7000000.0,700000.0,,,3,1525000,0.4,1.3333333333333333
354587,Levi,García,2024,2441,Trinidad and Tobago,Santa Flora,Trinidad and Tobago,20-11-97,Centre-Forward,Attack,Left,182.0,30-06-28,Football Mix B.V.,https://img.a.transfermarkt.technology/portrait/header/354587-1728416237.png?lm=1,GR1,Athlitiki Enosi Konstantinoupoleos,15000000.0,15000000.0,27,130,140,12,12,14,11,10,10,12,9,3,7,10,9,6,13,8,11,8,11,9,12,10,11,15,4,12,5,11,12,16,14,14,15,11,16,11,14,9,3,12,12,13,2,1,2,2,3,1,3,1,1,4,3,15,12,6,10,10,12,16,15,1,1,1,1,1,1,1,10,1,10,16,10,20,17,78,20,12,8370000,6750,6250,4500,African_Caribbean,122,37,8,12214.0,Unknown,82060853,1400000.0,2.0,98,1325,98,0,0,1,34,3,0.5772691188145012,0.4759358288770053,0.536764705882353,0.0117853587316424,0.2434210526315789,0.1052631578947368,0.0747686921730432,0.0747686921730432,0.0077502152837578,0.1428571428571428,0.4418604651162785,0.375,301,80,44,27,1,12481,17,56,58,15000000,596000.0,15000000.0,300000.0,1000000.0,600000.0,5,2100000,0.15384615384615385,0.25
354666,Shamar,Nicholson,2024,232,Jamaica,Kingston,Jamaica,16-03-97,Centre-Forward,Attack,Right,192.0,30-06-26,Unknown,https://img.a.transfermarkt.technology/portrait/header/354666-1722687123.png?lm=1,RU1,FK Spartak Moskva,4000000.0,7500000.0,27,126,127,9,11,11,13,12,11,15,10,5,5,10,10,6,11,12,12,13,14,13,12,12,15,14,7,15,8,11,13,14,13,11,16,14,13,13,13,13,7,12,3,12,1,1,1,1,2,3,3,1,1,3,1,8,15,3,13,14,13,13,15,1,1,1,1,1,1,1,1,1,1,13,1,14,20,79,9,20,12522949,6150,6150,3750,African_Caribbean,126,31,10,4999.0,Unknown,81037383,4750000.0,2.0,53,728,55,0,1,1,82,3,0.5640381053188674,0.3957219251336898,0.5661764705882353,0.0048184301573859,0.2039473684210526,0.131578947368421,0.0197549387346836,0.0372593148287071,0.0263618433845384,0.1428571428571428,0.6744186046511627,0.375,266,88,24,25,2,5312,1,1,11,4000000,179545.45454545456,7500000.0,2000000.0,,50000.0,4,3100000,-0.2,0.0
354726,Florian,Sotoca,2024,826,France,Narbonne,France,25-10-90,Centre-Forward,Attack,Right,187.0,30-06-26,One Team Football ,https://img.a.transfermarkt.technology/portrait/header/354726-1701294869.jpg?lm=1,FR1,Racing Club de Lens,3000000.0,4000000.0,34,125,125,6,12,13,12,12,8,13,10,5,5,13,12,8,12,12,12,14,14,13,13,13,16,13,8,14,9,15,18,14,12,12,14,15,13,14,13,13,8,14,7,11,1,1,2,3,1,1,2,2,1,1,3,12,13,8,14,13,12,14,14,1,1,1,1,1,1,1,1,1,14,7,1,16,20,77,8,20,347975206,6250,6250,3750,Northern_European,127,0,0,9343.0,Unknown,48032631,1100000.0,1.0,34,1017,36,0,1,7,158,3,0.5772691188145012,0.3957219251336898,0.5735294117647058,0.0090130715609299,0.0,0.0,0.0147536884221055,0.0197549387346836,0.0060835023195088,0.0,0.5581395348837206,0.6666666666666665,320,71,39,45,1,2960,1,3,19,2500000,117500.0,4000000.0,500000.0,,,2,800000,-0.16666666666666666,-0.2857142857142857
354814,M'Bala,Nzola,2024,826,Angola,Buco-Zau,Angola,18-08-96,Centre-Forward,Attack,Left,185.0,30-06-25,Unknown,https://img.a.transfermarkt.technology/portrait/header/354814-1664974000.jpg?lm=1,FR1,Racing Club de Lens,7000000.0,10000000.0,28,133,138,4,12,13,14,13,9,12,11,4,5,12,14,7,13,18,12,13,13,11,11,11,16,9,8,14,7,15,12,14,14,16,13,17,16,14,17,12,10,12,3,14,2,1,3,1,2,1,2,3,1,2,1,10,17,9,8,12,17,9,6,1,1,1,1,1,1,1,1,1,1,14,1,13,20,82,20,8,4194259,6650,5969,4459,African_Caribbean,133,5,2,14230.0,Unknown,83103196,4450000.0,3.0,3,272,3,0,0,1,158,3,0.5400899708917704,0.4715508021390374,0.6176470588235294,0.0137320431399169,0.0328947368421052,0.0263157894736842,0.0347586896724181,0.0497624406101525,0.0246951304202894,0.2857142857142857,0.5116279069767438,0.4166666666666665,277,75,24,43,2,4882,9,26,48,8000000,329166.6666666667,10000000.0,2000000.0,100000.0,350000.0,7,3300000,0.14285714285714285,-0.2
354909,Giorgio,Altare,2024,607,Italy,Bergamo,Italy,09-08-98,Centre-Back,Defender,Right,190.0,Unknown,Mondial,https://img.a.transfermarkt.technology/portrait/header/354909-1630510736.jpg?lm=1,IT1,Venezia Football Club,2000000.0,2000000.0,26,120,134,7,7,6,7,6,6,15,6,9,14,7,6,13,9,13,13,12,12,12,8,12,13,10,12,6,13,13,13,11,11,13,15,16,12,14,15,13,13,6,8,13,2,1,2,2,1,1,1,1,3,3,1,11,13,11,10,11,12,13,12,1,1,20,1,1,1,10,1,1,1,1,1,1,1,75,9,20,2187721,5992,5992,2992,Mediterranean_Hispanic,118,0,0,10493.0,Unknown,43206161,750000.0,2.0,52,176,54,1,1,3,210,2,0.5431331039957661,0.3146524064171123,0.5073529411764706,0.0101235314168405,0.0,0.0,0.0097524381095273,0.0097524381095273,0.0041390038612183,0.1428571428571428,0.6279069767441858,0.3333333333333332,220,15,7,37,1,4525,8,50,172,1800000,97222.22222222222,2000000.0,300000.0,100000.0,75000.0,5,350000,-0.1,0.0
355501,Amadou,Diawara,2024,58,Guinea,Conakry,Guinea,17-07-97,Defensive Midfield,Midfield,Right,183.0,30-06-25,Unknown,https://img.a.transfermarkt.technology/portrait/header/355501-1666809838.jpg?lm=1,BE1,Royal Sporting Club Anderlecht,1000000.0,23000000.0,27,130,144,6,8,13,6,15,5,8,6,8,12,15,7,15,13,13,14,15,15,9,11,10,13,8,8,8,15,15,14,14,15,17,10,15,13,16,13,12,13,7,8,8,2,3,2,2,2,1,2,3,1,2,1,16,14,7,12,11,15,11,12,1,1,1,1,1,1,20,1,20,1,1,1,1,1,76,12,20,11285999,6600,7150,5600,African_Caribbean,132,26,0,88941.0,Unknown,43223311,9497500.0,4.0,43,378,44,3,1,1,175,4,0.696348240275205,0.5935828877005347,0.6102941176470589,0.085874274700731,0.1710526315789473,0.0,0.0047511877969492,0.1147786946736684,0.0527375760437789,0.4285714285714285,0.4651162790697669,0.375,242,5,6,43,1,7452,7,46,73,700000,10714.285714285714,23000000.0,4500000.0,11000000.0,18000000.0,4,15100000,-0.5333333333333333,-0.6111111111111112
355627,Sergio,Akieme,2024,1421,Spain,Madrid,Spain,16-12-97,Left-Back,Defender,Left,175.0,30-06-28,Promoesport,https://img.a.transfermarkt.technology/portrait/header/355627-1723835849.png?lm=1,FR1,Stade de Reims,7000000.0,9000000.0,27,126,144,8,13,12,8,13,7,9,9,12,9,12,8,12,13,13,12,13,10,10,9,14,12,12,8,12,11,13,14,15,13,12,11,15,15,15,14,12,10,12,5,12,3,3,3,3,2,1,3,3,3,3,3,15,12,5,14,11,14,13,12,1,20,1,1,18,1,1,10,1,1,8,1,1,1,70,20,6,3406194,6200,6200,4207,North_African__Middle_Eastern,121,0,0,3068.0,Unknown,67213135,3666666.667,3.0,89,892,89,1,0,6,197,8,0.5706536120666843,0.4445989304812833,0.5294117647058822,0.0029538232167221,0.0,0.0,0.0347586896724181,0.0447611902975743,0.0203431576821578,0.2857142857142857,0.2790697674418605,0.375,194,9,12,23,2,2916,3,6,25,7000000,345000.0,9000000.0,1500000.0,,100000.0,3,3700000,0.0,-0.125
355628,Igor,Zubeldia,2024,681,Spain,Azkoitia,Spain,30-03-97,Centre-Back,Defender,Right,181.0,30-06-29,Wasserman,https://img.a.transfermarkt.technology/portrait/header/355628-1664974849.jpg?lm=1,ES1,Real Sociedad de FÃºtbol S.A.D.,22000000.0,30000000.0,27,139,147,9,11,12,12,12,12,13,12,8,14,14,12,14,14,15,15,13,12,13,12,13,12,9,11,11,14,16,15,12,13,13,11,14,12,15,14,13,14,11,7,14,3,2,2,3,3,4,1,3,3,1,3,12,11,8,15,12,13,12,14,1,1,20,1,1,1,15,1,12,1,1,1,1,1,79,12,20,17242702,6949,6949,4849,Mediterranean_Hispanic,139,0,0,21547.0,Unknown,67215898,9111392.0,2.0,89,113,89,1,1,3,168,2,0.6697539031489812,0.5132620320855614,0.6617647058823528,0.0207974646753063,0.0,0.0,0.1097774443610902,0.1497874468617154,0.0505924720131114,0.1428571428571428,0.418604651162791,0.375,340,7,11,88,2,5182,10,23,99,22000000,941304.3478260869,30000000.0,6000000.0,,3000000.0,1,250000,0.0,0.0
355816,Ko,Itakura,2024,18,Japan,"Yokohama, Kanagawa",Japan,27-01-97,Centre-Back,Defender,Right,188.0,30-06-26,CAA Base Ltd,https://img.a.transfermarkt.technology/portrait/header/355816-1662966245.jpg?lm=1,L1,Borussia Verein fÃ¼r LeibesÃ¼bungen 1900 MÃ¶nchengladbach,15000000.0,15000000.0,27,132,140,4,7,11,8,12,4,13,7,4,13,14,6,13,13,13,14,13,15,13,13,13,14,12,12,12,15,16,14,12,12,14,13,15,13,15,13,16,7,14,4,14,1,3,3,2,2,1,4,3,2,2,2,17,15,4,9,16,18,14,14,1,1,20,1,1,1,19,1,15,1,1,1,1,1,74,10,20,5426597,6600,6500,5600,10,131,12,1,28766.0,Unknown,45092658,3050000.0,2.0,54,1686,56,1,1,0,42,2,0.6103466525535857,0.5935828877005347,0.6029411764705883,0.0277682557186268,0.0789473684210526,0.0131578947368421,0.0747686921730432,0.0747686921730432,0.0169171365871274,0.1428571428571428,0.581395348837209,0.375,225,14,8,33,3,3299,6,39,73,15000000,598000.0,15000000.0,3000000.0,50000.0,175000.0,3,2700000,0.25,0.0
355861,Arnaut,Danjuma,2024,12321,Nigeria,Lagos,Netherlands,31-01-97,Left Winger,Attack,Right,178.0,30-06-25,Panthera Sports,https://img.a.transfermarkt.technology/portrait/header/355861-1674657323.jpg?lm=1,ES1,Girona FÃºtbol Club S. A. D.,13000000.0,50000000.0,27,151,160,12,14,17,14,16,13,11,11,11,6,12,8,7,17,14,13,15,14,14,14,14,15,16,4,13,6,13,11,17,14,13,10,14,16,13,9,12,12,14,14,16,1,3,2,1,1,1,2,1,1,3,3,7,18,16,5,13,10,11,12,1,1,1,1,1,1,1,17,11,11,20,14,15,11,74,8,20,29803798,7300,7300,5750,African_Caribbean,149,6,2,35606.0,Unknown,37051305,9111392.0,2.0,69,789,68,0,1,1,107,7,0.7161947605186557,0.6096256684491979,0.7352941176470587,0.0343730778181298,0.0394736842105263,0.0263157894736842,0.0647661915478869,0.2498124531132783,0.0505924720131114,0.1428571428571428,0.3488372093023257,0.375,277,81,38,12,0,10317,11,87,145,8000000,319000.0,50000000.0,15000000.0,25000.0,400000.0,7,30550000,-0.38461538461538464,-0.5294117647058824
355915,Cristian,Romero,2024,148,Argentina,CÃ³rdoba,Argentina,27-04-98,Centre-Back,Defender,Right,185.0,30-06-27,Ciro Palermo,https://img.a.transfermarkt.technology/portrait/header/355915-1665609429.jpg?lm=1,GB1,Tottenham Hotspur Football Club,65000000.0,65000000.0,26,153,164,5,6,9,8,13,4,16,5,4,17,12,8,17,12,18,17,15,14,14,11,14,16,8,12,6,14,14,17,13,14,14,14,15,13,14,15,15,15,15,8,8,4,2,1,4,2,3,3,3,2,3,2,16,15,4,12,14,14,9,13,1,1,20,7,1,1,1,1,1,1,1,1,1,1,79,9,20,160448769,7650,7550,6400,Mediterranean_Hispanic,151,11,1,202986.0,Unknown,14130029,26187500.0,4.0,4,400,4,1,1,3,202,2,0.7492722942577401,0.6791443850267379,0.75,0.1959980958027514,0.0723684210526315,0.0131578947368421,0.3248312078019504,0.3248312078019504,0.145462373954832,0.4285714285714285,0.5116279069767438,0.3333333333333332,239,13,9,74,2,4792,15,76,92,65000000,2494230.769230769,65000000.0,5000000.0,2000000.0,15000000.0,4,6100000,0.0,0.0
356081,Bryan,Heynen,2024,1184,Belgium,Bree,Belgium,06-02-97,Central Midfield,Midfield,Right,183.0,30-06-26,M.P. Sports,https://img.a.transfermarkt.technology/portrait/header/356081-1714037998.png?lm=1,BE1,Koninklijke Racing Club Genk,10000000.0,11000000.0,27,126,130,14,8,10,10,11,12,11,9,8,11,15,7,14,13,7,13,15,12,14,15,14,14,12,13,13,12,14,15,13,10,10,10,14,14,14,7,14,8,12,11,17,4,2,1,2,2,4,1,3,3,1,2,13,14,3,10,12,11,12,14,1,1,1,1,1,1,15,1,20,1,1,1,1,1,75,9,20,6724573,6200,6200,5750,Northern_European,123,0,0,10000.0,Unknown,18083974,9111392.0,2.0,7,250,8,3,1,7,122,1,0.5706536120666843,0.6096256684491979,0.5441176470588236,0.009647482104698,0.0,0.0,0.0497624406101525,0.0547636909227306,0.0505924720131114,0.1428571428571428,0.4651162790697669,0.375,325,35,33,41,1,9514,7,78,313,10000000,369230.76923076925,11000000.0,1500000.0,800000.0,1700000.0,0,0,0.0,-0.09090909090909091
356141,Daichi,Kamada,2024,873,Japan,"Iyo, Ehime",Japan,05-08-96,Attacking Midfield,Midfield,Right,184.0,30-06-26,Roberto Tukada,https://img.a.transfermarkt.technology/portrait/header/356141-1707947777.jpg?lm=1,GB1,Crystal Palace Football Club,18000000.0,30000000.0,28,139,141,11,12,16,13,16,9,7,9,3,6,14,12,10,15,13,10,8,13,13,15,14,11,14,6,14,6,15,14,14,16,10,11,14,13,14,8,13,5,11,5,13,1,1,2,1,1,1,2,2,1,3,3,9,15,3,13,9,17,14,17,1,1,1,1,1,1,1,12,18,12,16,20,16,13,76,12,20,9421939,7000,7100,6000,10,136,19,5,8500.0,Unknown,45092714,9111392.0,2.0,54,681,56,3,1,0,58,0,0.6897327335273882,0.6363636363636364,0.6397058823529411,0.0081990562056842,0.125,0.0657894736842105,0.0897724431107777,0.1497874468617154,0.0505924720131114,0.1428571428571428,0.4883720930232553,0.4166666666666665,362,76,57,25,1,8999,10,17,22,15000000,622916.6666666666,30000000.0,7000000.0,200000.0,750000.0,5,17000000,-0.16666666666666666,-0.25
356197,Alfonso,Pedraza,2024,1050,Spain,San SebastiÃ¡n de los Ballesteros,Spain,09-04-96,Left-Back,Defender,Left,184.0,30-06-26,LEADERBROCK,https://img.a.transfermarkt.technology/portrait/header/356197-1620304916.jpg?lm=1,ES1,Villarreal Club de FÃºtbol S.A.D.,5000000.0,22000000.0,28,144,148,12,15,12,11,12,9,12,12,13,12,12,11,12,12,16,14,12,11,14,11,13,13,12,9,15,13,14,14,15,13,12,11,14,16,15,12,14,13,8,5,13,3,1,1,2,3,2,3,3,1,1,1,16,11,6,10,7,10,15,14,1,20,1,1,18,1,1,16,1,11,16,10,11,1,73,20,8,21999999,7200,7200,4750,Mediterranean_Hispanic,136,0,0,31542.0,Unknown,67212046,9111392.0,2.0,89,1309,89,1,0,3,216,8,0.702963747023022,0.5026737967914437,0.6397058823529411,0.0304488092490684,0.0,0.0,0.0247561890472618,0.1097774443610902,0.0505924720131114,0.1428571428571428,0.4883720930232553,0.4166666666666665,326,31,37,46,1,4867,11,57,68,2500000,68965.5172413793,22000000.0,5500000.0,,1000000.0,6,8000000,-0.5,-0.7916666666666666
356546,Borja,González,2024,653,Spain,Pinto,Spain,17-11-95,Right-Back,Defender,Left,176.0,30-06-26,Unknown,https://img.a.transfermarkt.technology/portrait/header/356546-1727962072.jpg?lm=1,GR1,Omilos Filathlon Irakliou FC,500000.0,500000.0,29,92,-8,8,11,12,11,10,7,8,9,9,8,10,10,8,11,9,10,10,9,9,10,11,13,9,7,10,9,9,10,12,13,10,10,9,10,9,8,12,7,9,8,10,1,2,3,2,1,1,2,1,3,3,3,10,12,8,10,9,10,10,8,1,1,1,1,1,1,1,17,12,1,20,1,1,1,71,20,10,5968946,4600,4606,1752,Mediterranean_Hispanic,84,0,0,512.0,Unknown,51080920,9111392.0,2.0,89,1148,89,1,0,3,145,11,0.359751256946282,0.1820320855614973,0.2573529411764706,0.0004857054848026,0.0,0.0,0.0022505626406601,0.0022505626406601,0.0505924720131114,0.1428571428571428,0.3023255813953489,0.4583333333333332,204,15,18,25,1,4401,0,0,0,500000,31250.0,500000.0,200000.0,,0.0,6,700000,0.0,0.0
357003,Martin,Erli?,2024,1025,Croatia,Zadar,Croatia,24-01-98,Centre-Back,Defender,Right,193.0,30-06-29,GR Sports,https://img.a.transfermarkt.technology/portrait/header/357003-1692882873.jpg?lm=1,IT1,Bologna Football Club 1909,3000000.0,5500000.0,26,130,144,5,7,7,7,9,8,14,8,13,13,14,8,13,10,12,14,14,10,14,11,13,14,12,10,8,14,13,14,12,11,14,15,13,14,15,14,12,11,10,9,12,3,3,3,2,1,2,1,1,3,4,3,15,14,3,13,12,14,11,10,1,1,20,1,1,1,1,1,1,1,1,1,1,1,83,9,20,4400928,6500,5530,4533,Northern_European,130,3,0,5384.0,Unknown,43212365,1500500.0,2.0,24,1695,25,1,1,7,40,2,0.4820058216459381,0.4794652406417112,0.5955882352941175,0.0051901928047995,0.0197368421052631,0.0,0.0147536884221055,0.0272568142035508,0.0083085641267813,0.1428571428571428,0.6976744186046511,0.3333333333333332,239,13,5,39,2,1903,10,58,95,5000000,233333.33333333334,5500000.0,1000000.0,100000.0,200000.0,4,2075000,0.6666666666666666,0.0
357047,Gautier,Larsonneur,2024,618,France,Saint-Renan,France,23-02-97,Goalkeeper,Goalkeeper,Right,181.0,30-06-26,TTMA,https://img.a.transfermarkt.technology/portrait/header/357047-1727720726.jpg?lm=1,FR1,Association sportive de Saint-Ã‰tienne Loire,4000000.0,8000000.0,27,123,140,2,1,8,3,12,5,1,1,2,2,11,6,3,11,12,12,14,13,13,10,12,13,10,12,2,11,13,12,12,13,14,11,14,12,13,12,12,5,16,5,1,10,13,11,12,13,12,13,14,14,8,12,12,11,6,15,13,15,13,15,20,1,1,1,1,1,1,1,1,1,1,1,1,1,70,6,20,1840603,6143,6143,3843,Northern_European,121,0,0,6898.0,Valenciennes FC,85133818,1600000.0,1.0,34,1279,36,2,1,7,25,5,0.5631119343741731,0.4056684491978609,0.5294117647058822,0.0066521373455374,0.0,0.0,0.0197549387346836,0.0397599399849962,0.0088613572599238,0.0,0.418604651162791,0.375,0,0,0,0,0,0,1,6,37,3500000,150000.0,8000000.0,2000000.0,,,2,500000,-0.125,0.0
357117,Alban,Lafont,2024,995,Burkina Faso,Ouagadougou,France,23-01-99,Goalkeeper,Goalkeeper,Right,196.0,30-06-27,Sport Cover,https://img.a.transfermarkt.technology/portrait/header/357117-1704212970.jpg?lm=1,FR1,Football Club de Nantes,9000000.0,20000000.0,25,140,160,5,2,1,2,11,9,3,3,2,3,12,2,2,10,7,13,12,12,13,11,12,14,7,13,2,14,11,10,11,14,14,17,15,11,14,13,12,11,13,5,13,14,13,15,7,14,12,14,16,14,12,13,11,14,14,12,12,12,16,16,20,1,1,1,1,1,1,1,1,1,1,1,1,1,82,8,20,14843965,6989,6989,4989,Mixed_Race,137,0,0,19547.0,Unknown,48036990,7750000.0,2.0,12,1100,36,2,1,4,93,5,0.6750463085472347,0.528235294117647,0.6470588235294117,0.0188662301432879,0.0,0.0,0.0447611902975743,0.0997749437359339,0.0430289730270285,0.1428571428571428,0.7674418604651163,0.2916666666666665,0,0,0,0,0,0,3,13,38,7000000,239285.7142857143,20000000.0,5000000.0,8000000.0,12000000.0,2,10000000,-0.2222222222222222,-0.4166666666666667
357119,Ibrahima,Konaté,2024,31,France,Paris,France,25-05-99,Centre-Back,Defender,Right,194.0,30-06-26,CAA Stellar,https://img.a.transfermarkt.technology/portrait/header/357119-1669190550.jpg?lm=1,GB1,Liverpool Football Club,45000000.0,45000000.0,25,152,165,3,5,13,7,14,6,16,5,12,14,13,7,15,13,15,14,16,14,14,9,14,14,6,10,7,14,14,14,14,12,16,17,14,16,12,17,15,9,15,9,7,3,3,1,2,2,3,2,1,3,1,4,13,16,10,10,15,13,11,15,1,1,20,1,1,1,12,1,10,1,1,1,1,1,95,10,20,58367041,7600,6328,6123,African_Caribbean,151,2,0,81194.0,Unknown,48037822,40000000.0,1.0,34,1122,36,1,1,1,129,2,0.5875893093410955,0.64951871657754,0.75,0.0783936377409577,0.0131578947368421,0.0,0.2248062015503876,0.2248062015503876,0.2222006166837967,0.0,0.7209302325581395,0.2916666666666665,227,10,5,45,0,9497,13,111,161,50000000,2366666.6666666665,50000000.0,5500000.0,7000000.0,40500000.0,2,7700000,0.1111111111111111,0.3157894736842105
357147,Diogo,Dalot,2024,985,Portugal,Braga,Portugal,18-03-99,Right-Back,Defender,Right,183.0,30-06-28,Proeleven S.A.,https://img.a.transfermarkt.technology/portrait/header/357147-1727785546.jpg?lm=1,GB1,Manchester United Football Club,40000000.0,40000000.0,25,139,158,9,13,13,8,14,4,9,7,13,12,13,10,13,13,13,13,11,12,12,9,12,12,11,8,13,13,14,14,15,14,13,11,15,14,14,11,12,9,13,8,15,3,2,2,1,1,1,1,2,3,1,2,14,15,5,12,12,15,14,12,1,17,1,20,14,18,1,13,1,15,7,1,10,1,75,12,20,34660456,7250,7500,5650,Mediterranean_Hispanic,129,5,0,34999.0,Unknown,83105845,22000000.0,1.0,76,237,79,1,1,3,132,11,0.7426567875099233,0.5989304812834224,0.588235294117647,0.0337869481376622,0.0328947368421052,0.0,0.1997999499874969,0.1997999499874969,0.1221978388288563,0.0,0.4651162790697669,0.2916666666666665,275,13,25,36,1,8303,7,63,125,40000000,1598000.0,40000000.0,6000000.0,1750000.0,20000000.0,5,3450000,0.14285714285714285,0.14285714285714285
357153,Diogo,Costa,2024,720,Switzerland,Rothrist,Portugal,19-09-99,Goalkeeper,Goalkeeper,Right,186.0,30-06-27,Gestifute,https://img.a.transfermarkt.technology/portrait/header/357153-1716296015.jpg?lm=1,PO1,Futebol Clube do Porto,45000000.0,45000000.0,25,150,174,6,1,3,3,11,11,5,2,1,1,13,5,2,12,14,13,14,16,14,14,14,14,1,8,3,14,14,13,11,15,12,13,14,11,11,13,15,5,14,9,15,13,14,14,7,14,16,14,16,12,8,12,12,13,6,14,18,17,15,16,20,1,1,1,1,1,1,1,1,1,1,1,1,1,80,13,20,60000001,7400,7500,5900,Mediterranean_Hispanic,151,5,0,25350.0,Unknown,83169226,9111392.0,2.0,92,1252,79,2,1,3,100,5,0.7426567875099233,0.6256684491978609,0.75,0.0244697071379393,0.0328947368421052,0.0,0.2248062015503876,0.2248062015503876,0.0505924720131114,0.1428571428571428,0.5348837209302322,0.2916666666666665,0,0,0,0,0,0,6,22,52,40000000,1817045.4545454546,45000000.0,5000000.0,2000000.0,5000000.0,1,1000000,-0.1111111111111111,-0.1111111111111111
357156,Diogo,Leite,2024,89,Portugal,Porto,Portugal,23-01-99,Centre-Back,Defender,Left,190.0,Unknown,Unknown,https://img.a.transfermarkt.technology/portrait/header/357156-1691999912.jpg?lm=1,L1,1. FC Union Berlin,15000000.0,15000000.0,25,130,144,8,10,11,8,12,8,13,8,10,15,14,8,12,13,11,13,11,14,11,13,13,12,7,13,8,13,14,13,11,13,14,14,14,12,13,13,13,7,11,4,6,2,4,2,1,1,1,2,1,1,1,1,9,12,7,16,11,15,13,14,1,5,20,1,1,1,1,1,1,1,1,1,1,1,83,20,9,1856376,6496,6496,4996,Mediterranean_Hispanic,128,0,0,5521.0,1. FC Union Berlin,83111536,7500000.0,1.0,76,1170,79,1,0,3,0,2,0.6098174120137603,0.5289839572192513,0.5808823529411764,0.0053224823702427,0.0,0.0,0.0747686921730432,0.0747686921730432,0.041640045556821,0.0,0.6279069767441858,0.2916666666666665,246,7,5,43,3,6193,3,6,13,17000000,888157.8947368421,17000000.0,2000000.0,125000.0,6000000.0,3,5000000,0.13333333333333333,0.13333333333333333
357163,Filipe,Soares,2024,4294,Portugal,Lisboa,Portugal,20-05-99,Attacking Midfield,Midfield,Right,180.0,30-06-25,Sportsbloom,https://img.a.transfermarkt.technology/portrait/header/357163-1694781256.png?lm=1,PO1,Sporting Clube Farense,1500000.0,4000000.0,25,120,130,11,12,14,10,14,11,10,11,6,7,13,12,8,15,10,9,10,12,12,15,13,13,11,6,13,11,14,13,11,13,14,10,13,12,14,11,13,4,10,6,12,3,2,4,2,2,3,1,3,1,2,2,9,14,3,15,13,15,14,9,1,1,1,1,1,1,10,1,20,1,1,16,1,1,70,10,20,2532246,6000,6200,3000,Mediterranean_Hispanic,120,0,0,7671.0,Unknown,83111342,2125000.0,2.0,76,843,79,3,1,3,191,0,0.5706536120666843,0.3155080213903743,0.5220588235294117,0.0073985594921625,0.0,0.0,0.0072518129532383,0.0197549387346836,0.0117781049473596,0.1428571428571428,0.3953488372093026,0.2916666666666665,196,12,16,38,0,3234,8,38,75,1200000,28571.428571428572,4000000.0,1000000.0,,1300000.0,4,800000,-0.2,-0.2
357164,Rafael,Leão,2024,5,Portugal,Almada,Portugal,10-06-99,Left Winger,Attack,Right,188.0,30-06-28,Unknown,https://img.a.transfermarkt.technology/portrait/header/357164-1661352687.jpg?lm=1,IT1,Associazione Calcio Milan,90000000.0,90000000.0,25,163,176,5,15,17,15,16,6,11,13,6,4,15,12,7,15,9,13,8,13,11,14,13,14,17,8,15,7,13,13,17,18,16,14,15,16,11,14,14,5,12,8,12,2,1,1,1,2,4,2,2,3,2,1,12,16,6,11,12,13,9,12,1,1,1,1,1,1,1,1,1,1,20,14,12,17,81,14,20,150000002,8100,7650,6350,African_Caribbean,159,9,0,34423.0,Unknown,83111483,34850000.0,2.0,76,46,79,0,1,1,27,7,0.7625033077533738,0.6737967914438502,0.8088235294117647,0.0332307525924409,0.0592105263157894,0.0,0.4498624656164041,0.4498624656164041,0.1935887107975221,0.1428571428571428,0.581395348837209,0.2916666666666665,298,90,64,32,0,5727,9,66,89,75000000,3104166.6666666665,90000000.0,15000000.0,4000000.0,20000000.0,3,8000000,-0.16666666666666666,-0.16666666666666666
357233,Leandro,Barreiro,2024,294,Luxembourg,Erpeldingen,Luxembourg,03-01-00,Central Midfield,Midfield,Right,174.0,30-06-29,CAA Stellar,https://img.a.transfermarkt.technology/portrait/header/357233-1692000330.jpg?lm=1,PO1,Sport Lisboa e Benfica,17000000.0,17000000.0,24,129,148,11,7,11,8,12,6,8,8,3,13,12,7,16,12,16,13,17,12,14,12,12,16,10,7,12,13,16,17,12,13,12,8,17,13,15,10,13,12,13,5,10,2,2,1,1,1,2,3,2,3,3,3,15,14,7,17,15,16,11,10,1,1,1,1,1,1,18,12,20,12,1,15,1,1,65,12,20,18017998,6497,6347,5497,African_Caribbean,122,39,2,28766.0,Unknown,91187556,9111392.0,2.0,59,467,60,3,1,1,188,1,0.590103201905266,0.582566844919786,0.536764705882353,0.0277682557186268,0.256578947368421,0.0263157894736842,0.0847711927981995,0.0847711927981995,0.0505924720131114,0.1428571428571428,0.2558139534883721,0.25,256,29,34,58,0,4450,5,23,52,15000000,778947.3684210526,17000000.0,2000000.0,400000.0,4000000.0,1,2000000,-0.11764705882352941,0.07142857142857142
357498,Dušan,Vlahovi?,2024,506,Yugoslavia (Republic),Belgrad,Serbia,28-01-00,Centre-Forward,Attack,Left,190.0,30-06-26,Unknown,https://img.a.transfermarkt.technology/portrait/header/357498-1683293071.jpg?lm=1,IT1,Juventus Football Club,65000000.0,85000000.0,24,153,170,6,8,13,17,12,16,15,15,4,4,12,18,7,14,14,15,16,15,14,13,14,17,14,11,16,7,14,15,12,13,15,14,17,15,16,18,15,11,14,9,9,3,3,1,1,1,2,3,2,2,3,1,12,17,9,10,15,16,9,13,1,1,1,1,1,1,1,1,1,1,1,1,1,20,81,20,9,106620002,7650,7650,6750,Northern_European,153,14,7,249230.0,Unknown,62182055,43350000.0,2.0,110,166,85,0,0,7,116,3,0.7625033077533738,0.7165775401069518,0.7647058823529411,0.2406521006520813,0.0921052631578947,0.0921052631578947,0.3248312078019504,0.4248562140535133,0.2408122447845773,0.1428571428571428,0.6279069767441858,0.25,287,126,21,31,1,4592,13,27,52,60000000,2288461.5384615385,85000000.0,10000000.0,1000000.0,16000000.0,2,15000000,-0.07692307692307693,0.0
357565,Unknown,Rodri,2024,281,Spain,Madrid,Spain,22-06-96,Defensive Midfield,Midfield,Right,191.0,30-06-27,Pablo Barquero,https://img.a.transfermarkt.technology/portrait/header/357565-1682587890.jpg?lm=1,GB1,Manchester City Football Club,130000000.0,130000000.0,28,175,175,7,8,13,9,15,8,13,14,8,12,15,8,17,14,13,18,15,17,16,14,18,13,9,11,13,17,16,16,14,13,12,17,16,13,17,16,17,10,15,4,10,3,1,4,2,3,2,2,2,1,1,1,15,16,6,13,15,18,13,16,1,1,1,1,1,1,20,1,15,1,1,1,1,1,75,13,20,347975206,8750,8150,8250,Mediterranean_Hispanic,173,33,1,185587.0,Unknown,67217524,30500000.0,3.0,89,892,89,3,1,3,131,4,0.8286583752315428,0.8770053475935828,0.9117647058823528,0.1791973209914572,0.2171052631578947,0.0131578947368421,0.6499124781195299,0.6499124781195299,0.1694213728159115,0.2857142857142857,0.6511627906976742,0.4166666666666665,433,33,37,71,1,10457,4,51,220,130000000,5630434.782608695,130000000.0,16000000.0,,2500000.0,2,15000000,0.0,0.18181818181818182
357628,Alfon,González,2024,940,Spain,Albacete,Spain,04-05-99,Left Winger,Attack,Left,172.0,30-06-25,Unknown,https://img.a.transfermarkt.technology/portrait/header/default.jpg?lm=1,ES1,Real Club Celta de Vigo S. A. D.,300000.0,300000.0,25,132,140,10,14,15,12,14,12,11,13,11,7,14,9,6,15,8,12,13,12,12,14,14,17,12,8,15,6,12,13,14,15,11,10,12,13,14,10,15,4,13,5,12,2,2,1,1,1,3,3,3,1,1,3,18,12,7,13,11,11,10,14,1,1,1,1,1,1,1,18,20,1,10,12,1,1,70,20,10,3702022,6598,6598,2849,Mediterranean_Hispanic,128,3,0,17590.0,Unknown,51015275,250000.0,1.0,89,35,89,0,0,3,165,7,0.6233130457793067,0.2993582887700534,0.5808823529411764,0.0169765171537079,0.0197368421052631,0.0,0.0012503125781445,0.0012503125781445,0.0013611489208033,0.0,0.2093023255813952,0.2916666666666665,183,39,17,17,1,2093,1,4,20,1000000,53333.333333333336,1000000.0,50000.0,,150000.0,7,850000,2.3333333333333335,2.3333333333333335
357658,Mark,Travers,2024,989,Ireland,Maynooth,Ireland,18-05-99,Goalkeeper,Goalkeeper,Right,191.0,30-06-27,Unique Sports Group,https://img.a.transfermarkt.technology/portrait/header/357658-1702296610.jpg?lm=1,GB1,Association Football Club Bournemouth,3500000.0,3500000.0,25,125,145,7,3,1,1,9,8,1,1,3,2,10,2,3,10,8,14,12,10,12,11,11,12,6,8,3,14,11,12,11,13,10,13,14,11,15,11,13,7,12,9,12,14,11,13,7,14,14,12,15,8,7,14,10,10,6,15,13,14,12,12,20,1,1,1,1,1,1,1,1,1,1,1,1,1,0,8,20,8818215,6250,6250,3757,Northern_European,123,3,0,23198.0,Unknown,52080573,9111392.0,2.0,49,931,52,2,1,7,22,5,0.5772691188145012,0.3964705882352941,0.5441176470588236,0.0223916987814875,0.0197368421052631,0.0,0.0172543135783946,0.0172543135783946,0.0505924720131114,0.1428571428571428,0.6511627906976742,0.2916666666666665,0,0,0,0,0,0,0,0,0,4000000,267857.14285714284,4000000.0,500000.0,,250000.0,1,0,0.14285714285714285,0.14285714285714285
357662,Declan,Rice,2024,11,England,London,England,14-01-99,Defensive Midfield,Midfield,Right,188.0,30-06-28,Unknown,https://img.a.transfermarkt.technology/portrait/header/357662-1687962936.jpg?lm=1,GB1,Arsenal Football Club,120000000.0,120000000.0,25,162,178,7,11,14,9,14,8,12,9,10,14,15,11,17,14,13,15,14,17,15,14,15,17,10,16,16,17,16,17,13,13,13,12,18,13,17,13,17,12,15,6,16,2,2,3,2,1,2,1,1,3,2,1,12,16,5,15,14,15,16,14,1,1,16,1,1,1,20,1,19,1,1,1,1,1,80,11,20,92610121,8100,8100,7500,Northern_European,160,32,2,69595.0,Unknown,28106491,116600000.0,1.0,32,858,33,3,1,7,21,4,0.8220428684837258,0.7967914438502673,0.8161764705882353,0.0671934430725168,0.2105263157894736,0.0263157894736842,0.5998999749937485,0.5998999749937485,0.6477679935553765,0.0,0.581395348837209,0.2916666666666665,363,25,31,41,0,6336,2,10,16,110000000,4977272.7272727275,120000000.0,10000000.0,2000000.0,55000000.0,1,10000000,-0.08333333333333333,0.0
357796,Domagoj,Bradari?,2024,276,Croatia,Split,Croatia,10-12-99,Left-Back,Defender,Left,178.0,30-06-25,IDUB GLOBAL,https://img.a.transfermarkt.technology/portrait/header/357796-1663668545.jpg?lm=1,IT1,Verona Hellas Football Club,5000000.0,7000000.0,25,121,139,13,15,14,8,13,9,7,10,14,11,14,8,12,13,9,11,11,10,12,10,11,14,14,13,13,10,13,14,13,14,9,9,12,14,14,8,11,12,10,11,12,3,4,2,4,3,1,3,1,1,1,3,9,12,11,12,10,9,8,12,1,20,1,11,20,1,1,13,1,1,10,1,10,1,69,20,11,4457466,6046,6296,3496,Northern_European,116,4,0,9198.0,Unknown,24054803,5750000.0,2.0,24,1409,25,1,0,7,214,8,0.5833553850224927,0.3685561497326203,0.4926470588235294,0.0088730570573586,0.0263157894736842,0.0,0.0247561890472618,0.0347586896724181,0.0319175532653684,0.1428571428571428,0.3488372093023257,0.2916666666666665,226,6,14,36,0,2829,4,8,26,4000000,187500.0,7000000.0,1500000.0,,6000000.0,3,8000000,-0.2,-0.38461538461538464
357884,Fernando,Calero,2024,714,Spain,Boecillo (Valladolid),Spain,14-09-95,Centre-Back,Defender,Right,184.0,30-06-25,MRH Football Agency,https://img.a.transfermarkt.technology/portrait/header/357884-1447238696.jpg?lm=1,ES1,Reial Club Deportiu Espanyol de Barcelona S.A.D.,1800000.0,10000000.0,29,129,145,7,6,5,5,14,9,13,11,10,14,13,9,14,13,10,14,14,12,12,13,12,12,11,12,10,14,15,14,13,12,12,11,11,14,13,13,13,7,12,10,11,1,1,3,2,3,1,1,3,3,1,2,15,11,1,12,10,11,10,19,1,1,20,1,1,1,1,1,1,1,1,1,1,1,71,10,20,4363492,6450,6450,4950,Mediterranean_Hispanic,129,0,0,9641.0,Unknown,67211739,8000000.0,1.0,89,215,89,1,1,3,170,2,0.6037311458057687,0.5240641711229946,0.588235294117647,0.0093008255062007,0.0,0.0,0.0087521880470117,0.0497624406101525,0.044417900497236,0.0,0.4883720930232553,0.4583333333333332,244,8,2,52,2,2937,3,8,15,1500000,60416.666666666664,10000000.0,5000000.0,,50000.0,1,5000000,-0.16666666666666666,-0.4
357885,Pablo,Fornals,2024,150,Spain,CastellÃ³ de la Plana,Spain,22-02-96,Attacking Midfield,Midfield,Right,178.0,30-06-29,Unknown,https://img.a.transfermarkt.technology/portrait/header/357885-1714124764.jpg?lm=1,ES1,Real Betis BalompiÃ© S.A.D.,14000000.0,30000000.0,28,144,165,9,14,13,12,16,12,8,12,7,12,15,9,14,15,15,14,8,14,12,15,12,14,15,11,15,12,15,15,12,15,12,9,14,12,15,11,10,7,10,7,10,2,4,2,2,1,2,2,1,1,3,2,16,16,4,16,17,19,16,16,1,1,1,1,1,1,10,13,18,11,18,20,11,1,67,12,20,41384691,7199,7199,5599,Mediterranean_Hispanic,142,6,1,92793.0,Unknown,67214613,16000000.0,3.0,89,329,89,3,1,3,164,0,0.7028314368880656,0.5934759358288769,0.6838235294117647,0.0895938324093985,0.0394736842105263,0.0131578947368421,0.0697674418604651,0.1497874468617154,0.0888635795438762,0.2857142857142857,0.3488372093023257,0.4166666666666665,397,43,42,34,0,5386,2,3,15,9000000,326923.07692307694,30000000.0,5000000.0,,5000000.0,3,8000000,-0.35714285714285715,-0.47058823529411764
357992,Raoul,Bellanova,2024,800,Italy,Rho,Italy,17-05-00,Right-Back,Defender,Right,188.0,30-06-29,CAA Base Ltd,https://img.a.transfermarkt.technology/portrait/header/357992-1695028689.jpg?lm=1,IT1,Atalanta Bergamasca Calcio S.p.a.,15000000.0,15000000.0,24,130,155,6,14,14,8,13,5,11,6,8,12,12,5,10,12,11,13,14,12,13,11,11,16,10,8,11,12,10,12,16,13,12,12,15,16,14,12,13,7,12,6,13,1,3,3,1,3,4,4,2,3,3,3,14,16,4,12,12,15,15,14,1,12,10,20,12,19,1,10,1,17,1,1,1,1,78,8,20,21991200,6500,6250,5250,Mediterranean_Hispanic,121,0,0,18249.0,FC Internazionale Milano,43295110,7117500.0,4.0,52,1224,54,1,1,3,31,11,0.5772691188145012,0.5561497326203209,0.5294117647058822,0.0176128589320079,0.0,0.0,0.0747686921730432,0.0747686921730432,0.0395149865274035,0.4285714285714285,0.581395348837209,0.25,267,9,25,18,4,2510,5,15,21,22000000,1166666.6666666667,22000000.0,2000000.0,,1100000.0,7,8300000,0.4666666666666667,2.142857142857143
358008,Gianluca,Gaetano,2024,1390,Italy,Cimitile,Italy,05-05-00,Attacking Midfield,Midfield,Right,183.0,30-06-25,Unknown,https://img.a.transfermarkt.technology/portrait/header/358008-1656581154.jpg?lm=1,IT1,Cagliari Calcio,6000000.0,6000000.0,24,123,149,13,12,15,12,14,13,7,12,6,6,13,13,7,14,9,13,8,9,8,13,11,14,14,7,14,9,14,12,13,14,11,8,15,13,15,10,12,4,10,4,15,2,2,3,3,1,2,1,2,2,4,1,10,14,3,11,10,12,13,12,1,1,1,1,1,1,1,15,20,15,15,19,15,10,74,10,20,5685000,6150,6050,4750,Mediterranean_Hispanic,116,0,0,14230.0,Unknown,43317758,9111392.0,2.0,52,364,54,3,1,3,46,0,0.5508070918232336,0.5026737967914437,0.4926470588235294,0.0137320431399169,0.0,0.0,0.0297574393598399,0.0297574393598399,0.0505924720131114,0.1428571428571428,0.4651162790697669,0.25,281,99,41,25,1,5628,7,8,71,5000000,300000.0,6000000.0,1000000.0,,1100000.0,3,575000,-0.16666666666666666,0.1111111111111111
358115,Luis,Pérez,2024,366,Spain,Utrera,Spain,04-02-95,Right-Back,Defender,Left,173.0,30-06-25,PROTIO SPORT,https://img.a.transfermarkt.technology/portrait/header/358115-1544697482.jpg?lm=1,ES1,Real Valladolid Club de FÃºtbol S.A.D.,1600000.0,1600000.0,29,132,150,13,13,14,14,14,14,8,13,7,5,13,15,7,15,14,14,12,12,13,13,13,11,15,12,14,6,13,13,14,13,13,9,13,13,13,13,9,11,11,11,13,1,1,3,3,3,1,3,3,4,2,1,11,12,11,11,10,13,12,9,1,1,1,1,1,1,1,10,10,10,16,16,15,20,78,20,9,1548471,6497,6497,5297,Mediterranean_Hispanic,128,0,0,18509.0,Unknown,813076,9111392.0,2.0,89,1552,89,1,0,3,169,11,0.6099497221487166,0.5611764705882353,0.5808823529411764,0.0178639194211703,0.0,0.0,0.0077519379844961,0.0077519379844961,0.0505924720131114,0.1428571428571428,0.2325581395348837,0.4583333333333332,314,2,14,32,0,1170,5,19,72,2000000,72727.27272727272,2000000.0,150000.0,,,2,250000,0.25,0.3333333333333333
358166,Eldor,Shomurodov,2024,12,Uzbekistan,"Jarkurgan, Surxondaryo Region",Uzbekistan,29-06-95,Centre-Forward,Attack,Right,190.0,30-06-26,prosm,https://img.a.transfermarkt.technology/portrait/header/358166-1661514115.jpg?lm=1,IT1,Associazione Sportiva Roma,5000000.0,14000000.0,29,132,141,6,9,14,13,15,7,12,9,5,6,12,11,8,15,13,13,12,12,12,11,11,14,14,4,16,8,15,14,14,14,15,12,16,15,12,12,11,5,8,5,12,2,2,2,3,1,1,4,3,4,4,2,12,16,1,13,8,15,14,17,1,1,1,1,1,1,1,1,1,1,15,10,10,20,76,12,20,2375105,6600,7200,5500,Asian,132,57,31,36922.0,Unknown,59061760,9800000.0,3.0,107,685,104,0,1,2,29,3,0.702963747023022,0.5828877005347594,0.6102941176470589,0.0356438301401979,0.375,0.4078947368421052,0.0247561890472618,0.0697674418604651,0.05441817828273,0.2857142857142857,0.6279069767441858,0.4583333333333332,328,60,34,19,0,8515,5,21,75,4000000,145000.0,14000000.0,2000000.0,,400000.0,6,10150000,-0.2,-0.2
358250,Joseph,Aidoo,2024,940,Ghana,Tema,Ghana,29-09-95,Centre-Back,Defender,Right,181.0,30-06-26,Unknown,https://img.a.transfermarkt.technology/portrait/header/358250-1496923402.jpg?lm=1,ES1,Real Club Celta de Vigo S. A. D.,4000000.0,8000000.0,29,130,140,7,7,7,4,11,8,14,7,9,14,11,6,15,11,12,12,14,11,9,11,13,14,7,11,8,13,14,13,14,15,15,12,15,14,15,16,11,8,12,5,6,3,1,2,2,3,3,1,1,3,2,2,14,13,4,10,13,13,14,14,1,1,20,5,1,1,1,1,1,1,1,1,1,1,80,7,20,4007288,6500,6700,5000,African_Caribbean,130,8,0,36438.0,Unknown,13158416,4625000.0,2.0,39,1483,41,1,1,1,165,2,0.6368086795448531,0.5294117647058822,0.5955882352941175,0.0351764713834495,0.0526315789473684,0.0,0.0197549387346836,0.0397599399849962,0.0256673796494347,0.1428571428571428,0.418604651162791,0.4583333333333332,269,12,2,27,0,6024,5,51,258,2000000,66379.31034482758,8000000.0,2000000.0,,75000.0,2,4500000,-0.5,-0.5
358504,Ritsu,Doan,2024,60,Japan,"Amagasaki, Hyogo",Japan,16-06-98,Right Winger,Attack,Left,172.0,Unknown,CAA Stellar,https://img.a.transfermarkt.technology/portrait/header/358504-1658413443.jpg?lm=1,L1,Sport-Club Freiburg,18000000.0,18000000.0,26,133,146,12,11,13,11,15,11,7,9,7,5,13,13,7,16,9,12,11,12,11,15,10,12,12,7,12,7,14,13,13,15,14,7,14,13,13,11,12,9,8,6,15,2,3,2,1,1,1,2,2,2,1,3,15,10,8,12,11,9,9,15,1,1,1,1,1,1,1,10,10,15,17,19,20,10,70,20,16,8224628,6550,7000,5000,10,130,26,3,14999.0,Unknown,45095577,5900000.0,3.0,54,58,56,0,0,0,189,10,0.6765017200317545,0.5294117647058822,0.5955882352941175,0.014474602817478,0.1710526315789473,0.0394736842105263,0.0897724431107777,0.0897724431107777,0.0327509097474929,0.2857142857142857,0.2093023255813952,0.3333333333333332,322,70,44,21,0,4695,6,10,26,22000000,952173.9130434783,22000000.0,3000000.0,150000.0,10000000.0,5,7800000,0.2222222222222222,0.2222222222222222
358948,Bright,Osayi-Samuel,2024,36,Nigeria,Okija,Nigeria,31-12-97,Right-Back,Defender,Right,175.0,30-06-25,Triple S Sports,https://img.a.transfermarkt.technology/portrait/header/358948-1728392103.JPG?lm=1,TR1,FenerbahÃ§e Spor KulÃ¼bÃ¼,8000000.0,9000000.0,26,130,140,5,7,17,10,12,9,5,6,3,14,10,11,12,13,12,7,11,11,15,11,6,15,15,2,16,11,15,17,17,15,15,8,12,17,15,13,15,13,12,6,6,2,1,3,3,3,1,3,1,1,3,3,8,14,10,8,16,12,12,11,1,1,1,20,11,20,1,12,1,12,14,8,14,10,72,8,20,7817461,6534,5984,5234,African_Caribbean,118,0,0,38462.0,Unknown,29143882,508000.0,1.0,69,1075,70,1,1,1,84,11,0.5420746229161154,0.5544385026737968,0.5073529411764706,0.0371308807298521,0.0,0.0,0.0397599399849962,0.0447611902975743,0.0027945220700575,0.0,0.2790697674418605,0.3333333333333332,360,25,32,59,0,8612,12,27,22,8000000,304807.6923076923,9000000.0,1500000.0,100000.0,500000.0,2,400000,-0.058823529411764705,-0.058823529411764705
359247,Maryan,Shved,2024,660,Ukraine,"Mykolaiv, Lviv Oblast",Ukraine,16-07-97,Right Winger,Attack,Left,171.0,30-06-27,ProStar,https://img.a.transfermarkt.technology/portrait/header/359247-1723487001.png?lm=1,UKR1,FC Shakhtar Donetsk,1200000.0,2000000.0,27,125,128,13,13,14,13,14,12,7,14,6,8,14,15,7,14,9,12,7,13,11,14,12,15,14,10,14,9,10,11,15,14,12,6,11,14,12,9,9,8,11,9,9,2,1,1,3,3,1,1,3,2,2,3,2,11,6,11,12,9,12,14,1,1,1,1,1,1,1,1,1,11,14,15,20,17,63,20,5,4873445,5800,5850,4750,Northern_European,124,2,0,5177.0,Unknown,71083284,1333333.333,3.0,103,996,101,0,0,7,72,10,0.5243450648319662,0.5026737967914437,0.5514705882352942,0.0049903100307355,0.0131578947368421,0.0,0.0057514378594648,0.0097524381095273,0.0073798346231839,0.2857142857142857,0.1860465116279068,0.375,163,40,19,9,0,5964,11,77,267,1000000,16666.666666666668,2000000.0,600000.0,600000.0,300000.0,6,1600000,-0.16666666666666666,0.0
360140,Majeed,Ashimeru,2024,58,Ghana,Accra,Ghana,10-10-97,Central Midfield,Midfield,Right,174.0,30-06-27,Libera Sports,https://img.a.transfermarkt.technology/portrait/header/360140-1660676946.jpg?lm=1,BE1,Royal Sporting Club Anderlecht,2000000.0,3500000.0,27,124,126,6,6,11,8,12,6,7,9,7,9,13,9,12,12,10,12,12,13,11,12,12,11,10,8,14,12,14,17,13,13,11,11,12,12,14,11,11,8,9,7,7,3,2,1,2,2,1,3,4,4,3,1,8,13,6,10,11,14,13,15,1,1,1,1,1,1,12,1,20,1,1,15,1,1,75,13,20,1506686,5771,5759,3961,African_Caribbean,118,3,0,12499.0,Unknown,13197577,1500000.0,1.0,39,20,41,3,1,1,175,1,0.5123048425509394,0.4182887700534758,0.5073529411764706,0.012060559652455,0.0197368421052631,0.0,0.0097524381095273,0.0172543135783946,0.0083057862718408,0.0,0.2558139534883721,0.375,233,21,25,32,2,5265,7,55,104,2000000,94736.84210526316,3500000.0,700000.0,,700000.0,4,2700000,0.0,0.0
360518,Teun,Koopmeiners,2024,506,Netherlands,Castricum,Netherlands,28-02-98,Attacking Midfield,Midfield,Left,184.0,30-06-29,Wasserman,https://img.a.transfermarkt.technology/portrait/header/360518-1707302998.jpg?lm=1,IT1,Juventus Football Club,50000000.0,50000000.0,26,149,164,12,12,11,13,14,16,10,15,4,11,15,16,12,14,12,16,12,12,14,13,16,18,7,15,10,13,17,15,11,12,15,12,15,12,16,15,15,7,12,3,13,1,2,1,3,1,2,2,3,2,3,1,18,16,8,12,11,18,16,10,1,8,14,1,1,1,19,1,20,1,1,1,1,1,77,20,12,23015697,7450,7100,5500,Northern_European,147,9,1,36922.0,Unknown,37057982,34350000.0,2.0,67,333,68,3,0,7,116,0,0.6897327335273882,0.5828877005347594,0.7205882352941175,0.0356438301401979,0.0592105263157894,0.0131578947368421,0.2498124531132783,0.2498124531132783,0.1908108558571071,0.1428571428571428,0.4883720930232553,0.3333333333333332,367,78,35,48,1,7890,11,32,45,50000000,1909615.3846153845,55000000.0,5000000.0,,3500000.0,2,6500000,0.0,0.25
360791,Lucas,Chaves,2024,6418,Argentina,MartÃ­n Coronado,Argentina,09-08-95,Goalkeeper,Goalkeeper,Right,182.0,31-12-25,AREA SPORT TEAM,https://img.a.transfermarkt.technology/portrait/header/360791-1636584205.JPG?lm=1,GR1,Panetolikos Agrinio,1200000.0,4000000.0,29,131,131,5,8,11,5,14,7,6,4,11,8,15,6,8,13,12,14,11,11,13,13,13,16,13,11,10,11,13,14,13,14,13,11,13,12,12,12,15,8,15,7,8,9,13,13,12,12,14,15,14,18,15,15,11,11,5,15,14,14,8,14,20,1,1,1,1,1,1,1,1,1,1,1,1,1,72,10,20,3017780,6460,6460,3976,Mediterranean_Hispanic,132,0,0,5105.0,Club AtlÃ©tico HuracÃ¡n,14121997,9111392.0,2.0,4,922,4,2,1,3,151,5,0.6050542471553321,0.4198930481283422,0.6102941176470589,0.0049207855875829,0.0,0.0,0.0057514378594648,0.0197549387346836,0.0505924720131114,0.1428571428571428,0.4418604651162785,0.4583333333333332,0,0,0,0,0,0,1,16,107,1200000,60526.31578947369,4000000.0,2000000.0,,50000.0,2,2500000,0.0,-0.6842105263157895
361065,Mitchel,Bakker,2024,1082,Netherlands,Purmerend,Netherlands,20-06-00,Left-Back,Defender,Left,189.0,30-06-25,Team Raiola,https://img.a.transfermarkt.technology/portrait/header/361065-1658913284.jpg?lm=1,FR1,Lille Olympique Sporting Club Lille MÃ©tropole,6000000.0,14000000.0,24,131,145,10,13,11,8,12,12,12,11,10,11,12,10,13,12,14,11,14,13,11,11,11,13,11,9,13,12,14,14,14,12,15,13,12,16,14,14,13,12,12,6,8,3,3,1,1,2,1,1,3,4,2,3,12,14,10,11,11,13,10,10,1,20,15,1,17,1,10,12,1,1,1,1,1,1,87,20,8,5400000,6548,5998,5248,Northern_European,126,0,0,28766.0,Unknown,37063645,8250000.0,2.0,67,1194,68,1,0,7,128,8,0.5439269648055041,0.5559358288770053,0.5661764705882353,0.0277682557186268,0.0,0.0,0.0297574393598399,0.0697674418604651,0.0458068279674435,0.1428571428571428,0.6046511627906974,0.25,263,13,22,36,1,8494,6,21,47,5000000,204545.45454545456,14000000.0,3000000.0,500000.0,10000000.0,5,1500000,-0.23076923076923078,-0.375
361066,Davy,Van Den Berg,2024,1269,Netherlands,Uden,Netherlands,04-02-00,Central Midfield,Midfield,Right,185.0,30-06-25,Panthera Sports,https://img.a.transfermarkt.technology/portrait/header/361066-1629451739.jpg?lm=1,NL1,Prins Hendrik Ende Desespereert Nimmer Combinatie Zwolle,1500000.0,1500000.0,24,94,-75,9,8,10,7,12,11,12,9,6,10,12,9,13,9,7,10,11,10,9,7,10,12,9,10,7,13,12,14,11,9,14,13,10,10,10,13,8,8,11,6,7,3,2,1,3,1,1,1,1,3,3,3,16,9,7,11,10,11,13,20,1,1,20,1,1,1,1,1,1,1,1,1,1,1,0,7,20,7800000,4641,4641,2991,Northern_European,94,0,0,668.0,Unknown,2000010316,9111392.0,2.0,67,1543,68,3,1,7,156,1,0.3643821116697538,0.3145454545454545,0.3308823529411764,0.0006363417783,0.0,0.0,0.0072518129532383,0.0072518129532383,0.0505924720131114,0.1428571428571428,0.5116279069767438,0.25,179,18,20,23,0,3505,1,4,32,1500000,98333.33333333333,1500000.0,50000.0,,200000.0,2,250000,0.0,0.5789473684210527
361068,Jurgen,Ekkelenkamp,2024,410,Netherlands,Zeist,Netherlands,05-04-00,Attacking Midfield,Midfield,Right,188.0,30-06-29,Unknown,https://img.a.transfermarkt.technology/portrait/header/361068-1657098697.jpg?lm=1,IT1,Udinese Calcio,4500000.0,6000000.0,24,132,155,8,10,11,15,15,10,14,11,10,8,13,13,7,13,10,14,12,14,15,14,13,15,10,8,16,8,15,14,11,12,15,13,12,12,14,12,13,4,12,5,13,2,1,2,4,3,1,4,2,1,2,3,15,12,3,12,14,14,12,14,1,1,1,1,1,1,11,1,20,12,1,15,12,1,74,12,20,18600000,6650,6500,4250,Northern_European,129,0,0,19999.0,Unknown,37064578,4500000.0,3.0,67,1703,68,3,1,7,205,0,0.6103466525535857,0.4491978609625668,0.588235294117647,0.0193026891475241,0.0,0.0,0.0222555638909727,0.0297574393598399,0.0249729159143309,0.2857142857142857,0.581395348837209,0.25,292,83,30,22,1,9127,6,10,23,5500000,270000.0,6000000.0,1000000.0,400000.0,3200000.0,5,2800000,0.2222222222222222,0.1
361074,Peer,Koopmeiners,2024,1090,Netherlands,Amsterdam,Netherlands,04-05-00,Defensive Midfield,Midfield,Right,186.0,30-06-28,Wasserman,https://img.a.transfermarkt.technology/portrait/header/361074-1721657696.jpg?lm=1,NL1,Alkmaar Zaanstreek,1800000.0,1800000.0,24,110,-75,4,5,6,5,12,8,9,10,4,11,12,10,13,12,12,15,11,12,14,12,14,15,6,14,14,13,15,13,9,11,12,9,12,9,13,11,13,4,12,5,8,2,2,1,3,3,2,3,2,3,2,3,7,13,8,10,13,16,11,13,1,1,15,1,1,1,20,1,18,1,1,1,1,1,67,10,20,25050001,5398,5398,4256,Northern_European,109,0,0,1567.0,Unknown,37064597,9111392.0,2.0,67,64,68,3,1,7,16,4,0.4645408838317015,0.4498395721925133,0.4411764705882353,0.0015044317004423,0.0,0.0,0.0087521880470117,0.0087521880470117,0.0505924720131114,0.1428571428571428,0.5348837209302322,0.25,274,13,27,23,1,3528,2,4,19,4500000,278125.0,4500000.0,100000.0,75000.0,700000.0,5,2325000,1.5,2.75
361093,Sven,Botman,2024,762,Netherlands,Badhoevedorp,Netherlands,12-01-00,Centre-Back,Defender,Left,195.0,30-06-27,Muy Manero,https://img.a.transfermarkt.technology/portrait/header/361093-1683290679.jpg?lm=1,GB1,Newcastle United Football Club,45000000.0,45000000.0,24,135,149,7,9,9,6,12,3,15,6,11,15,14,8,16,13,10,14,13,13,14,10,12,13,8,12,9,13,12,14,10,9,14,16,12,12,15,15,13,5,11,7,12,1,2,3,2,4,1,3,3,3,3,3,13,13,8,12,11,15,13,7,1,16,20,1,13,1,13,1,1,1,1,1,1,10,0,20,8,49760455,6750,6750,5500,Northern_European,131,0,0,104393.0,Unknown,37063649,22500000.0,2.0,67,125,68,1,0,7,137,2,0.6434241862926701,0.5828877005347594,0.6029411764705883,0.1007949926951053,0.0,0.0,0.2248062015503876,0.2248062015503876,0.1249756937692713,0.1428571428571428,0.7441860465116279,0.25,269,23,11,29,0,5944,8,73,269,45000000,2235000.0,45000000.0,200000.0,,25000000.0,3,10000000,0.0,0.0
361104,Sergiño,Dest,2024,383,Netherlands,Almere,United States,03-11-00,Right-Back,Defender,Right,173.0,30-06-28,Joes Blakborn,https://img.a.transfermarkt.technology/portrait/header/361104-1713981952.jpg?lm=1,NL1,Eindhovense Voetbalvereniging Philips Sport Vereniging,22000000.0,30000000.0,24,140,155,8,14,14,8,14,8,8,10,12,11,13,9,13,14,11,12,13,11,11,12,11,16,15,10,15,11,13,14,15,16,11,7,12,15,13,8,12,10,9,9,14,2,3,1,3,1,3,1,2,2,2,1,15,14,8,10,14,14,13,10,1,18,1,20,18,19,1,12,1,14,12,1,12,1,62,12,20,24420000,6995,6995,5995,African_Caribbean,125,17,2,76923.0,AC Milan,37065767,21000000.0,1.0,67,50,102,1,1,1,62,11,0.6758401693569728,0.6358288770053475,0.5588235294117647,0.0742694863978323,0.1118421052631578,0.0263157894736842,0.1097774443610902,0.1497874468617154,0.1166421289480263,0.0,0.2325581395348837,0.25,239,13,27,9,1,6675,18,80,216,22000000,1150000.0,30000000.0,12000000.0,5500000.0,30000000.0,4,11900000,0.0,0.2222222222222222
361254,Rafa,Mir,2024,1049,Spain,Cartagena,Spain,18-06-97,Centre-Forward,Attack,Right,191.0,30-06-25,Unknown,https://img.a.transfermarkt.technology/portrait/header/361254-1720020544.jpg?lm=1,ES1,Valencia Club de FÃºtbol S. A. D.,2500000.0,16000000.0,27,144,154,5,10,12,15,14,7,17,14,7,6,11,15,6,12,10,13,14,13,14,10,13,13,12,10,13,12,11,14,14,12,14,15,15,15,14,15,12,8,14,8,11,1,1,4,2,3,3,3,3,2,2,3,12,17,13,9,12,12,12,12,1,1,1,1,1,1,1,1,1,1,5,1,5,20,75,12,20,16412929,7200,7200,5700,Mediterranean_Hispanic,144,0,0,32145.0,Unknown,67221051,9000000.0,2.0,89,320,89,0,1,3,208,3,0.702963747023022,0.6042780748663101,0.6985294117647058,0.0310310764604719,0.0,0.0,0.0122530632658164,0.0797699424856214,0.049973610378066,0.1428571428571428,0.6511627906976742,0.375,293,88,17,39,1,4351,2,9,69,800000,16666.666666666668,16000000.0,4000000.0,,1500000.0,5,6000000,-0.68,-0.84
361256,Berke,ÃÂZer,2024,7160,TÃ¼rkiye,Izmir,TÃ¼rkiye,25-05-00,Goalkeeper,Goalkeeper,Right,191.0,30-06-25,We4You,https://img.a.transfermarkt.technology/portrait/header/361256-1695763409.png?lm=1,TR1,EyÃ¼p Spor KulÃ¼bÃ¼,2000000.0,3500000.0,24,107,135,2,3,2,3,8,5,1,2,3,2,11,5,3,8,5,10,11,12,14,7,11,12,3,7,7,12,8,12,8,13,13,13,9,9,7,8,10,3,10,6,10,14,11,10,5,13,9,14,14,10,12,13,14,13,11,8,10,11,12,14,20,1,1,1,1,1,1,1,1,1,1,1,1,1,79,12,20,804999,5350,5350,3500,Mediterranean_Hispanic,105,0,0,1500.0,Unknown,70104047,2500000.0,1.0,100,682,100,2,1,3,66,5,0.4581899973537973,0.3689839572192513,0.411764705882353,0.0014397353436197,0.0,0.0,0.0097524381095273,0.0172543135783946,0.0138614961526709,0.0,0.6511627906976742,0.25,0,0,0,0,0,0,11,30,37,3500000,139000.0,3500000.0,1000000.0,2000000.0,1100000.0,6,2900000,1.3333333333333333,1.1875
361260,Ozan,Kabak,2024,533,TÃ¼rkiye,Ankara,TÃ¼rkiye,25-03-00,Centre-Back,Defender,Right,187.0,30-06-26,F-F SPORT,https://img.a.transfermarkt.technology/portrait/header/361260-1691269223.jpg?lm=1,L1,TSG 1899 Hoffenheim FuÃŸball-Spielbetriebs GmbH,10000000.0,32000000.0,24,130,150,3,6,12,6,12,4,16,6,6,14,12,6,15,12,15,13,16,12,12,11,12,14,11,10,8,14,11,12,13,11,14,14,12,14,12,15,12,12,13,12,6,1,3,2,1,4,1,2,3,3,1,1,11,13,14,8,11,12,8,9,1,1,20,1,1,1,10,1,1,1,1,1,1,1,80,10,20,8999999,6500,6750,5500,North_African__Middle_Eastern,130,17,0,52739.0,Unknown,70110530,11000000.0,3.0,100,71,100,1,1,6,199,2,0.6434241862926701,0.5828877005347594,0.5955882352941175,0.0509169984366656,0.1118421052631578,0.0,0.0497624406101525,0.1597899474868717,0.0610850301397261,0.2857142857142857,0.5581395348837206,0.25,166,14,6,38,0,3204,15,72,236,7500000,321739.1304347826,32000000.0,8000000.0,10000000.0,25000000.0,6,18850000,-0.25,-0.4230769230769231
361914,Nayef,Aguerd,2024,681,Morocco,KÃ©nitra,Morocco,30-03-96,Centre-Back,Defender,Left,190.0,30-06-25,CANTERASPORT,https://img.a.transfermarkt.technology/portrait/header/361914-1659355782.jpg?lm=1,ES1,Real Sociedad de FÃºtbol S.A.D.,35000000.0,38000000.0,28,128,133,3,9,5,12,12,4,16,7,11,13,12,9,14,11,11,13,14,15,14,10,13,12,5,11,9,15,11,12,13,11,13,16,12,11,13,12,12,7,13,6,9,2,3,2,2,3,4,1,3,2,2,3,12,12,7,13,11,11,13,12,1,13,20,1,1,1,10,1,1,1,1,1,1,1,76,20,6,27629844,6400,6400,3800,North_African__Middle_Eastern,128,25,1,75395.0,Unknown,13199286,10153750.0,4.0,66,775,67,1,0,6,168,2,0.5971156390579518,0.4010695187165775,0.5808823529411764,0.0727940232153703,0.1644736842105263,0.0131578947368421,0.1747936984246061,0.1897974493623406,0.0563835106530736,0.4285714285714285,0.6279069767441858,0.4166666666666665,288,21,5,34,2,5523,11,58,99,35000000,1652380.9523809524,38000000.0,3000000.0,,,4,17350000,0.0,-0.07894736842105263
362086,Isi,Palazón,2024,367,Spain,Cieza,Spain,27-12-94,Right Winger,Attack,Left,169.0,30-06-28,JV SPORTS ,https://img.a.transfermarkt.technology/portrait/header/362086-1726662958.jpg?lm=1,ES1,Rayo Vallecano de Madrid S.A.D.,8000000.0,12000000.0,29,139,143,9,13,16,14,15,8,7,11,6,5,13,11,9,14,10,13,12,13,12,14,15,14,15,8,13,9,10,14,14,16,15,7,11,14,14,12,13,11,11,9,10,2,3,1,3,2,2,1,3,3,1,1,12,12,10,14,14,15,10,10,1,1,1,1,1,1,1,16,1,18,19,13,20,11,68,20,8,7730057,6950,6950,4950,Mediterranean_Hispanic,139,0,0,18479.0,Unknown,67173045,600000.0,1.0,89,362,89,0,0,3,163,10,0.6698862132839376,0.5240641711229946,0.6617647058823528,0.0178349509031901,0.0,0.0,0.0397599399849962,0.0597649412353088,0.0033056473790938,0.0,0.13953488372093,0.4583333333333332,381,56,27,55,2,4799,0,0,0,4000000,156250.0,12000000.0,4000000.0,,,2,150000,-0.5,-0.6666666666666666
362108,Gabriel,Gudmundsson,2024,1082,Sweden,MalmÃ¶,Sweden,29-04-99,Left-Back,Defender,Left,180.0,30-06-26,MD Management,https://img.a.transfermarkt.technology/portrait/header/362108-1666691160.jpg?lm=1,FR1,Lille Olympique Sporting Club Lille MÃ©tropole,5000000.0,6000000.0,25,118,138,9,12,14,10,11,7,9,12,5,8,12,6,6,12,9,10,10,10,10,8,10,12,13,8,12,10,13,13,15,13,10,10,11,15,13,9,11,7,7,7,7,1,1,2,3,2,2,2,2,2,3,2,10,12,2,17,11,12,13,16,1,18,1,10,20,10,1,18,1,10,18,8,10,1,78,20,7,1617317,5889,5939,5239,Northern_European,102,0,0,6534.0,Unknown,93065006,6000000.0,1.0,91,902,91,1,0,7,128,8,0.5361206668430802,0.5549732620320855,0.3897058823529412,0.00630065266071,0.0,0.0,0.0247561890472618,0.0297574393598399,0.0333064807355759,0.0,0.3953488372093026,0.2916666666666665,303,33,18,26,0,7223,6,47,87,7000000,384722.22222222225,7000000.0,1000000.0,200000.0,525000.0,2,2500000,0.4,0.75
362562,Greg,Taylor,2024,371,Scotland,Greenock,Scotland,05-11-97,Left-Back,Defender,Left,171.0,30-06-25,PLG,https://img.a.transfermarkt.technology/portrait/header/362562-1696454674.jpg?lm=1,SC1,The Celtic Football Club,7500000.0,7500000.0,27,125,132,5,13,13,4,11,6,12,10,8,13,13,9,13,12,14,11,14,12,13,14,12,15,4,10,12,14,14,16,14,12,12,8,14,13,15,11,14,10,10,5,12,3,2,1,1,1,2,2,2,1,1,3,10,12,8,12,12,15,12,14,1,20,1,1,15,1,1,1,1,1,1,1,1,1,62,20,10,4591968,6250,6250,3857,Northern_European,124,7,0,16239.0,Unknown,61074608,9111392.0,2.0,82,559,83,1,0,7,200,8,0.5772691188145012,0.4071657754010694,0.5514705882352942,0.0156719682273294,0.0460526315789473,0.0,0.0372593148287071,0.0372593148287071,0.0505924720131114,0.1428571428571428,0.1860465116279068,0.375,338,10,42,41,1,10113,4,11,23,7000000,375000.0,7500000.0,500000.0,,500000.0,1,250000,-0.06666666666666667,0.0
362570,Andrey,Mostovoy,2024,964,Russia,Omsk,Russia,05-11-97,Left Winger,Attack,Right,180.0,30-06-27,Unknown,https://img.a.transfermarkt.technology/portrait/header/362570-1721723812.png?lm=1,RU1,AO FK Zenit Sankt-Peterburg,3500000.0,3500000.0,27,127,135,12,11,14,13,13,8,7,12,9,10,14,13,9,14,10,10,10,12,10,11,13,12,14,11,13,7,11,11,14,14,13,9,10,14,12,10,14,6,12,6,13,3,2,2,3,3,3,3,2,2,1,1,18,10,8,12,12,13,10,12,1,1,1,5,11,7,1,18,1,15,20,14,15,12,73,13,20,4856540,6150,6150,4012,Northern_European,126,10,1,33277.0,Unknown,58120006,50000.0,1.0,78,1084,81,0,1,7,7,7,0.5640381053188674,0.4237433155080213,0.5661764705882353,0.0321241552055944,0.0657894736842105,0.0131578947368421,0.0172543135783946,0.0172543135783946,0.0002500069446373,0.0,0.3953488372093026,0.375,317,49,33,19,0,6666,8,14,35,4000000,164583.33333333334,4000000.0,400000.0,100000.0,350000.0,5,1650000,0.14285714285714285,0.14285714285714285
362667,Mateo,Cassierra,2024,964,Colombia,Barbacoas,Colombia,13-04-97,Centre-Forward,Attack,Right,186.0,30-06-27,Wasserman,https://img.a.transfermarkt.technology/portrait/header/362667-1721723658.png?lm=1,RU1,AO FK Zenit Sankt-Peterburg,11000000.0,11000000.0,27,124,130,6,8,12,14,14,8,13,9,7,4,12,12,5,13,10,15,11,12,12,10,13,9,11,5,14,5,9,8,14,13,13,12,14,14,13,12,12,7,8,10,8,4,1,3,1,3,2,3,4,3,3,1,9,12,8,11,10,9,9,11,1,1,1,1,1,1,1,1,1,1,13,10,10,20,79,11,20,5995130,6361,5369,4685,African_Caribbean,124,0,0,19177.0,Unknown,76043519,3733333.333,3.0,20,139,20,0,1,1,7,3,0.4607038899179677,0.4957219251336898,0.5514705882352942,0.0185089517548645,0.0,0.0,0.0547636909227306,0.0547636909227306,0.020713538337176,0.2857142857142857,0.5348837209302322,0.375,339,117,45,9,0,5945,7,13,22,11000000,492857.14285714284,11000000.0,1500000.0,650000.0,3000000.0,6,7850000,0.0,0.2222222222222222
362977,Josip,Juranovic,2024,89,Croatia,Zagreb,Croatia,16-08-95,Right-Back,Defender,Right,173.0,30-06-27,Unknown,https://img.a.transfermarkt.technology/portrait/header/362977-1691614466.jpg?lm=1,L1,1. FC Union Berlin,7500000.0,12000000.0,29,131,138,12,14,12,8,12,13,12,12,4,9,13,18,12,13,14,13,16,12,11,12,12,17,13,15,12,12,13,14,14,13,12,7,13,16,15,11,13,8,13,6,17,3,2,1,2,1,3,2,2,1,1,3,15,12,6,16,8,16,19,14,1,15,1,20,13,20,1,1,1,1,1,1,1,1,69,10,20,9893494,6443,6443,5743,Northern_European,129,20,0,20879.0,Unknown,24047634,3983333.333,3.0,24,1697,25,1,1,7,0,11,0.6028049748610743,0.6088770053475935,0.588235294117647,0.0201524323416122,0.131578947368421,0.0,0.0372593148287071,0.0597649412353088,0.0221024658073835,0.2857142857142857,0.2325581395348837,0.4583333333333332,312,15,32,26,1,8491,5,27,91,6000000,258695.65217391305,12000000.0,2500000.0,,750000.0,3,4800000,-0.2,-0.4
363057,Pedro,Díaz,2024,367,Spain,Siero,Spain,05-06-98,Central Midfield,Midfield,Right,180.0,30-06-28,Wasserman,https://img.a.transfermarkt.technology/portrait/header/363057-1664207844.jpg?lm=1,ES1,Rayo Vallecano de Madrid S.A.D.,2500000.0,2500000.0,26,121,146,10,11,11,11,13,13,9,13,7,11,12,12,11,14,13,11,13,10,11,14,11,10,12,9,9,11,15,15,12,12,11,10,12,12,15,13,11,8,10,9,13,1,1,3,1,2,3,1,3,2,3,2,12,9,6,16,12,14,15,14,1,1,1,1,1,1,12,1,20,10,1,17,10,1,78,12,20,1480469,6050,6050,4050,Mediterranean_Hispanic,121,0,0,4966.0,Unknown,67220203,2200000.0,1.0,89,1369,89,3,1,3,163,1,0.5508070918232336,0.427807486631016,0.5294117647058822,0.0047865647876076,0.0,0.0,0.0122530632658164,0.0122530632658164,0.0121947831884219,0.0,0.3953488372093026,0.3333333333333332,313,29,21,30,0,2304,1,0,6,2000000,90476.19047619047,2500000.0,650000.0,,300000.0,3,1100000,-0.2,0.0
363205,Unknown,Gabriel Jesus,2024,11,Brazil,SÃ£o Paulo,Brazil,03-04-97,Centre-Forward,Attack,Right,175.0,30-06-27,Energy Sports,https://img.a.transfermarkt.technology/portrait/header/363205-1669711141.jpg?lm=1,GB1,Arsenal Football Club,55000000.0,80000000.0,27,162,175,7,12,16,16,15,11,15,12,4,6,14,13,8,16,12,15,13,15,14,14,15,13,16,8,16,7,15,16,15,16,15,10,15,15,14,13,13,12,14,8,12,1,1,1,2,2,3,2,1,4,1,4,15,13,8,12,14,14,11,11,1,1,1,1,1,1,1,1,1,1,15,11,17,20,73,13,20,282622772,8098,7998,7848,African_Caribbean,161,56,19,139190.0,Unknown,19220266,42100000.0,2.0,10,1456,11,0,1,1,21,3,0.8085472347181795,0.8340106951871658,0.8235294117647058,0.1343955767004278,0.3684210526315789,0.25,0.274818704676169,0.3998499624906226,0.2338676074335398,0.1428571428571428,0.2790697674418605,0.375,415,149,70,62,1,9696,18,109,200,45000000,1638888.888888889,80000000.0,14000000.0,4000000.0,70000000.0,2,24000000,-0.3076923076923077,-0.35714285714285715
364133,Pietro,Pellegri,2024,749,Italy,Genova,Italy,17-03-01,Centre-Forward,Attack,Right,189.0,30-06-25,GR Sports,https://img.a.transfermarkt.technology/portrait/header/364133-1663596740.jpg?lm=1,IT1,Empoli Football Club S.r.l.,3000000.0,8000000.0,23,125,155,7,7,12,13,13,8,15,11,7,5,12,13,5,13,11,12,16,13,13,11,13,14,12,9,15,6,14,14,12,12,15,15,13,12,13,14,12,9,13,16,11,3,3,4,1,1,1,2,1,1,3,2,10,16,8,12,11,13,14,11,1,1,1,1,1,1,1,1,1,1,6,8,10,20,80,9,20,11090000,6250,6250,4900,Mediterranean_Hispanic,125,1,0,24615.0,Unknown,43344129,12550000.0,2.0,52,531,54,0,1,3,64,3,0.5772691188145012,0.5187165775401069,0.5588235294117647,0.0237599784474226,0.006578947368421,0.0,0.0147536884221055,0.0397599399849962,0.0696963804550126,0.1428571428571428,0.6046511627906974,0.2083333333333332,146,22,3,24,2,5194,33,234,247,3000000,111111.11111111111,8000000.0,1000000.0,7000000.0,5000000.0,4,1500000,0.0,-0.14285714285714285
364135,Moise,Kean,2024,430,Italy,Vercelli,Italy,28-02-00,Centre-Forward,Attack,Right,183.0,30-06-29,World Soccer Agency,https://img.a.transfermarkt.technology/portrait/header/364135-1725532147.jpg?lm=1,IT1,Associazione Calcio Fiorentina,14000000.0,40000000.0,24,137,156,4,10,14,14,12,10,10,12,4,5,12,12,6,13,16,15,15,12,11,10,9,15,14,12,15,5,11,13,16,15,14,12,18,15,14,16,10,15,11,7,8,2,1,3,2,1,1,2,4,3,2,3,12,17,13,10,16,11,11,14,1,1,1,1,1,1,1,1,1,1,16,8,15,20,72,11,20,27999999,6850,6850,5800,African_Caribbean,135,12,4,57996.0,Juventus,43274977,23500000.0,3.0,52,1573,54,0,1,1,26,3,0.6566551997883038,0.6149732620320855,0.6323529411764706,0.055993248404076,0.0789473684210526,0.0526315789473684,0.0697674418604651,0.1997999499874969,0.1305314036501014,0.2857142857142857,0.4651162790697669,0.25,313,109,13,41,3,7825,24,117,103,30000000,1278260.8695652173,40000000.0,8000000.0,15000000.0,30000000.0,6,19000000,1.1428571428571428,0.6666666666666666
364237,Mamadou,Loum,2024,8024,Senegal,Dakar,Senegal,30-12-96,Defensive Midfield,Midfield,Right,188.0,30-06-26,TEAM MANAGEMENT,https://img.a.transfermarkt.technology/portrait/header/364237-1647530166.jpg?lm=1,PO1,Futebol Clube de Arouca,2000000.0,5000000.0,27,121,130,6,6,12,6,12,8,11,12,7,12,12,7,13,12,13,14,12,13,14,13,13,13,6,10,11,14,16,13,10,11,11,15,15,11,14,15,14,13,11,6,8,1,1,2,1,3,1,3,2,2,1,4,13,11,5,15,14,16,15,16,1,1,1,1,1,1,20,1,19,1,1,1,1,1,84,9,20,440858,6050,5800,4600,African_Caribbean,120,3,0,7652.0,Reading,83100794,3815000.0,2.0,83,402,84,3,1,1,98,4,0.5177295580841492,0.4866310160427807,0.5220588235294117,0.0073802127641083,0.0197368421052631,0.0,0.0097524381095273,0.0247561890472618,0.0211672546459623,0.1428571428571428,0.581395348837209,0.375,220,12,1,51,2,3012,3,9,40,1500000,64130.434782608696,5000000.0,1000000.0,25000.0,100000.0,6,6950000,-0.25,-0.34782608695652173
364240,Moussa,Wagué,2024,3385,Senegal,Bignona,Senegal,04-10-98,Right-Back,Defender,Right,177.0,30-06-26,Unknown,https://img.a.transfermarkt.technology/portrait/header/364240-1613848094.jpg?lm=1,GR1,Panserraikos Serres,750000.0,7500000.0,26,120,135,7,12,11,8,13,7,6,10,12,11,10,8,12,13,12,11,15,10,11,9,11,14,13,7,12,10,11,13,15,15,13,8,9,15,14,10,10,4,12,13,15,3,3,4,3,1,3,3,3,3,1,3,12,13,8,8,13,11,12,15,1,14,1,20,14,19,1,9,1,10,7,1,10,1,70,8,20,1382699,6000,6920,4942,African_Caribbean,113,17,1,10643.0,Unknown,13158640,9111392.0,2.0,83,189,84,1,1,1,152,11,0.6659169092352474,0.5232085561497326,0.4705882352941176,0.0102683740067419,0.1118421052631578,0.0131578947368421,0.0035008752188047,0.0372593148287071,0.0505924720131114,0.1428571428571428,0.3255813953488373,0.3333333333333332,135,3,11,17,2,4549,8,114,408,600000,25000.0,7500000.0,2000000.0,500000.0,5000000.0,10,7000000,-0.2,-0.25
364245,Jordan,Teze,2024,162,Netherlands,Groningen,Netherlands,30-09-99,Right-Back,Defender,Right,183.0,30-06-29,Unknown,https://img.a.transfermarkt.technology/portrait/header/364245-1707214531.jpg?lm=1,FR1,Association sportive de Monaco Football Club,18000000.0,18000000.0,25,134,150,8,11,11,7,13,8,12,7,12,12,13,9,13,12,13,12,12,13,12,11,13,13,11,9,12,14,14,14,13,15,14,12,15,13,15,13,14,5,9,6,16,2,3,1,2,1,2,3,2,2,3,2,7,10,2,11,13,10,10,13,1,1,20,19,1,18,14,1,1,12,1,1,10,1,68,7,20,11924999,6593,6593,5343,African_Caribbean,126,3,0,10000.0,Unknown,37058008,10000000.0,1.0,67,565,68,1,1,1,24,11,0.622651495104525,0.5660962566844919,0.5661764705882353,0.009647482104698,0.0197368421052631,0.0,0.0897724431107777,0.0897724431107777,0.055529320258896,0.0,0.4651162790697669,0.2916666666666665,304,12,35,33,1,8546,5,19,24,15000000,647826.0869565217,18000000.0,3000000.0,200000.0,450000.0,1,3000000,-0.16666666666666666,0.07142857142857142
364258,Unknown,Bernardo,2024,80,Brazil,SÃ£o Paulo,Brazil,14-05-95,Left-Back,Defender,Right,186.0,30-06-25,Kick&Run,https://img.a.transfermarkt.technology/portrait/header/364258-1691250245.jpg?lm=1,L1,Verein fÃ¼r LeibesÃ¼bungen Bochum 1848 FuÃŸballgemeinschaft,7000000.0,9000000.0,29,130,150,11,15,16,10,16,10,9,11,6,3,13,10,6,17,10,12,8,12,11,14,14,14,17,10,14,6,15,11,13,16,8,4,13,12,12,7,10,13,13,9,12,3,4,2,3,1,2,4,2,2,1,3,10,14,3,11,12,9,12,10,1,1,1,1,1,1,1,14,7,10,20,17,16,10,62,11,20,7672500,6750,6850,6000,Northern_European,127,14,1,28383.0,Unknown,19152048,5533333.333,3.0,10,1456,11,1,1,7,212,8,0.6566551997883038,0.6363636363636364,0.5735294117647058,0.0273984243057453,0.0921052631578947,0.0131578947368421,0.0347586896724181,0.0447611902975743,0.03071381612267,0.2857142857142857,0.5348837209302322,0.4583333333333332,240,8,9,34,0,6866,14,64,98,5500000,216000.0,9000000.0,3000000.0,,350000.0,5,6050000,0.0,0.375
364857,Falaye,Sacko,2024,969,Mali,Bamako,Mali,01-05-95,Right-Back,Defender,Right,180.0,30-06-26,Unknown,https://img.a.transfermarkt.technology/portrait/header/364857-1702665617.JPG?lm=1,FR1,Montpellier HÃ©rault Sport Club,4000000.0,4000000.0,29,130,136,10,12,13,8,12,9,8,10,9,11,13,9,13,14,12,15,11,12,13,13,11,12,13,7,13,10,11,13,17,15,12,10,15,16,14,7,12,9,8,9,12,3,1,2,3,2,3,1,2,1,2,3,12,12,5,13,8,14,12,11,1,1,12,20,1,16,1,1,1,1,1,1,1,1,67,9,20,2356198,6500,6500,5000,African_Caribbean,125,28,1,3015.0,Montpellier HÃ©rault SC,13162801,1300000.0,1.0,61,133,61,1,1,1,133,11,0.6103466525535857,0.5294117647058822,0.5588235294117647,0.0029026455016236,0.1842105263157894,0.0131578947368421,0.0197549387346836,0.0197549387346836,0.0071946442956748,0.0,0.3953488372093026,0.4583333333333332,257,2,20,33,0,5419,4,23,55,3000000,131818.18181818182,4000000.0,1000000.0,,150000.0,4,1100000,-0.25,-0.25
365108,Dan,Ndoye,2024,1025,Switzerland,Nyon,Switzerland,25-10-00,Right Winger,Attack,Right,184.0,30-06-27,BSG GROUP,https://img.a.transfermarkt.technology/portrait/header/365108-1718218474.jpg?lm=1,IT1,Bologna Football Club 1909,22000000.0,22000000.0,24,123,145,7,11,14,10,12,6,7,11,4,5,12,10,6,13,9,11,8,11,11,9,10,14,14,7,13,7,13,11,15,13,14,11,14,16,14,12,10,6,12,6,10,2,3,3,3,3,2,3,1,3,2,2,13,13,6,13,11,14,10,13,1,1,1,1,1,1,1,1,1,13,14,1,20,16,79,8,20,5852871,6150,6400,3751,African_Caribbean,117,0,0,6136.0,Unknown,84153276,5500000.0,2.0,92,1065,92,0,1,1,40,10,0.5971156390579518,0.3958288770053475,0.4999999999999999,0.0059163369888384,0.0,0.0,0.1097774443610902,0.1097774443610902,0.0305286257951609,0.1428571428571428,0.4883720930232553,0.25,308,66,30,38,0,9123,10,27,41,25000000,1388888.888888889,25000000.0,500000.0,1000000.0,4000000.0,4,6300000,0.13636363636363635,1.5
365172,Patson,Daka,2024,1003,Zambia,Chingola,Zambia,09-10-98,Centre-Forward,Attack,Right,183.0,30-06-26,12 MANagement,https://img.a.transfermarkt.technology/portrait/header/365172-1638810490.jpg?lm=1,GB1,Leicester City Football Club,12000000.0,22000000.0,26,141,165,6,8,10,16,14,7,9,11,6,8,12,9,8,13,5,13,13,14,13,12,13,16,11,9,13,11,14,15,16,15,13,12,13,17,13,13,11,5,11,6,6,3,3,2,1,3,1,2,1,1,1,3,13,14,6,12,11,13,12,15,1,1,1,1,1,1,1,1,1,1,12,1,12,20,72,11,20,48203845,7050,7500,5250,African_Caribbean,138,31,9,92793.0,Unknown,13158264,15125000.0,2.0,112,357,107,0,1,1,127,3,0.7426567875099233,0.5561497326203209,0.6544117647058822,0.0895938324093985,0.2039473684210526,0.1184210526315789,0.0597649412353088,0.1097774443610902,0.0840023333981499,0.1428571428571428,0.4651162790697669,0.3333333333333332,265,99,48,16,0,5526,4,28,88,12000000,564285.7142857143,22000000.0,3000000.0,250000.0,3000000.0,2,250000,0.0,-0.14285714285714285
365261,Vyacheslav,Grulev,2024,121,Russia,Kemerovo,Russia,23-03-99,Left Winger,Attack,Left,190.0,30-06-25,Pavel Andreev,https://img.a.transfermarkt.technology/portrait/header/365261-1721728111.png?lm=1,RU1,FK Dinamo Moskva,1500000.0,3500000.0,25,120,131,10,9,12,13,11,8,13,11,6,6,8,10,10,12,15,13,13,13,11,10,12,14,11,3,13,9,13,12,14,12,10,15,15,14,13,12,13,8,12,11,11,4,1,1,1,1,1,3,1,3,3,2,16,12,3,15,8,14,15,14,1,1,1,1,1,1,1,12,1,6,19,1,10,20,81,20,10,3497509,5750,5750,3000,Northern_European,120,0,0,24132.0,Unknown,58123712,9111392.0,2.0,78,720,81,0,0,7,74,7,0.5111140513363324,0.3155080213903743,0.5220588235294117,0.0232935853079401,0.0,0.0,0.0072518129532383,0.0172543135783946,0.0505924720131114,0.1428571428571428,0.6279069767441858,0.2916666666666665,222,39,19,23,0,4052,5,29,101,1200000,52500.0,3500000.0,1000000.0,300000.0,700000.0,4,525000,-0.2,-0.4
365877,Matt,Smith,2024,2578,England,Redditch,Wales,22-11-99,Defensive Midfield,Midfield,Right,175.0,31-05-25,CAA Stellar,https://img.a.transfermarkt.technology/portrait/header/365877-1668521047.jpg?lm=1,SC1,Saint Johnstone Football Club,400000.0,1500000.0,25,109,138,11,10,11,7,13,10,7,9,7,6,13,8,10,13,10,11,10,13,9,13,11,12,11,10,13,11,14,13,12,13,11,7,8,10,14,9,12,5,2,10,10,3,1,2,2,3,3,1,3,2,2,3,17,10,4,10,9,11,9,12,1,1,1,1,1,1,14,1,20,1,1,1,1,1,0,12,20,7759847,5500,5500,2750,Northern_European,107,0,0,2552.0,Unknown,28116314,9111392.0,2.0,32,1211,106,3,1,7,178,4,0.4780365175972479,0.2887700534759358,0.4264705882352941,0.0024555647074614,0.0,0.0,0.0017504376094023,0.0072518129532383,0.0505924720131114,0.1428571428571428,0.2790697674418605,0.2916666666666665,260,11,25,28,0,6327,0,0,0,400000,0.0,1500000.0,500000.0,,900000.0,6,2250000,0.0,0.0
366278,Rodrigo,Pinho,2024,2431,Germany,Henstedt-Ulzburg,Brazil,30-05-91,Centre-Forward,Attack,Left,185.0,30-06-25,Unknown,https://img.a.transfermarkt.technology/portrait/header/366278-1643889005.jpg?lm=1,PO1,Club Football Estrela da Amadora,400000.0,2500000.0,33,131,132,11,12,15,14,16,12,12,13,5,5,15,15,6,16,8,10,7,16,9,15,14,8,15,10,11,7,13,12,12,13,14,13,10,12,10,11,12,9,11,15,10,3,1,3,1,3,2,2,3,3,1,3,12,13,7,11,11,12,6,12,1,1,1,1,1,1,1,1,1,1,1,14,1,20,79,20,13,1255094,6449,5629,4723,Mediterranean_Hispanic,130,0,0,9522.0,Unknown,19250042,450000.0,2.0,38,612,11,0,0,3,55,3,0.4951045250066155,0.4997860962566844,0.5955882352941175,0.0091859170515456,0.0,0.0,0.0017504376094023,0.0122530632658164,0.0024722908969693,0.1428571428571428,0.5116279069767438,0.625,227,65,8,32,0,5127,15,87,260,350000,9615.384615384615,2500000.0,700000.0,,,6,500000,-0.125,-0.65
366723,Vladyslav,Dubinchak,2024,338,Ukraine,"Tomashpil, Vinnytsya Oblast",Ukraine,01-07-98,Left-Back,Defender,Left,173.0,30-06-25,ProStar,https://img.a.transfermarkt.technology/portrait/header/366723-1726134774.png?lm=1,UKR1,Futbolniy Klub Dynamo Kyiv,2500000.0,2500000.0,26,120,127,11,12,12,6,12,5,9,6,6,11,11,5,11,12,10,12,13,10,11,13,11,14,9,12,11,12,12,14,14,14,14,10,13,14,14,12,12,7,16,11,13,4,3,2,3,2,1,3,2,2,2,2,15,12,4,10,9,11,10,12,1,20,3,10,18,8,1,14,1,1,10,1,1,1,65,20,10,1381122,5739,5739,2520,Northern_European,116,0,0,4538.0,Unknown,71087925,9111392.0,2.0,103,1501,101,1,0,7,97,8,0.5096586398518127,0.2641711229946524,0.4926470588235294,0.0043732805977557,0.0,0.0,0.0122530632658164,0.0122530632658164,0.0505924720131114,0.1428571428571428,0.2325581395348837,0.3333333333333332,182,1,19,50,1,5324,3,8,25,2500000,143750.0,2500000.0,50000.0,,500000.0,3,50000,0.0,0.0
366930,Sergio,Gómez,2024,681,Spain,Badalona,Spain,04-09-00,Right Winger,Attack,Left,171.0,30-06-30,SEG,https://img.a.transfermarkt.technology/portrait/header/366930-1727678534.jpg?lm=1,ES1,Real Sociedad de FÃºtbol S.A.D.,10000000.0,15000000.0,24,133,158,15,17,13,10,16,15,5,11,9,10,15,15,9,15,7,10,14,13,13,14,11,12,16,8,12,12,14,15,14,13,7,6,12,14,13,8,10,6,10,8,15,2,3,3,1,2,1,3,2,1,1,2,11,15,7,7,14,13,10,9,1,20,1,1,19,1,1,10,1,8,19,14,15,1,68,20,7,37349339,6400,6500,4750,Northern_European,117,0,0,46397.0,Unknown,67258414,7625000.0,4.0,89,124,89,0,0,7,168,10,0.6103466525535857,0.5026737967914437,0.4999999999999999,0.0447930537356352,0.0,0.0,0.0497624406101525,0.0747686921730432,0.0423345092919247,0.4285714285714285,0.1860465116279068,0.25,221,14,33,11,1,5269,2,5,34,20000000,1000000.0,20000000.0,3000000.0,3000000.0,2500000.0,4,14000000,1.0,1.0
366948,Unknown,Jailson,2024,940,Brazil,CaÃ§apava do Sul,Brazil,07-09-95,Defensive Midfield,Midfield,Right,187.0,30-06-25,Unknown,https://img.a.transfermarkt.technology/portrait/header/366948-1567081021.JPG?lm=1,ES1,Real Club Celta de Vigo S. A. D.,1500000.0,5500000.0,29,127,134,11,11,11,10,12,11,12,13,10,14,13,10,14,12,14,14,13,13,12,10,12,13,12,10,11,14,15,16,12,13,15,14,15,14,11,11,13,14,12,6,14,1,2,3,2,3,3,3,3,3,3,1,13,12,6,13,12,12,10,9,1,1,16,1,1,1,20,1,16,1,1,1,1,1,74,10,20,2193459,6350,6350,4500,African_Caribbean,129,0,0,11135.0,Unknown,19256906,4700000.0,2.0,10,339,11,3,1,1,165,4,0.590500132310135,0.4759358288770053,0.588235294117647,0.0107434577016184,0.0,0.0,0.0072518129532383,0.0272568142035508,0.0260840578904969,0.1428571428571428,0.5581395348837206,0.4583333333333332,253,9,5,25,1,10814,2,62,262,1500000,23809.52380952381,5500000.0,1000000.0,,,4,2200000,0.0,0.0
367284,Leo,ÃËStigãÂ¥Rd,2024,273,Norway,Ã…ndalsnes,Norway,28-11-99,Centre-Back,Defender,Right,182.0,30-06-27,Unknown,https://img.a.transfermarkt.technology/portrait/header/367284-1708552959.jpg?lm=1,FR1,Stade Rennais Football Club,8000000.0,10000000.0,25,134,157,6,8,7,6,11,6,16,6,12,14,11,8,15,10,17,13,17,12,12,10,13,16,10,11,7,14,13,17,13,11,14,13,15,14,15,15,16,17,13,5,10,2,3,1,3,1,2,1,3,2,1,2,14,18,16,6,12,14,12,18,1,1,20,1,1,1,1,1,1,1,1,1,1,1,80,8,20,12519999,6700,6500,5250,Northern_European,134,5,0,23462.0,Unknown,53122155,4203333.333,3.0,71,1719,73,1,1,7,195,2,0.6103466525535857,0.5561497326203209,0.625,0.022646621739714,0.0328947368421052,0.0,0.0397599399849962,0.0497624406101525,0.0233247219811661,0.2857142857142857,0.4418604651162785,0.2916666666666665,194,14,2,40,1,3386,4,6,24,7000000,347500.0,10000000.0,2000000.0,50000.0,2500000.0,9,5750000,-0.125,-0.3
367992,Jesper,Karlsson,2024,1025,Sweden,Falkenberg,Sweden,25-07-98,Left Winger,Attack,Right,179.0,30-06-28,World Soccer Agency,https://img.a.transfermarkt.technology/portrait/header/367992-1676466550.jpg?lm=1,IT1,Bologna Football Club 1909,8000000.0,18000000.0,26,139,149,13,13,15,13,14,13,7,14,7,5,13,14,5,15,8,13,14,13,13,12,12,13,17,6,14,7,11,12,14,16,11,9,12,14,13,6,10,4,10,7,7,3,1,1,3,2,1,4,1,2,1,3,11,13,5,11,13,13,12,11,1,1,1,1,1,1,1,14,1,14,20,9,19,18,73,12,20,17374499,6900,6500,5250,Northern_European,133,7,0,7191.0,Unknown,93070929,6800000.0,2.0,91,481,91,0,1,7,40,7,0.6103466525535857,0.5561497326203209,0.6176470588235294,0.0069350632044781,0.0460526315789473,0.0,0.0397599399849962,0.0897724431107777,0.03775104864024,0.1428571428571428,0.3720930232558141,0.3333333333333332,315,107,56,24,3,7979,7,40,93,6000000,237000.0,18000000.0,4000000.0,200000.0,150000.0,3,5300000,-0.25,-0.45454545454545453
368468,Unknown,Moisés,2024,2410,Brazil,SÃ£o Paulo,Brazil,11-03-95,Left-Back,Defender,Right,184.0,30-06-26,Elenko Sports Ltda.,https://img.a.transfermarkt.technology/portrait/header/368468-1659678313.png?lm=1,RU1,PFK CSKA Moskva,5000000.0,5000000.0,29,131,140,10,12,14,11,14,10,13,14,15,12,15,13,12,14,14,13,13,13,14,14,14,14,8,11,13,13,14,12,12,11,11,13,13,12,10,13,12,13,11,13,12,3,3,2,2,1,2,1,1,3,2,3,12,9,11,11,12,16,14,12,1,1,8,1,1,1,12,1,20,1,1,18,1,9,77,10,20,618858,6532,6487,4489,Mediterranean_Hispanic,132,0,0,15384.0,Unknown,19117285,1355000.0,2.0,10,1456,11,1,1,3,148,8,0.6086266207991532,0.47475935828877,0.6102941176470589,0.0148463654648916,0.0,0.0,0.0247561890472618,0.0247561890472618,0.0075002083391205,0.1428571428571428,0.4883720930232553,0.4583333333333332,355,9,28,74,5,10581,2,7,27,5000000,204166.66666666666,5000000.0,500000.0,,400000.0,7,1250000,0.1111111111111111,0.0
368482,Riccardo,Orsolini,2024,1025,Italy,Ascoli Piceno,Italy,24-01-97,Right Winger,Attack,Left,183.0,30-06-27,MM-Management,https://img.a.transfermarkt.technology/portrait/header/368482-1724827463.jpg?lm=1,IT1,Bologna Football Club 1909,16000000.0,25000000.0,27,135,143,14,13,15,12,14,14,11,14,5,4,12,13,4,15,15,14,14,11,11,11,10,16,15,11,13,5,11,14,15,14,13,11,14,15,14,13,12,7,14,4,14,2,2,2,3,1,1,2,3,1,3,3,12,16,12,10,12,13,14,12,1,1,1,3,1,5,1,3,5,14,7,12,20,15,73,20,9,5900759,6747,6747,5497,Mediterranean_Hispanic,135,2,2,39231.0,Unknown,43162321,10500000.0,2.0,52,98,54,0,0,3,40,10,0.643027255887801,0.582566844919786,0.6323529411764706,0.0378734404074132,0.0131578947368421,0.0263157894736842,0.0797699424856214,0.1247811952988247,0.058307175199311,0.1428571428571428,0.4651162790697669,0.375,330,94,48,21,1,2959,11,32,43,16000000,637000.0,25000000.0,5000000.0,75000.0,3500000.0,2,0,0.0,0.3333333333333333
368611,Mykola,Shaparenko,2024,338,Ukraine,"Velyka Novosilka Rayon, Donetsk Oblast",Ukraine,04-10-98,Central Midfield,Midfield,Right,178.0,30-09-25,ProStar,https://img.a.transfermarkt.technology/portrait/header/368611-1726135099.png?lm=1,UKR1,Futbolniy Klub Dynamo Kyiv,10000000.0,10000000.0,26,130,144,14,11,13,11,13,15,9,12,6,8,15,13,11,14,10,12,10,12,8,15,12,15,15,10,13,10,14,13,13,14,12,10,10,13,13,9,10,11,15,14,4,2,3,4,1,2,3,2,3,2,2,2,13,14,8,16,10,14,10,10,1,1,1,1,3,1,18,8,20,5,5,17,6,5,69,12,20,18182595,6650,6650,4750,Northern_European,126,28,1,17000.0,Unknown,71088179,9111392.0,2.0,103,1570,101,3,1,7,97,1,0.6301931727970362,0.5026737967914437,0.5661764705882353,0.0164068029667624,0.1842105263157894,0.0131578947368421,0.0497624406101525,0.0497624406101525,0.0505924720131114,0.1428571428571428,0.3488372093023257,0.3333333333333332,207,29,33,48,1,9395,12,53,237,10000000,475000.0,10000000.0,1000000.0,,3500000.0,0,0,0.1111111111111111,0.6666666666666666
368887,Loïs,Openda,2024,23826,Belgium,LiÃ¨ge,Belgium,16-02-00,Centre-Forward,Attack,Right,177.0,30-06-28,Stirr Associates,https://img.a.transfermarkt.technology/portrait/header/368887-1713944805.jpg?lm=1,L1,RasenBallsport Leipzig,60000000.0,60000000.0,24,122,140,11,11,13,13,13,6,9,6,5,6,12,12,5,14,16,13,14,12,12,8,13,14,14,6,7,5,14,14,16,14,14,8,14,15,13,14,13,14,2,4,1,1,3,3,2,2,1,2,1,3,1,3,13,12,1,9,10,10,10,7,1,1,1,1,1,1,1,1,1,12,1,12,14,20,79,10,20,9660001,6250,5900,4750,African_Caribbean,117,3,1,14999.0,Unknown,18101745,18526666.67,3.0,7,849,8,0,1,1,162,3,0.530960571579783,0.5026737967914437,0.4999999999999999,0.014474602817478,0.0197368421052631,0.0131578947368421,0.2998249562390597,0.2998249562390597,0.1029010065279591,0.2857142857142857,0.3255813953488373,0.25,269,102,38,28,3,5556,1,1,6,60000000,2392000.0,60000000.0,1500000.0,900000.0,3500000.0,3,14500000,0.0,0.09090909090909091
368891,Arthur,Theate,2024,24,Belgium,LiÃ¨ge,Belgium,25-05-00,Centre-Back,Defender,Left,185.0,30-06-25,DW Sports Management,https://img.a.transfermarkt.technology/portrait/header/368891-1666698276.jpg?lm=1,L1,Eintracht Frankfurt FuÃŸball AG,20000000.0,22000000.0,24,134,162,5,9,11,9,11,6,16,9,8,14,12,7,14,12,15,16,15,11,12,11,11,17,13,13,11,14,14,14,14,13,12,14,13,13,14,14,13,13,14,5,11,1,2,2,3,3,2,1,3,2,1,1,15,16,12,11,12,15,10,10,1,13,20,1,1,1,10,1,1,1,1,1,1,1,76,20,8,28937999,6700,5806,5452,Mixed_Race,135,3,0,23464.0,Unknown,18105815,12875000.0,2.0,7,849,8,1,0,4,63,2,0.5185234188938873,0.5777540106951871,0.6323529411764706,0.022648552974246,0.0197368421052631,0.0,0.0997749437359339,0.1097774443610902,0.0715019861662824,0.1428571428571428,0.5116279069767438,0.25,182,15,2,29,1,3265,4,7,35,20000000,1417857.142857143,22000000.0,2000000.0,,4000000.0,3,4000000,0.0,0.0
369081,Federico,Valverde,2024,418,Uruguay,Montevideo,Uruguay,22-07-98,Central Midfield,Midfield,Right,182.0,30-06-29,Wasserman,https://img.a.transfermarkt.technology/portrait/header/369081-1681999815.jpg?lm=1,ES1,Real Madrid Club de FÃºtbol,120000000.0,120000000.0,26,169,175,13,13,12,11,14,12,12,15,10,13,15,12,13,13,12,14,15,12,14,14,14,15,14,13,15,12,17,17,17,15,15,12,17,17,17,14,15,8,14,6,14,2,3,3,1,3,2,3,3,2,3,2,10,12,7,12,10,14,10,11,1,1,1,10,1,12,13,1,20,17,1,10,16,1,74,12,20,99900007,8450,8000,7500,Mediterranean_Hispanic,164,42,4,209790.0,Unknown,78074594,5000000.0,1.0,106,975,103,3,1,3,167,1,0.808811854988092,0.7967914438502673,0.8455882352941175,0.2025681556806781,0.2763157894736842,0.0526315789473684,0.5998999749937485,0.5998999749937485,0.0277507708547459,0.0,0.4418604651162785,0.3333333333333332,372,32,32,38,1,8520,12,43,49,130000000,5184000.0,130000000.0,6000000.0,3000000.0,20000000.0,3,50000,0.08333333333333333,0.3
369316,Ferdi,Kad?O?Lu,2024,1237,Netherlands,Arnhem,TÃ¼rkiye,07-10-99,Left-Back,Defender,Right,174.0,30-06-28,Wasserman,https://img.a.transfermarkt.technology/portrait/header/369316-1724792538.jpg?lm=1,GB1,Brighton and Hove Albion Football Club,30000000.0,30000000.0,25,130,145,11,12,14,12,13,8,7,12,15,11,13,10,11,14,11,12,12,13,11,14,10,13,11,7,13,11,12,12,15,13,12,8,11,12,14,10,15,8,10,3,15,1,2,1,3,2,3,3,3,3,3,3,9,15,10,14,16,13,12,13,1,19,1,15,19,15,10,10,20,10,14,11,12,8,68,8,20,10399771,6597,6597,5447,Northern_European,120,4,0,26588.0,Unknown,37060600,17200000.0,2.0,67,91,100,1,1,7,44,8,0.6231807356443504,0.5772192513368983,0.5220588235294117,0.0256651413132587,0.0263157894736842,0.0,0.1497874468617154,0.1497874468617154,0.0955304314008722,0.1428571428571428,0.2558139534883721,0.2916666666666665,298,32,39,32,1,7903,21,74,152,30000000,1069642.857142857,30000000.0,700000.0,1500000.0,4000000.0,2,400000,0.0,0.5
369674,Joakim,Maehle,2024,82,Denmark,Ã˜stervrÃ¥,Denmark,20-05-97,Right-Back,Defender,Right,185.0,30-06-27,Boutique Transfers,https://img.a.transfermarkt.technology/portrait/header/369674-1724770995.jpg?lm=1,L1,Verein fÃ¼r LeibesÃ¼bungen Wolfsburg,14000000.0,19000000.0,27,138,144,6,13,13,9,13,6,7,10,6,9,12,6,11,13,15,12,11,13,12,12,10,15,14,10,13,10,14,16,14,13,14,11,16,14,17,12,12,8,14,6,17,1,1,2,1,2,3,1,3,3,1,4,17,15,5,14,13,13,14,13,1,17,1,19,17,20,1,14,1,15,9,1,11,1,81,12,20,7103724,6800,7500,5500,Northern_European,127,29,9,24615.0,Unknown,27097478,9066666.667,3.0,28,1715,30,1,1,7,213,11,0.7426567875099233,0.5828877005347594,0.5735294117647058,0.0237599784474226,0.1907894736842105,0.1184210526315789,0.0697674418604651,0.0947736934233558,0.0503439910386399,0.2857142857142857,0.5116279069767438,0.375,304,18,40,34,1,5943,9,22,29,14000000,581250.0,19000000.0,3000000.0,,1500000.0,3,1500000,0.0,0.0
369684,Rasmus,Kristensen,2024,24,Denmark,Brande,Denmark,11-07-97,Right-Back,Defender,Right,187.0,30-06-25,Boutique Transfers,https://img.a.transfermarkt.technology/portrait/header/369684-1725875948.jpg?lm=1,L1,Eintracht Frankfurt FuÃŸball AG,10000000.0,15000000.0,27,133,144,9,15,11,10,12,8,13,9,13,12,13,9,13,11,18,12,15,11,11,11,11,15,11,13,12,11,14,16,12,12,14,14,14,14,15,14,15,11,12,5,15,2,1,1,3,3,3,1,3,4,2,2,9,17,6,14,13,14,12,11,1,14,12,20,12,17,16,1,10,15,1,1,8,1,86,11,20,15120555,6649,6699,5499,Northern_European,127,8,0,52196.0,Unknown,27100968,7833333.333,3.0,28,241,30,1,1,7,63,11,0.6366763694098968,0.5827807486631016,0.5735294117647058,0.0503926682612226,0.0526315789473684,0.0,0.0497624406101525,0.0747686921730432,0.0434919488485791,0.2857142857142857,0.5581395348837206,0.375,314,30,50,30,0,10943,5,31,141,10000000,384000.0,15000000.0,3000000.0,,3000000.0,5,4750000,0.0,0.0
370042,Driess,Saddiki,2024,10484,Netherlands,Tegelen,Morocco,09-08-96,Defensive Midfield,Midfield,Right,179.0,30-06-25,Unknown,https://img.a.transfermarkt.technology/portrait/header/370042-1695905222.png?lm=1,TR1,Kas?mpa?a Spor KulÃ¼bÃ¼,275000.0,800000.0,28,120,124,8,11,12,9,12,9,11,10,5,13,13,8,14,12,15,11,14,11,12,10,12,13,10,12,13,12,17,16,12,12,13,12,12,12,16,12,11,11,11,6,11,2,2,1,3,2,3,3,3,1,3,2,17,10,8,12,12,12,5,10,1,1,1,1,1,1,20,10,18,10,1,10,1,1,70,8,20,8526340,6250,6000,5000,North_African__Middle_Eastern,119,0,0,36381.0,Unknown,37057350,9111392.0,2.0,67,1477,67,3,1,6,117,4,0.5441915850754168,0.5294117647058822,0.5147058823529411,0.0351214311992869,0.0,0.0,0.00112528132033,0.0037509377344336,0.0505924720131114,0.1428571428571428,0.3720930232558141,0.4166666666666665,246,9,4,32,0,7355,2,35,159,200000,7291.666666666667,800000.0,200000.0,25000.0,75000.0,5,500000,-0.38461538461538464,-0.6
370683,Andreas,Hanche-Olsen,2024,39,Norway,BodÃ¸,Norway,17-01-97,Centre-Back,Defender,Right,185.0,30-06-26,Nordic Sky,https://img.a.transfermarkt.technology/portrait/header/370683-1692000124.jpg?lm=1,L1,1. FuÃŸball- und Sportverein Mainz 05,9000000.0,9000000.0,27,123,127,6,7,5,8,8,6,14,4,7,13,11,11,15,6,14,12,16,11,14,6,13,18,6,15,11,12,13,11,12,14,13,14,14,11,13,15,12,8,13,3,12,3,1,1,1,2,1,3,2,2,4,1,14,16,12,16,11,15,14,12,1,10,20,17,16,1,1,15,1,1,1,1,1,1,70,5,20,2158649,6011,6401,5004,Northern_European,121,12,0,8500.0,Unknown,53102029,1650000.0,2.0,71,214,73,1,1,7,1,2,0.5972479491929081,0.5298395721925133,0.5294117647058822,0.0081990562056842,0.0789473684210526,0.0,0.0447611902975743,0.0447611902975743,0.0091391427539653,0.1428571428571428,0.5116279069767438,0.375,289,11,10,42,1,7802,7,45,141,7000000,400000.0,9000000.0,2000000.0,,400000.0,2,4300000,-0.2222222222222222,-0.06666666666666667
370789,Julian,Ryerson,2024,16,Norway,Lyngdal,Norway,17-11-97,Right-Back,Defender,Right,183.0,30-06-28,CAA Base Ltd,https://img.a.transfermarkt.technology/portrait/header/370789-1709561216.jpg?lm=1,L1,Borussia Dortmund,20000000.0,20000000.0,27,134,137,7,12,13,9,12,6,11,9,12,13,12,9,14,13,15,12,15,13,12,10,12,15,12,12,12,13,17,14,13,13,15,10,15,13,16,13,13,8,15,5,18,3,1,2,2,1,4,3,2,3,1,2,10,14,8,10,12,12,14,11,1,10,1,20,10,20,15,10,15,14,1,1,10,1,81,7,20,2769143,6399,6499,4999,Northern_European,128,11,0,10000.0,Unknown,53113114,2575000.0,2.0,71,883,73,1,1,7,41,11,0.6102143424186293,0.5293048128342246,0.5808823529411764,0.009647482104698,0.0723684210526315,0.0,0.0997749437359339,0.0997749437359339,0.0142781743937331,0.1428571428571428,0.4651162790697669,0.375,258,16,9,36,0,4222,17,34,60,20000000,990000.0,20000000.0,100000.0,,400000.0,2,2500000,0.0,0.3333333333333333
370791,Pablo,Rosario,2024,417,Netherlands,Amsterdam,Netherlands,07-01-97,Defensive Midfield,Midfield,Right,185.0,30-06-25,Team Raiola,https://img.a.transfermarkt.technology/portrait/header/370791-1613229620.jpg?lm=1,FR1,Olympique Gymnaste Club Nice CÃ´te d'Azur,8000000.0,13000000.0,27,138,145,10,8,11,7,12,10,13,8,9,14,13,8,13,13,15,12,16,13,15,14,13,14,11,14,14,13,16,16,12,13,15,13,16,12,15,14,15,13,14,7,16,3,1,2,2,1,1,3,3,1,3,1,13,11,4,14,16,14,14,13,1,1,15,11,1,1,18,10,20,11,1,1,1,1,83,12,20,10204817,6800,6800,5100,African_Caribbean,135,1,0,26087.0,Unknown,37057370,3082500.0,2.0,67,64,68,3,1,1,142,4,0.6500396930404869,0.5401069518716577,0.6323529411764706,0.0251813670629881,0.006578947368421,0.0,0.0397599399849962,0.0647661915478869,0.0170976971582543,0.1428571428571428,0.5116279069767438,0.375,361,18,22,59,2,5414,5,9,18,8000000,319000.0,13000000.0,2000000.0,25000.0,400000.0,2,100000,0.0,0.14285714285714285
370846,Timothy,Weah,2024,506,United States,"New York City, New York",United States,22-02-00,Right Midfield,Midfield,Right,183.0,30-06-28,BS Group - BS Law,https://img.a.transfermarkt.technology/portrait/header/370846-1692277669.jpg?lm=1,IT1,Juventus Football Club,12000000.0,15000000.0,24,127,150,11,9,14,13,12,11,8,11,7,4,10,14,5,13,9,11,10,12,12,11,11,10,13,7,12,7,11,13,16,14,12,10,14,14,12,9,11,6,9,11,11,3,1,3,2,1,3,2,1,1,1,2,11,13,7,13,10,12,9,13,1,1,1,1,1,1,1,1,1,1,20,15,20,18,66,8,20,9219999,6344,6344,4244,African_Caribbean,116,25,3,13808.0,Unknown,48042432,10500000.0,2.0,104,1035,102,3,1,1,116,9,0.5897062715003969,0.4485561497326202,0.4926470588235294,0.013324552653661,0.1644736842105263,0.0394736842105263,0.0597649412353088,0.0747686921730432,0.058307175199311,0.1428571428571428,0.4651162790697669,0.25,220,29,17,21,1,5025,12,85,194,17000000,888888.8888888889,17000000.0,2000000.0,5000000.0,7500000.0,3,6000000,0.4166666666666667,0.21428571428571427
370997,Dominik,Kotarski,2024,1091,Croatia,Zabok,Croatia,10-02-00,Goalkeeper,Goalkeeper,Right,189.0,30-06-28,Unknown,https://img.a.transfermarkt.technology/portrait/header/370997-1727967003.png?lm=1,GR1,Panthessalonikios Athlitikos Omilos Konstantinoupoliton,7000000.0,7000000.0,24,115,135,5,2,3,2,8,8,1,1,2,3,10,3,2,9,15,12,13,12,9,11,10,12,3,6,2,13,12,11,10,12,13,14,12,9,11,13,11,10,10,7,15,15,13,14,10,12,11,14,13,14,8,10,12,13,7,11,11,12,10,9,20,1,1,1,1,1,1,1,1,1,1,1,1,1,82,7,20,2914999,5750,5600,4014,Northern_European,110,0,0,10547.0,Unknown,24056362,1666666.667,3.0,24,1693,25,2,1,7,153,5,0.4912675310928817,0.4239572192513368,0.4485294117647059,0.010175674749205,0.0,0.0,0.0347586896724181,0.0347586896724181,0.0092317379204977,0.2857142857142857,0.6046511627906974,0.25,0,0,0,0,0,0,5,9,41,8000000,354545.45454545453,8000000.0,300000.0,250000.0,1000000.0,3,950000,0.6,1.0
370998,Bartol,Franjic,2024,660,Croatia,Zagreb,Croatia,14-01-00,Defensive Midfield,Midfield,Left,188.0,30-06-25,Unknown,https://img.a.transfermarkt.technology/portrait/header/370998-1723486731.png?lm=1,UKR1,FC Shakhtar Donetsk,1800000.0,6500000.0,24,126,146,4,10,12,8,12,6,12,9,10,12,13,12,13,12,13,12,16,12,12,12,12,16,10,14,11,12,18,16,12,10,12,12,15,13,15,13,13,9,11,5,18,4,1,2,1,2,3,3,3,2,4,1,14,13,4,18,12,17,14,13,1,15,18,1,12,1,20,10,18,1,1,1,1,1,77,20,12,7332001,6300,5900,5300,Northern_European,123,0,0,16958.0,Unknown,24058104,7500000.0,1.0,24,1697,25,3,0,7,72,4,0.530960571579783,0.5614973262032085,0.5441176470588236,0.0163662470415901,0.0,0.0,0.0087521880470117,0.032258064516129,0.041640045556821,0.0,0.581395348837209,0.25,167,7,7,23,0,5587,5,23,80,1800000,116666.66666666667,6500000.0,2500000.0,,1500000.0,4,3650000,0.0,-0.28
371001,Josip,Sutalo,2024,610,Bosnia-Herzegovina,?apljina,Croatia,28-02-00,Centre-Back,Defender,Right,185.0,30-06-28,Unknown,https://img.a.transfermarkt.technology/portrait/header/371001-1683031171.jpg?lm=1,NL1,AFC Ajax Amsterdam,15000000.0,18000000.0,24,136,161,2,8,11,5,13,3,14,5,6,15,13,6,16,13,12,16,13,16,14,11,12,14,9,9,7,15,14,12,13,10,11,16,14,13,13,14,14,8,13,6,9,1,3,3,2,1,2,2,1,4,3,1,13,14,4,14,17,16,9,15,1,1,20,10,1,1,1,1,1,1,1,1,1,1,82,10,20,20591999,6900,6850,6250,Northern_European,136,2,0,7671.0,Unknown,24058106,20500000.0,1.0,9,5,25,1,1,7,6,2,0.6566551997883038,0.6631016042780749,0.6397058823529411,0.0073985594921625,0.0131578947368421,0.0,0.0747686921730432,0.0897724431107777,0.1138642740076113,0.0,0.5116279069767438,0.25,212,12,4,24,1,7869,0,0,0,18000000,1275000.0,18000000.0,2000000.0,,650000.0,4,5350000,0.2,0.125
371003,Ante,Palaversa,2024,370,Croatia,Split,Croatia,06-04-00,Central Midfield,Midfield,Right,187.0,30-06-25,Marjan Sisic,https://img.a.transfermarkt.technology/portrait/header/371003-1611689828.jpg?lm=1,SC1,Aberdeen Football Club,350000.0,5000000.0,24,111,143,7,8,12,9,11,8,10,10,6,10,13,10,12,11,11,12,13,11,12,14,13,11,11,9,12,12,14,14,12,11,10,11,13,12,13,10,11,7,12,7,11,1,3,2,1,3,1,4,3,2,2,1,16,12,7,10,10,11,10,14,1,1,1,1,1,1,17,12,20,12,7,8,5,1,77,10,20,3343999,5900,5700,3000,Northern_European,111,0,0,14999.0,Unknown,24055163,6300000.0,1.0,24,1409,25,3,1,7,12,1,0.5044985445885155,0.3155080213903743,0.4558823529411764,0.014474602817478,0.0,0.0,0.0015003750937734,0.0247561890472618,0.0349731936998249,0.0,0.5581395348837206,0.25,152,10,5,23,1,2018,0,0,0,600000,2941.176470588235,5000000.0,1000000.0,5000000.0,3000000.0,5,1150000,0.7142857142857143,0.5
371021,Arijanet,Muric,2024,677,Switzerland,Schlieren,Kosovo,07-11-98,Goalkeeper,Goalkeeper,Right,198.0,30-06-28,11WINS,https://img.a.transfermarkt.technology/portrait/header/371021-1685718424.jpg?lm=1,GB1,Ipswich Town Football Club,7000000.0,12000000.0,26,125,150,5,1,1,1,13,8,4,3,3,2,12,3,1,12,16,14,17,12,12,12,12,15,2,7,3,12,10,11,12,12,12,18,7,16,8,13,8,10,9,5,10,16,12,10,5,12,8,14,15,14,8,12,15,9,13,12,13,16,16,10,20,1,1,1,1,1,1,1,1,1,1,1,1,1,87,6,20,9960656,6150,6500,5000,Northern_European,126,27,0,27838.0,Unknown,28108492,6275000.0,2.0,92,1350,59,2,1,7,115,5,0.6103466525535857,0.5294117647058822,0.5661764705882353,0.0268721628957703,0.1776315789473684,0.0,0.0347586896724181,0.0597649412353088,0.0348343009528042,0.1428571428571428,0.8139534883720931,0.3333333333333332,0,0,0,0,0,0,0,0,0,8000000,375000.0,12000000.0,3000000.0,,2000000.0,6,1600000,0.14285714285714285,0.14285714285714285
371141,Stanley,Nsoki,2024,533,France,Poissy,France,09-04-99,Centre-Back,Defender,Left,184.0,30-06-27,CAA Base Ltd,https://img.a.transfermarkt.technology/portrait/header/371141-1691269161.jpg?lm=1,L1,TSG 1899 Hoffenheim FuÃŸball-Spielbetriebs GmbH,2500000.0,12000000.0,25,128,136,6,11,10,10,10,6,15,10,12,14,10,9,15,9,16,13,15,13,10,10,9,13,10,10,10,14,14,15,13,11,16,12,14,14,15,16,12,15,13,7,12,2,2,1,2,3,1,3,3,1,1,3,8,14,1,12,12,12,9,11,1,16,20,1,1,1,13,1,1,1,1,1,1,1,75,20,9,11914569,6500,6000,4250,African_Caribbean,127,0,0,23095.0,Unknown,48043092,10333333.33,3.0,34,1160,36,1,0,1,199,2,0.5441915850754168,0.4491978609625668,0.5735294117647058,0.0222922402030886,0.0,0.0,0.0122530632658164,0.0597649412353088,0.057381223533987,0.2857142857142857,0.4883720930232553,0.2916666666666665,174,1,4,29,2,6536,0,0,0,2500000,-113636.36363636363,12000000.0,3000000.0,,11000000.0,3,5500000,0.0,-0.16666666666666666
371149,Evan,Ndicka,2024,12,France,Paris,Cote d'Ivoire,20-08-99,Centre-Back,Defender,Left,192.0,30-06-28,AMS CONSULTING,https://img.a.transfermarkt.technology/portrait/header/371149-1663064716.jpg?lm=1,IT1,Associazione Sportiva Roma,25000000.0,32000000.0,25,137,157,4,9,10,8,12,4,13,6,12,12,14,7,13,13,9,13,13,15,13,12,14,13,8,10,7,12,14,12,13,13,14,18,15,16,12,14,13,8,15,6,9,3,2,3,1,4,1,3,1,1,3,2,11,16,7,11,14,12,12,14,1,17,20,1,12,1,12,1,10,1,1,1,1,1,80,20,9,53024996,6850,6126,5325,African_Caribbean,134,0,0,11499.0,Unknown,48032198,5500000.0,1.0,34,1122,24,1,0,1,29,2,0.5608626620799153,0.5641711229946523,0.625,0.0110949423864458,0.0,0.0,0.1247811952988247,0.1597899474868717,0.0305286257951609,0.0,0.6744186046511627,0.2916666666666665,276,13,15,44,1,7775,0,0,0,25000000,1131818.1818181819,32000000.0,4000000.0,400000.0,22500000.0,2,7600000,0.0,0.041666666666666664
371256,Unknown,Tetê,2024,265,Brazil,Alvorada,Brazil,15-02-00,Right Winger,Attack,Left,175.0,30-06-28,PabloBueno360,https://img.a.transfermarkt.technology/portrait/header/371256-1672830660.jpg?lm=1,GR1,Panathinaikos Athlitikos Omilos,10000000.0,28000000.0,24,137,156,11,12,14,13,16,11,7,8,5,3,12,13,8,17,7,12,11,13,14,13,12,13,14,8,14,9,11,11,16,15,13,9,13,16,13,12,13,7,11,9,13,1,3,1,3,4,1,2,3,1,1,1,16,16,3,6,12,13,14,12,1,1,1,1,1,1,1,1,1,17,1,13,20,1,73,20,5,65175826,7500,7000,6000,Mixed_Race,135,0,0,28236.0,Olympique Lyonnais,19348859,8250000.0,3.0,10,55,11,0,0,4,150,10,0.6765017200317545,0.6363636363636364,0.6323529411764706,0.0272564785676419,0.0,0.0,0.0497624406101525,0.1397849462365591,0.0458068279674435,0.2857142857142857,0.2790697674418605,0.25,234,52,33,21,0,6748,0,0,0,11000000,58823.529411764706,28000000.0,6000000.0,,20000000.0,4,4000000,0.1,-0.45
371371,Marash,Kumbulla,2024,714,Italy,Peschiera del Garda,Albania,08-02-00,Centre-Back,Defender,Right,191.0,30-06-25,Gianni Vitali,https://img.a.transfermarkt.technology/portrait/header/371371-1716969202.jpg?lm=1,ES1,Reial Club Deportiu Espanyol de Barcelona S.A.D.,4500000.0,27000000.0,24,135,154,5,7,8,9,11,5,17,5,13,16,12,6,15,10,8,14,13,11,11,9,12,11,7,6,5,14,16,15,10,9,12,16,15,15,16,15,12,13,11,8,4,1,2,2,2,2,3,2,1,1,4,2,14,15,7,12,8,16,13,12,1,1,20,7,1,1,1,1,1,1,1,1,1,1,82,11,20,18188001,6750,6950,5600,Mediterranean_Hispanic,133,15,0,64038.0,Unknown,43296495,9111392.0,2.0,52,1139,0,1,1,3,170,2,0.6698862132839376,0.5935828877005347,0.6176470588235294,0.0618275079253037,0.0986842105263157,0.0,0.0222555638909727,0.134783695923981,0.0505924720131114,0.1428571428571428,0.6511627906976742,0.25,194,12,1,40,1,3125,0,0,0,4500000,232894.73684210525,27000000.0,5000000.0,75000.0,27000000.0,3,5000000,0.0,-0.4
371851,Jaka,Bijol,2024,410,Slovenia,Vuzenica,Slovenia,05-02-99,Centre-Back,Defender,Right,190.0,30-06-27,SEG,https://img.a.transfermarkt.technology/portrait/header/371851-1695029407.jpg?lm=1,IT1,Udinese Calcio,15000000.0,15000000.0,25,130,151,4,7,8,9,11,6,18,10,7,13,11,7,12,10,13,13,15,13,15,9,12,15,7,7,9,13,16,14,11,11,14,16,17,12,13,16,14,10,11,4,13,3,2,1,2,3,1,2,3,2,1,2,12,15,5,14,14,15,11,12,1,1,20,1,1,1,16,1,14,1,1,7,1,10,85,8,20,5110198,6500,6450,4500,Northern_European,127,31,1,24439.0,Unknown,62215974,2200000.0,2.0,87,1634,87,1,1,7,205,2,0.6037311458057687,0.4759358288770053,0.5735294117647058,0.023590029808605,0.2039473684210526,0.0131578947368421,0.0747686921730432,0.0747686921730432,0.0121947831884219,0.1428571428571428,0.6279069767441858,0.2916666666666665,241,15,15,47,0,1901,0,0,0,18000000,942105.2631578947,18000000.0,300000.0,100000.0,2800000.0,4,7800000,0.2,0.8
371998,Unknown,Vinicius Junior,2024,418,Brazil,SÃ£o GonÃ§alo,Brazil,12-07-00,Left Winger,Attack,Right,176.0,30-06-27,Roc Nation Sports,https://img.a.transfermarkt.technology/portrait/header/371998-1664869583.jpg?lm=1,ES1,Real Madrid Club de FÃºtbol,180000000.0,180000000.0,24,174,184,7,13,18,16,13,8,11,12,4,3,14,12,6,15,15,14,15,15,13,14,15,18,16,12,16,9,13,15,19,16,14,8,15,17,14,12,13,8,12,5,10,2,1,4,2,1,1,3,4,3,2,3,12,15,12,12,16,14,8,8,1,1,1,1,1,1,1,14,1,10,20,1,15,13,62,12,20,281778742,8700,8750,8000,Mixed_Race,165,14,1,215753.0,Unknown,19302146,45000000.0,1.0,10,1450,11,0,1,4,167,7,0.9080444562053454,0.8502673796791443,0.8529411764705881,0.208326131437891,0.0921052631578947,0.0131578947368421,0.8999749937484371,0.8999749937484371,0.2499791660879468,0.0,0.3023255813953489,0.25,370,119,91,68,3,11384,0,0,0,200000000,9047619.047619049,200000000.0,20000000.0,70000000.0,40000000.0,1,0,0.1111111111111111,0.3333333333333333
372240,Mads,Bech Sørensen,2024,865,Denmark,Horsens,Denmark,07-01-99,Centre-Back,Defender,Left,189.0,30-06-27,People In Sport,https://img.a.transfermarkt.technology/portrait/header/372240-1727291104.jpg?lm=1,DK1,Fodbold Club Midtjylland,2500000.0,5000000.0,25,130,145,6,8,10,7,12,7,13,8,19,13,13,6,14,12,14,13,13,14,14,12,13,14,9,12,7,14,13,14,11,11,13,16,15,11,14,14,13,7,12,5,14,2,1,3,2,2,3,1,3,4,1,1,13,14,8,16,13,14,14,13,1,15,20,1,8,1,10,1,1,1,1,1,1,1,0,20,8,11602489,6499,6249,4999,Northern_European,129,0,0,34798.0,OGC Nice,27114700,9111392.0,2.0,28,636,30,1,0,7,86,2,0.5771368086795449,0.5293048128342246,0.588235294117647,0.0335928590671944,0.0,0.0,0.0122530632658164,0.0247561890472618,0.0505924720131114,0.1428571428571428,0.6046511627906974,0.2916666666666665,190,11,6,16,0,9597,0,0,0,3500000,172500.0,5000000.0,1500000.0,150000.0,350000.0,6,2600000,0.4,0.4
372246,Carlos,Soler,2024,379,Spain,Valencia,Spain,02-01-97,Central Midfield,Midfield,Right,180.0,30-06-25,Promoesport,https://img.a.transfermarkt.technology/portrait/header/372246-1662059930.jpg?lm=1,GB1,West Ham United Football Club,20000000.0,50000000.0,27,155,163,13,15,13,13,14,12,12,15,9,10,15,16,10,14,13,15,12,13,13,14,14,15,14,15,14,12,13,14,14,13,13,10,14,14,14,13,14,11,14,8,15,2,3,3,1,2,3,2,1,3,3,2,12,14,4,18,14,16,13,12,1,1,1,1,1,16,16,14,20,20,13,19,19,1,76,10,20,40747461,7750,7750,6250,Mediterranean_Hispanic,145,9,3,108102.0,Unknown,67196204,18000000.0,1.0,89,1556,89,3,1,3,220,1,0.7757343212490078,0.6631016042780749,0.7058823529411764,0.1043764671347335,0.0592105263157894,0.0394736842105263,0.0997749437359339,0.2498124531132783,0.0999749993055362,0.0,0.3953488372093026,0.375,358,51,41,53,1,5459,0,0,0,20000000,822916.6666666666,50000000.0,10000000.0,,25000000.0,3,10300000,0.0,0.0
372267,Guus,Til,2024,383,Zambia,Samfya,Netherlands,22-12-97,Attacking Midfield,Midfield,Right,187.0,30-06-26,Muy Manero,https://img.a.transfermarkt.technology/portrait/header/372267-1707303129.jpg?lm=1,NL1,Eindhovense Voetbalvereniging Philips Sport Vereniging,12000000.0,12000000.0,27,131,138,6,11,12,13,13,11,12,12,3,6,13,13,6,13,13,14,13,14,14,13,14,12,9,14,14,8,15,14,12,12,15,13,14,13,14,13,13,7,11,4,12,2,2,3,2,1,2,1,3,3,2,2,8,14,5,13,15,14,16,16,1,1,1,1,1,1,10,10,17,10,10,20,10,12,74,12,20,9112500,6750,6750,5000,Northern_European,130,5,1,19999.0,Unknown,37057616,10500000.0,2.0,112,1293,68,3,1,7,62,0,0.6434241862926701,0.5294117647058822,0.5955882352941175,0.0193026891475241,0.0328947368421052,0.0131578947368421,0.0597649412353088,0.0597649412353088,0.058307175199311,0.1428571428571428,0.5581395348837206,0.375,358,100,41,28,1,7623,0,0,0,12000000,458653.8461538461,12000000.0,2500000.0,300000.0,6000000.0,5,9225000,0.0,0.4117647058823529
372445,Unknown,Dani Silva,2024,276,Portugal,Beja,Portugal,11-04-00,Central Midfield,Midfield,Left,180.0,30-06-28,Unknown,https://img.a.transfermarkt.technology/portrait/header/372445-1707150919.jpg?lm=1,IT1,Verona Hellas Football Club,2000000.0,2000000.0,24,151,179,13,13,18,11,18,14,9,13,5,8,17,12,9,19,12,14,13,17,15,18,17,15,17,12,18,8,15,14,9,12,14,7,13,9,10,9,16,9,14,13,13,3,2,2,2,3,1,2,1,2,3,3,13,16,7,13,15,13,15,17,1,1,1,1,1,1,4,15,20,15,15,20,15,9,67,20,12,3569836,7550,7550,7500,Mediterranean_Hispanic,146,125,35,100000.0,Unknown,7458280,1500000.0,1.0,76,164,79,3,0,3,214,1,0.7492722942577401,0.7967914438502673,0.713235294117647,0.0965530360455269,0.8223684210526315,0.4605263157894737,0.0097524381095273,0.0097524381095273,0.0083057862718408,0.0,0.3953488372093026,0.25,118,5,2,10,0,3796,0,0,0,1500000,171428.57142857142,2000000.0,500000.0,,,1,0,-0.25,-0.25
372535,Danil,Krugovoy,2024,2410,Russia,"Siversky, Leningrad Oblast",Russia,28-05-98,Left-Back,Defender,Left,176.0,30-06-28,Unknown,https://img.a.transfermarkt.technology/portrait/header/372535-1720501830.png?lm=1,RU1,PFK CSKA Moskva,3000000.0,3000000.0,26,125,135,12,13,12,13,13,12,8,13,12,12,12,10,12,13,11,13,12,11,12,13,10,13,9,10,11,12,14,14,14,14,13,7,10,13,14,9,17,8,10,8,10,1,3,2,3,2,4,3,2,1,3,2,7,9,9,13,13,13,11,10,1,20,1,1,19,1,1,11,1,1,7,1,1,1,70,20,11,3430877,5998,5998,3848,Northern_European,122,0,0,4163.0,Unknown,58123725,1065000.0,2.0,78,1379,81,1,0,7,148,8,0.5439269648055041,0.4062032085561496,0.536764705882353,0.0040111741230022,0.0,0.0,0.0147536884221055,0.0147536884221055,0.0058890524736798,0.1428571428571428,0.3023255813953489,0.3333333333333332,237,8,20,13,1,6863,0,0,0,3000000,138095.2380952381,3000000.0,500000.0,250000.0,400000.0,4,2000000,0.6666666666666666,0.5
372711,Amine,Harit,2024,244,France,Pontoise,Morocco,18-06-97,Attacking Midfield,Midfield,Right,180.0,30-06-27,Sport Cover,https://img.a.transfermarkt.technology/portrait/header/372711-1666815306.jpg?lm=1,FR1,Olympique de Marseille,15000000.0,30000000.0,27,136,153,14,11,17,11,15,14,5,10,3,8,15,12,8,17,12,12,9,13,11,16,12,12,17,4,13,8,12,12,15,16,12,8,13,14,12,7,12,6,12,8,15,1,2,1,1,3,1,3,1,1,1,3,12,13,16,8,10,10,10,11,1,1,1,1,1,1,1,15,12,11,18,20,15,12,67,10,20,4111059,6750,6750,5800,North_African__Middle_Eastern,133,14,0,95889.0,Olympique de Marseille,85137101,6500000.0,2.0,34,1166,67,3,1,6,144,0,0.6434241862926701,0.6149732620320855,0.6176470588235294,0.092583383464963,0.0921052631578947,0.0,0.0747686921730432,0.1497874468617154,0.0360843356759909,0.1428571428571428,0.3953488372093026,0.375,270,25,43,29,2,3982,0,0,0,15000000,584000.0,30000000.0,7000000.0,,25000000.0,2,7000000,0.0,0.0
372712,Ibrahima,Sissoko,2024,80,France,Meaux,Mali,27-10-97,Defensive Midfield,Midfield,Right,193.0,30-06-27,ASR SPORT,https://img.a.transfermarkt.technology/portrait/header/372712-1721851302.jpg?lm=1,L1,Verein fÃ¼r LeibesÃ¼bungen Bochum 1848 FuÃŸballgemeinschaft,6000000.0,8000000.0,27,127,137,8,9,13,10,13,8,16,12,8,12,13,7,14,11,14,12,15,12,13,8,12,13,10,8,11,13,15,16,13,12,14,16,16,13,15,16,12,11,12,7,12,2,1,3,1,2,1,1,1,2,2,2,11,14,7,11,9,13,10,16,1,1,12,1,1,1,20,1,20,1,1,1,1,1,88,8,20,3051845,6350,6350,3803,African_Caribbean,128,0,0,4598.0,Unknown,48037152,2000000.0,1.0,34,935,61,3,1,1,212,4,0.590500132310135,0.4013903743315508,0.5808823529411764,0.0044312176337162,0.0,0.0,0.0297574393598399,0.0397599399849962,0.0110836412122558,0.0,0.6976744186046511,0.375,253,7,17,55,1,2346,0,0,0,4500000,202272.72727272726,8000000.0,2000000.0,150000.0,5000000.0,2,3800000,-0.25,-0.1
372713,Florian,Ayé,2024,290,France,Paris,France,19-01-97,Centre-Forward,Attack,Right,184.0,30-06-26,Classico,https://img.a.transfermarkt.technology/portrait/header/372713-1567613065.jpg?lm=1,FR1,Association de la Jeunesse auxerroise,1800000.0,4000000.0,27,121,124,6,7,12,13,12,6,12,10,6,5,10,14,7,12,10,13,14,13,13,11,10,12,10,8,14,8,12,14,14,13,14,14,15,14,14,14,12,7,13,7,8,4,3,3,3,3,2,3,3,2,3,3,8,14,7,12,11,12,12,15,1,1,1,1,1,1,1,1,1,1,10,1,10,20,75,8,20,1778153,6050,5650,3900,African_Caribbean,122,0,0,5337.0,Unknown,85116733,9111392.0,2.0,34,1122,36,0,1,1,23,3,0.4978830378406986,0.4117647058823529,0.536764705882353,0.005144808793297,0.0,0.0,0.0087521880470117,0.0197549387346836,0.0505924720131114,0.1428571428571428,0.4883720930232553,0.375,300,75,21,9,0,5183,0,0,0,1500000,58333.333333333336,4000000.0,800000.0,100000.0,300000.0,3,1900000,-0.16666666666666666,-0.16666666666666666
373187,Unknown,Maracás,2024,979,Brazil,ItiruÃ§u,Brazil,27-04-94,Centre-Back,Defender,Right,184.0,30-06-26,CTS-SMI ,https://img.a.transfermarkt.technology/portrait/header/373187-1705662823.png?lm=1,PO1,Moreirense Futebol Clube,1000000.0,1000000.0,30,124,126,4,7,7,9,10,7,14,8,6,15,11,7,14,10,13,14,16,10,12,8,12,13,9,12,11,14,12,13,11,12,14,13,14,12,13,14,13,9,10,7,5,2,3,2,1,1,3,3,3,2,2,3,14,13,6,8,13,13,14,14,1,1,20,1,1,1,1,1,1,1,1,1,1,1,78,8,20,-1,6200,5516,4713,African_Caribbean,124,0,0,32655.0,Unknown,19191673,9111392.0,2.0,10,675,11,1,1,1,134,2,0.4801534797565493,0.4987165775401069,0.5514705882352942,0.0315235412661366,0.0,0.0,0.0047511877969492,0.0047511877969492,0.0505924720131114,0.1428571428571428,0.4883720930232553,0.5,246,12,2,59,1,6498,0,0,0,1000000,57812.5,1000000.0,200000.0,,,4,525000,0.0,0.6666666666666666
373373,Lucas,Martínez Quarta,2024,430,Argentina,Mar del Plata,Argentina,10-05-96,Centre-Back,Defender,Right,183.0,30-06-28,Universal Twenty Two,https://img.a.transfermarkt.technology/portrait/header/373373-1663591880.jpg?lm=1,IT1,Associazione Calcio Fiorentina,15000000.0,15000000.0,28,140,146,5,8,12,8,12,6,14,7,9,15,13,7,16,13,14,14,15,14,14,12,12,15,8,11,12,15,15,14,14,13,15,13,14,13,14,13,13,12,14,7,11,1,2,3,1,1,3,2,4,1,1,3,15,14,6,12,14,14,12,12,1,1,20,1,1,1,8,1,1,1,1,1,1,1,78,8,20,11706474,7050,6850,5750,Mediterranean_Hispanic,139,11,0,24615.0,Unknown,14110832,13000000.0,1.0,4,908,4,1,1,3,26,2,0.6566551997883038,0.6096256684491979,0.6617647058823528,0.0237599784474226,0.0723684210526315,0.0,0.0747686921730432,0.0747686921730432,0.0721964499013861,0.0,0.4651162790697669,0.4166666666666665,251,21,9,70,3,6939,0,0,0,10000000,526315.7894736842,15000000.0,3000000.0,,1750000.0,1,2000000,-0.3333333333333333,-0.2857142857142857
373374,Brian,Mansilla,2024,14589,Argentina,Rosario,Argentina,16-04-97,Left Winger,Attack,Left,178.0,30-06-26,La Squadra Sports,https://img.a.transfermarkt.technology/portrait/header/373374-1690113551.png?lm=1,RU1,FC Orenburg,1500000.0,3000000.0,27,120,122,11,11,14,12,12,10,9,14,8,10,13,12,13,14,16,12,16,11,12,12,9,13,11,13,12,9,11,15,14,13,11,10,14,14,10,10,11,8,12,13,12,2,3,1,1,3,1,2,3,2,3,1,12,14,9,12,10,10,12,11,1,1,1,1,10,1,1,12,1,1,18,1,14,20,75,20,8,2241350,5994,5994,3894,Native_American,112,0,0,1841.0,FC Orenburg,14118232,1200000.0,1.0,4,1248,4,0,0,5,70,7,0.5433977242656788,0.4111229946524063,0.463235294117647,0.0017690108313288,0.0,0.0,0.0072518129532383,0.0147536884221055,0.0066390733075918,0.0,0.3488372093023257,0.375,233,23,20,45,1,3308,0,0,0,1500000,64285.71428571428,3000000.0,1500000.0,150000.0,2750000.0,6,1500000,0.25,0.25
374954,Kristijan,Jakic,2024,167,Croatia,Split,Croatia,14-05-97,Defensive Midfield,Midfield,Right,184.0,30-06-28,Unknown,https://img.a.transfermarkt.technology/portrait/header/374954-1722850639.jpg?lm=1,L1,FC Augsburg 1907,6500000.0,9000000.0,27,132,137,3,8,10,8,11,5,13,11,10,15,12,7,15,12,16,13,17,10,14,11,12,16,8,12,10,14,15,17,13,11,13,13,16,12,17,15,13,9,13,7,17,3,3,3,3,2,2,3,1,2,1,1,11,13,8,12,13,13,10,7,1,1,14,14,1,14,20,7,15,7,7,8,1,1,0,10,20,8201562,6750,6000,4500,Northern_European,130,4,0,17500.0,Unknown,24051635,2458750.0,4.0,24,1409,25,3,1,7,67,4,0.5441915850754168,0.4759358288770053,0.5955882352941175,0.016889611599767,0.0263157894736842,0.0,0.032258064516129,0.0447611902975743,0.0136323231200866,0.4285714285714285,0.4883720930232553,0.375,285,13,13,60,0,6390,0,0,0,6500000,331578.94736842107,9000000.0,2000000.0,,250000.0,6,5450000,0.0,0.18181818181818182
375137,Ismail,Jakobs,2024,141,Germany,KÃ¶ln,Senegal,17-08-99,Left-Back,Defender,Left,184.0,30-06-25,Dirk Hebel,https://img.a.transfermarkt.technology/portrait/header/375137-1666691935.jpg?lm=1,TR1,Galatasaray Spor KulÃ¼bÃ¼,8000000.0,8000000.0,25,130,141,8,13,12,9,12,8,8,9,9,10,11,9,11,11,16,12,13,9,9,9,10,14,10,6,11,10,12,15,15,11,12,8,12,17,15,10,10,7,10,14,14,3,4,2,1,2,3,3,1,4,1,2,7,14,7,15,15,15,13,13,1,17,1,5,17,8,1,20,1,8,17,5,8,5,75,20,10,5259999,6500,6500,4254,African_Caribbean,113,0,0,17224.0,Unknown,91184349,7250000.0,2.0,38,777,84,1,0,1,102,8,0.6103466525535857,0.4496256684491978,0.4705882352941176,0.0166231012343485,0.0,0.0,0.0397599399849962,0.0397599399849962,0.0402511180866135,0.1428571428571428,0.4883720930232553,0.2916666666666665,240,11,18,23,0,4829,0,0,0,8000000,418421.05263157893,8000000.0,1000000.0,50000.0,5000000.0,4,50000,0.0,0.0
375376,Pedro,Álvaro,2024,1465,Portugal,Seia,Portugal,02-03-00,Centre-Back,Defender,Right,187.0,30-06-25,Traquifoot,https://img.a.transfermarkt.technology/portrait/header/375376-1724848555.jpg?lm=1,PO1,Grupo Desportivo Estoril Praia,1500000.0,1500000.0,24,122,142,4,8,11,8,12,5,12,5,10,13,12,5,12,12,13,12,14,12,15,12,13,13,6,12,8,12,14,13,13,11,13,14,14,14,12,13,13,6,12,10,11,1,4,1,3,2,3,1,1,2,3,2,7,14,5,15,12,15,13,12,1,1,20,1,1,1,14,1,1,1,1,1,1,1,81,10,20,2179999,6086,6086,4087,Mediterranean_Hispanic,122,0,0,2950.0,Unknown,83169853,9111392.0,2.0,76,1357,79,1,1,3,109,2,0.5555702566816618,0.4317647058823529,0.536764705882353,0.002839880379333,0.0,0.0,0.0072518129532383,0.0072518129532383,0.0505924720131114,0.1428571428571428,0.5581395348837206,0.25,164,4,3,44,2,4348,0,0,0,1500000,91666.66666666667,1500000.0,300000.0,,450000.0,3,900000,0.0,0.25
375382,André,Almeida,2024,1049,Portugal,GuimarÃ£es,Portugal,30-05-00,Attacking Midfield,Midfield,Right,176.0,30-06-28,Gestifute,https://img.a.transfermarkt.technology/portrait/header/375382-1547563680.png?lm=1,ES1,Valencia Club de FÃºtbol S. A. D.,15000000.0,20000000.0,24,129,148,12,14,15,10,13,12,5,14,5,7,13,12,8,14,10,12,12,13,12,14,15,14,12,8,13,11,14,11,13,13,15,6,14,13,13,10,12,5,10,8,10,3,2,3,2,3,3,2,1,1,1,2,13,13,6,18,14,14,12,10,1,1,1,1,1,1,1,1,20,1,13,17,1,1,66,12,20,8879999,6450,6450,5000,Mediterranean_Hispanic,126,0,0,10620.0,Unknown,83152928,8000000.0,1.0,76,579,79,3,1,3,208,0,0.6037311458057687,0.5294117647058822,0.5661764705882353,0.0102461648096237,0.0,0.0,0.0747686921730432,0.0997749437359339,0.044417900497236,0.0,0.3023255813953489,0.25,193,7,10,16,0,3169,0,0,0,9000000,406818.1818181818,20000000.0,6000000.0,300000.0,3000000.0,2,3500000,-0.4,-0.55
375667,Daniil,Utkin,2024,3725,Russia,"Aksay, Rostov Oblast",Russia,12-10-99,Central Midfield,Midfield,Left,183.0,30-06-25,Unknown,https://img.a.transfermarkt.technology/portrait/header/375667-1721922867.png?lm=1,RU1,RFK Akhmat Grozny,5000000.0,7000000.0,25,124,148,15,14,11,12,13,16,9,13,8,9,16,8,10,13,10,11,13,13,14,14,11,13,14,12,13,10,13,11,12,12,10,11,12,13,13,10,12,11,13,7,9,2,3,2,4,1,1,1,1,3,3,1,16,9,5,9,11,13,12,20,1,1,1,1,1,1,13,1,20,1,1,19,1,7,72,20,11,9026905,6257,6257,4000,Northern_European,122,0,0,18999.0,Unknown,58123749,3000000.0,1.0,78,32,81,3,0,7,157,1,0.5781952897591955,0.4224598930481283,0.536764705882353,0.0183370718815149,0.0,0.0,0.0247561890472618,0.0347586896724181,0.0166393510930859,0.0,0.4651162790697669,0.2916666666666665,281,63,46,29,0,5114,5,22,48,3500000,141304.34782608695,7000000.0,1500000.0,400000.0,3000000.0,5,3700000,-0.4166666666666667,-0.4166666666666667
375885,Ibrahim,Sangaré,2024,703,Cote d'Ivoire,Abidjan,Cote d'Ivoire,02-12-97,Defensive Midfield,Midfield,Right,191.0,30-06-28,Unknown,https://img.a.transfermarkt.technology/portrait/header/375885-1700738495.jpg?lm=1,GB1,Nottingham Forest Football Club,30000000.0,35000000.0,27,142,149,9,9,12,7,12,11,14,13,5,14,13,4,15,13,16,13,17,15,11,12,13,12,13,13,11,15,17,17,13,14,15,16,15,12,16,17,12,8,13,5,14,3,4,3,3,3,1,1,2,2,3,1,18,9,3,12,10,11,10,20,1,1,10,1,1,1,20,1,19,1,1,10,1,1,77,7,20,19045125,7000,6343,5647,African_Caribbean,142,23,5,40000.0,Unknown,48042717,21000000.0,2.0,23,14,24,3,1,1,140,4,0.5895739613654406,0.5986096256684491,0.6838235294117647,0.0386160000849743,0.1513157894736842,0.0657894736842105,0.1497874468617154,0.1747936984246061,0.1166421289480263,0.1428571428571428,0.6511627906976742,0.375,250,17,18,55,0,5871,7,42,141,28000000,1031481.4814814815,35000000.0,3000000.0,150000.0,10000000.0,2,3000000,-0.06666666666666667,-0.125
376228,Dmytro,Ivanisenya,2024,2696,Ukraine,"Kryvyi Rig, Dnipropetrovsk Oblast",Ukraine,11-01-94,Defensive Midfield,Midfield,Right,187.0,30-06-25,Unknown,https://img.a.transfermarkt.technology/portrait/header/376228-1722144590.png?lm=1,RU1,PFK Krylya Sovetov Samara,700000.0,2000000.0,30,122,124,9,8,11,10,13,11,5,11,11,13,15,8,13,12,10,13,14,13,11,12,9,19,12,10,10,14,12,14,12,13,13,15,12,13,14,12,14,8,10,4,9,1,3,1,2,3,1,3,3,3,2,3,20,12,6,10,9,11,12,12,1,1,10,1,1,1,19,1,20,13,1,1,12,1,74,11,20,3007457,5850,4698,2975,Northern_European,122,1,0,22203.0,Unknown,71042853,9111392.0,2.0,103,765,101,3,1,7,149,4,0.3719237893622652,0.3128342245989304,0.536764705882353,0.0214309096018084,0.006578947368421,0.0,0.0032508127031757,0.0097524381095273,0.0505924720131114,0.1428571428571428,0.5581395348837206,0.5,212,16,11,31,0,5361,4,28,109,500000,19047.619047619046,2000000.0,600000.0,,,4,1400000,-0.2857142857142857,-0.375
376514,Mathías,Olivera,2024,6195,Uruguay,Montevideo,Uruguay,31-10-97,Left-Back,Defender,Left,185.0,30-06-27,Unknown,https://img.a.transfermarkt.technology/portrait/header/376514-1681910576.jpg?lm=1,IT1,SocietÃ  Sportiva Calcio Napoli,15000000.0,18000000.0,27,136,148,10,14,12,8,13,9,12,9,13,13,12,8,15,12,11,14,13,13,14,10,13,14,12,11,13,14,15,16,14,12,12,13,14,14,14,13,14,11,12,7,11,1,2,2,1,4,1,2,1,1,2,2,7,12,7,3,10,11,12,10,1,20,1,1,16,1,1,15,1,1,1,1,1,1,78,20,9,6088906,6800,6900,5750,Mediterranean_Hispanic,137,6,0,36922.0,Unknown,78076343,8675000.0,2.0,106,975,103,1,0,3,184,8,0.6632707065361206,0.6096256684491979,0.6470588235294117,0.0356438301401979,0.0394736842105263,0.0,0.0747686921730432,0.0897724431107777,0.0481680046667962,0.1428571428571428,0.5116279069767438,0.375,217,6,14,39,0,1836,16,59,76,18000000,813636.3636363636,18000000.0,2000000.0,200000.0,800000.0,5,2800000,0.2,0.058823529411764705
377042,Michael,Folorunsho,2024,6195,Italy,Roma,Italy,07-02-98,Central Midfield,Midfield,Right,190.0,30-06-29,Unknown,https://img.a.transfermarkt.technology/portrait/header/377042-1722173196.jpg?lm=1,IT1,SocietÃ  Sportiva Calcio Napoli,8500000.0,8500000.0,26,124,137,8,11,12,12,12,11,10,14,8,11,13,10,11,12,16,12,14,13,12,13,13,15,13,11,14,12,13,13,14,13,14,14,15,12,14,13,13,14,12,3,10,3,2,2,1,1,3,3,3,2,2,3,12,14,10,11,11,13,13,12,1,1,1,1,1,1,15,1,20,7,10,18,10,9,77,7,20,1227719,6200,5410,3930,African_Caribbean,125,0,0,573.0,Bari,43207763,1000000.0,1.0,52,1244,54,3,1,1,184,1,0.4661286054511776,0.4149732620320855,0.5588235294117647,0.0005446081380291,0.0,0.0,0.0422605651412853,0.0422605651412853,0.0055279313314258,0.0,0.6279069767441858,0.3333333333333332,278,38,17,59,2,2459,15,40,50,7000000,346250.0,8500000.0,1500000.0,175000.0,250000.0,8,5325000,-0.17647058823529413,0.75
377219,Selim,Amallah,2024,366,Belgium,Hautrage,Morocco,15-11-96,Attacking Midfield,Midfield,Right,185.0,30-06-27,CAA Stellar,https://img.a.transfermarkt.technology/portrait/header/377219-1616872969.jpg?lm=1,ES1,Real Valladolid Club de FÃºtbol S.A.D.,1500000.0,7000000.0,28,129,132,11,11,13,10,13,12,5,13,11,10,13,8,13,14,11,13,13,14,14,13,14,12,12,11,15,8,14,12,14,12,7,5,13,13,14,7,12,8,10,14,19,1,2,3,1,3,2,2,2,3,2,2,15,14,1,12,11,13,3,17,1,1,1,1,1,1,17,12,20,18,15,18,16,7,82,8,20,4942222,6297,6297,4030,North_African__Middle_Eastern,120,22,4,8000.0,Unknown,18089862,1250000.0,2.0,7,601,67,3,1,6,169,0,0.583487695157449,0.4256684491978609,0.5220588235294117,0.0077162475726795,0.1447368421052631,0.0526315789473684,0.0072518129532383,0.0347586896724181,0.0069168588016333,0.1428571428571428,0.5116279069767438,0.4166666666666665,227,51,27,61,2,6712,7,41,64,1800000,58620.68965517241,7000000.0,2500000.0,100000.0,450000.0,6,5450000,0.2,-0.28
377387,Sergio,Córdova,2024,11282,Venezuela,"Calabozo, GuÃ¡rico",Venezuela,09-08-97,Centre-Forward,Attack,Right,188.0,30-06-27,YOU FIRST,https://img.a.transfermarkt.technology/portrait/header/377387-1724671068.jpg?lm=1,TR1,Alanyaspor,1500000.0,2000000.0,27,121,134,7,9,13,11,14,7,14,9,8,6,10,11,6,13,12,12,16,12,9,10,8,15,14,8,11,5,12,15,14,13,15,15,12,16,11,14,10,10,13,10,10,1,3,3,1,1,1,3,1,1,3,2,7,14,12,9,13,9,10,8,1,1,1,1,1,1,1,10,1,18,10,1,18,20,87,9,20,1991995,6033,5793,4193,African_Caribbean,119,15,0,7499.0,Real Salt Lake,86047757,1633333.333,3.0,108,297,105,0,1,1,15,3,0.516803387139455,0.4431016042780748,0.5147058823529411,0.0072324733224089,0.0986842105263157,0.0,0.0072518129532383,0.0097524381095273,0.0090465475874329,0.2857142857142857,0.581395348837209,0.375,244,35,12,17,1,5014,14,66,113,1500000,64130.434782608696,2000000.0,400000.0,25000.0,1500000.0,9,1950000,0.0,-0.16666666666666666
377393,Pierre,Lees-Melou,2024,3911,France,Langon,France,25-05-93,Defensive Midfield,Midfield,Right,185.0,30-06-27,NexSt11,https://img.a.transfermarkt.technology/portrait/header/377393-1710182831.jpg?lm=1,FR1,Stade brestois 29,10000000.0,10000000.0,31,129,135,13,11,13,10,13,12,5,14,5,7,16,11,10,14,12,12,13,14,13,14,12,17,12,14,13,13,14,16,12,12,12,7,15,12,15,12,13,10,13,10,9,1,2,4,3,2,1,1,2,3,1,1,13,14,6,13,13,14,14,12,1,1,1,1,1,1,13,1,20,1,11,14,12,1,69,10,20,4293058,6450,6450,5000,Mediterranean_Hispanic,129,0,0,40597.0,Unknown,48034511,3400000.0,3.0,34,800,36,3,1,3,196,4,0.6037311458057687,0.5294117647058822,0.588235294117647,0.0391924735927818,0.0,0.0,0.0497624406101525,0.0497624406101525,0.0188616350454179,0.2857142857142857,0.5116279069767438,0.5416666666666665,336,53,26,60,4,4113,5,25,158,8000000,290740.74074074073,10000000.0,2000000.0,,,3,3000000,-0.2,0.14285714285714285
378139,Aitor,Ruibal,2024,150,Spain,Sallent de Llobregat,Spain,22-03-96,Right Winger,Attack,Right,176.0,30-06-28,JV SPORTS ,https://img.a.transfermarkt.technology/portrait/header/378139-1583334036.jpg?lm=1,ES1,Real Betis BalompiÃ© S.A.D.,3500000.0,5000000.0,28,138,143,10,12,12,11,11,8,8,11,9,8,10,11,10,12,12,12,13,12,12,12,13,14,12,10,12,10,13,14,12,12,11,11,14,14,13,13,12,9,11,6,15,2,1,1,2,2,1,3,2,1,4,1,9,13,6,12,12,14,14,12,1,1,1,17,1,14,1,14,1,18,16,1,20,16,75,12,20,4452543,6500,6500,4000,Mediterranean_Hispanic,120,0,0,10816.0,Unknown,67220941,20000.0,1.0,89,1287,89,0,1,3,164,10,0.6103466525535857,0.4224598930481283,0.5220588235294117,0.0104354257937615,0.0,0.0,0.0172543135783946,0.0247561890472618,8.333564821245035e-05,0.0,0.3023255813953489,0.4166666666666665,291,37,16,57,2,5877,2,8,36,3500000,178947.36842105264,5000000.0,1500000.0,,,3,1150000,0.0,-0.3
378293,Yangel,Herrera,2024,12321,Venezuela,"La Guaira, Vargas",Venezuela,07-01-98,Central Midfield,Midfield,Right,184.0,30-06-27,PARRI GROUP,https://img.a.transfermarkt.technology/portrait/header/378293-1719230693.jpg?lm=1,ES1,Girona FÃºtbol Club S. A. D.,25000000.0,25000000.0,26,138,155,8,9,11,9,13,9,12,14,8,11,14,11,12,14,16,14,14,13,14,13,15,14,8,13,12,9,13,15,14,13,13,12,15,13,15,13,13,13,12,10,13,2,3,4,4,2,3,1,3,3,1,4,13,15,12,10,12,11,10,8,1,1,12,1,1,1,16,11,20,1,1,7,1,1,77,12,20,16363534,6900,6900,5500,Mediterranean_Hispanic,138,25,2,23198.0,Girona,86047272,3000000.0,2.0,108,781,105,3,1,3,107,1,0.6632707065361206,0.5828877005347594,0.6544117647058822,0.0223916987814875,0.1644736842105263,0.0263157894736842,0.1247811952988247,0.1247811952988247,0.0166393510930859,0.1428571428571428,0.4883720930232553,0.3333333333333332,262,25,18,82,1,4493,12,74,131,20000000,798000.0,25000000.0,5000000.0,400000.0,1000000.0,5,6500000,-0.2,0.0
378710,Unknown,Richarlison,2024,148,Brazil,Nova VenÃ©cia,Brazil,10-05-97,Centre-Forward,Attack,Right,184.0,30-06-27,CAA Base Ltd,https://img.a.transfermarkt.technology/portrait/header/378710-1665608231.jpg?lm=1,GB1,Tottenham Hotspur Football Club,35000000.0,65000000.0,27,148,166,10,11,15,14,13,9,14,11,8,6,12,12,12,15,15,12,13,12,12,10,10,14,14,9,14,10,12,16,15,14,12,11,15,15,17,13,13,6,11,8,12,3,2,1,2,1,2,4,1,2,4,2,15,13,8,14,13,12,5,11,1,1,1,1,1,1,1,1,1,1,20,1,16,19,71,12,20,62635537,7500,7950,6693,Mediterranean_Hispanic,143,36,14,202986.0,Unknown,19265858,27995000.0,4.0,10,1056,11,0,1,3,202,3,0.8021963482402752,0.7104812834224599,0.6911764705882353,0.1959980958027514,0.2368421052631578,0.1842105263157894,0.1747936984246061,0.3248312078019504,0.1555043195644323,0.4285714285714285,0.4883720930232553,0.375,364,104,37,55,3,4589,20,74,73,30000000,985000.0,65000000.0,13000000.0,700000.0,20000000.0,4,18300000,-0.21052631578947367,-0.14285714285714285
378953,Gerzino,Nyamsi,2024,932,France,Saint-Brieuc,France,22-01-97,Centre-Back,Defender,Right,194.0,30-06-27,Wasserman,https://img.a.transfermarkt.technology/portrait/header/378953-1721715198.png?lm=1,RU1,"?????????? ???? ""?????????"" ??????",4500000.0,7500000.0,27,128,135,4,7,8,7,10,5,15,6,10,15,9,8,14,10,15,9,14,12,12,8,11,15,7,13,12,13,12,12,13,10,15,17,16,12,12,18,13,4,13,13,13,3,3,3,2,1,2,1,2,1,3,1,15,12,5,16,14,14,15,13,1,1,20,15,1,1,1,1,1,1,1,1,1,1,91,8,20,790994,5650,5703,3276,African_Caribbean,125,0,0,6956.0,Unknown,48036582,2500000.0,2.0,34,1270,36,1,1,1,3,2,0.5048954749933845,0.3450267379679144,0.5588235294117647,0.0067081431469659,0.0,0.0,0.0222555638909727,0.0372593148287071,0.0138614961526709,0.1428571428571428,0.7209302325581395,0.375,188,10,4,27,1,6380,8,39,62,6000000,322222.22222222225,7500000.0,1500000.0,,,3,1000000,0.3333333333333333,0.2
379168,Noah,Fadiga,2024,157,Belgium,Brugge,Senegal,03-12-99,Right-Back,Defender,Right,187.0,30-06-26,SENERGIES BV,https://img.a.transfermarkt.technology/portrait/header/379168-1696754051.jpg?lm=1,BE1,Koninklijke Atletiek Associatie Gent,2200000.0,2200000.0,25,121,139,7,11,13,9,14,7,4,8,10,8,10,8,9,13,9,11,14,13,10,9,10,5,14,7,8,9,11,13,15,11,7,8,13,15,14,8,12,11,8,5,12,1,3,2,3,1,1,2,3,3,4,2,11,16,9,8,11,12,11,12,1,1,1,20,1,18,1,1,1,16,1,1,16,1,77,14,20,3055999,6045,6045,3750,Mixed_Race,100,0,0,3999.0,Unknown,18092701,350000.0,1.0,7,264,84,1,1,4,120,11,0.5501455411484519,0.3957219251336898,0.3749999999999999,0.0038528128913767,0.0,0.0,0.010752688172043,0.010752688172043,0.0019167199088863,0.0,0.5581395348837206,0.2916666666666665,168,11,6,19,0,3765,4,27,104,3000000,190000.0,3000000.0,200000.0,,275000.0,4,725000,2.0,2.0
379249,Unknown,Matheus Reis,2024,336,Brazil,SÃ£o JoÃ£o da Boa Vista,Brazil,18-02-95,Left-Back,Defender,Left,184.0,30-06-25,ADM Esporte,https://img.a.transfermarkt.technology/portrait/header/379249-1666100890.jpg?lm=1,PO1,Sporting Clube de Portugal,8000000.0,8000000.0,29,141,142,13,13,13,10,14,8,11,12,13,13,14,11,14,15,14,13,12,16,15,14,14,14,11,7,12,12,12,14,13,12,15,12,15,13,14,14,15,15,8,2,12,3,1,2,1,1,1,2,3,3,2,2,13,18,5,5,14,5,5,11,1,20,19,1,20,1,14,12,12,1,1,1,1,1,80,20,7,17503200,7050,6040,6175,African_Caribbean,137,0,0,14715.0,Unknown,19171604,9111392.0,2.0,10,1454,11,1,0,1,193,8,0.5494839904736702,0.6550802139037433,0.6470588235294117,0.0142003675139314,0.0,0.0,0.0397599399849962,0.0397599399849962,0.0505924720131114,0.1428571428571428,0.4883720930232553,0.4583333333333332,316,5,23,56,2,9083,4,11,21,7000000,321428.5714285714,8000000.0,1000000.0,,500000.0,4,250000,-0.125,-0.125
380350,Unknown,Igor,2024,1237,Brazil,Bom Sucesso,Brazil,07-02-98,Centre-Back,Defender,Left,188.0,30-06-27,Unknown,https://img.a.transfermarkt.technology/portrait/header/380350-1700737326.jpg?lm=1,GB1,Brighton and Hove Albion Football Club,17000000.0,17000000.0,26,140,154,6,9,11,6,12,6,14,9,12,15,14,7,15,13,14,13,14,12,13,11,12,14,11,8,9,14,14,15,14,12,15,14,15,14,15,15,13,12,10,8,12,3,2,1,2,2,1,3,4,2,3,3,12,14,6,10,10,14,12,12,1,16,20,1,15,1,1,12,1,1,1,1,1,1,85,20,10,11706474,7050,5460,5460,African_Caribbean,139,0,0,17307.0,Unknown,16199713,8933333.333,3.0,10,222,11,1,0,1,44,2,0.4727441121989945,0.5786096256684491,0.6617647058823528,0.0167032474674273,0.0,0.0,0.0847711927981995,0.0847711927981995,0.0496032297174921,0.2857142857142857,0.581395348837209,0.3333333333333332,271,2,3,53,1,6426,5,35,148,22000000,913541.6666666666,22000000.0,3000000.0,250000.0,1500000.0,6,9100000,0.29411764705882354,0.29411764705882354
380598,Santi,Comesaña,2024,1050,Spain,Vigo,Spain,05-10-96,Central Midfield,Midfield,Right,188.0,30-06-27,Unknown,https://img.a.transfermarkt.technology/portrait/header/380598-1726231263.jpg?lm=1,ES1,Villarreal Club de FÃºtbol S.A.D.,6000000.0,7500000.0,28,135,145,9,10,11,11,13,7,14,10,6,12,14,7,13,13,12,15,13,12,13,13,14,14,11,14,13,14,14,14,12,13,12,13,15,13,14,14,13,12,10,8,13,1,3,3,2,3,3,2,1,2,1,1,14,15,8,12,12,13,10,8,1,1,9,1,1,1,18,1,20,1,1,12,1,1,75,11,20,5468604,6750,6750,4750,Mediterranean_Hispanic,134,0,0,14585.0,Unknown,67224142,9111392.0,2.0,89,1587,89,3,1,3,216,1,0.6434241862926701,0.5026737967914437,0.625,0.0140748372693502,0.0,0.0,0.0297574393598399,0.0372593148287071,0.0505924720131114,0.1428571428571428,0.581395348837209,0.4166666666666665,317,27,12,67,2,2850,0,0,0,8000000,267857.14285714284,8000000.0,2500000.0,,500000.0,2,2600000,0.3333333333333333,0.6
381348,Daniel,Mancini,2024,265,Argentina,TrÃ¡nsito,Argentina,11-11-96,Right Winger,Attack,Right,172.0,30-06-26,DRANGOLD AGENCY,https://img.a.transfermarkt.technology/portrait/header/381348-1566894713.jpg?lm=1,GR1,Panathinaikos Athlitikos Omilos,3000000.0,3000000.0,28,125,125,13,12,12,8,11,12,10,8,8,12,12,12,9,13,16,12,13,8,10,12,10,15,11,7,13,10,12,17,15,15,11,8,15,14,14,9,13,10,12,3,15,1,3,3,3,2,3,1,1,2,1,2,10,12,6,13,10,14,8,9,1,1,1,1,1,1,1,16,10,19,16,14,20,10,72,10,20,4083749,6250,5750,3038,Mediterranean_Hispanic,122,0,0,6711.0,Unknown,14123774,1750000.0,2.0,4,1530,4,0,1,3,150,10,0.5111140513363324,0.3195721925133689,0.536764705882353,0.0064715669167937,0.0,0.0,0.0147536884221055,0.0147536884221055,0.0096947137420483,0.1428571428571428,0.2093023255813952,0.4166666666666665,311,36,35,50,1,10409,0,0,0,3000000,136842.1052631579,3000000.0,250000.0,400000.0,1250000.0,5,1200000,0.0,0.0
381714,Danil,Prutsev,2024,232,Russia,"Mostovskoy, Krasnodar Region",Russia,25-03-00,Central Midfield,Midfield,Right,174.0,30-06-26,Pavel Andreev,https://img.a.transfermarkt.technology/portrait/header/381714-1643025572.png?lm=1,RU1,FK Spartak Moskva,4500000.0,4500000.0,24,110,138,11,11,11,7,12,11,6,7,7,9,13,4,12,13,10,12,10,12,13,12,13,4,12,4,10,10,13,12,13,14,12,7,13,13,15,6,12,6,13,10,16,3,1,1,1,3,3,3,1,3,1,2,19,9,4,13,11,10,11,13,1,1,1,1,1,1,19,1,20,1,1,12,1,1,62,9,20,4896513,5250,5250,2864,Northern_European,107,0,0,14927.0,Unknown,58140557,792500.0,4.0,78,986,81,3,1,7,82,1,0.4449589838581635,0.3009625668449197,0.4264705882352941,0.0144050783743253,0.0,0.0,0.0222555638909727,0.0222555638909727,0.0043751215311536,0.4285714285714285,0.2558139534883721,0.25,214,7,16,32,0,5839,0,0,0,4500000,231578.94736842104,4500000.0,300000.0,200000.0,700000.0,3,1050000,0.0,0.125
381724,Unknown,Victor Sá,2024,16704,Brazil,SÃ£o JosÃ© dos Campos,Brazil,27-03-94,Left Winger,Attack,Left,178.0,30-06-26,BS Football Business,https://img.a.transfermarkt.technology/portrait/header/381724-1721724527.png?lm=1,RU1,FK Krasnodar,2500000.0,4500000.0,30,124,130,9,11,13,14,12,9,8,14,7,6,12,13,6,13,10,13,8,12,11,14,12,13,14,7,15,6,12,10,14,14,11,9,13,14,12,9,15,8,15,7,11,3,2,3,1,3,2,1,2,2,1,2,12,14,13,8,12,10,8,11,1,1,1,1,1,1,1,20,1,12,20,10,12,14,72,20,14,3586589,6262,5570,4596,Mixed_Race,121,0,0,8993.0,Unknown,19186267,2525000.0,4.0,10,1453,11,0,0,4,78,7,0.4872982270441915,0.4862032085561497,0.5294117647058822,0.0086751055178267,0.0,0.0,0.0122530632658164,0.0222555638909727,0.0140003888996916,0.4285714285714285,0.3488372093023257,0.5,352,85,53,34,0,6517,3,6,19,3000000,118000.0,4500000.0,1000000.0,,,5,2200000,0.5,0.6666666666666666
381833,Nail,Umyarov,2024,232,Russia,"Syzran, Samara Region",Russia,27-06-00,Defensive Midfield,Midfield,Right,182.0,30-06-26,Pavel Andreev,https://img.a.transfermarkt.technology/portrait/header/381833-1632577946.png?lm=1,RU1,FK Spartak Moskva,3500000.0,4000000.0,24,124,148,12,11,11,8,15,10,7,10,5,10,14,13,12,14,13,13,12,16,11,14,13,16,14,13,11,10,13,11,12,13,13,11,9,12,13,9,12,13,7,9,20,2,3,1,3,7,1,2,2,1,4,3,13,10,4,11,10,13,12,13,1,1,1,1,1,1,20,1,17,1,1,1,1,1,71,11,20,8577226,5986,5986,3988,Northern_European,118,0,0,13225.0,Unknown,58140558,300000.0,1.0,78,1442,81,3,1,7,82,4,0.5423392431860281,0.4211764705882352,0.5073529411764706,0.0127615977875777,0.0,0.0,0.0172543135783946,0.0197549387346836,0.0016389344148448,0.0,0.4418604651162785,0.25,195,5,5,40,0,5172,8,51,250,3500000,162500.0,4000000.0,1000000.0,900000.0,3000000.0,2,300000,0.4,0.4
381950,Alexis,Saelemaekers,2024,12,Belgium,Berchem-Sainte-Agathe,Belgium,27-06-99,Right Winger,Attack,Right,180.0,30-06-25,Unique Sports Group,https://img.a.transfermarkt.technology/portrait/header/381950-1609842664.jpg?lm=1,IT1,Associazione Sportiva Roma,12000000.0,20000000.0,25,143,159,6,13,14,8,13,10,11,12,9,11,13,7,13,13,14,12,13,11,13,14,11,16,11,10,14,13,18,15,15,14,12,10,15,14,15,10,13,12,12,5,17,1,3,3,3,3,1,2,2,1,2,3,15,14,4,11,13,15,12,11,1,7,1,13,9,16,1,11,1,19,13,11,20,1,72,12,20,13488424,7150,6750,6250,Northern_European,139,9,1,24615.0,Unknown,18097159,7650000.0,1.0,7,174,8,0,1,7,29,10,0.6434241862926701,0.6631016042780749,0.6617647058823528,0.0237599784474226,0.0592105263157894,0.0131578947368421,0.0597649412353088,0.0997749437359339,0.0424734020389455,0.0,0.3953488372093026,0.2916666666666665,263,20,32,41,2,5694,10,60,75,12000000,560000.0,20000000.0,5000000.0,800000.0,6300000.0,3,5700000,0.0,0.2
381967,Albert Sambi,Lokonga,2024,368,Belgium,Verviers,Belgium,22-10-99,Central Midfield,Midfield,Right,183.0,30-06-25,Stirr Associates,https://img.a.transfermarkt.technology/portrait/header/381967-1678466372.jpg?lm=1,ES1,Sevilla FÃºtbol Club S.A.D.,15000000.0,16000000.0,25,137,165,10,10,13,8,15,10,10,12,10,11,14,11,13,14,13,14,12,14,14,13,12,15,14,12,13,11,16,15,13,13,11,10,14,14,14,12,12,12,14,14,12,3,1,2,1,3,1,3,3,3,3,1,14,14,6,14,12,14,12,14,1,1,1,1,1,1,19,1,20,1,1,12,1,1,0,12,20,42568967,6948,6948,5248,African_Caribbean,136,1,0,57996.0,Unknown,18097160,17500000.0,1.0,7,1579,8,3,1,1,181,1,0.6696215930140249,0.5559358288770053,0.6397058823529411,0.055993248404076,0.006578947368421,0.0,0.0747686921730432,0.0797699424856214,0.0971971443651212,0.0,0.4651162790697669,0.2916666666666665,168,5,12,21,0,4573,7,69,244,12000000,557142.8571428572,16000000.0,3000000.0,700000.0,10000000.0,3,10000000,-0.2,0.0
382478,Cédric,Zesiger,2024,82,Switzerland,Meyriez FR,Switzerland,24-06-98,Centre-Back,Defender,Left,194.0,30-06-27,Wasserman,https://img.a.transfermarkt.technology/portrait/header/382478-1689866125.jpg?lm=1,L1,Verein fÃ¼r LeibesÃ¼bungen Wolfsburg,5000000.0,7500000.0,26,129,140,4,6,7,6,8,5,16,6,10,13,10,7,14,8,14,13,14,12,13,7,12,13,5,12,8,13,14,12,12,10,12,15,13,12,14,17,12,13,13,8,14,1,1,3,1,1,3,2,3,2,3,2,20,12,5,12,11,14,13,13,1,13,20,1,1,1,1,1,1,1,1,1,1,1,88,20,13,5497242,6446,6396,4448,Northern_European,126,1,0,11808.0,Unknown,98035093,1983333.333,3.0,92,949,92,1,0,7,213,2,0.5965863985181264,0.4703743315508021,0.5661764705882353,0.0113933181216426,0.006578947368421,0.0,0.0247561890472618,0.0372593148287071,0.0109910460457234,0.2857142857142857,0.7209302325581395,0.3333333333333332,300,10,10,80,0,9236,8,32,78,4000000,127586.20689655172,7500000.0,1500000.0,750000.0,750000.0,3,2500000,-0.2,-0.4666666666666667
382528,Kerem,Aktürko?Lu,2024,294,TÃ¼rkiye,Kocaeli,TÃ¼rkiye,21-10-98,Left Winger,Attack,Right,173.0,30-06-29,DW Sports Management,https://img.a.transfermarkt.technology/portrait/header/382528-1671102813.png?lm=1,PO1,Sport Lisboa e Benfica,18000000.0,18000000.0,26,130,140,8,7,14,13,12,12,5,13,6,3,9,12,5,12,12,13,12,14,13,13,10,16,15,7,14,6,10,12,17,17,12,7,14,14,14,8,16,10,13,4,12,2,2,3,3,3,1,2,2,1,3,1,20,17,5,9,16,12,8,7,1,1,1,1,1,1,1,1,1,1,20,12,18,12,66,12,20,6573768,6600,6600,5000,Northern_European,126,14,3,14180.0,Unknown,70099785,9111392.0,2.0,100,739,100,0,1,7,188,7,0.6235776660492194,0.5294117647058822,0.5661764705882353,0.0136837622766165,0.0921052631578947,0.0394736842105263,0.0897724431107777,0.0897724431107777,0.0505924720131114,0.1428571428571428,0.2325581395348837,0.3333333333333332,308,83,52,23,0,5345,5,8,13,25000000,1377777.7777777778,25000000.0,2000000.0,,,1,3000000,0.6666666666666666,0.47058823529411764
383638,Unknown,Juninho,2024,865,Brazil,Londrina,Brazil,01-02-95,Centre-Back,Defender,Right,187.0,30-06-26,COMUNIGOAL,https://img.a.transfermarkt.technology/portrait/header/383638-1525791516.jpg?lm=1,DK1,Fodbold Club Midtjylland,1000000.0,2250000.0,29,130,131,11,11,13,10,14,11,6,10,10,12,14,9,13,13,7,12,16,13,13,13,14,6,14,18,14,13,16,16,13,14,12,6,14,13,15,11,12,5,6,9,17,3,2,4,2,3,1,1,3,2,2,3,12,12,7,13,11,13,13,11,1,1,1,13,1,15,17,1,20,17,1,13,1,1,66,6,20,347975206,6369,6369,3109,African_Caribbean,132,0,0,3575.0,Unknown,19189819,2300000.0,2.0,10,859,11,1,1,1,86,2,0.5930140248743054,0.3271657754010695,0.6102941176470589,0.0034433911705888,0.0,0.0,0.0047511877969492,0.0110027506876719,0.0127503541765049,0.1428571428571428,0.5581395348837206,0.4583333333333332,318,12,9,31,4,12333,0,0,0,1000000,25000.0,2250000.0,1000000.0,,1000000.0,5,1800000,0.0,0.0
384060,Tino,Kadewere,2024,995,Zimbabwe,Harare,Zimbabwe,05-01-96,Centre-Forward,Attack,Right,183.0,30-06-27,P.P.M.,https://img.a.transfermarkt.technology/portrait/header/384060-1640776127.jpg?lm=1,FR1,Football Club de Nantes,3000000.0,14000000.0,28,131,134,8,12,12,13,13,8,13,10,7,7,12,14,5,13,9,12,12,13,11,13,12,12,14,8,14,8,12,13,15,14,12,12,14,15,15,14,11,8,12,6,17,1,3,1,1,1,2,3,2,1,2,2,10,14,6,8,10,12,9,9,1,1,1,1,1,1,1,1,7,1,12,17,15,20,72,8,20,1894145,6000,6550,3950,African_Caribbean,130,22,3,23014.0,Mallorca,93070869,7000000.0,2.0,113,597,108,0,1,1,93,3,0.6169621593014025,0.4171122994652406,0.5955882352941175,0.0222140252045418,0.1447368421052631,0.0394736842105263,0.0147536884221055,0.0697674418604651,0.038862190616406,0.1428571428571428,0.4651162790697669,0.4166666666666665,242,76,25,20,2,7407,14,75,106,3000000,116000.0,14000000.0,5000000.0,,400000.0,5,2450000,0.2,0.2
384461,Jakub,Moder,2024,1237,Poland,Szczecinek,Poland,07-04-99,Central Midfield,Midfield,Right,191.0,30-06-25,CAA Base Ltd,https://img.a.transfermarkt.technology/portrait/header/384461-1716985274.jpg?lm=1,GB1,Brighton and Hove Albion Football Club,10000000.0,12000000.0,25,135,155,13,10,11,11,13,13,11,14,7,10,13,12,12,13,9,13,12,13,13,13,13,14,13,11,14,13,14,14,12,11,11,13,13,12,14,13,14,7,13,6,15,3,4,4,2,1,1,3,3,2,2,1,13,14,5,14,10,14,14,12,1,1,1,1,14,1,17,14,20,1,1,17,1,1,78,14,20,29143571,6750,6750,4750,Northern_European,132,20,2,26098.0,Unknown,96086697,11000000.0,1.0,75,1443,78,3,1,7,44,1,0.6434241862926701,0.5026737967914437,0.6102941176470589,0.0251919888529142,0.131578947368421,0.0263157894736842,0.0497624406101525,0.0597649412353088,0.0610850301397261,0.0,0.6511627906976742,0.2916666666666665,254,26,23,27,0,4746,1,93,576,10000000,522368.4210526316,12000000.0,2000000.0,75000.0,550000.0,3,7100000,0.0,0.0
384593,Alexis,Claude-Maurice,2024,167,France,Noisy-le-Grand,France,06-06-98,Attacking Midfield,Midfield,Right,174.0,30-06-27,Sport Cover,https://img.a.transfermarkt.technology/portrait/header/384593-1726605505.jpg?lm=1,L1,FC Augsburg 1907,3500000.0,12000000.0,26,120,138,10,11,14,12,13,13,7,11,7,8,14,12,7,14,10,12,10,10,12,14,10,13,14,7,13,8,14,12,13,14,10,7,15,14,13,6,14,7,13,14,12,2,1,3,4,4,1,2,2,1,1,1,15,13,7,15,12,15,13,20,1,1,1,1,1,1,1,17,16,12,20,18,15,12,64,10,20,1156143,5999,5999,3749,African_Caribbean,118,0,0,25298.0,RC Lens,48036267,13000000.0,1.0,34,1051,36,3,1,1,67,0,0.5440592749404605,0.395614973262032,0.5073529411764706,0.0244194950401069,0.0,0.0,0.0172543135783946,0.0597649412353088,0.0721964499013861,0.0,0.2558139534883721,0.3333333333333332,246,52,20,18,0,4418,3,36,131,5000000,230952.38095238095,12000000.0,2000000.0,150000.0,7500000.0,4,4500000,0.42857142857142855,0.25
384859,Fabien,Centonze,2024,995,France,Voiron,France,16-01-96,Right-Back,Defender,Right,182.0,30-06-27,USM GROUP ,https://img.a.transfermarkt.technology/portrait/header/384859-1703065658.jpg?lm=1,FR1,Football Club de Nantes,3000000.0,8000000.0,28,127,133,6,14,11,8,12,6,8,7,7,12,11,10,13,12,10,14,14,14,14,14,13,12,8,9,12,13,14,14,14,12,12,10,14,13,14,12,14,6,12,7,14,1,2,2,3,2,4,2,1,3,3,1,14,13,3,12,15,14,13,12,1,12,1,20,1,17,13,1,1,16,1,1,14,1,75,8,20,7957924,6350,6350,3850,Mediterranean_Hispanic,124,0,0,12807.0,Unknown,48037272,3500000.0,2.0,34,1623,36,1,1,3,93,11,0.590500132310135,0.4064171122994652,0.5514705882352942,0.0123579697703858,0.0,0.0,0.0147536884221055,0.0397599399849962,0.0194172060335009,0.1428571428571428,0.4418604651162785,0.4166666666666665,279,11,17,42,2,3542,8,38,102,2500000,104545.45454545454,8000000.0,2000000.0,,300000.0,6,3700000,-0.16666666666666666,-0.16666666666666666
386047,Axel,Disasi,2024,631,France,Gonesse,France,11-03-98,Centre-Back,Defender,Right,190.0,30-06-29,Unknown,https://img.a.transfermarkt.technology/portrait/header/386047-1727785671.jpg?lm=1,GB1,Chelsea Football Club,35000000.0,42000000.0,26,136,148,5,6,8,6,11,5,16,5,10,14,11,8,14,10,12,13,15,12,12,10,13,13,6,12,10,13,12,14,13,11,14,15,14,14,15,18,14,12,13,8,8,2,2,3,2,4,1,3,3,2,2,3,7,15,7,12,12,14,12,15,1,1,20,10,1,1,1,1,1,1,1,1,1,1,86,8,20,15468353,6800,6800,4750,African_Caribbean,135,0,0,17260.0,Unknown,48037291,29000000.0,2.0,34,549,36,1,1,1,50,2,0.6500396930404869,0.5026737967914437,0.6323529411764706,0.0166578634559248,0.0,0.0,0.1747936984246061,0.2098024506126531,0.1610878079946665,0.1428571428571428,0.6279069767441858,0.3333333333333332,304,24,6,33,2,6517,5,7,62,30000000,1247916.6666666667,42000000.0,5000000.0,,400000.0,3,11800000,-0.25,-0.2857142857142857
386446,Alessandro,Buongiorno,2024,6195,Italy,Torino,Italy,06-06-99,Centre-Back,Defender,Left,190.0,30-06-29,GR Sports,https://img.a.transfermarkt.technology/portrait/header/386446-1663596475.jpg?lm=1,IT1,SocietÃ  Sportiva Calcio Napoli,35000000.0,35000000.0,25,132,153,4,8,9,6,11,7,14,10,6,14,12,5,14,11,14,14,12,12,14,10,14,15,8,10,7,15,12,13,12,13,13,15,14,12,13,14,13,10,13,7,10,1,2,1,4,1,2,2,3,3,2,1,14,16,7,14,14,15,12,13,1,12,20,1,1,1,1,1,1,1,1,1,1,1,82,20,8,7590243,6594,6394,4894,Mediterranean_Hispanic,132,0,0,7884.0,Unknown,43270682,35000000.0,1.0,52,1504,54,1,0,3,184,2,0.5963217782482139,0.5180748663101604,0.6102941176470589,0.0076042359698225,0.0,0.0,0.1747936984246061,0.1747936984246061,0.1944220672796466,0.0,0.6279069767441858,0.2916666666666665,241,10,8,36,0,3948,10,38,44,45000000,2140476.1904761903,45000000.0,50000.0,75000.0,450000.0,4,10575000,0.2857142857142857,1.0454545454545454
386455,Riccardo,Sottil,2024,430,Italy,Torino,Italy,03-06-99,Left Winger,Attack,Right,180.0,30-06-26,GR Sports,https://img.a.transfermarkt.technology/portrait/header/386455-1663591627.jpg?lm=1,IT1,Associazione Calcio Fiorentina,6000000.0,9000000.0,25,138,154,9,12,14,12,14,10,11,12,4,6,14,12,6,14,7,11,11,12,10,12,10,13,14,8,14,6,14,14,15,14,11,11,17,16,14,12,12,5,11,8,14,1,2,3,3,3,1,1,1,3,3,2,13,13,1,14,12,14,13,10,1,1,1,1,10,10,1,16,1,16,20,14,18,13,70,11,20,10271686,6900,6500,5150,Mediterranean_Hispanic,133,0,0,21346.0,Unknown,43270713,9111392.0,2.0,52,1504,54,0,1,3,26,7,0.6103466525535857,0.5454545454545454,0.6176470588235294,0.0206033756048385,0.0,0.0,0.0297574393598399,0.0447611902975743,0.0505924720131114,0.1428571428571428,0.3953488372093026,0.2916666666666665,276,63,33,29,1,8702,12,68,144,6000000,297500.0,9000000.0,1500000.0,175000.0,3600000.0,4,5500000,0.0,-0.25
386552,Lassana,Coulibaly,2024,1005,Mali,Bamako,Mali,10-04-96,Central Midfield,Midfield,Right,183.0,30-06-27,PIVETEAU,https://img.a.transfermarkt.technology/portrait/header/386552-1725529617.jpg?lm=1,IT1,Unione Sportiva Lecce,3500000.0,5000000.0,28,129,135,7,8,15,8,12,7,13,8,6,11,12,8,16,9,15,15,16,11,12,11,12,10,6,8,15,14,15,16,15,13,16,12,14,13,17,15,13,8,9,4,13,2,2,3,3,3,2,1,3,1,2,3,10,8,3,12,12,13,14,14,1,1,1,1,1,1,14,1,20,1,1,14,1,1,74,8,20,3346314,6450,6300,3750,African_Caribbean,128,29,0,14806.0,Unknown,48036752,1900000.0,2.0,61,133,61,3,1,1,206,1,0.5838846255623181,0.3957219251336898,0.5808823529411764,0.0142882386851382,0.1907894736842105,0.0,0.0172543135783946,0.0247561890472618,0.0105280702241728,0.1428571428571428,0.4651162790697669,0.4166666666666665,273,9,14,40,1,3530,7,32,59,2500000,106818.18181818182,5000000.0,1000000.0,,1500000.0,6,1200000,-0.2857142857142857,-0.4444444444444444
386726,Yusuf,Yaz?C?,2024,683,TÃ¼rkiye,Trabzon,TÃ¼rkiye,29-01-97,Attacking Midfield,Midfield,Left,184.0,30-06-27,CY Management,https://img.a.transfermarkt.technology/portrait/header/386726-1728417949.png?lm=1,GR1,Olympiakos Syndesmos Filathlon Peiraios,10000000.0,20000000.0,27,137,145,15,15,16,14,16,14,11,14,7,7,16,13,10,16,15,13,11,15,14,15,13,12,16,16,13,8,13,13,12,14,10,13,13,13,11,12,12,14,14,10,15,1,1,3,2,3,3,4,1,2,2,1,13,15,2,16,14,15,8,10,1,1,1,1,1,1,5,10,18,14,12,20,15,13,74,20,8,12931966,6900,6900,5250,Mediterranean_Hispanic,138,39,2,23014.0,Trabzonspor A.Åž.,70103149,18500000.0,1.0,100,1515,100,3,0,3,141,0,0.6632707065361206,0.5561497326203209,0.6544117647058822,0.0222140252045418,0.256578947368421,0.0263157894736842,0.0497624406101525,0.0997749437359339,0.1027528542459512,0.0,0.4883720930232553,0.375,268,64,39,38,2,6667,14,76,184,8000000,331250.0,20000000.0,5000000.0,200000.0,2500000.0,5,10000000,-0.2,-0.2
386914,Sam,Lammers,2024,317,Netherlands,Tilburg,Netherlands,30-04-97,Centre-Forward,Attack,Left,191.0,30-06-27,Unknown,https://img.a.transfermarkt.technology/portrait/header/386914-1722335077.jpg?lm=1,NL1,Football Club Twente,5000000.0,9000000.0,27,128,134,6,9,13,12,14,10,13,11,7,5,11,13,5,13,8,14,12,12,12,13,11,15,13,7,14,6,12,13,12,14,14,14,12,12,13,12,12,7,11,6,12,1,1,2,1,2,1,2,3,1,3,3,11,15,7,11,14,15,12,11,1,1,1,1,1,1,1,7,7,6,8,16,11,20,77,20,15,1293112,6400,6000,5250,Northern_European,127,0,0,23384.0,Empoli Football Club,37056187,4700000.0,3.0,67,1492,68,0,0,7,91,3,0.5441915850754168,0.5561497326203209,0.5735294117647058,0.0225713035929652,0.0,0.0,0.0247561890472618,0.0447611902975743,0.0260840578904969,0.2857142857142857,0.6511627906976742,0.375,331,103,40,11,0,9154,5,41,177,5000000,165833.33333333334,9000000.0,2000000.0,100000.0,1500000.0,9,7100000,0.0,1.5
387047,Danilho,Doekhi,2024,89,Netherlands,Rotterdam,Netherlands,30-06-98,Centre-Back,Defender,Right,190.0,30-06-25,Wasserman,https://img.a.transfermarkt.technology/portrait/header/387047-1692707468.jpg?lm=1,L1,1. FC Union Berlin,17000000.0,17000000.0,26,123,135,9,9,7,5,10,8,13,10,6,12,10,3,15,12,11,12,12,11,12,12,11,12,8,14,9,12,14,14,10,13,14,13,11,10,14,16,12,7,4,6,10,1,2,3,2,2,2,2,1,1,3,2,14,9,8,8,9,9,10,12,1,1,20,16,1,13,16,1,12,1,1,1,1,1,83,10,20,2162790,6143,6143,4993,African_Caribbean,116,0,0,10000.0,Unknown,37051440,250000.0,1.0,67,1253,68,1,1,1,0,2,0.5631119343741731,0.528663101604278,0.4926470588235294,0.009647482104698,0.0,0.0,0.0847711927981995,0.0847711927981995,0.0013611489208033,0.0,0.6279069767441858,0.3333333333333332,303,16,5,16,1,7482,6,26,69,15000000,650000.0,17000000.0,2000000.0,150000.0,750000.0,4,450000,-0.11764705882352941,-0.11764705882352941
387105,Luka,Ivanusec,2024,234,Croatia,VaraÅ¾din,Croatia,26-11-98,Left Winger,Attack,Right,175.0,30-06-28,TTMA,https://img.a.transfermarkt.technology/portrait/header/387105-1686815745.jpg?lm=1,NL1,Feyenoord Rotterdam,12000000.0,13500000.0,26,132,145,10,10,16,11,11,13,7,12,6,7,13,13,9,14,14,11,12,10,9,12,10,16,13,11,13,8,12,14,17,14,19,7,13,11,13,13,8,7,11,7,15,1,1,2,1,3,3,2,1,2,4,1,8,14,8,12,13,12,7,8,1,1,1,1,1,1,8,16,20,16,16,20,16,1,76,11,20,5886081,6584,6534,5241,Northern_European,118,11,1,7671.0,Unknown,24051702,5400000.0,2.0,24,1562,25,0,1,7,85,7,0.6148451971421011,0.5551871657754011,0.5073529411764706,0.0073985594921625,0.0723684210526315,0.0131578947368421,0.0597649412353088,0.067266816704176,0.0299730548070779,0.1428571428571428,0.2790697674418605,0.3333333333333332,318,51,40,26,0,6544,3,24,58,6000000,278571.4285714286,13500000.0,4000000.0,1000000.0,3000000.0,2,1550000,-0.5,-0.5
387106,Lovro,Majer,2024,82,Croatia,Zagreb,Croatia,17-01-98,Attacking Midfield,Midfield,Left,178.0,30-06-28,Unknown,https://img.a.transfermarkt.technology/portrait/header/387106-1695624038.jpg?lm=1,L1,Verein fÃ¼r LeibesÃ¼bungen Wolfsburg,20000000.0,27000000.0,26,137,144,15,16,16,12,14,14,10,13,5,9,15,15,11,17,12,16,10,13,14,15,13,13,15,8,13,11,13,15,13,16,11,8,13,9,16,7,13,9,11,9,10,1,3,3,2,3,3,3,1,3,2,3,10,14,8,12,12,14,11,11,1,1,1,1,1,1,1,1,17,12,8,20,13,1,75,20,9,18601140,6900,6900,5250,Northern_European,139,8,2,30178.0,Unknown,24053458,13166666.67,3.0,24,1697,25,3,0,7,213,0,0.6632707065361206,0.5561497326203209,0.6617647058823528,0.0291317072982318,0.0526315789473684,0.0263157894736842,0.0997749437359339,0.134783695923981,0.0731224015667101,0.2857142857142857,0.3488372093023257,0.3333333333333332,282,53,62,36,0,5236,7,33,112,20000000,902272.7272727273,27000000.0,5000000.0,150000.0,2500000.0,3,7000000,0.0,-0.2
387234,Szymon,?Urkowski,2024,749,Poland,Tychy,Poland,25-09-97,Central Midfield,Midfield,Right,185.0,30-06-25,KFM,https://img.a.transfermarkt.technology/portrait/header/387234-1656583041.jpg?lm=1,IT1,Empoli Football Club S.r.l.,2500000.0,7000000.0,27,130,138,10,10,12,13,12,9,8,14,10,9,12,10,11,14,15,12,13,10,12,12,12,15,12,10,14,12,13,16,13,13,14,12,14,13,14,14,13,9,13,5,12,3,3,1,2,2,3,1,1,3,3,2,7,10,6,12,12,11,11,19,1,1,1,1,1,1,15,1,20,1,1,16,1,1,77,14,20,1822997,6499,5949,4999,Northern_European,130,5,0,17885.0,Unknown,96110489,3940000.0,2.0,75,1538,78,3,1,7,64,1,0.5374437681926436,0.5293048128342246,0.5955882352941175,0.0172613742471806,0.0328947368421052,0.0,0.0122530632658164,0.0347586896724181,0.0218617183810661,0.1428571428571428,0.5116279069767438,0.375,251,33,16,32,0,4381,9,46,154,2500000,106521.73913043478,7000000.0,1300000.0,50000.0,2500000.0,5,4000000,0.0,0.25
387626,Leon,Bailey,2024,405,Jamaica,Kingston,Jamaica,09-08-97,Right Winger,Attack,Left,178.0,30-06-27,Unknown,https://img.a.transfermarkt.technology/portrait/header/387626-1694712703.jpg?lm=1,GB1,Aston Villa Football Club,42000000.0,45000000.0,27,142,160,14,14,15,13,12,12,7,14,11,4,11,12,7,15,13,11,12,11,10,12,8,15,17,8,13,6,9,13,17,16,10,12,14,17,13,9,11,8,13,13,12,3,4,1,1,1,1,2,3,3,1,2,16,18,16,5,12,10,10,10,1,1,1,1,1,1,1,18,1,18,19,14,20,12,75,20,9,37117355,7100,7550,6000,African_Caribbean,135,17,3,98593.0,Unknown,18083491,16700000.0,3.0,53,728,55,0,0,1,30,10,0.7492722942577401,0.6363636363636364,0.6323529411764706,0.0951944125522519,0.1118421052631578,0.0394736842105263,0.2098024506126531,0.2248062015503876,0.0927525764604572,0.2857142857142857,0.3488372093023257,0.375,369,75,70,43,2,7696,20,72,68,38000000,1504000.0,45000000.0,10000000.0,7500000.0,45000000.0,2,4500000,-0.09523809523809523,0.26666666666666666
387687,César,Montes,2024,932,Mexico,Hermosillo,Mexico,24-02-97,Centre-Back,Defender,Right,195.0,30-06-29,Unknown,https://img.a.transfermarkt.technology/portrait/header/387687-1728229633.png?lm=1,RU1,"?????????? ???? ""?????????"" ??????",5000000.0,8000000.0,27,138,148,8,12,7,6,10,7,15,9,14,15,11,11,12,14,9,13,13,14,13,13,14,13,8,8,7,14,12,14,12,13,14,15,14,14,13,9,12,8,12,13,8,2,2,3,3,2,4,1,1,1,3,1,20,10,8,15,12,15,9,13,1,1,20,1,1,1,1,1,1,1,1,1,1,1,70,7,20,4976951,6849,6849,4241,Mediterranean_Hispanic,130,26,1,22392.0,Unknown,51055610,9333333.333,3.0,63,619,64,1,1,3,3,2,0.6565228896533475,0.448235294117647,0.5955882352941175,0.0216134112650841,0.1710526315789473,0.0131578947368421,0.0247561890472618,0.0397599399849962,0.0518255136698241,0.2857142857142857,0.7441860465116279,0.375,337,18,10,72,0,12689,9,36,33,5000000,160000.0,8000000.0,2000000.0,1000000.0,3000000.0,4,5000000,0.6666666666666666,0.0
388165,Yoane,Wissa,2024,1148,France,Villeneuve-Saint-George,DR Congo,03-09-96,Centre-Forward,Attack,Right,176.0,30-06-26,CAA Stellar,https://img.a.transfermarkt.technology/portrait/header/388165-1579276540.jpg?lm=1,GB1,Brentford Football Club,28000000.0,28000000.0,28,130,136,9,12,13,13,12,11,8,10,6,6,13,13,6,13,10,13,12,12,12,13,12,13,13,7,14,8,13,14,15,14,12,8,14,15,14,12,13,8,12,7,12,3,1,1,2,1,2,2,2,2,1,2,12,13,6,13,12,14,15,14,1,1,1,1,1,1,1,17,1,1,20,1,10,18,74,7,20,11763156,6495,6495,5245,African_Caribbean,127,6,2,32478.0,Unknown,85140175,6000000.0,2.0,34,1603,29,0,1,1,43,3,0.6096851018788039,0.555614973262032,0.5735294117647058,0.031352627010053,0.0394736842105263,0.0263157894736842,0.1397849462365591,0.1397849462365591,0.0333064807355759,0.1428571428571428,0.3023255813953489,0.4166666666666665,330,99,34,36,1,1742,1,6,36,28000000,1259090.9090909092,28000000.0,600000.0,,300000.0,3,1200000,0.0,0.12
388198,Nico,Schlotterbeck,2024,16,Germany,Waiblingen,Germany,01-12-99,Centre-Back,Defender,Left,191.0,30-06-27,Robert Schneider,https://img.a.transfermarkt.technology/portrait/header/388198-1709560457.jpg?lm=1,L1,Borussia Dortmund,40000000.0,40000000.0,25,141,162,5,8,12,7,11,7,13,7,10,14,12,8,16,12,12,13,16,15,14,14,14,14,11,11,11,14,15,15,12,12,15,15,12,12,14,13,13,10,15,7,14,2,3,2,1,1,1,4,1,1,2,2,9,13,8,12,15,13,15,10,1,15,20,12,11,1,12,1,10,1,1,1,1,1,89,20,12,50309996,7000,7000,5750,Northern_European,140,4,0,55000.0,Unknown,92088306,10045000.0,2.0,38,1640,40,1,0,7,41,2,0.6765017200317545,0.6096256684491979,0.6691176470588234,0.0531002590751124,0.0263157894736842,0.0,0.1997999499874969,0.1997999499874969,0.0557793272035334,0.1428571428571428,0.6511627906976742,0.2916666666666665,290,30,22,60,1,5040,8,36,57,40000000,2101315.789473684,40000000.0,5000000.0,75000.0,4000000.0,4,7700000,0.0,0.14285714285714285
388363,Maximilian,Bauer,2024,167,Germany,Vilshofen,Germany,09-02-00,Centre-Back,Defender,Left,189.0,30-06-27,Robert Schneider,https://img.a.transfermarkt.technology/portrait/header/388363-1723533985.jpg?lm=1,L1,FC Augsburg 1907,3000000.0,3500000.0,24,132,141,6,8,10,6,12,12,14,9,9,13,13,14,14,11,11,13,14,13,13,11,12,16,6,10,10,14,13,15,14,12,12,14,14,13,13,13,13,8,11,12,11,3,3,2,2,2,3,2,2,3,3,1,10,15,3,14,15,15,15,18,1,18,20,1,10,1,13,1,1,1,1,1,1,1,85,20,10,6842392,6607,6607,5255,Northern_European,132,9,0,24931.0,Unknown,16147700,9111392.0,2.0,38,1611,40,1,0,7,67,2,0.6245038369939138,0.5566844919786096,0.6102941176470589,0.0240651135034815,0.0592105263157894,0.0,0.0147536884221055,0.0172543135783946,0.0505924720131114,0.1428571428571428,0.6046511627906974,0.25,196,12,1,40,2,3310,7,14,21,3000000,155555.55555555556,3500000.0,1000000.0,350000.0,1200000.0,1,900000,0.0,-0.14285714285714285
388465,Louka,Prip,2024,2293,Denmark,Hvidovre,Denmark,29-06-97,Right Winger,Attack,Left,182.0,30-06-25,Elite Consulting,https://img.a.transfermarkt.technology/portrait/header/388465-1727457886.png?lm=1,TR1,Konyaspor,1300000.0,1800000.0,27,120,122,14,13,14,14,12,14,7,14,4,8,11,13,8,12,13,11,10,11,10,12,10,12,13,7,12,8,12,14,13,13,11,11,14,13,13,10,10,6,11,6,12,2,3,1,1,3,2,1,1,3,1,3,10,15,4,12,9,14,13,14,1,1,1,1,1,1,1,14,14,16,17,18,20,14,72,20,10,846471,5545,5545,3997,Northern_European,117,0,0,1881.0,Unknown,27116677,9111392.0,2.0,28,644,30,0,0,7,125,10,0.4839904736702831,0.422139037433155,0.4999999999999999,0.0018076355219692,0.0,0.0,0.0062515628907226,0.0087521880470117,0.0505924720131114,0.1428571428571428,0.4418604651162785,0.375,307,63,28,13,0,6577,2,1,8,1100000,50000.0,1800000.0,300000.0,,150000.0,3,900000,-0.3125,-0.21428571428571427
388513,Mateu,Morey,2024,237,Spain,Palma de Mallorca,Spain,02-03-00,Right-Back,Defender,Right,173.0,30-06-25,Goal Management,https://img.a.transfermarkt.technology/portrait/header/388513-1661413734.jpg?lm=1,ES1,Real Club Deportivo Mallorca S.A.D.,800000.0,7000000.0,24,129,145,11,13,14,8,15,11,6,8,12,11,14,7,12,15,13,13,14,11,11,13,12,12,13,8,13,12,14,14,15,15,12,6,10,14,15,9,15,8,15,16,12,3,3,2,1,1,4,3,2,2,2,1,11,12,5,8,14,13,15,15,1,1,1,20,1,19,1,1,1,14,1,1,13,1,67,5,20,4620000,6243,5258,4692,Mediterranean_Hispanic,123,0,0,19164.0,Unknown,67258408,9111392.0,2.0,89,1112,89,1,1,3,166,11,0.4460174649378142,0.4964705882352941,0.5441176470588236,0.0184963987304064,0.0,0.0,0.0037509377344336,0.0347586896724181,0.0505924720131114,0.1428571428571428,0.2325581395348837,0.25,64,0,7,8,0,3840,14,132,376,800000,29411.764705882353,7000000.0,3000000.0,300000.0,3000000.0,2,700000,0.0,0.0
388516,Josep,Martínez,2024,46,Spain,Alzira,Spain,27-05-98,Goalkeeper,Goalkeeper,Right,191.0,30-06-29,Unknown,https://img.a.transfermarkt.technology/portrait/header/388516-1686153132.jpg?lm=1,IT1,Football Club Internazionale Milano S.p.A.,8000000.0,8000000.0,26,139,142,4,10,14,15,15,5,14,8,3,3,13,15,6,14,14,11,16,12,12,12,11,16,14,12,13,5,14,15,15,16,13,14,11,14,14,13,13,11,12,10,9,1,3,2,2,3,2,2,3,2,1,3,10,13,11,10,11,9,11,8,1,1,1,1,1,1,1,1,1,1,17,12,1,20,74,14,20,9476451,6934,7440,5348,Mixed_Race,141,58,12,80305.0,Unknown,14023276,6500000.0,3.0,89,56,89,2,1,4,89,5,0.734718179412543,0.5666310160427807,0.6764705882352942,0.0775352039914755,0.381578947368421,0.1578947368421052,0.0397599399849962,0.0397599399849962,0.0360843356759909,0.2857142857142857,0.6511627906976742,0.3333333333333332,0,0,0,0,0,0,1,3,121,12000000,566666.6666666666,12000000.0,300000.0,,250000.0,4,4800000,0.5,2.0
388548,Jandro,Orellana,2024,1465,Spain,GavÃ ,Spain,07-08-00,Central Midfield,Midfield,Right,176.0,30-06-27,AC Talent,https://img.a.transfermarkt.technology/portrait/header/388548-1724848451.jpg?lm=1,PO1,Grupo Desportivo Estoril Praia,1000000.0,2000000.0,24,120,150,12,7,11,8,14,11,8,10,6,8,14,12,11,13,11,12,11,12,11,14,14,14,14,13,12,12,15,11,12,13,12,8,14,12,13,11,15,8,15,13,12,3,1,1,3,2,2,2,3,2,1,3,8,13,5,14,14,15,14,15,1,1,1,1,1,1,20,1,20,1,1,12,1,1,68,10,20,2339999,6000,6000,3250,Mediterranean_Hispanic,116,0,0,6240.0,Unknown,219032,9111392.0,2.0,89,524,89,3,1,3,109,1,0.5441915850754168,0.3422459893048128,0.4926470588235294,0.0060167611845033,0.0,0.0,0.0047511877969492,0.0097524381095273,0.0505924720131114,0.1428571428571428,0.3023255813953489,0.25,159,2,8,28,0,3479,7,26,285,1200000,69230.76923076923,2000000.0,500000.0,,2000000.0,3,200000,0.2,0.0
389253,Auston,Trusty,2024,371,United States,"Media, Pennsylvania",United States,12-08-98,Centre-Back,Defender,Left,190.0,30-06-29,Unknown,https://img.a.transfermarkt.technology/portrait/header/389253-1647191322.jpg?lm=1,SC1,The Celtic Football Club,7000000.0,10000000.0,26,118,137,8,7,8,5,10,6,15,6,6,13,11,4,13,10,10,12,12,11,11,10,12,10,7,10,10,12,13,14,13,9,11,14,11,14,14,14,12,5,8,6,8,7,1,1,1,1,9,1,1,1,1,1,9,14,6,11,10,10,10,14,1,11,20,1,1,1,1,1,1,1,1,1,1,1,85,20,11,4823065,5900,5900,3260,African_Caribbean,117,0,0,17399.0,Birmingham City,72047555,3845000.0,4.0,104,938,102,1,0,1,200,2,0.530960571579783,0.3433155080213903,0.4999999999999999,0.0167920842559001,0.0,0.0,0.0347586896724181,0.0497624406101525,0.0213339259423872,0.4285714285714285,0.6279069767441858,0.3333333333333332,282,9,5,37,0,3266,0,0,0,8000000,373809.5238095238,10000000.0,2000000.0,150000.0,1250000.0,6,4225000,0.14285714285714285,0.0
389837,Nicolò,Casale,2024,1025,Italy,Negrar,Italy,14-02-98,Centre-Back,Defender,Right,191.0,30-06-25,Unknown,https://img.a.transfermarkt.technology/portrait/header/389837-1695026993.jpg?lm=1,IT1,Bologna Football Club 1909,14000000.0,22000000.0,26,135,149,4,8,9,5,11,5,13,5,11,14,11,5,16,11,13,15,13,14,16,9,13,15,4,11,8,14,12,14,13,11,14,14,13,14,15,14,14,8,12,10,12,1,3,2,2,1,3,4,2,1,1,2,15,15,8,11,14,15,13,12,1,13,20,14,11,11,1,1,1,1,1,1,1,1,82,9,20,6943404,6750,6750,4400,Mediterranean_Hispanic,135,0,0,35577.0,Unknown,43206174,8000000.0,1.0,52,1026,54,1,1,3,40,2,0.6434241862926701,0.4652406417112299,0.6323529411764706,0.0343450749174155,0.0,0.0,0.0697674418604651,0.1097774443610902,0.044417900497236,0.0,0.6511627906976742,0.3333333333333332,259,6,4,43,0,2499,9,21,33,7000000,302173.9130434783,22000000.0,6000000.0,75000.0,150000.0,8,9225000,-0.5,-0.65
390177,Nedim,Bajrami,2024,124,Switzerland,ZÃ¼rich,Albania,28-02-99,Attacking Midfield,Midfield,Right,179.0,Unknown,LIAN Sports Group,https://img.a.transfermarkt.technology/portrait/header/390177-1661510744.jpg?lm=1,SC1,Rangers Football Club,4500000.0,10000000.0,25,134,151,13,13,13,13,14,13,8,14,4,7,14,14,8,15,13,12,12,14,11,14,13,13,14,10,14,7,14,14,13,13,13,9,13,14,13,11,11,8,10,5,14,2,1,3,3,1,1,3,2,1,1,3,14,14,7,12,13,14,11,9,1,1,1,1,1,1,10,1,18,1,1,20,1,1,68,11,20,9878407,6696,6096,5346,Northern_European,134,7,0,29614.0,Unknown,98038311,3250000.0,2.0,92,1711,0,3,1,7,161,0,0.5568933580312252,0.5664171122994652,0.625,0.0285870991602026,0.0460526315789473,0.0,0.0222555638909727,0.0497624406101525,0.0180282785632934,0.1428571428571428,0.3720930232558141,0.2916666666666665,357,63,36,27,0,6906,5,27,50,4500000,220000.0,10000000.0,2000000.0,2000000.0,2500000.0,3,500000,0.0,-0.25
390304,Federico,Ravaglia,2024,1025,Italy,Bologna,Italy,11-11-99,Goalkeeper,Goalkeeper,Right,196.0,30-06-28,BC Group,https://img.a.transfermarkt.technology/portrait/header/390304-1701253429.jpg?lm=1,IT1,Bologna Football Club 1909,1000000.0,1000000.0,25,111,136,1,1,1,1,10,3,5,3,2,2,10,1,1,10,8,12,6,10,10,8,12,9,5,10,2,13,10,10,12,15,13,14,12,12,15,13,11,5,7,5,4,14,10,10,3,13,14,13,13,8,11,9,12,8,7,10,6,11,12,8,20,1,1,1,1,1,1,1,1,1,1,1,1,1,75,7,20,1958000,5540,5540,3490,Mediterranean_Hispanic,111,0,0,899.0,Reggina 1914,43272011,9111392.0,2.0,52,220,54,2,1,3,40,5,0.4833289229955014,0.3679144385026737,0.4558823529411764,0.0008593993667481,0.0,0.0,0.0047511877969492,0.0047511877969492,0.0505924720131114,0.1428571428571428,0.7674418604651163,0.2916666666666665,0,0,0,0,0,0,1,3,21,1000000,55882.35294117647,1000000.0,50000.0,100000.0,100000.0,6,400000,0.0,1.2222222222222223
390638,Arthur,Cabral,2024,294,Brazil,Campina Grande,Brazil,25-04-98,Centre-Forward,Attack,Right,186.0,30-06-28,Talents Sports,https://img.a.transfermarkt.technology/portrait/header/390638-1701333640.jpg?lm=1,PO1,Sport Lisboa e Benfica,14000000.0,20000000.0,26,136,145,6,8,12,15,13,8,15,12,5,4,12,15,6,12,8,14,14,14,12,10,14,12,13,9,16,7,12,10,12,12,12,13,14,13,15,15,12,9,14,5,7,2,4,1,3,4,3,1,1,3,3,3,12,13,8,13,13,11,8,9,1,1,1,1,1,1,1,1,1,1,1,1,6,20,89,13,20,9966417,6800,7496,5397,Mixed_Race,136,0,0,41923.0,Unknown,19266403,10700000.0,4.0,10,306,11,0,1,4,188,3,0.7421275469700979,0.5718716577540106,0.6397058823529411,0.04047288208751,0.0,0.0,0.0697674418604651,0.0997749437359339,0.059418317175477,0.4285714285714285,0.5348837209302322,0.3333333333333332,319,131,27,40,2,7529,9,13,38,12000000,590000.0,20000000.0,4000000.0,,1000000.0,4,5600000,-0.14285714285714285,-0.25
390688,Juan,Iglesias,2024,3709,Spain,Valladolid,Spain,03-07-98,Right-Back,Defender,Right,187.0,30-06-26,ADM PRO,https://img.a.transfermarkt.technology/portrait/header/390688-1632295269.jpg?lm=1,ES1,Getafe Club de FÃºtbol S.A.D. Team Dubai,2500000.0,3500000.0,26,124,135,9,14,13,9,13,6,10,9,12,12,13,12,13,13,12,12,12,11,12,11,12,5,12,10,13,13,12,12,13,12,11,10,12,14,14,13,11,9,12,8,13,2,2,2,2,4,1,1,2,1,1,3,7,10,6,11,9,11,11,20,1,1,1,19,1,20,1,1,1,13,1,1,14,10,75,8,20,1816636,6200,6200,4700,Mediterranean_Hispanic,124,0,0,3068.0,Unknown,67235978,100000.0,1.0,89,1558,89,1,1,3,105,11,0.5706536120666843,0.4973262032085561,0.5514705882352942,0.0029538232167221,0.0,0.0,0.0122530632658164,0.0172543135783946,0.0005277924386788,0.0,0.5581395348837206,0.3333333333333332,219,1,6,36,1,3548,0,0,0,3500000,164285.7142857143,3500000.0,1000000.0,,300000.0,3,350000,0.4,0.4
391004,Jonas,Wind,2024,82,Denmark,Hvidovre,Denmark,07-02-99,Centre-Forward,Attack,Right,190.0,30-06-26,ROOF,https://img.a.transfermarkt.technology/portrait/header/391004-1689866009.jpg?lm=1,L1,Verein fÃ¼r LeibesÃ¼bungen Wolfsburg,15000000.0,25000000.0,25,136,150,2,7,12,13,15,13,14,11,3,7,14,17,7,16,11,13,13,15,13,15,13,16,15,6,14,7,12,12,11,12,15,16,13,11,14,16,12,7,15,10,11,3,3,4,1,1,1,4,1,1,3,1,15,15,8,18,16,15,14,15,1,1,1,1,1,1,1,1,12,1,12,18,12,20,82,12,20,17655135,6800,6750,5900,Northern_European,136,15,5,38355.0,Unknown,27122565,12000000.0,1.0,28,644,30,0,1,7,213,3,0.6434241862926701,0.6256684491978609,0.6397058823529411,0.0370275596823891,0.0986842105263157,0.0657894736842105,0.0747686921730432,0.1247811952988247,0.0666407400205561,0.0,0.6279069767441858,0.2916666666666665,260,107,40,17,0,6924,6,77,225,13000000,563043.4782608695,25000000.0,5000000.0,50000.0,2500000.0,2,3050000,-0.35,-0.48
391005,Mads,Roerslev,2024,1148,Denmark,Copenhagen,Denmark,24-06-99,Right-Back,Defender,Right,184.0,30-06-26,Boutique Transfers,https://img.a.transfermarkt.technology/portrait/header/391005-1684772936.jpg?lm=1,GB1,Brentford Football Club,10000000.0,10000000.0,25,129,141,12,14,13,9,13,7,12,9,9,13,14,7,13,14,13,13,14,14,14,13,12,14,13,9,11,13,14,14,13,13,12,12,12,13,13,12,13,7,13,6,13,2,1,2,3,1,3,1,3,3,3,2,12,13,5,13,11,13,14,12,1,7,10,20,5,17,1,1,1,12,1,1,1,1,67,9,20,12019169,6450,6000,4750,Northern_European,129,0,0,23198.0,Unknown,27122563,60000.0,1.0,28,382,30,1,1,7,43,11,0.5441915850754168,0.5026737967914437,0.588235294117647,0.0223916987814875,0.0,0.0,0.0497624406101525,0.0497624406101525,0.0003055640434456,0.0,0.4883720930232553,0.2916666666666665,224,5,17,12,0,6645,1,27,92,12000000,697058.8235294118,12000000.0,300000.0,200000.0,450000.0,3,300000,0.2,0.5
391766,Marco,Grüll,2024,86,Austria,Schwarzach im Pongau,Austria,06-07-98,Left Winger,Attack,Right,182.0,Unknown,Unknown,https://img.a.transfermarkt.technology/portrait/header/391766-1692995037.png?lm=1,L1,Sportverein Werder Bremen von 1899,4000000.0,5000000.0,26,123,137,14,10,12,13,11,12,6,7,3,5,10,12,6,13,8,12,11,11,12,11,11,14,11,14,15,5,12,13,15,13,10,11,12,15,14,11,11,8,13,6,13,2,3,1,3,3,1,3,2,1,2,3,19,16,8,11,13,11,9,12,1,1,1,1,1,1,1,1,1,1,20,15,17,18,74,8,20,3400648,6187,6187,3987,Northern_European,117,4,0,2784.0,Unknown,16195163,9111392.0,2.0,6,1353,7,0,1,7,194,7,0.5689335803122519,0.4210695187165775,0.4999999999999999,0.0026795879131755,0.0263157894736842,0.0,0.0197549387346836,0.0247561890472618,0.0505924720131114,0.1428571428571428,0.4418604651162785,0.3333333333333332,337,132,73,45,0,5036,3,4,16,4000000,203947.36842105264,5000000.0,1000000.0,,400000.0,2,1200000,0.0,0.3333333333333333
391780,Derrick,Köhn,2024,86,Germany,Hamburg,Germany,04-02-99,Left-Back,Defender,Left,180.0,30-06-25,EMG Mundial,https://img.a.transfermarkt.technology/portrait/header/391780-1707464358.png?lm=1,L1,Sportverein Werder Bremen von 1899,6000000.0,6000000.0,25,123,138,13,14,13,8,12,14,7,11,14,10,11,6,12,13,13,12,12,11,10,12,11,16,14,4,13,11,12,12,15,12,12,9,16,15,15,11,13,7,12,4,12,1,3,2,1,2,3,3,2,1,2,1,9,14,8,8,12,12,9,10,1,20,12,1,18,1,10,17,10,1,12,1,1,1,73,20,7,2391532,6150,6150,4150,African_Caribbean,115,0,0,14383.0,Unknown,91181667,1316666.667,3.0,38,594,40,1,0,1,194,8,0.5640381053188674,0.4385026737967914,0.4852941176470588,0.0138797825816163,0.0,0.0,0.0297574393598399,0.0297574393598399,0.0072872394622072,0.2857142857142857,0.3953488372093026,0.2916666666666665,305,18,39,34,1,1753,2,5,39,6000000,278571.4285714286,6000000.0,200000.0,150000.0,450000.0,4,2550000,0.0,1.0
392085,Nicolò,Zaniolo,2024,800,Italy,Massa,Italy,02-07-99,Attacking Midfield,Midfield,Left,190.0,30-06-25,Unknown,https://img.a.transfermarkt.technology/portrait/header/392085-1713472570.jpg?lm=1,IT1,Atalanta Bergamasca Calcio S.p.a.,20000000.0,55000000.0,25,150,165,13,12,16,13,13,9,12,15,6,8,12,12,9,15,18,13,18,15,14,14,12,18,14,9,16,9,8,15,14,13,12,12,13,16,13,17,11,15,14,12,15,3,2,2,1,2,1,1,1,1,4,2,7,17,15,8,19,11,7,6,1,1,1,1,1,1,1,12,15,12,12,20,19,15,79,20,9,57585624,7500,7300,6750,Mediterranean_Hispanic,141,9,2,89038.0,Unknown,43270517,7850000.0,3.0,52,924,54,3,0,3,31,0,0.7161947605186557,0.7165775401069518,0.6764705882352942,0.0859679395755339,0.0592105263157894,0.0263157894736842,0.0997749437359339,0.274818704676169,0.0435845440151115,0.2857142857142857,0.6279069767441858,0.2916666666666665,290,63,34,75,3,7235,24,130,267,18000000,815909.0909090909,55000000.0,10000000.0,1000000.0,45000000.0,5,9000000,-0.1,-0.28
392163,Noah,WeiãÅ¸Haupt,2024,60,Germany,Rostock,Germany,20-09-01,Left Winger,Attack,Right,181.0,Unknown,Unknown,https://img.a.transfermarkt.technology/portrait/header/392163-1658413281.jpg?lm=1,L1,Sport-Club Freiburg,5000000.0,7000000.0,23,112,-75,7,11,13,9,12,4,6,8,3,8,11,6,9,11,6,7,10,8,8,10,7,15,13,8,10,9,13,13,13,11,12,8,12,14,14,6,10,3,14,6,15,3,1,3,3,3,1,1,3,1,4,1,11,14,6,17,12,13,10,4,1,10,1,10,18,20,1,15,1,17,20,10,20,1,0,15,20,60800000,5249,5249,3249,Northern_European,90,0,0,1500.0,Unknown,91190768,9111392.0,2.0,38,1251,40,0,1,7,189,7,0.4448266737232071,0.342139037433155,0.3014705882352941,0.0014397353436197,0.0,0.0,0.0247561890472618,0.0347586896724181,0.0505924720131114,0.1428571428571428,0.418604651162791,0.2083333333333332,206,24,42,6,1,4220,5,24,52,3500000,315909.0909090909,7000000.0,2000000.0,25000.0,1700000.0,1,400000,-0.3,-0.5
392516,Antonino,Gallo,2024,1005,Italy,Palermo,Italy,05-01-00,Left-Back,Defender,Left,183.0,30-06-26,Unknown,https://img.a.transfermarkt.technology/portrait/header/392516-1663745734.jpg?lm=1,IT1,Unione Sportiva Lecce,4500000.0,4500000.0,24,120,143,9,14,14,7,14,9,9,9,12,11,13,7,13,13,13,11,11,10,11,10,11,14,12,10,13,12,11,11,14,14,11,10,14,14,14,10,14,4,14,3,16,3,1,2,2,1,3,2,3,1,3,2,16,13,4,13,13,15,14,14,1,20,1,10,18,10,1,15,1,10,10,1,1,1,74,20,8,3439999,5991,5991,3001,Mediterranean_Hispanic,115,0,0,7115.0,Unknown,43297394,9111392.0,2.0,52,1111,54,1,0,3,206,8,0.5430007938608098,0.315614973262032,0.4852941176470588,0.0068616762922614,0.0,0.0,0.0222555638909727,0.0222555638909727,0.0505924720131114,0.1428571428571428,0.4651162790697669,0.25,245,9,15,15,1,3095,6,19,50,5500000,353333.3333333333,5500000.0,50000.0,200000.0,250000.0,3,150000,0.2222222222222222,1.2
392538,Tommaso,Pobega,2024,1025,Italy,Trieste,Italy,15-07-99,Central Midfield,Midfield,Left,188.0,30-06-25,Patrick Bastianelli,https://img.a.transfermarkt.technology/portrait/header/392538-1661767249.jpg?lm=1,IT1,Bologna Football Club 1909,10000000.0,18000000.0,25,139,158,4,10,11,12,13,7,11,15,10,12,14,11,14,12,16,15,13,14,13,12,14,16,8,10,14,13,14,14,12,12,14,12,14,13,15,14,14,14,11,6,12,1,3,2,4,1,1,1,3,1,1,3,8,14,4,13,12,19,13,14,1,1,7,1,1,1,18,8,20,8,1,12,1,1,75,20,12,10953487,6950,7200,5250,Northern_European,137,1,0,35577.0,Unknown,43269242,9111392.0,2.0,52,1523,54,3,0,7,40,1,0.702963747023022,0.5561497326203209,0.6470588235294117,0.0343450749174155,0.006578947368421,0.0,0.0497624406101525,0.0897724431107777,0.0505924720131114,0.1428571428571428,0.581395348837209,0.2916666666666665,252,31,18,56,2,4363,12,54,135,10000000,523684.2105263158,18000000.0,3000000.0,75000.0,2000000.0,6,6525000,0.0,-0.16666666666666666
392569,Gabriele,Zappa,2024,1390,Italy,Monza,Italy,22-12-99,Right-Back,Defender,Right,187.0,30-06-25,GR Sports,https://img.a.transfermarkt.technology/portrait/header/392569-1695033763.jpg?lm=1,IT1,Cagliari Calcio,2500000.0,7000000.0,25,124,148,7,12,11,10,11,7,10,12,11,11,12,7,13,12,11,12,12,12,12,10,12,13,9,9,12,13,14,14,14,12,13,13,15,14,14,13,12,9,11,6,14,3,1,3,2,1,4,2,4,3,3,3,10,14,1,11,10,13,14,7,1,10,12,20,1,18,1,1,1,17,1,1,10,1,78,9,20,6730498,6200,6200,4750,Mediterranean_Hispanic,122,0,0,10672.0,Unknown,43272248,3100000.0,2.0,52,980,54,1,1,3,46,11,0.5706536120666843,0.5026737967914437,0.536764705882353,0.0102963769074562,0.0,0.0,0.0122530632658164,0.0347586896724181,0.0171949220811689,0.1428571428571428,0.5581395348837206,0.2916666666666665,281,14,21,24,0,3860,2,3,14,3500000,214062.5,7000000.0,1300000.0,75000.0,2500000.0,2,4500000,0.4,0.75
392591,Chiedozie,Ogbene,2024,677,Nigeria,Lagos,Ireland,01-05-97,Right Winger,Attack,Right,181.0,30-06-28,Unknown,https://img.a.transfermarkt.technology/portrait/header/392591-1700737518.jpg?lm=1,GB1,Ipswich Town Football Club,8000000.0,8000000.0,27,124,130,5,12,14,11,12,6,8,11,4,8,11,7,8,12,9,9,12,10,9,10,11,16,15,6,13,6,11,12,16,12,11,8,13,16,12,11,13,7,11,4,17,2,2,1,2,3,1,2,2,3,2,3,14,13,5,10,12,14,14,11,1,1,1,1,10,18,1,15,1,20,15,1,18,19,0,5,20,3858850,6200,6200,3767,African_Caribbean,103,10,3,4060.0,Unknown,52079878,9500000.0,1.0,69,789,52,0,1,1,115,10,0.5706536120666843,0.3975401069518716,0.3970588235294117,0.0039117155446033,0.0657894736842105,0.0394736842105263,0.0397599399849962,0.0397599399849962,0.052751465318481,0.0,0.418604651162791,0.375,260,33,35,17,0,4381,3,75,218,8000000,564285.7142857143,8000000.0,50000.0,,100000.0,3,1100000,0.0,1.6666666666666667
392757,Marc,Guéhi,2024,873,Cote d'Ivoire,Abidjan,England,13-07-00,Centre-Back,Defender,Right,182.0,30-06-26,Unique Sports Group,https://img.a.transfermarkt.technology/portrait/header/392757-1683030598.jpg?lm=1,GB1,Crystal Palace Football Club,45000000.0,45000000.0,24,143,168,5,6,11,9,12,7,11,8,9,14,12,6,15,12,10,14,14,14,14,10,13,14,11,14,9,14,13,14,14,13,14,14,15,14,14,15,14,10,12,9,12,2,1,3,2,3,1,2,1,2,1,1,13,12,5,13,10,15,13,16,1,12,20,10,1,1,8,1,1,1,1,1,1,1,80,14,20,58162896,7130,7130,5930,African_Caribbean,142,3,0,52196.0,Unknown,28108033,23340000.0,1.0,23,14,33,1,1,1,58,2,0.6937020375760783,0.6288770053475935,0.6838235294117647,0.0503926682612226,0.0197368421052631,0.0,0.2248062015503876,0.2248062015503876,0.1296424900691686,0.0,0.4418604651162785,0.25,304,17,10,33,0,7675,2,16,89,45000000,2718750.0,45000000.0,300000.0,,10000000.0,3,15500000,0.18421052631578946,0.18421052631578946
392765,Emile,Smith Rowe,2024,931,England,London,England,28-07-00,Attacking Midfield,Midfield,Right,182.0,30-06-29,Jordan Wise,https://img.a.transfermarkt.technology/portrait/header/392765-1684164628.jpg?lm=1,GB1,Fulham Football Club,28000000.0,40000000.0,24,147,168,11,12,15,11,14,12,5,13,2,6,15,11,8,15,13,14,11,13,12,15,13,15,15,9,15,8,15,15,16,15,15,8,13,14,14,8,13,6,13,11,15,3,1,4,1,1,1,2,1,1,1,1,13,15,6,15,15,15,15,15,1,1,1,1,1,1,1,14,14,14,19,20,16,8,76,12,20,96746387,7350,7350,6250,Northern_European,144,3,1,63795.0,Unknown,28109599,31800000.0,1.0,32,858,33,3,1,7,95,0,0.7228102672664726,0.6631016042780749,0.6985294117647058,0.0615928629296634,0.0197368421052631,0.0131578947368421,0.1397849462365591,0.1997999499874969,0.1766437956609906,0.0,0.4418604651162785,0.25,219,46,25,4,0,6812,14,147,128,32000000,1473684.2105263157,40000000.0,5000000.0,4000000.0,18000000.0,4,7000000,0.45454545454545453,0.28
392767,Unknown,Danny Namaso,2024,720,England,Reading,England,28-08-00,Centre-Forward,Attack,Right,182.0,30-06-28,Unknown,https://img.a.transfermarkt.technology/portrait/header/392767-1669115274.png?lm=1,PO1,Futebol Clube do Porto,5000000.0,5000000.0,24,123,145,9,10,13,13,11,9,10,10,8,6,12,12,6,12,12,10,11,12,11,12,9,12,14,8,13,6,10,13,13,14,13,11,15,14,15,12,12,9,11,3,12,3,1,2,3,1,3,1,1,3,2,1,15,18,5,11,11,10,15,9,1,1,1,1,1,1,1,5,5,5,18,20,15,19,77,11,20,3056249,6147,6147,4647,Mixed_Race,113,0,0,6499.0,Unknown,29165730,9111392.0,2.0,32,1207,33,0,1,4,100,3,0.5636411749139985,0.4916577540106951,0.4705882352941176,0.0062668560563997,0.0,0.0,0.0247561890472618,0.0247561890472618,0.0505924720131114,0.1428571428571428,0.4418604651162785,0.25,248,67,22,28,2,7916,1,4,20,5000000,321428.5714285714,5000000.0,50000.0,500000.0,850000.0,2,1050000,0.0,0.0
392768,Callum,Hudson-Odoi,2024,703,England,London,England,07-11-00,Left Winger,Attack,Right,178.0,30-06-26,BTS,https://img.a.transfermarkt.technology/portrait/header/392768-1659969850.png?lm=1,GB1,Nottingham Forest Football Club,22000000.0,35000000.0,24,148,170,10,15,15,9,15,12,7,8,3,5,15,10,5,15,7,10,6,14,8,14,13,10,15,6,15,9,9,14,16,15,12,8,12,15,12,8,12,8,6,8,4,1,3,3,2,1,4,3,2,2,3,3,17,18,7,9,15,11,13,14,1,1,1,1,1,15,1,15,1,15,20,16,19,9,79,13,20,71914876,7400,7150,6250,African_Caribbean,135,3,0,139190.0,Bayer 04 Leverkusen,28112986,9111392.0,2.0,32,858,33,0,1,1,140,7,0.696348240275205,0.6631016042780749,0.6323529411764706,0.1343955767004278,0.0197368421052631,0.0,0.1097774443610902,0.1747936984246061,0.0505924720131114,0.1428571428571428,0.3488372093023257,0.25,266,59,41,6,0,10825,13,65,144,24000000,-52631.57894736842,35000000.0,8000000.0,35000000.0,32000000.0,2,3000000,0.3333333333333333,1.0
392770,Angel,Gomes,2024,1082,England,London,England,31-08-00,Attacking Midfield,Midfield,Right,166.0,30-06-25,Gol International,https://img.a.transfermarkt.technology/portrait/header/392770-1666690396.jpg?lm=1,FR1,Lille Olympique Sporting Club Lille MÃ©tropole,28000000.0,28000000.0,24,124,142,11,12,14,12,15,12,6,13,4,6,14,11,7,15,8,10,8,13,9,15,12,14,18,8,12,6,10,8,14,14,10,6,10,14,12,6,12,6,9,11,8,1,3,4,4,2,3,1,2,3,3,1,16,12,5,8,12,13,8,12,1,1,1,1,1,1,1,14,16,13,17,20,16,8,58,14,20,6924999,6200,6200,5000,African_Caribbean,123,0,0,11999.0,Unknown,28109888,9111392.0,2.0,32,858,33,3,1,1,128,0,0.5706536120666843,0.5294117647058822,0.5441176470588236,0.0115777510194504,0.0,0.0,0.1397849462365591,0.1397849462365591,0.0505924720131114,0.1428571428571428,0.0697674418604648,0.25,241,45,40,35,0,6311,5,19,37,25000000,1235294.1176470588,28000000.0,3000000.0,4000000.0,6000000.0,2,0,0.0,0.25
392775,Ryan,Sessegnon,2024,931,England,London,England,18-05-00,Left-Back,Defender,Left,178.0,30-06-26,Unique Sports Group,https://img.a.transfermarkt.technology/portrait/header/392775-1722077271.jpg?lm=1,GB1,Fulham Football Club,10000000.0,35000000.0,24,137,151,7,12,12,12,10,9,7,11,6,12,12,9,12,14,4,13,7,13,12,14,11,12,14,7,15,12,14,15,15,14,13,8,17,15,16,8,12,4,13,2,14,2,1,2,1,2,2,1,1,4,1,2,14,14,8,14,13,12,10,15,1,19,1,1,20,1,1,16,1,1,18,1,10,1,71,20,8,42777752,6842,6842,5742,African_Caribbean,127,0,0,63795.0,Unknown,29165656,27000000.0,1.0,32,858,33,1,0,1,95,8,0.6555967187086531,0.6087700534759358,0.5735294117647058,0.0615928629296634,0.0,0.0,0.0497624406101525,0.1747936984246061,0.1499763882330064,0.0,0.3488372093023257,0.25,217,30,28,15,0,4170,12,124,178,9000000,404761.90476190473,35000000.0,6500000.0,35000000.0,20000000.0,4,9000000,-0.1,-0.3076923076923077
392777,Jonathan,Panzo,2024,2425,England,London,England,25-10-00,Centre-Back,Defender,Left,188.0,30-06-25,CAA Base Ltd,https://img.a.transfermarkt.technology/portrait/header/392777-1684494358.jpg?lm=1,PO1,Rio Ave Futebol Clube,1200000.0,5000000.0,24,112,-75,6,11,10,6,11,6,11,7,10,11,12,7,12,12,12,11,12,12,9,11,11,13,12,8,7,12,11,13,13,12,13,14,13,14,13,14,12,10,12,6,13,1,2,2,1,4,1,1,1,2,3,3,13,15,6,11,9,11,12,15,1,18,20,1,12,1,14,1,1,1,1,1,1,1,72,20,11,39344397,5587,5987,3737,African_Caribbean,110,0,0,9279.0,Coventry City,28112990,2700000.0,3.0,32,858,33,1,0,1,171,2,0.5424715533209844,0.394331550802139,0.4485294117647059,0.0089512720559053,0.0,0.0,0.0057514378594648,0.0247561890472618,0.0149726381288369,0.2857142857142857,0.581395348837209,0.25,176,4,5,30,3,4766,6,40,123,1200000,-105882.35294117648,5000000.0,1000000.0,3000000.0,4000000.0,8,2300000,0.0,0.0
392881,Antonio,Candela,2024,607,Italy,La Spezia,Italy,27-04-00,Right-Back,Defender,Right,185.0,30-06-27,Esse Sports,https://img.a.transfermarkt.technology/portrait/header/392881-1717659772.jpg?lm=1,IT1,Venezia Football Club,2300000.0,2300000.0,24,136,155,12,16,15,13,16,12,5,12,6,9,15,13,8,15,11,16,11,13,12,14,13,18,16,12,15,12,10,13,13,12,13,9,17,12,13,9,16,8,12,8,16,1,3,3,3,3,3,3,1,2,1,1,13,12,9,13,12,18,11,13,1,1,1,1,1,18,1,12,16,20,12,10,14,1,70,12,20,1624188,6800,6600,6700,Mediterranean_Hispanic,136,54,7,46249.0,U.S. Salernitana 1919,1400480,9111392.0,2.0,52,787,54,1,1,3,210,11,0.6235776660492194,0.7112299465240641,0.6397058823529411,0.0446501423802658,0.3552631578947368,0.0921052631578947,0.0112528132033008,0.0112528132033008,0.0505924720131114,0.1428571428571428,0.5116279069767438,0.25,268,8,15,28,1,5994,1,12,54,2300000,130882.35294117648,2300000.0,100000.0,,350000.0,6,350000,0.0,0.35294117647058826
392956,Enrico,Delprato,2024,130,Italy,Bergamo,Italy,10-11-99,Right-Back,Defender,Right,183.0,30-06-27,Unknown,https://img.a.transfermarkt.technology/portrait/header/392956-1686206609.jpg?lm=1,IT1,Parma Calcio 1913,4500000.0,4500000.0,25,121,144,10,11,11,8,12,9,11,8,11,12,12,9,12,11,11,12,14,13,14,13,13,14,11,13,12,14,11,13,13,13,12,11,13,13,12,12,10,10,11,4,17,2,2,1,1,1,1,3,3,1,1,3,13,12,10,12,12,14,14,14,1,3,17,20,1,17,13,3,3,15,1,1,1,1,67,6,20,3832500,6050,6050,3751,Northern_European,119,0,0,11452.0,Unknown,43252473,2750000.0,1.0,52,176,54,1,1,7,155,11,0.5508070918232336,0.3958288770053475,0.5147058823529411,0.0110495583749433,0.0,0.0,0.0222555638909727,0.0222555638909727,0.0152504236228784,0.0,0.4651162790697669,0.2916666666666665,278,16,10,39,0,3003,3,3,12,6000000,371875.0,6000000.0,100000.0,200000.0,1100000.0,3,1050000,0.3333333333333333,0.6216216216216216
392959,Andrea,Colpani,2024,430,Italy,Brescia,Italy,11-05-99,Attacking Midfield,Midfield,Right,184.0,30-06-25,TMP SOCCER srl ,https://img.a.transfermarkt.technology/portrait/header/392959-1695030851.jpg?lm=1,IT1,Associazione Calcio Fiorentina,18000000.0,18000000.0,25,122,143,7,13,13,7,11,6,10,9,12,13,13,7,12,13,13,12,13,12,10,9,12,13,8,10,15,13,13,13,13,13,12,12,11,13,13,12,12,15,12,15,12,3,2,1,1,1,3,4,1,2,3,1,10,13,4,12,12,13,12,11,1,1,1,20,1,20,1,1,1,16,1,1,10,1,76,12,20,1606434,6100,6100,5500,Mediterranean_Hispanic,119,1,0,71154.0,Unknown,43081379,9000000.0,1.0,52,257,54,3,1,3,26,0,0.5574225985710506,0.5828877005347594,0.5147058823529411,0.0686988403902252,0.006578947368421,0.0,0.0897724431107777,0.0897724431107777,0.049973610378066,0.0,0.4883720930232553,0.2916666666666665,299,43,25,25,0,4132,3,10,29,16000000,839473.6842105263,18000000.0,2000000.0,75000.0,500000.0,3,2200000,-0.1111111111111111,0.06666666666666667
392966,Nadir,Zortea,2024,1390,Italy,Feltre,Italy,19-06-99,Right Midfield,Midfield,Right,175.0,30-06-28,TMP SOCCER srl ,https://img.a.transfermarkt.technology/portrait/header/392966-1695028134.jpg?lm=1,IT1,Cagliari Calcio,3000000.0,3000000.0,25,125,142,9,14,13,9,12,7,10,11,13,11,12,8,12,12,13,13,10,10,11,13,11,13,8,10,12,12,13,12,13,13,12,10,14,14,14,13,12,9,13,8,13,3,3,1,4,1,2,3,1,2,3,3,11,13,7,9,13,13,8,12,1,12,1,20,15,20,1,13,1,17,1,1,13,1,70,7,20,2305744,6248,5998,3598,Mediterranean_Hispanic,116,0,0,20109.0,Unknown,43252462,2501000.0,2.0,52,488,54,3,1,3,46,9,0.5439269648055041,0.3794652406417111,0.4926470588235294,0.0194089070467851,0.0,0.0,0.0147536884221055,0.0147536884221055,0.0138670518625517,0.1428571428571428,0.2790697674418605,0.2916666666666665,232,16,26,34,0,4027,7,15,28,3000000,184375.0,3000000.0,0.0,75000.0,300000.0,8,1725000,0.0,0.5
393239,Mitchell,Van Bergen,2024,317,Netherlands,Oss,Netherlands,27-08-99,Right Winger,Attack,Right,170.0,30-06-27,Sp international,https://img.a.transfermarkt.technology/portrait/header/393239-1723459920.jpg?lm=1,NL1,Football Club Twente,900000.0,4000000.0,25,115,135,10,9,15,9,10,7,5,11,9,4,10,9,4,10,9,10,7,11,11,10,11,12,14,5,13,4,13,11,17,14,8,9,5,16,10,8,11,6,13,14,17,2,2,2,3,1,3,1,4,3,1,2,13,11,6,10,13,13,13,10,1,1,1,1,1,1,1,8,1,17,14,1,20,1,62,8,20,2191999,5749,5749,4499,North_African__Middle_Eastern,105,0,0,4999.0,Unknown,37059427,1166666.667,3.0,67,1098,68,0,1,6,91,10,0.5109817412013761,0.4758288770053475,0.411764705882353,0.0048184301573859,0.0,0.0,0.0042510627656914,0.0197549387346836,0.0064538829800827,0.2857142857142857,0.1627906976744184,0.2916666666666665,287,27,26,7,0,8569,5,11,32,1500000,55769.230769230766,4000000.0,1500000.0,300000.0,3600000.0,4,500000,0.6666666666666666,0.25
393512,Felix,Agu,2024,86,Germany,OsnabrÃ¼ck,Germany,27-09-99,Right-Back,Defender,Right,180.0,30-06-27,TDS SPORTS,https://img.a.transfermarkt.technology/portrait/header/393512-1722887707.jpg?lm=1,L1,Sportverein Werder Bremen von 1899,6000000.0,6000000.0,25,126,145,8,11,12,8,14,6,9,8,14,12,10,8,12,13,14,10,11,11,10,8,9,12,8,7,13,10,13,15,15,14,11,11,16,15,14,10,13,5,14,6,15,1,1,1,1,2,1,1,3,3,2,2,8,14,6,10,10,13,14,16,1,18,10,20,18,20,1,1,1,12,1,1,10,1,71,12,20,4674999,6299,6299,4599,Mixed_Race,113,0,0,12997.0,Unknown,92098106,9111392.0,2.0,38,1097,40,1,1,4,194,11,0.5837523154273617,0.4865240641711229,0.4705882352941176,0.0125414370509276,0.0,0.0,0.0297574393598399,0.0297574393598399,0.0505924720131114,0.1428571428571428,0.3953488372093026,0.2916666666666665,177,9,19,16,0,3787,13,64,162,6000000,257608.69565217392,6000000.0,1000000.0,75000.0,1800000.0,1,0,0.5,9.0
393621,Douglas,Augusto,2024,995,Brazil,Rio de Janeiro,Brazil,13-01-97,Central Midfield,Midfield,Left,173.0,30-06-27,MFD Sports,https://img.a.transfermarkt.technology/portrait/header/393621-1704213513.jpg?lm=1,FR1,Football Club de Nantes,6000000.0,6000000.0,27,120,135,8,10,11,11,12,9,9,13,9,13,13,13,13,13,16,12,13,12,11,11,13,14,12,11,10,13,12,13,11,13,12,9,12,12,12,12,12,15,10,14,12,3,2,2,4,1,1,2,3,1,1,1,11,12,9,12,13,10,7,6,1,1,1,1,1,1,19,1,20,1,1,16,1,1,68,20,10,3526874,6250,6250,3030,Mediterranean_Hispanic,116,0,0,28766.0,Unknown,19259561,3173333.333,3.0,10,1234,11,3,0,3,93,1,0.5772691188145012,0.3187165775401069,0.4926470588235294,0.0277682557186268,0.0,0.0,0.0297574393598399,0.0297574393598399,0.0176023408039112,0.2857142857142857,0.2325581395348837,0.375,306,20,16,86,3,10095,6,36,141,6000000,310526.3157894737,6000000.0,1500000.0,250000.0,3500000.0,4,3250000,0.0,0.0
394134,Felix,Bacher,2024,1465,Austria,Lienz,Austria,25-10-00,Centre-Back,Defender,Right,190.0,30-06-26,YOU FIRST,https://img.a.transfermarkt.technology/portrait/header/394134-1724845183.jpg?lm=1,PO1,Grupo Desportivo Estoril Praia,500000.0,500000.0,24,101,137,3,7,8,4,10,7,14,8,9,11,11,11,13,9,11,11,10,10,12,8,10,12,5,12,5,11,15,13,9,9,11,15,14,11,12,14,8,6,12,5,10,3,2,3,3,1,1,3,3,3,2,3,10,14,7,8,12,14,14,7,1,1,20,1,1,1,17,1,12,1,1,1,1,1,0,9,20,1327999,4602,4368,2818,Northern_European,98,0,0,3016.0,Unknown,16155609,9111392.0,2.0,6,832,7,1,1,7,109,2,0.3282614448266737,0.2960427807486631,0.3602941176470588,0.0029036111188896,0.0,0.0,0.0022505626406601,0.0022505626406601,0.0505924720131114,0.1428571428571428,0.6279069767441858,0.25,194,5,5,30,3,2564,2,10,57,500000,30000.0,500000.0,50000.0,200000.0,200000.0,4,50000,0.0,0.1111111111111111
394300,Davide,Frattesi,2024,46,Italy,Roma,Italy,22-09-99,Central Midfield,Midfield,Right,178.0,30-06-28,GR Sports,https://img.a.transfermarkt.technology/portrait/header/394300-1663594621.jpg?lm=1,IT1,Football Club Internazionale Milano S.p.A.,35000000.0,35000000.0,25,140,159,7,10,15,13,13,8,14,13,6,10,14,12,12,14,14,13,14,13,14,13,14,15,12,10,15,12,15,14,15,14,12,13,16,14,14,13,13,13,12,3,13,1,1,1,2,1,4,3,1,2,1,3,10,13,5,13,16,15,11,13,1,1,1,1,1,1,15,1,20,1,1,12,1,1,74,10,20,33179997,6997,7197,5247,Mediterranean_Hispanic,141,3,0,25000.0,Unknown,43272557,23000000.0,2.0,52,1244,54,3,1,3,89,1,0.7025668166181529,0.5558288770053476,0.6764705882352942,0.0241317410948361,0.0197368421052631,0.0,0.1747936984246061,0.1747936984246061,0.1277535487096864,0.1428571428571428,0.3488372093023257,0.2916666666666665,336,56,26,29,0,5947,5,8,12,32000000,1520238.0952380951,35000000.0,3000000.0,1000000.0,5000000.0,6,16800000,-0.08571428571428572,0.06666666666666667
394327,Boubacar,Kamara,2024,405,France,Marseille,France,23-11-99,Defensive Midfield,Midfield,Right,184.0,30-06-27,Unknown,https://img.a.transfermarkt.technology/portrait/header/394327-1604256413.jpg?lm=1,GB1,Aston Villa Football Club,38000000.0,38000000.0,25,139,164,6,8,13,6,12,6,13,8,5,14,15,7,15,13,12,14,14,14,13,13,13,13,9,9,11,14,15,15,14,13,15,14,14,15,14,12,14,11,12,8,12,3,2,1,1,3,1,3,1,4,3,3,18,14,8,13,12,14,12,14,1,6,20,8,1,1,20,1,13,1,1,1,1,1,68,10,20,61429223,6950,6950,5500,African_Caribbean,139,3,0,115992.0,Unknown,48043084,9111392.0,2.0,34,919,36,3,1,1,30,4,0.6698862132839376,0.5828877005347594,0.6617647058823528,0.1119951873635462,0.0197368421052631,0.0,0.1897974493623406,0.1897974493623406,0.0505924720131114,0.1428571428571428,0.4883720930232553,0.2916666666666665,282,5,8,59,3,6621,10,86,263,38000000,1780952.380952381,38000000.0,9000000.0,10000000.0,32000000.0,1,0,0.0,0.0
394328,Rafik,Guitane,2024,1075,France,Ã‰vreux,Algeria,26-05-99,Right Winger,Attack,Left,170.0,30-06-25,KDS FM,https://img.a.transfermarkt.technology/portrait/header/394328-1724846346.jpg?lm=1,PO1,Sporting Clube de Braga,5000000.0,5000000.0,25,120,134,12,12,15,8,13,11,6,9,5,6,13,10,5,16,7,11,9,14,11,14,11,8,15,10,12,9,9,11,13,16,14,5,11,13,11,8,10,7,14,14,10,3,2,3,3,1,3,3,3,3,3,3,10,14,8,12,13,12,8,10,1,1,1,1,1,1,1,1,18,1,12,20,18,1,60,20,12,1853658,6000,6000,4008,North_African__Middle_Eastern,117,0,0,6547.0,Unknown,48043095,4125000.0,2.0,34,1723,1,0,0,6,192,10,0.5441915850754168,0.4233155080213903,0.4999999999999999,0.0063132056851682,0.0,0.0,0.0247561890472618,0.0247561890472618,0.0228895247090196,0.1428571428571428,0.1627906976744184,0.2916666666666665,181,17,13,14,0,4688,8,108,261,5000000,255263.15789473685,5000000.0,1000000.0,5000000.0,2700000.0,5,1000000,0.0,0.42857142857142855
395083,Andreaw,Gravillon,2024,3840,Guadeloupe,Pointe-Ã -Pitre,Guadeloupe,08-02-98,Centre-Back,Defender,Right,189.0,30-06-26,AIS SPORT SERVICE,https://img.a.transfermarkt.technology/portrait/header/395083-1728552938.jpg?lm=1,TR1,Adana Demirspor KulÃ¼bÃ¼,3500000.0,7000000.0,26,120,139,6,6,6,6,11,5,14,9,5,14,10,10,13,11,13,12,14,11,12,7,13,13,6,10,6,13,12,12,13,13,14,13,16,13,15,14,13,7,12,2,10,2,2,2,1,1,2,3,2,1,4,2,11,12,10,10,11,12,12,8,1,1,20,10,1,1,1,1,1,1,1,1,1,1,75,7,20,1994260,6000,6150,4750,African_Caribbean,121,4,0,6547.0,Unknown,43207127,3820000.0,5.0,41,1159,43,1,1,1,13,2,0.5640381053188674,0.5026737967914437,0.5294117647058822,0.0063132056851682,0.0263157894736842,0.0,0.0172543135783946,0.0347586896724181,0.0211950331953665,0.5714285714285714,0.6046511627906974,0.3333333333333332,261,15,4,51,4,5264,4,37,230,3000000,117000.0,7000000.0,2000000.0,175000.0,5000000.0,7,3300000,-0.1891891891891892,-0.3617021276595745
395228,Till,Cissokho,2024,2431,France,Paris,France,08-02-00,Centre-Back,Defender,Left,200.0,30-06-26,2SAgency,https://img.a.transfermarkt.technology/portrait/header/395228-1669737163.jpg?lm=1,PO1,Club Football Estrela da Amadora,1000000.0,1000000.0,24,108,137,4,5,8,7,9,6,14,6,8,13,8,6,11,9,8,11,9,12,11,9,12,14,12,12,9,13,11,8,12,11,14,18,15,11,11,13,11,10,13,10,9,1,2,1,1,3,1,2,1,1,4,2,20,12,8,10,7,13,12,14,1,1,20,1,1,1,1,1,1,1,1,1,1,1,88,20,6,1132499,5393,5393,2243,African_Caribbean,107,0,0,2795.0,Unknown,48042334,9111392.0,2.0,34,1122,36,1,0,1,55,2,0.4638793331569198,0.2345454545454545,0.4264705882352941,0.0026902097031016,0.0,0.0,0.0047511877969492,0.0047511877969492,0.0505924720131114,0.1428571428571428,0.86046511627907,0.25,183,4,2,18,3,2933,1,1,3,800000,39285.71428571428,1000000.0,200000.0,,375000.0,4,475000,-0.2,-0.2
395234,Batista,Mendy,2024,449,France,Saint-Nazaire,France,12-01-00,Defensive Midfield,Midfield,Right,191.0,30-06-27,Unknown,https://img.a.transfermarkt.technology/portrait/header/395234-1723800722.jpg?lm=1,TR1,Trabzonspor KulÃ¼bÃ¼,10000000.0,10000000.0,24,124,147,8,9,12,8,13,8,14,7,4,12,13,6,12,13,7,13,14,12,12,13,12,15,11,9,14,13,13,15,12,13,14,14,13,12,15,14,11,7,11,5,15,2,2,2,2,1,2,2,3,2,3,1,11,13,10,12,10,14,14,11,1,1,14,1,1,1,20,1,18,1,1,1,1,1,82,10,20,5539998,6200,6200,3028,North_African__Middle_Eastern,123,0,0,9847.0,Unknown,48043868,4400000.0,1.0,34,1277,36,3,1,6,204,4,0.5706536120666843,0.3185026737967914,0.5441176470588236,0.0094997426629986,0.0,0.0,0.0497624406101525,0.0497624406101525,0.0244173449262479,0.0,0.6511627906976742,0.25,187,2,4,31,0,2413,0,0,0,10000000,615625.0,10000000.0,0.0,,500000.0,2,5500000,0.05263157894736842,0.25
395236,Yacine,Adli,2024,430,France,Vitry-sur-Seine,France,29-07-00,Defensive Midfield,Midfield,Right,186.0,30-06-25,Unknown,https://img.a.transfermarkt.technology/portrait/header/395236-1725531271.jpg?lm=1,IT1,Associazione Calcio Fiorentina,15000000.0,15000000.0,24,132,155,12,13,15,11,16,14,8,13,4,6,15,10,11,15,9,12,12,14,12,14,13,15,15,10,12,7,13,13,12,14,15,9,14,13,13,12,13,11,13,7,12,1,3,1,3,3,1,3,1,3,2,3,15,16,13,12,12,14,10,12,1,1,1,1,1,1,1,10,18,10,10,20,10,1,78,10,20,11675000,6600,6600,5250,North_African__Middle_Eastern,132,0,0,19808.0,Unknown,48044568,7125000.0,2.0,34,1618,36,3,1,6,26,4,0.6235776660492194,0.5561497326203209,0.6102941176470589,0.0191182562497163,0.0,0.0,0.0747686921730432,0.0747686921730432,0.0395566543515097,0.1428571428571428,0.5348837209302322,0.25,201,16,24,26,0,3334,1,3,18,15000000,611111.1111111111,15000000.0,3000000.0,5500000.0,9000000.0,3,4500000,0.0,0.875
395237,Maxence,Caqueret,2024,1041,France,VÃ©nissieux,France,15-02-00,Central Midfield,Midfield,Right,174.0,30-06-27,Unknown,https://img.a.transfermarkt.technology/portrait/header/395237-1672831706.jpg?lm=1,FR1,Olympique Lyonnais,18000000.0,25000000.0,24,137,156,10,6,12,6,15,7,6,8,4,14,15,9,13,15,15,14,14,14,13,15,13,15,13,14,14,15,15,16,12,13,12,7,14,12,16,11,14,10,13,6,15,1,1,1,3,1,2,3,1,2,3,3,17,13,7,14,12,15,13,17,1,1,1,1,1,1,19,1,20,1,1,15,1,1,63,10,20,21330001,7000,6850,4500,Mediterranean_Hispanic,136,0,0,57533.0,Unknown,48044737,9111392.0,2.0,34,1639,36,3,1,3,143,1,0.6566551997883038,0.4759358288770053,0.6397058823529411,0.0555461676099138,0.0,0.0,0.0897724431107777,0.1247811952988247,0.0505924720131114,0.1428571428571428,0.2558139534883721,0.25,240,13,23,31,0,5220,4,9,36,15000000,763157.8947368421,25000000.0,4000000.0,,12000000.0,0,0,-0.25,-0.16666666666666666
395659,Ivan,Sergeev,2024,2696,Russia,"Cherepovets, Vologda Oblast",Russia,11-05-95,Centre-Forward,Attack,Right,184.0,30-06-27,Pavel Andreev,https://img.a.transfermarkt.technology/portrait/header/395659-1726166199.png?lm=1,RU1,PFK Krylya Sovetov Samara,4000000.0,6000000.0,29,125,128,8,7,10,15,13,6,10,9,6,6,10,14,6,13,5,17,10,14,14,10,13,2,14,6,16,8,13,12,13,13,14,9,15,13,14,10,14,6,14,6,14,1,3,4,2,1,2,2,2,1,3,3,14,13,6,12,11,10,10,19,1,1,1,1,6,5,1,8,7,7,12,1,9,20,80,11,20,2655110,6000,6000,3764,Northern_European,123,0,0,29489.0,Unknown,58106360,1450000.0,3.0,78,352,81,0,1,7,149,3,0.5441915850754168,0.3972192513368983,0.5441176470588236,0.0284663970019515,0.0,0.0,0.0197549387346836,0.0297574393598399,0.0080280007777993,0.2857142857142857,0.4883720930232553,0.4583333333333332,339,155,47,20,0,6651,2,3,25,3000000,141666.66666666666,6000000.0,1000000.0,,,5,2500000,-0.4,-0.5
395695,Elisha,Owusu,2024,290,France,Montreuil,Ghana,07-11-97,Defensive Midfield,Midfield,Right,182.0,30-06-27,Unknown,https://img.a.transfermarkt.technology/portrait/header/395695-1626767315.jpg?lm=1,FR1,Association de la Jeunesse auxerroise,3000000.0,7500000.0,27,121,129,8,8,9,8,11,7,11,9,8,13,13,8,14,12,13,14,13,11,13,10,12,12,10,14,10,15,15,15,13,11,13,10,14,12,16,13,12,11,10,8,11,2,1,3,1,2,2,4,3,1,1,1,7,14,10,13,12,13,14,10,1,1,13,1,1,1,20,1,18,1,1,1,1,1,72,8,20,1103367,5736,5740,4940,African_Caribbean,121,2,0,15500.0,Unknown,48036651,9111392.0,2.0,34,979,41,3,1,1,23,4,0.509790949986769,0.5229946524064171,0.5294117647058822,0.0149583770677486,0.0131578947368421,0.0,0.0147536884221055,0.0372593148287071,0.0505924720131114,0.1428571428571428,0.4418604651162785,0.375,270,3,8,45,1,5780,6,41,108,3000000,138095.2380952381,7500000.0,2000000.0,,100000.0,3,4400000,0.2,0.2
396342,Toni,Borevkovi?,2024,2420,Croatia,Slavonski Brod,Croatia,18-06-97,Centre-Back,Defender,Right,193.0,30-06-26,Team of Future,https://img.a.transfermarkt.technology/portrait/header/396342-1695208414.jpg?lm=1,PO1,VitÃ³ria Sport Clube,4000000.0,4000000.0,27,124,130,4,8,8,5,11,4,11,7,7,14,13,7,13,11,10,13,13,14,13,12,12,12,4,10,7,13,13,12,12,10,11,16,13,13,12,15,11,9,7,10,12,2,3,2,1,3,3,3,3,3,1,2,14,12,6,12,8,15,16,15,1,1,20,17,1,1,1,1,1,1,1,1,1,1,86,11,20,1425599,6200,5476,5023,Northern_European,122,0,0,4250.0,HNK Hajduk Split,24048102,1200000.0,1.0,24,1383,25,1,1,7,217,2,0.4748610743582958,0.5318716577540107,0.536764705882353,0.004095182825145,0.0,0.0,0.0197549387346836,0.0197549387346836,0.0066390733075918,0.0,0.6976744186046511,0.375,274,3,2,66,3,4864,3,23,81,5000000,255263.15789473685,5000000.0,1000000.0,,150000.0,4,1650000,0.6666666666666666,4.0
396394,Valeriy,Bondar,2024,660,Ukraine,Kharkiv,Ukraine,27-02-99,Centre-Back,Defender,Right,185.0,31-12-27,Unknown,https://img.a.transfermarkt.technology/portrait/header/396394-1723486447.png?lm=1,UKR1,FC Shakhtar Donetsk,5000000.0,5000000.0,25,120,136,5,7,9,5,12,4,12,5,7,11,11,6,13,12,14,12,16,10,11,12,12,14,7,15,11,16,14,10,12,13,13,13,14,13,13,12,11,10,13,11,5,1,1,2,2,3,2,2,1,2,3,2,5,7,4,20,12,17,14,10,1,1,20,1,1,1,1,1,1,1,1,1,1,1,76,10,20,2536715,6000,6000,4500,Northern_European,118,2,0,8119.0,Unknown,71093182,9111392.0,2.0,103,722,101,1,1,7,72,2,0.5441915850754168,0.4759358288770053,0.5073529411764706,0.0078311560273346,0.0131578947368421,0.0,0.0247561890472618,0.0247561890472618,0.0505924720131114,0.1428571428571428,0.5116279069767438,0.2916666666666665,134,2,2,28,0,5904,4,48,131,6000000,396666.6666666667,6000000.0,500000.0,,1800000.0,1,1100000,0.2,0.2
396516,Nicholas,Opoku,2024,10484,Ghana,Kumasi,Ghana,11-08-97,Centre-Back,Defender,Right,190.0,30-06-26,Unknown,https://img.a.transfermarkt.technology/portrait/header/396516-1727695066.jpg?lm=1,TR1,Kas?mpa?a Spor KulÃ¼bÃ¼,1200000.0,1200000.0,27,120,138,8,8,8,8,6,6,15,6,14,13,11,6,13,13,13,13,14,11,12,8,12,14,8,10,11,13,13,13,12,10,14,14,12,13,14,15,12,13,10,4,8,1,3,1,3,3,2,3,2,3,2,3,10,14,3,6,13,16,13,18,1,1,20,1,1,1,1,1,1,1,1,1,1,1,81,7,20,1545793,5991,5991,3991,African_Caribbean,120,13,1,7107.0,Unknown,13169837,1500000.0,1.0,39,768,41,1,1,1,117,2,0.5430007938608098,0.4214973262032085,0.5220588235294117,0.0068539513541333,0.0855263157894736,0.0131578947368421,0.0057514378594648,0.0057514378594648,0.0083057862718408,0.0,0.6279069767441858,0.375,178,0,4,35,1,4271,2,43,189,1300000,34210.52631578947,1300000.0,200000.0,,700000.0,3,500000,0.4444444444444444,0.4444444444444444
396908,Yunus,Akgün,2024,141,TÃ¼rkiye,Istanbul,TÃ¼rkiye,07-07-00,Right Winger,Attack,Left,173.0,30-06-26,DW Sports Management,https://img.a.transfermarkt.technology/portrait/header/396908-1671104289.png?lm=1,TR1,Galatasaray Spor KulÃ¼bÃ¼,6500000.0,8500000.0,24,125,140,13,12,15,11,13,10,9,12,5,4,13,10,5,15,12,10,12,12,12,12,12,15,16,8,12,6,12,13,15,16,12,7,14,13,12,7,13,10,13,10,10,4,3,1,3,3,1,3,3,1,2,2,15,16,8,12,12,14,14,14,1,1,1,1,1,1,1,12,1,12,18,12,20,8,65,20,10,6231748,6345,6345,4995,Mediterranean_Hispanic,123,3,1,1381.0,Unknown,70110533,9111392.0,2.0,100,667,100,0,0,3,102,10,0.5898385816353533,0.5288770053475935,0.5441176470588236,0.0013248268889646,0.0197368421052631,0.0131578947368421,0.032258064516129,0.0422605651412853,0.0505924720131114,0.1428571428571428,0.2325581395348837,0.25,216,48,49,23,0,4389,8,22,34,11000000,456250.0,11000000.0,1000000.0,2000000.0,2000000.0,5,3950000,1.2,0.8333333333333334
397033,Sandro,Tonali,2024,762,Italy,Lodi,Italy,08-05-00,Central Midfield,Midfield,Right,181.0,30-06-28,GR Sports,https://img.a.transfermarkt.technology/portrait/header/397033-1688389270.jpg?lm=1,GB1,Newcastle United Football Club,38000000.0,60000000.0,24,156,172,14,12,13,10,15,15,9,13,11,13,15,11,14,15,14,16,16,14,15,14,14,16,12,14,14,14,16,16,13,14,15,10,14,14,14,12,16,15,13,6,10,2,1,3,2,2,2,2,2,2,1,1,9,16,3,14,14,15,15,17,1,1,1,1,1,1,19,1,20,1,1,14,1,1,79,12,20,126967514,7800,7800,6900,Mediterranean_Hispanic,155,11,0,89038.0,Unknown,43298481,36590000.0,2.0,52,854,54,3,1,3,137,1,0.7823498279968246,0.7326203208556149,0.7794117647058822,0.0859679395755339,0.0723684210526315,0.0,0.1897974493623406,0.2998249562390597,0.2032556459901664,0.1428571428571428,0.418604651162791,0.25,315,29,33,65,1,3697,12,17,17,38000000,1887500.0,60000000.0,20000000.0,15000000.0,32000000.0,2,10000000,0.0,-0.05
397090,Unknown,Davidson,2024,6890,Brazil,Rio de Janeiro,Brazil,05-03-91,Left Winger,Attack,Right,177.0,30-06-25,UJ Football Talent,https://img.a.transfermarkt.technology/portrait/header/397090-1712671366.png?lm=1,TR1,?stanbul Ba?ak?ehir Futbol KulÃ¼bÃ¼,850000.0,4400000.0,33,130,135,10,12,14,14,14,10,8,12,3,6,14,11,9,14,12,11,13,12,12,14,12,12,13,10,14,6,11,13,14,15,14,9,13,13,10,11,12,10,11,6,10,2,1,4,1,3,2,3,3,1,1,1,11,14,12,9,14,12,9,11,1,1,1,1,1,1,1,13,1,13,20,12,18,12,63,12,20,347975206,6562,6483,6304,Mixed_Race,127,0,0,15384.0,Unknown,19126109,1100000.0,3.0,10,1234,11,0,1,4,4,7,0.6080973802593279,0.6688770053475935,0.5735294117647058,0.0148463654648916,0.0,0.0,0.0040010002500625,0.0217554388597149,0.0060835023195088,0.2857142857142857,0.3255813953488373,0.625,380,90,65,41,1,6286,3,3,7,750000,29000.0,4400000.0,1500000.0,,,6,1675000,-0.11764705882352941,-0.16666666666666666
397171,Gideon,Mensah,2024,290,Ghana,Accra,Ghana,18-07-98,Left-Back,Defender,Left,178.0,30-06-26,HC,https://img.a.transfermarkt.technology/portrait/header/397171-1565700436.jpg?lm=1,FR1,Association de la Jeunesse auxerroise,2500000.0,3000000.0,26,123,135,9,9,13,4,12,9,11,8,7,12,12,8,14,12,12,13,13,12,13,12,11,12,13,8,10,9,13,15,16,15,8,10,12,17,13,12,13,7,10,7,3,4,1,2,2,3,1,2,2,4,2,2,12,11,6,10,11,13,12,13,1,20,1,1,15,1,1,1,1,1,1,1,1,1,64,20,9,2329883,6150,6150,4700,African_Caribbean,123,11,0,6730.0,Unknown,16199712,9111392.0,2.0,39,20,41,1,0,1,23,8,0.5640381053188674,0.4973262032085561,0.5441176470588236,0.0064899136448479,0.0723684210526315,0.0,0.0122530632658164,0.0147536884221055,0.0505924720131114,0.1428571428571428,0.3488372093023257,0.3333333333333332,212,1,12,40,1,1974,9,29,73,3500000,161904.7619047619,3500000.0,500000.0,300000.0,900000.0,5,1800000,0.4,0.4
397225,Alessandro,Zanoli,2024,252,Italy,Carpi,Italy,03-10-00,Right-Back,Defender,Right,188.0,30-06-25,Gea World,https://img.a.transfermarkt.technology/portrait/header/397225-1673603620.jpg?lm=1,IT1,Genoa Cricket and Football Club,5000000.0,6000000.0,24,123,146,8,11,9,6,11,6,11,8,14,12,11,7,14,11,9,13,12,12,14,10,12,13,6,7,12,13,13,13,13,12,14,13,14,14,14,14,12,7,9,6,14,3,3,1,2,3,4,2,2,1,2,2,15,14,6,11,13,14,10,12,1,13,16,20,10,14,1,1,1,14,1,1,1,1,81,10,20,4807499,6150,5800,3500,Mediterranean_Hispanic,123,0,0,2115.0,Unknown,43390940,1500000.0,1.0,52,319,54,1,1,3,104,11,0.5177295580841492,0.3689839572192513,0.5441176470588236,0.0020335899622153,0.0,0.0,0.0247561890472618,0.0297574393598399,0.0083057862718408,0.0,0.581395348837209,0.25,219,5,9,23,0,3124,5,11,25,6000000,493750.0,6000000.0,1000000.0,75000.0,200000.0,6,3800000,0.2,0.0
397486,Dennis,Man,2024,130,Romania,Vladimirescu,Romania,26-08-98,Right Winger,Attack,Left,183.0,30-06-27,Ioan Becali,https://img.a.transfermarkt.technology/portrait/header/397486-1718259797.jpg?lm=1,IT1,Parma Calcio 1913,10000000.0,11000000.0,26,120,135,11,10,12,11,13,7,12,12,7,5,12,10,7,14,11,11,12,11,10,11,11,16,13,8,11,7,8,12,15,14,12,10,13,12,15,13,10,4,10,2,11,1,1,1,1,3,3,2,2,2,2,2,10,18,6,13,10,17,13,8,1,1,1,1,1,1,1,10,1,12,1,7,20,10,82,20,10,1798818,6000,6500,5450,Mediterranean_Hispanic,117,14,4,32018.0,Unknown,57142187,4341666.667,3.0,77,1622,80,0,0,3,155,10,0.6103466525535857,0.5775401069518716,0.4999999999999999,0.0309084430676888,0.0921052631578947,0.0526315789473684,0.0497624406101525,0.0547636909227306,0.0240932618517181,0.2857142857142857,0.4651162790697669,0.3333333333333332,317,94,49,34,1,7955,14,43,91,17000000,583620.6896551724,17000000.0,2000000.0,250000.0,5500000.0,2,4600000,0.7,2.4
397676,Dani,Cárdenas,2024,367,Spain,Terrassa,Spain,28-03-97,Goalkeeper,Goalkeeper,Right,186.0,30-06-27,Identity Sports,https://img.a.transfermarkt.technology/portrait/header/397676-1663571879.jpg?lm=1,ES1,Rayo Vallecano de Madrid S.A.D.,1800000.0,2000000.0,27,127,142,4,2,2,2,12,8,8,3,3,1,14,2,1,15,12,13,12,12,13,7,13,11,7,7,3,12,11,12,10,14,10,13,13,11,12,11,13,8,13,7,15,13,12,12,8,13,15,14,15,13,12,10,10,14,8,14,14,13,13,9,20,1,1,1,1,1,1,1,1,1,1,1,1,1,74,8,20,2640357,6343,6343,3843,Mediterranean_Hispanic,127,0,0,9588.0,Unknown,67225564,1300000.0,1.0,89,1485,89,2,1,3,163,5,0.5895739613654406,0.4056684491978609,0.5735294117647058,0.0092496477911022,0.0,0.0,0.0087521880470117,0.0097524381095273,0.0071946442956748,0.0,0.5348837209302322,0.375,0,0,0,0,0,0,2,9,56,1800000,83333.33333333333,2000000.0,200000.0,,50000.0,2,500000,0.0,0.0
398065,Harvey,Barnes,2024,762,England,Burnley,England,09-12-97,Left Winger,Attack,Right,182.0,30-06-28,Wasserman,https://img.a.transfermarkt.technology/portrait/header/398065-1700650664.jpg?lm=1,GB1,Newcastle United Football Club,35000000.0,35000000.0,27,144,165,9,13,16,12,14,11,8,14,12,6,12,8,7,15,9,12,9,12,9,13,12,12,15,7,12,6,12,12,15,15,13,10,13,16,14,12,8,2,12,5,12,1,3,2,1,4,1,1,1,3,1,3,15,11,1,13,12,14,12,12,1,1,1,1,7,1,1,18,10,13,20,15,15,12,66,13,20,45103386,7200,7200,5500,Northern_European,141,1,0,115992.0,Unknown,28100207,44000000.0,1.0,32,279,33,0,1,7,137,7,0.702963747023022,0.5828877005347594,0.6764705882352942,0.1119951873635462,0.006578947368421,0.0,0.1747936984246061,0.1747936984246061,0.2444234562071168,0.0,0.4418604651162785,0.375,350,88,58,16,0,6975,7,63,131,35000000,1938888.888888889,35000000.0,4500000.0,,1500000.0,4,6900000,0.0,0.0
398073,Achraf,Hakimi,2024,583,Spain,Madrid,Morocco,04-11-98,Right-Back,Defender,Right,181.0,30-06-26,Footfeel ISM  ,https://img.a.transfermarkt.technology/portrait/header/398073-1672304327.jpg?lm=1,FR1,Paris Saint-Germain Football Club,60000000.0,70000000.0,26,160,172,7,15,13,14,14,12,8,13,12,10,14,8,13,14,14,13,12,12,10,13,12,15,14,8,18,10,12,14,18,14,14,9,17,20,14,11,14,8,13,4,15,3,2,2,3,2,3,3,1,1,1,2,15,16,10,12,14,14,11,13,1,12,1,20,13,20,1,12,1,17,8,1,10,1,73,10,20,164955893,8000,8000,7900,North_African__Middle_Eastern,139,51,8,199067.0,Unknown,67228634,9111392.0,2.0,89,892,67,1,1,6,154,11,0.808811854988092,0.8395721925133689,0.6617647058823528,0.1922138417372613,0.3355263157894737,0.1052631578947368,0.2998249562390597,0.3498374593648412,0.0505924720131114,0.1428571428571428,0.418604651162791,0.3333333333333332,328,42,67,51,3,8689,6,15,67,60000000,2298076.923076923,70000000.0,6000000.0,300000.0,30000000.0,4,21200000,0.0,-0.07692307692307693
398184,Ferran,Torres,2024,131,Spain,Foios,Spain,29-02-00,Right Winger,Attack,Right,184.0,30-06-27,LEADERBROCK,https://img.a.transfermarkt.technology/portrait/header/398184-1699383547.jpg?lm=1,ES1,Futbol Club Barcelona,30000000.0,50000000.0,24,154,167,8,13,15,14,14,9,10,12,7,6,13,12,7,15,8,13,10,13,13,13,13,15,15,8,14,7,12,12,17,15,12,12,15,16,12,11,11,6,13,4,14,1,4,3,2,1,1,1,3,2,1,2,11,14,7,12,14,15,14,15,1,1,1,1,1,1,1,13,1,14,19,12,20,18,77,11,20,74140000,7698,7698,7248,Mediterranean_Hispanic,144,28,13,70000.0,Unknown,89056845,44250000.0,2.0,89,497,89,0,1,3,96,10,0.7688541942312781,0.7698395721925133,0.6985294117647058,0.0675845180652506,0.1842105263157894,0.1710526315789473,0.1497874468617154,0.2498124531132783,0.2458123836773243,0.1428571428571428,0.4883720930232553,0.25,291,61,37,30,2,7985,6,47,89,28000000,1173913.043478261,50000000.0,5000000.0,12000000.0,50000000.0,2,0,-0.06666666666666667,-0.2
399369,Beni,Baningime,2024,43,DR Congo,Kinshasa,DR Congo,09-09-98,Defensive Midfield,Midfield,Right,178.0,31-05-26,Triple S Sports,https://img.a.transfermarkt.technology/portrait/header/399369-1514553831.jpg?lm=1,SC1,Heart of Midlothian Football Club,1200000.0,3000000.0,26,116,136,5,7,10,7,12,5,11,7,5,13,11,9,15,13,14,15,15,14,11,10,13,15,10,10,8,13,15,16,12,13,15,11,14,11,14,12,14,12,13,5,10,1,2,1,1,1,2,3,4,2,2,1,14,8,5,11,14,11,15,15,1,1,1,1,1,1,16,1,20,1,1,1,1,1,0,8,20,2603348,5800,5800,3500,African_Caribbean,112,0,0,3480.0,Unknown,28106923,9111392.0,2.0,27,729,29,3,1,1,112,4,0.5177295580841492,0.3689839572192513,0.463235294117647,0.0033516575303179,0.0,0.0,0.0057514378594648,0.0147536884221055,0.0505924720131114,0.1428571428571428,0.3488372093023257,0.3333333333333332,166,3,8,31,0,5256,7,102,438,1200000,11111.111111111111,3000000.0,500000.0,,2000000.0,3,300000,-0.2,0.3333333333333333
399383,Mathieu,Cafaro,2024,618,France,Saint-Doulchard,France,25-03-97,Right Winger,Attack,Right,175.0,30-06-25,One Team Football ,https://img.a.transfermarkt.technology/portrait/header/399383-1727721832.jpg?lm=1,FR1,Association sportive de Saint-Ã‰tienne Loire,2500000.0,7500000.0,27,125,135,14,13,12,10,14,14,8,15,5,10,13,13,10,14,10,12,9,12,12,14,12,13,12,8,11,9,14,13,13,14,12,8,14,13,14,9,11,9,12,6,13,1,1,1,2,1,2,1,4,2,1,2,12,15,12,12,10,12,12,10,1,1,1,1,14,12,1,17,15,14,20,17,14,1,60,8,20,5517000,6242,6242,3892,Mediterranean_Hispanic,124,0,0,6499.0,AS Saint-Etienne,48040712,375000.0,2.0,34,1272,36,0,1,3,25,10,0.5762106377348505,0.4109090909090909,0.5514705882352942,0.0062668560563997,0.0,0.0,0.0122530632658164,0.0372593148287071,0.0020556126559071,0.1428571428571428,0.2790697674418605,0.375,214,31,25,41,2,3871,7,19,41,2000000,92500.0,7500000.0,2000000.0,,,3,2000000,-0.2,-0.2
399434,Marcus,Tavernier,2024,989,England,Leeds,England,22-03-99,Left Midfield,Midfield,Left,178.0,30-06-28,StormSportsX,https://img.a.transfermarkt.technology/portrait/header/399434-1700650360.jpg?lm=1,GB1,Association Football Club Bournemouth,20000000.0,20000000.0,25,127,142,12,12,14,11,13,12,7,11,6,11,13,11,9,13,10,11,11,11,10,11,11,12,12,10,14,10,14,15,14,13,13,10,10,14,14,10,12,7,11,8,16,1,2,3,3,1,1,1,1,2,3,2,12,14,9,11,11,10,10,12,1,8,1,8,14,14,1,12,18,12,15,20,15,10,0,20,11,13857438,6350,6350,3500,African_Caribbean,123,0,0,28998.0,Unknown,29162667,11900000.0,1.0,32,810,33,3,0,1,22,6,0.590500132310135,0.3689839572192513,0.5441176470588236,0.0279922789243409,0.0,0.0,0.0997749437359339,0.0997749437359339,0.0660851690324731,0.0,0.3488372093023257,0.2916666666666665,279,44,36,32,2,5203,5,30,86,20000000,1161764.705882353,20000000.0,200000.0,,2000000.0,1,5500000,0.0,0.17647058823529413
399543,Rémi,Oudin,2024,1005,France,ChÃ¢lons-en-Champagne,France,18-11-96,Attacking Midfield,Midfield,Left,186.0,30-06-26,Carrierefoot,https://img.a.transfermarkt.technology/portrait/header/399543-1662015046.jpg?lm=1,IT1,Unione Sportiva Lecce,3500000.0,11000000.0,28,122,135,11,13,13,10,13,10,12,13,5,6,14,12,7,14,10,11,13,14,12,11,10,12,13,10,13,10,14,13,13,13,12,12,14,13,12,13,14,10,12,10,11,1,3,3,3,2,2,4,3,1,4,3,13,14,3,14,10,14,10,12,1,1,1,1,1,1,1,1,1,1,15,15,20,12,81,20,10,3208681,6100,6400,3950,Northern_European,122,0,0,25298.0,Salento,48033600,5500000.0,2.0,34,359,36,3,0,7,206,0,0.5971156390579518,0.4171122994652406,0.536764705882353,0.0244194950401069,0.0,0.0,0.0172543135783946,0.0547636909227306,0.0305286257951609,0.1428571428571428,0.5348837209302322,0.4166666666666665,292,54,29,24,0,3656,0,0,0,2500000,112500.0,11000000.0,2000000.0,,800000.0,2,3000000,-0.2857142857142857,-0.2857142857142857
399776,Pau,Torres,2024,405,Spain,Villarreal,Spain,16-01-97,Centre-Back,Defender,Left,192.0,30-06-28,InterStarDeporte,https://img.a.transfermarkt.technology/portrait/header/399776-1691079911.jpg?lm=1,GB1,Aston Villa Football Club,45000000.0,50000000.0,27,157,167,7,8,11,6,14,5,16,7,7,16,14,8,16,14,13,15,14,12,15,11,14,13,5,11,6,16,14,15,15,11,6,17,14,15,16,16,13,6,12,7,14,1,1,1,2,3,2,2,2,1,2,2,17,16,4,17,10,14,14,13,1,1,20,1,1,1,14,1,10,1,1,1,1,1,80,20,9,60000001,7850,7850,6500,Mediterranean_Hispanic,155,19,1,56871.0,Unknown,67217522,33000000.0,1.0,89,1602,89,1,0,3,30,2,0.7889653347446415,0.6898395721925134,0.7794117647058822,0.0549069289798157,0.125,0.0131578947368421,0.2248062015503876,0.2498124531132783,0.1833106475179866,0.0,0.6744186046511627,0.375,343,17,7,46,0,4179,5,32,68,45000000,1726923.076923077,50000000.0,5000000.0,,500000.0,3,3000000,0.0,0.0
400131,Siebe,Van Der Heyden,2024,237,Belgium,Denderleeuw,Belgium,30-05-98,Centre-Back,Defender,Left,185.0,30-06-28,KV Sports Management,https://img.a.transfermarkt.technology/portrait/header/400131-1642262598.jpg?lm=1,ES1,Real Club Deportivo Mallorca S.A.D.,2000000.0,4000000.0,26,120,130,8,8,11,8,11,10,12,11,3,12,12,6,10,12,12,12,11,12,15,8,14,7,11,13,14,11,14,12,12,11,14,12,12,12,12,14,15,14,12,8,16,1,3,2,3,1,1,4,3,1,2,3,20,11,3,11,11,11,9,17,1,14,20,1,1,1,19,1,1,1,1,1,1,1,76,20,11,3104242,6012,6012,4020,Northern_European,117,1,0,3499.0,Unknown,18087990,1400000.0,2.0,7,409,8,1,0,7,166,2,0.5457793066948928,0.4245989304812834,0.4999999999999999,0.0033700042583721,0.006578947368421,0.0,0.0097524381095273,0.0197549387346836,0.0077502152837578,0.1428571428571428,0.5116279069767438,0.3333333333333332,172,4,5,63,0,4320,3,5,34,1500000,71052.63157894737,4000000.0,1000000.0,150000.0,275000.0,3,1200000,-0.25,-0.5
400489,Eljif,Elmas,2024,23826,Macedonia,Skopje,North Macedonia,24-09-99,Attacking Midfield,Midfield,Right,184.0,30-06-28,Unknown,https://img.a.transfermarkt.technology/portrait/header/400489-1709127683.jpg?lm=1,L1,RasenBallsport Leipzig,15000000.0,26000000.0,25,143,157,10,13,15,12,15,11,13,13,6,8,16,11,11,15,14,13,13,14,11,12,13,13,14,8,15,11,15,15,14,14,14,12,15,13,13,12,12,11,12,7,16,2,2,1,3,2,3,4,3,3,1,1,13,15,8,10,13,13,8,8,1,1,1,1,1,1,10,16,20,13,17,19,14,10,68,12,20,19318000,7150,6287,6035,Mediterranean_Hispanic,140,42,9,36922.0,Unknown,47064795,13960000.0,3.0,60,1381,71,3,1,3,162,0,0.5821645938078857,0.6401069518716577,0.6691176470588234,0.0356438301401979,0.2763157894736842,0.1184210526315789,0.0747686921730432,0.1297824456114028,0.0775299313869829,0.2857142857142857,0.4883720930232553,0.2916666666666665,305,32,21,43,1,5346,9,31,49,12000000,515217.39130434784,26000000.0,5000000.0,500000.0,18000000.0,3,11000000,-0.4,-0.5
400536,Mads,Hermansen,2024,1003,Denmark,Odense,Denmark,11-07-00,Goalkeeper,Goalkeeper,Right,187.0,30-06-28,Unknown,https://img.a.transfermarkt.technology/portrait/header/400536-1707386039.jpg?lm=1,GB1,Leicester City Football Club,9000000.0,9000000.0,24,118,139,2,3,1,1,4,6,8,2,1,3,10,3,3,9,8,12,12,12,11,11,12,11,1,11,2,12,15,11,11,13,11,13,15,11,12,11,10,4,11,8,12,14,13,12,7,12,10,14,14,9,12,11,9,15,4,16,10,12,18,17,20,1,1,1,1,1,1,1,1,1,1,1,1,1,81,6,20,1457304,5950,5950,1750,Northern_European,116,0,0,1344.0,Unknown,27120988,7700000.0,1.0,28,1070,30,2,1,7,127,5,0.5375760783275999,0.1818181818181818,0.4926470588235294,0.0012890990501222,0.0,0.0,0.0447611902975743,0.0447611902975743,0.042751187532987,0.0,0.5581395348837206,0.25,0,0,0,0,0,0,4,20,47,12000000,795000.0,12000000.0,0.0,75000.0,200000.0,2,3525000,0.3333333333333333,0.3333333333333333
400548,Victor,Jensen,2024,200,Denmark,KÃ¸benhavn,Denmark,08-02-00,Attacking Midfield,Midfield,Left,175.0,30-06-26,People In Sport,https://img.a.transfermarkt.technology/portrait/header/400548-1723460317.jpg?lm=1,NL1,Football Club Utrecht,2000000.0,2000000.0,24,118,135,13,10,11,12,13,12,8,10,5,4,14,10,4,13,10,11,6,14,12,13,11,13,12,5,11,9,13,11,12,11,9,8,12,11,12,6,8,6,8,6,16,2,4,3,4,1,2,1,3,3,3,3,11,14,6,14,7,11,12,8,1,1,1,1,1,1,18,14,20,14,12,17,12,1,62,20,17,84302,5200,5303,3510,Northern_European,103,0,0,1373.0,Rosenborg BK,27135741,3500000.0,1.0,28,778,30,3,0,7,92,0,0.4519714210108494,0.3700534759358288,0.3970588235294117,0.0013171019508365,0.0,0.0,0.0097524381095273,0.0097524381095273,0.0194172060335009,0.0,0.2790697674418605,0.25,237,55,29,16,1,8081,3,19,60,2300000,128125.0,2300000.0,200000.0,250000.0,700000.0,5,700000,0.15,0.5333333333333333
400713,Daniil,Fomin,2024,121,Russia,"Tikhoretsk, Krasnodar Region",Russia,02-03-97,Defensive Midfield,Midfield,Right,187.0,30-06-29,FM Sports Agency,https://img.a.transfermarkt.technology/portrait/header/400713-1721727868.png?lm=1,RU1,FK Dinamo Moskva,8000000.0,9000000.0,27,125,140,12,10,10,10,12,14,12,14,11,14,12,16,12,12,8,14,12,14,13,11,14,18,10,12,12,12,15,15,12,11,10,13,14,12,16,11,15,9,13,5,12,3,3,1,1,2,3,1,2,3,1,2,20,15,5,13,14,18,15,13,1,1,8,7,1,1,17,1,20,1,1,12,1,1,78,8,20,4699152,6000,6000,3501,Northern_European,125,8,0,28962.0,Unknown,58104504,2230000.0,2.0,78,1491,81,3,1,7,74,4,0.5441915850754168,0.369090909090909,0.5588235294117647,0.0279575167027646,0.0526315789473684,0.0,0.0397599399849962,0.0447611902975743,0.0123614544848468,0.1428571428571428,0.5581395348837206,0.375,348,54,31,56,1,4879,5,10,16,8000000,343478.26086956525,9000000.0,1000000.0,100000.0,400000.0,3,1350000,0.0,0.06666666666666667
401173,Jadon,Sancho,2024,631,England,London,England,25-03-00,Left Winger,Attack,Right,180.0,30-06-25,Unknown,https://img.a.transfermarkt.technology/portrait/header/401173-1688564217.jpg?lm=1,GB1,Chelsea Football Club,30000000.0,130000000.0,24,155,177,13,13,18,14,16,13,5,10,6,7,16,12,7,18,10,15,9,14,12,15,14,13,16,6,15,6,13,13,15,18,14,9,13,15,13,8,11,5,15,6,14,1,2,2,3,2,3,2,1,2,3,4,12,17,14,9,14,12,13,10,1,1,1,1,1,1,1,20,1,18,20,14,18,10,76,9,20,142837290,7747,7497,6747,Mixed_Race,148,23,3,318977.0,Unknown,28108490,35254000.0,3.0,32,858,33,0,1,4,50,7,0.7422598571050543,0.7162566844919785,0.7279411764705881,0.3080010081044257,0.1513157894736842,0.0394736842105263,0.1497874468617154,0.6499124781195299,0.1958332175893775,0.2857142857142857,0.3953488372093026,0.25,307,91,90,10,1,9547,13,56,48,30000000,961538.4615384615,130000000.0,17000000.0,80000000.0,100000000.0,3,15000000,0.0,0.2
401320,Dara,O'Shea,2024,677,Ireland,Dublin,Ireland,04-03-99,Centre-Back,Defender,Right,189.0,30-06-29,Unique Sports Group,https://img.a.transfermarkt.technology/portrait/header/401320-1632909442.jpg?lm=1,GB1,Ipswich Town Football Club,10000000.0,10000000.0,25,119,140,6,6,7,9,11,11,14,8,10,13,11,6,13,12,15,12,15,10,12,7,11,14,2,13,10,13,13,14,13,11,13,14,12,12,13,13,12,11,11,7,12,1,2,2,3,2,1,2,1,2,3,2,12,10,6,14,12,14,12,11,1,10,20,16,1,1,1,1,1,1,1,1,1,1,0,8,20,4823702,5940,6240,4001,Northern_European,118,13,0,17399.0,Unknown,28106528,11000000.0,2.0,49,433,52,1,1,7,115,2,0.5759460174649378,0.4225668449197861,0.5073529411764706,0.0167920842559001,0.0855263157894736,0.0,0.0497624406101525,0.0497624406101525,0.0610850301397261,0.1428571428571428,0.6046511627906974,0.2916666666666665,242,14,9,33,1,3699,2,31,154,14000000,865625.0,14000000.0,100000.0,,1000000.0,2,5000000,1.0,1.0
401356,Edson,Álvarez,2024,379,Mexico,Tlalnepantla,Mexico,24-10-97,Defensive Midfield,Midfield,Right,190.0,30-06-28,PROMOFUT,https://img.a.transfermarkt.technology/portrait/header/401356-1698343328.jpeg?lm=1,GB1,West Ham United Football Club,35000000.0,35000000.0,27,150,157,5,7,8,11,14,6,14,8,9,15,14,11,15,13,17,16,16,14,15,14,14,13,12,14,13,14,16,16,12,13,15,14,15,12,16,12,15,11,13,4,14,1,2,2,4,3,2,1,2,2,4,2,13,13,10,12,12,14,10,11,1,1,20,13,1,1,18,1,17,1,1,1,1,1,73,10,20,35905070,7495,7495,6245,Mediterranean_Hispanic,148,58,3,38355.0,Unknown,51054011,26500000.0,2.0,63,1496,64,3,1,3,220,4,0.7419952368351416,0.662566844919786,0.7279411764705881,0.0370275596823891,0.381578947368421,0.0394736842105263,0.1747936984246061,0.1747936984246061,0.1471985332925914,0.1428571428571428,0.6279069767441858,0.375,351,20,10,76,5,12284,5,5,58,30000000,1404761.9047619049,35000000.0,5000000.0,,4000000.0,3,6000000,-0.14285714285714285,-0.14285714285714285
401527,Unknown,Rogério,2024,82,Brazil,Nobres,Brazil,13-01-98,Left-Back,Defender,Left,178.0,30-06-27,Prattes Group,https://img.a.transfermarkt.technology/portrait/header/401527-1695624076.jpg?lm=1,L1,Verein fÃ¼r LeibesÃ¼bungen Wolfsburg,5000000.0,10000000.0,26,128,140,6,11,11,6,13,7,7,10,10,11,13,6,12,13,14,13,13,14,13,11,13,14,14,10,15,12,13,13,15,15,13,7,14,15,15,10,10,11,11,12,11,2,1,2,3,2,2,4,2,2,1,2,13,12,4,11,11,15,9,12,1,20,1,1,18,1,1,15,1,1,1,1,1,1,70,20,6,3174004,6400,6200,5250,Mixed_Race,123,0,0,25000.0,Unknown,19284576,4225000.0,4.0,10,1050,11,1,0,4,213,8,0.5706536120666843,0.5561497326203209,0.5441176470588236,0.0241317410948361,0.0,0.0,0.0247561890472618,0.0497624406101525,0.0234450956971026,0.4285714285714285,0.3488372093023257,0.3333333333333332,206,4,13,40,2,4097,12,65,283,3500000,95652.17391304347,10000000.0,3000000.0,1000000.0,5000000.0,3,2100000,-0.3,-0.5333333333333333
401529,Unknown,Dodô,2024,430,Brazil,TaubatÃ©,Brazil,17-11-98,Right-Back,Defender,Right,166.0,30-06-27,Bertolucci Sports,https://img.a.transfermarkt.technology/portrait/header/401529-1663591985.jpg?lm=1,IT1,Associazione Calcio Fiorentina,17000000.0,20000000.0,26,130,140,12,12,15,11,14,12,8,11,5,6,13,14,8,13,12,13,10,12,11,14,14,12,14,10,13,6,12,12,15,15,15,6,15,14,13,5,12,13,11,9,11,3,1,2,1,1,4,3,1,2,2,3,12,12,7,13,11,12,6,11,1,1,1,1,1,1,1,1,12,1,17,20,17,12,73,10,20,5515748,6150,6150,3000,Mediterranean_Hispanic,127,0,0,22548.0,Unknown,19158806,8700000.0,2.0,10,1473,11,1,1,3,26,11,0.5640381053188674,0.3155080213903743,0.5735294117647058,0.0217640475585815,0.0,0.0,0.0847711927981995,0.0997749437359339,0.048306897413817,0.1428571428571428,0.0697674418604648,0.3333333333333332,259,8,29,37,0,8210,4,34,123,22000000,1131578.9473684211,22000000.0,3000000.0,2000000.0,2000000.0,3,5000000,0.29411764705882354,0.1
401530,ÃÂ°Der,Militão,2024,418,Brazil,SertÃ£ozinho,Brazil,18-01-98,Centre-Back,Defender,Right,186.0,30-06-28,UJ Football Talent,https://img.a.transfermarkt.technology/portrait/header/401530-1719653438.jpg?lm=1,ES1,Real Madrid Club de FÃºtbol,60000000.0,70000000.0,26,160,168,9,10,12,8,12,14,15,11,10,16,13,13,15,12,15,16,16,13,12,11,13,15,10,16,12,15,14,15,15,15,15,15,18,15,16,16,13,12,13,4,12,1,1,2,3,3,3,3,2,1,4,3,15,12,6,12,15,14,12,12,1,1,20,14,1,7,10,1,1,1,1,1,1,1,79,8,20,128638129,8000,8250,7000,African_Caribbean,161,22,1,178081.0,Unknown,19273276,28500000.0,2.0,10,1362,11,1,1,1,167,2,0.8418893887271766,0.7433155080213903,0.8235294117647058,0.171949397792792,0.1447368421052631,0.0131578947368421,0.2998249562390597,0.3498374593648412,0.1583099530542515,0.1428571428571428,0.5348837209302322,0.3333333333333332,276,21,12,44,3,8360,12,115,266,40000000,1857142.857142857,70000000.0,20000000.0,,35000000.0,2,17000000,-0.3333333333333333,-0.42857142857142855
401534,Unknown,Arthur Gomes,2024,121,Brazil,UberlÃ¢ndia,Brazil,03-07-98,Left Winger,Attack,Right,175.0,30-06-29,Unknown,https://img.a.transfermarkt.technology/portrait/header/401534-1725957222.png?lm=1,RU1,FK Dinamo Moskva,3000000.0,4000000.0,26,133,146,13,15,15,10,12,12,9,13,7,5,12,10,7,14,8,11,12,11,10,13,10,14,12,7,12,5,9,10,16,15,12,7,12,15,13,11,10,14,11,5,15,4,1,3,3,1,3,1,4,2,1,2,19,12,7,10,13,11,11,10,1,1,1,1,1,1,1,12,12,1,19,20,18,13,71,11,20,3440249,6650,6400,5150,African_Caribbean,122,0,0,12750.0,Unknown,19273279,3633333.333,3.0,10,1540,11,0,1,1,74,7,0.5971156390579518,0.5454545454545454,0.536764705882353,0.0123029295862233,0.0,0.0,0.0147536884221055,0.0197549387346836,0.020157967349093,0.2857142857142857,0.2790697674418605,0.3333333333333332,300,37,22,28,1,8588,1,4,24,4000000,184210.52631578947,4000000.0,1000000.0,,1000000.0,7,5000000,0.3333333333333333,0.3333333333333333
401578,Exequiel,Palacios,2024,15,Argentina,FamaillÃ¡,Argentina,05-10-98,Central Midfield,Midfield,Right,178.0,30-06-28,Eleven Talent Group,https://img.a.transfermarkt.technology/portrait/header/401578-1695368200.jpg?lm=1,L1,Bayer 04 Leverkusen FuÃŸball,45000000.0,45000000.0,26,138,155,9,11,12,9,14,10,8,11,8,12,15,11,14,15,15,13,16,14,12,15,13,16,11,12,14,11,14,16,12,14,13,9,15,11,14,11,12,12,15,14,13,1,1,1,4,1,3,2,2,3,3,1,10,13,12,11,14,11,8,8,1,1,1,1,1,1,19,1,20,8,1,14,8,1,71,12,20,26037416,6900,7000,5750,Native_American,137,20,0,60999.0,Unknown,14110846,17000000.0,1.0,4,483,4,3,1,5,36,1,0.6765017200317545,0.6096256684491979,0.6470588235294117,0.0588929970539017,0.131578947368421,0.0,0.2248062015503876,0.2248062015503876,0.0944192894247062,0.0,0.3488372093023257,0.3333333333333332,235,25,25,31,2,8877,16,97,71,40000000,1890476.1904761905,45000000.0,5000000.0,,20000000.0,1,2500000,-0.1111111111111111,0.0
401922,Samuel,Chukwueze,2024,5,Nigeria,Umahaia,Nigeria,22-05-99,Right Winger,Attack,Left,172.0,30-06-28,InterLex Sport,https://img.a.transfermarkt.technology/portrait/header/401922-1692277617.jpg?lm=1,IT1,Associazione Calcio Milan,20000000.0,30000000.0,25,140,165,12,14,17,11,14,12,12,11,12,8,14,9,8,17,11,15,11,12,9,10,9,16,16,5,10,8,10,13,16,14,13,7,12,16,15,10,11,5,15,6,17,2,2,4,2,3,2,2,1,2,2,3,18,14,2,13,14,10,11,12,1,1,1,1,1,1,1,14,1,18,16,13,20,14,70,20,6,23444317,7000,7000,4650,African_Caribbean,136,24,4,23429.0,Unknown,67269484,10800000.0,2.0,69,1548,70,0,0,1,27,10,0.6765017200317545,0.4919786096256684,0.6397058823529411,0.0226147563699357,0.1578947368421052,0.0526315789473684,0.0997749437359339,0.1497874468617154,0.05997388816356,0.1428571428571428,0.2093023255813952,0.2916666666666665,286,48,37,16,0,6184,10,48,162,18000000,1029411.7647058824,30000000.0,5000000.0,,27000000.0,2,6500000,-0.1,-0.21739130434782608
401923,Victor,Osimhen,2024,141,Nigeria,Lagos,Nigeria,29-12-98,Centre-Forward,Attack,Right,186.0,30-06-25,Roberto Calenda,https://img.a.transfermarkt.technology/portrait/header/401923-1725459265.png?lm=1,TR1,Galatasaray Spor KulÃ¼bÃ¼,75000000.0,120000000.0,25,157,171,4,8,13,15,14,7,14,12,4,4,12,14,8,14,15,14,14,14,13,11,13,14,13,10,19,5,12,13,17,15,14,15,14,19,12,16,14,13,14,12,10,2,1,1,2,2,2,1,3,2,1,3,14,16,12,10,14,14,11,10,1,1,1,1,1,1,1,1,1,1,10,1,10,20,78,9,20,96427502,7850,7500,7250,African_Caribbean,154,23,15,110961.0,Unknown,13158205,26725000.0,4.0,69,789,70,0,1,1,102,3,0.7426567875099233,0.7700534759358288,0.7720588235294117,0.1071371668982538,0.1513157894736842,0.1973684210526315,0.3748437109277319,0.5998999749937485,0.1484485680157782,0.4285714285714285,0.5348837209302322,0.2916666666666665,247,133,32,33,1,4031,22,92,179,75000000,3217391.304347826,120000000.0,25000000.0,1000000.0,30000000.0,4,54000000,-0.25,-0.3181818181818182
402008,Amadou,Haidara,2024,23826,Mali,Bamako,Mali,31-01-98,Central Midfield,Midfield,Right,175.0,30-06-26,ROOF,https://img.a.transfermarkt.technology/portrait/header/402008-1713945184.jpg?lm=1,L1,RasenBallsport Leipzig,20000000.0,24000000.0,26,139,153,11,12,14,9,14,10,9,12,7,11,14,10,12,15,14,13,15,13,12,13,13,16,14,10,14,13,13,16,14,14,14,10,16,14,16,12,14,11,12,6,12,3,3,3,3,2,3,2,1,2,2,2,10,16,10,8,15,11,9,9,1,1,1,1,1,1,18,1,20,13,1,14,13,1,72,10,20,10216804,6787,6437,5237,African_Caribbean,140,32,2,66792.0,Unknown,16199711,9900000.0,2.0,61,133,61,3,1,1,162,1,0.6020111140513363,0.55475935828877,0.6691176470588234,0.064486817875893,0.2105263157894736,0.0263157894736842,0.0997749437359339,0.1197799449862465,0.054973749270813,0.1428571428571428,0.2790697674418605,0.3333333333333332,326,31,34,55,0,7273,5,45,99,20000000,865217.3913043478,24000000.0,4000000.0,300000.0,20000000.0,2,200000,0.0,0.17647058823529413
402010,Sékou,Koïta,2024,2410,Mali,Kita,Mali,28-11-99,Centre-Forward,Attack,Left,173.0,30-06-27,Unknown,https://img.a.transfermarkt.technology/portrait/header/402010-1721915630.png?lm=1,RU1,PFK CSKA Moskva,3500000.0,12500000.0,25,121,137,7,8,11,12,13,8,7,9,5,7,12,10,8,13,6,13,12,12,11,12,11,13,9,10,15,5,14,13,16,15,11,9,13,15,15,10,11,5,10,8,5,1,3,2,2,3,1,2,1,2,1,3,15,13,4,11,12,13,11,19,1,1,1,1,1,1,1,1,1,1,1,1,1,20,67,20,11,3549999,6048,6048,4748,African_Caribbean,119,19,4,7806.0,Unknown,13157142,9111392.0,2.0,61,736,61,0,0,1,148,3,0.550542471553321,0.5024598930481283,0.5147058823529411,0.0075289178230738,0.125,0.0526315789473684,0.0172543135783946,0.0622655663915979,0.0505924720131114,0.1428571428571428,0.2325581395348837,0.2916666666666665,157,52,29,27,0,5603,11,120,320,3000000,137500.0,12500000.0,2500000.0,400000.0,10000000.0,3,2200000,-0.25,-0.45454545454545453
402434,Sergey,Volkov,2024,71985,Russia,"Togliatti, Samara Region",Russia,10-05-95,Goalkeeper,Goalkeeper,Right,187.0,30-06-25,Unknown,https://img.a.transfermarkt.technology/portrait/header/402434-1722317441.png?lm=1,RU1,Akron Togliatti,1200000.0,1200000.0,29,105,-75,9,9,9,8,8,8,13,8,7,12,11,3,12,9,7,10,12,9,11,9,16,10,8,8,9,12,11,14,13,14,7,10,14,14,12,10,12,10,4,10,11,1,3,1,4,1,1,2,3,2,1,2,20,12,5,10,13,18,12,16,1,13,1,20,1,1,1,12,1,14,12,1,13,9,76,13,20,17454238,4748,4748,2498,Northern_European,110,0,0,7231.0,Unknown,58152085,9111392.0,2.0,78,1499,81,2,1,7,14,5,0.3785392961100821,0.2618181818181818,0.4485294117647059,0.0069736878951185,0.0,0.0,0.0057514378594648,0.0057514378594648,0.0505924720131114,0.1428571428571428,0.5581395348837206,0.4583333333333332,0,0,0,0,0,0,2,9,95,1200000,83928.57142857143,1200000.0,0.0,,,0,0,0.0,0.2
402733,Gonzalo,Montiel,2024,368,Argentina,GonzÃ¡lez CatÃ¡n,Argentina,01-01-97,Right-Back,Defender,Right,175.0,30-06-26,Interplayers,https://img.a.transfermarkt.technology/portrait/header/402733-1668181612.jpg?lm=1,ES1,Sevilla FÃºtbol Club S.A.D.,10000000.0,17000000.0,27,138,145,7,11,9,6,12,3,12,5,13,14,12,15,14,9,16,15,16,14,14,8,13,16,7,13,11,15,17,16,14,14,14,10,15,15,16,13,14,14,15,10,13,1,1,3,2,2,4,2,3,1,2,1,19,12,8,15,15,15,12,15,1,1,12,20,1,17,1,1,1,1,1,1,1,1,70,7,20,12026818,6900,6650,4500,Mediterranean_Hispanic,138,16,0,21487.0,Unknown,14136122,11000000.0,1.0,4,550,4,1,1,3,181,11,0.6301931727970362,0.4759358288770053,0.6544117647058822,0.0207395276393458,0.1052631578947368,0.0,0.0497624406101525,0.0847711927981995,0.0610850301397261,0.0,0.2790697674418605,0.375,248,11,24,55,1,10237,10,29,36,5000000,250000.0,17000000.0,3000000.0,,1500000.0,3,4000000,-0.5,-0.5
403151,Robert,Sánchez,2024,631,Spain,Cartagena,Spain,18-11-97,Goalkeeper,Goalkeeper,Right,197.0,30-06-30,CAA Stellar,https://img.a.transfermarkt.technology/portrait/header/403151-1695028195.jpg?lm=1,GB1,Chelsea Football Club,20000000.0,32000000.0,27,139,160,6,3,1,3,11,8,1,1,3,2,13,1,2,13,8,11,14,13,11,9,10,10,9,7,3,11,12,9,12,13,12,18,14,10,12,14,10,3,9,13,15,17,17,11,11,15,15,13,15,14,10,14,20,11,3,11,11,10,8,14,20,1,1,1,1,1,1,1,1,1,1,1,1,1,91,12,20,26813230,6934,6934,5484,Mixed_Race,136,1,0,28998.0,Unknown,29156212,23000000.0,1.0,89,320,89,2,1,4,50,5,0.6677692511246361,0.5811764705882353,0.6397058823529411,0.0279922789243409,0.006578947368421,0.0,0.0997749437359339,0.1597899474868717,0.1277535487096864,0.0,0.7906976744186047,0.375,0,0,0,0,0,0,4,32,67,20000000,1240625.0,32000000.0,10000000.0,,,1,6000000,0.0,-0.3333333333333333
403187,Dani,Fernández,2024,3719,Spain,Madrid,Spain,30-04-97,Right-Back,Defender,Right,178.0,30-06-25,11MANGMT,https://img.a.transfermarkt.technology/portrait/header/403187-1722419646.png?lm=1,RU1,FK Khimki,600000.0,600000.0,27,110,136,6,7,11,7,9,7,13,9,11,12,12,13,12,11,12,12,13,12,11,12,11,9,8,10,7,12,12,13,12,12,12,11,13,14,13,12,11,12,10,7,10,3,2,3,1,3,1,1,2,1,1,1,16,12,8,13,11,11,10,12,1,1,20,13,1,1,1,1,1,1,1,1,1,1,77,8,20,3361440,5300,5300,2100,Mediterranean_Hispanic,109,0,0,1677.0,Unknown,14222102,9111392.0,2.0,89,892,89,1,1,3,76,11,0.4515744906059804,0.2192513368983957,0.4411764705882353,0.0016106495997033,0.0,0.0,0.0027506876719179,0.0027506876719179,0.0505924720131114,0.1428571428571428,0.3488372093023257,0.375,233,4,20,44,0,2866,3,9,38,800000,30952.380952380954,800000.0,100000.0,,200000.0,8,600000,0.3333333333333333,0.3333333333333333
403315,Unknown,Claudinho,2024,964,Brazil,Guarulhos,Brazil,28-01-97,Attacking Midfield,Midfield,Right,170.0,30-06-28,Elenko Sports Ltda.,https://img.a.transfermarkt.technology/portrait/header/403315-1721723505.png?lm=1,RU1,AO FK Zenit Sankt-Peterburg,18000000.0,20000000.0,27,146,148,13,12,14,14,14,13,9,14,6,6,14,13,10,15,12,13,11,13,11,13,13,12,13,11,14,10,12,13,16,17,12,6,13,14,13,5,13,7,12,4,15,1,2,3,2,1,1,1,3,3,2,1,9,10,6,12,11,11,12,10,1,1,1,1,1,1,13,13,19,12,16,20,16,14,60,12,20,26862790,7218,7229,5243,Mixed_Race,141,0,0,32603.0,Unknown,19258928,6250000.0,2.0,10,575,11,3,1,4,7,0,0.7068007409367557,0.5554010695187165,0.6764705882352942,0.0314733291683041,0.0,0.0,0.0897724431107777,0.0997749437359339,0.0346954082057834,0.1428571428571428,0.1627906976744184,0.375,327,58,63,38,1,10289,2,5,25,17000000,1056250.0,20000000.0,2000000.0,,300000.0,4,5850000,-0.05555555555555555,-0.05555555555555555
403568,Stephen,Welsh,2024,371,Scotland,Coatbridge,Scotland,19-01-00,Centre-Back,Defender,Right,188.0,31-05-27,Deadline Day Soccer ,https://img.a.transfermarkt.technology/portrait/header/403568-1622031005.jpg?lm=1,SC1,The Celtic Football Club,800000.0,1500000.0,24,113,135,5,6,12,10,11,7,13,8,10,12,12,5,14,12,14,10,14,11,10,11,11,14,6,12,10,11,11,13,12,12,13,13,12,12,13,13,12,8,10,4,8,2,1,1,1,4,4,2,2,1,2,2,19,12,2,11,13,14,12,15,1,1,20,15,1,1,1,1,1,1,1,1,1,1,78,13,20,2830198,5650,5650,1500,Northern_European,113,0,0,9859.0,Unknown,61076929,9111392.0,2.0,82,371,83,1,1,7,200,2,0.4978830378406986,0.1550802139037433,0.4705882352941176,0.0095113300701907,0.0,0.0,0.0037509377344336,0.0072518129532383,0.0505924720131114,0.1428571428571428,0.581395348837209,0.25,100,5,1,12,0,6619,3,18,77,800000,68181.81818181818,1500000.0,500000.0,,200000.0,2,150000,0.0,0.0
404384,Rabbi,Matondo,2024,124,England,Liverpool,Wales,09-09-00,Left Winger,Attack,Right,175.0,31-05-26,Wasserman,https://img.a.transfermarkt.technology/portrait/header/404384-1640709163.jpg?lm=1,SC1,Rangers Football Club,3000000.0,9000000.0,24,123,140,11,11,14,11,12,6,5,10,4,6,12,8,7,14,12,13,6,9,6,13,4,8,15,3,13,5,8,9,18,15,9,6,12,18,10,11,6,8,12,13,10,2,3,1,2,3,3,1,3,1,2,2,12,8,15,8,9,5,12,10,1,1,1,1,10,12,1,17,1,15,20,10,19,14,66,10,20,8102023,6150,6150,5150,African_Caribbean,114,11,0,34798.0,Unknown,28111474,6000000.0,2.0,32,845,106,0,1,1,161,7,0.5640381053188674,0.5454545454545454,0.4779411764705882,0.0335928590671944,0.0723684210526315,0.0,0.0147536884221055,0.0447611902975743,0.0333064807355759,0.1428571428571428,0.2790697674418605,0.25,195,41,25,10,0,7982,8,70,107,3000000,-375000.0,9000000.0,3000000.0,9000000.0,4000000.0,3,4500000,0.0,0.2
404418,Dávid,Hancko,2024,234,Slovakia,Prievidza,Slovakia,13-12-97,Centre-Back,Defender,Left,188.0,30-06-28,FairSport,https://img.a.transfermarkt.technology/portrait/header/404418-1722415670.jpg?lm=1,NL1,Feyenoord Rotterdam,35000000.0,35000000.0,27,136,145,9,13,14,11,11,10,11,13,10,12,14,12,15,11,7,12,10,13,13,13,16,12,12,13,11,13,15,12,14,12,10,15,10,12,14,12,11,8,13,12,11,1,3,2,2,3,2,3,2,1,3,1,4,12,5,13,7,12,15,13,1,19,20,1,15,1,10,10,8,1,5,1,1,1,79,20,8,16505775,6950,6450,4850,Northern_European,133,22,1,14999.0,Unknown,63029353,4866666.667,3.0,86,1185,86,1,0,7,85,2,0.6037311458057687,0.5133689839572192,0.6176470588235294,0.014474602817478,0.1447368421052631,0.0131578947368421,0.1747936984246061,0.1747936984246061,0.0270100095391538,0.2857142857142857,0.581395348837209,0.375,318,49,29,30,0,10629,10,37,115,35000000,1519565.2173913044,35000000.0,500000.0,,2000000.0,3,4400000,0.0,0.0
404839,Andriy,Lunin,2024,418,Ukraine,"Krasnograd, Kharkiv Oblast",Ukraine,11-02-99,Goalkeeper,Goalkeeper,Right,191.0,30-06-30,Gestifute,https://img.a.transfermarkt.technology/portrait/header/404839-1701294131.jpg?lm=1,ES1,Real Madrid Club de FÃºtbol,25000000.0,25000000.0,25,140,156,3,1,3,2,12,7,9,1,2,1,12,1,2,10,5,13,12,13,12,11,13,15,3,8,3,13,13,14,12,15,12,15,14,11,14,12,13,5,10,3,13,15,14,14,12,13,12,15,16,12,14,11,14,10,5,14,12,17,14,12,20,1,1,1,1,1,1,1,1,1,1,1,1,1,80,10,20,9825937,7000,6700,5500,Northern_European,140,7,0,24317.0,Unknown,71099053,8500000.0,1.0,103,758,101,2,1,7,167,5,0.6368086795448531,0.5828877005347594,0.6691176470588234,0.0234722245021518,0.0460526315789473,0.0,0.1247811952988247,0.1247811952988247,0.047195755437651,0.0,0.6511627906976742,0.2916666666666665,0,0,0,0,0,0,6,4,13,20000000,895454.5454545454,25000000.0,5000000.0,2000000.0,3000000.0,6,14900000,-0.2,1.5
404841,Denys,Popov,2024,338,Ukraine,"Mygiya, Mykolaiv Oblast",Ukraine,17-02-99,Centre-Back,Defender,Right,185.0,30-06-25,ProStar,https://img.a.transfermarkt.technology/portrait/header/404841-1726134741.png?lm=1,UKR1,Futbolniy Klub Dynamo Kyiv,3000000.0,3500000.0,25,121,137,3,5,6,7,9,3,15,9,8,14,10,5,15,9,17,8,17,7,9,9,9,16,3,14,11,9,12,17,13,14,14,17,13,13,13,17,9,16,8,14,7,2,2,3,1,2,2,1,1,1,3,3,7,12,12,10,12,13,8,3,1,1,20,1,1,1,4,1,4,1,1,1,1,1,84,15,20,3437091,6150,6150,4005,Northern_European,121,3,0,6010.0,Unknown,71104592,9111392.0,2.0,103,995,101,1,1,7,97,2,0.5640381053188674,0.4229946524064171,0.5294117647058822,0.0057946692133212,0.0197368421052631,0.0,0.0147536884221055,0.0172543135783946,0.0505924720131114,0.1428571428571428,0.5116279069767438,0.2916666666666665,135,12,1,33,1,6384,18,84,185,4000000,282142.85714285716,4000000.0,500000.0,,1500000.0,1,700000,0.3333333333333333,0.6
404842,Vitaliy,Mykolenko,2024,29,Ukraine,Cherkasy,Ukraine,29-05-99,Left-Back,Defender,Left,180.0,30-06-26,ProStar,https://img.a.transfermarkt.technology/portrait/header/404842-1708012303.jpg?lm=1,GB1,Everton Football Club,28000000.0,28000000.0,25,135,150,8,13,12,7,12,5,13,12,10,12,13,4,14,12,12,12,15,12,14,11,13,16,7,8,13,13,13,16,15,14,11,13,14,15,15,11,13,12,15,3,6,2,3,3,3,2,1,2,1,2,3,2,12,15,5,13,16,14,11,12,1,20,11,4,19,3,2,1,1,1,1,1,1,1,71,20,9,44521841,6750,6750,5250,Northern_European,134,27,0,57996.0,Unknown,71104595,23500000.0,1.0,103,353,101,1,0,7,65,8,0.6434241862926701,0.5561497326203209,0.625,0.055993248404076,0.1776315789473684,0.0,0.1397849462365591,0.1397849462365591,0.1305314036501014,0.0,0.3953488372093026,0.2916666666666665,249,10,21,27,0,7169,19,44,41,28000000,1544444.4444444445,28000000.0,1000000.0,200000.0,9000000.0,1,1000000,0.0,0.0
404950,Nicolas,Seiwald,2024,23826,Austria,Kuchl,Austria,04-05-01,Central Midfield,Midfield,Right,179.0,30-06-28,Sports360 GmbH,https://img.a.transfermarkt.technology/portrait/header/404950-1716315232.jpg?lm=1,L1,RasenBallsport Leipzig,16000000.0,20000000.0,23,133,165,5,8,12,10,12,12,10,13,5,12,14,8,14,14,12,14,15,13,13,13,13,15,12,14,12,13,13,13,12,12,13,11,16,13,16,12,16,12,12,10,14,3,1,2,4,3,3,2,1,1,1,2,10,16,6,14,12,11,12,20,1,1,1,1,1,1,20,1,20,1,1,1,1,1,70,12,20,18648498,6650,6650,4150,Northern_European,132,7,0,14999.0,Unknown,16191724,9111392.0,2.0,6,766,7,3,1,7,162,1,0.6301931727970362,0.4385026737967914,0.6102941176470589,0.014474602817478,0.0460526315789473,0.0,0.0797699424856214,0.0997749437359339,0.0505924720131114,0.1428571428571428,0.3720930232558141,0.2083333333333332,252,15,27,23,0,6604,2,5,31,16000000,1061666.6666666667,20000000.0,4000000.0,300000.0,15000000.0,2,300000,0.0,-0.2
405385,Yukinari,Sugawara,2024,180,Japan,"Toyokawa, Aichi",Japan,28-06-00,Right-Back,Defender,Right,179.0,30-06-28,Sports360 GmbH,https://img.a.transfermarkt.technology/portrait/header/405385-1690965777.jpg?lm=1,GB1,Southampton Football Club,12000000.0,15000000.0,24,122,140,9,15,12,8,13,12,8,13,12,10,15,12,11,13,12,13,14,11,9,11,11,14,13,5,13,11,13,14,13,13,11,11,13,13,12,8,10,10,10,3,10,2,1,3,2,3,2,2,3,3,1,3,13,14,1,10,11,10,10,12,1,1,10,20,1,19,13,1,1,18,1,1,17,1,0,8,20,6100000,6000,4098,4644,10,109,1,0,4794.0,Unknown,45111317,7000000.0,1.0,54,1514,56,1,1,0,186,11,0.2925377083884626,0.4913368983957218,0.4411764705882353,0.004620478617854,0.006578947368421,0.0,0.0597649412353088,0.0747686921730432,0.038862190616406,0.0,0.3720930232558141,0.25,259,16,31,24,0,6017,1,9,63,12000000,618421.052631579,15000000.0,3000000.0,250000.0,3000000.0,2,750000,0.0,-0.2
405397,Keito,Nakamura,2024,1421,Japan,"Abiko, Chiba",Japan,28-07-00,Left Winger,Attack,Right,180.0,30-06-28,InterLex Sport,https://img.a.transfermarkt.technology/portrait/header/405397-1723837290.png?lm=1,FR1,Stade de Reims,10000000.0,12000000.0,24,123,139,7,11,11,12,12,7,8,11,8,6,13,7,8,15,8,12,12,12,12,14,11,14,11,8,15,6,13,13,12,13,12,10,12,14,14,11,11,6,10,8,11,3,1,2,3,3,1,3,1,2,3,1,14,10,4,10,11,12,11,15,1,1,1,1,1,1,1,10,10,10,20,18,16,16,75,11,20,4224999,6200,6200,3602,10,119,0,0,4999.0,Unknown,45108807,6250000.0,2.0,54,15,56,0,1,0,197,7,0.5706536120666843,0.3798930481283422,0.5147058823529411,0.0048184301573859,0.0,0.0,0.0497624406101525,0.0597649412353088,0.0346954082057834,0.1428571428571428,0.3953488372093026,0.25,220,68,22,9,1,6379,3,7,49,12000000,552380.9523809524,12000000.0,2000000.0,500000.0,225000.0,5,4725000,0.3333333333333333,0.2
405398,Takefusa,Kubo,2024,681,Japan,"Kawasaki, Kanagawa",Japan,04-06-01,Right Winger,Attack,Left,173.0,30-06-29,Roberto Tukada,https://img.a.transfermarkt.technology/portrait/header/405398-1697110254.jpg?lm=1,ES1,Real Sociedad de FÃºtbol S.A.D.,50000000.0,60000000.0,23,143,159,14,12,15,14,15,12,7,11,8,6,15,8,6,15,8,15,12,14,14,15,15,7,15,7,14,7,15,14,14,14,15,7,10,12,13,12,14,6,11,10,11,3,1,1,1,2,1,1,2,3,2,2,13,13,2,10,9,13,11,13,1,1,1,1,1,1,1,1,12,16,1,20,15,15,60,20,11,45540002,7150,7150,6000,10,141,18,1,41953.0,Unknown,45104608,6500000.0,1.0,54,715,56,0,0,0,168,10,0.696348240275205,0.6363636363636364,0.6764705882352942,0.0405018506054903,0.1184210526315789,0.0131578947368421,0.2498124531132783,0.2998249562390597,0.0360843356759909,0.0,0.2325581395348837,0.2083333333333332,293,42,36,27,0,5521,3,15,63,40000000,1666666.6666666667,60000000.0,10000000.0,13500000.0,7500000.0,8,37700000,-0.2,-0.3333333333333333
405686,Reda,Khadra,2024,1421,Germany,Berlin,Germany,04-07-01,Attacking Midfield,Midfield,Right,175.0,30-06-27,Unknown,https://img.a.transfermarkt.technology/portrait/header/405686-1723836051.png?lm=1,FR1,Stade de Reims,3000000.0,3000000.0,23,122,140,11,10,15,9,11,8,6,8,5,5,9,11,7,12,9,10,9,10,11,12,10,12,14,9,12,6,9,11,16,14,13,7,5,16,12,11,8,5,12,8,9,3,1,3,1,1,3,1,1,4,1,1,12,12,5,8,9,11,8,9,1,1,1,1,1,1,1,14,1,19,20,15,20,14,0,8,20,13538555,6099,6099,3749,North_African__Middle_Eastern,112,0,0,6960.0,Sheffield United,91203085,985000.0,2.0,38,178,40,3,1,6,197,0,0.5572902884360942,0.395614973262032,0.463235294117647,0.00671200561603,0.0,0.0,0.0147536884221055,0.0147536884221055,0.0054445956832134,0.1428571428571428,0.2790697674418605,0.2083333333333332,171,16,23,6,0,3620,3,57,204,2500000,235000.0,3000000.0,500000.0,,1000000.0,4,950000,-0.16666666666666666,0.25
405885,Giacomo,Raspadori,2024,6195,Italy,Bentivoglio,Italy,18-02-00,Second Striker,Attack,Right,172.0,30-06-28,TMP SOCCER srl ,https://img.a.transfermarkt.technology/portrait/header/405885-1708552564.jpg?lm=1,IT1,SocietÃ  Sportiva Calcio Napoli,25000000.0,35000000.0,24,146,165,13,10,13,15,16,14,11,12,6,6,13,13,6,14,12,14,11,14,12,13,13,15,16,11,16,4,14,14,15,16,15,7,15,14,13,11,13,4,14,6,13,2,4,2,4,2,2,1,1,1,4,3,15,15,6,14,13,17,15,14,1,1,1,1,1,1,1,1,1,1,16,17,10,20,69,15,20,25000000,7298,7398,5698,Mediterranean_Hispanic,144,13,3,13425.0,Parthenope,43316850,27000000.0,1.0,52,173,54,0,1,3,184,12,0.7291611537443768,0.6040641711229946,0.6985294117647058,0.0129547212407795,0.0855263157894736,0.0394736842105263,0.1247811952988247,0.1747936984246061,0.1499763882330064,0.0,0.2093023255813952,0.25,275,75,26,18,0,4398,5,16,44,15000000,778947.3684210526,35000000.0,5000000.0,500000.0,4000000.0,1,2000000,-0.4,-0.53125
406040,Ademola,Lookman,2024,800,England,London,Nigeria,20-10-97,Second Striker,Attack,Right,174.0,30-06-26,ROOF,https://img.a.transfermarkt.technology/portrait/header/406040-1682076571.jpg?lm=1,IT1,Atalanta Bergamasca Calcio S.p.a.,40000000.0,40000000.0,27,143,154,9,12,15,14,13,11,8,13,8,8,12,10,8,14,13,9,8,12,11,12,8,15,14,8,13,8,8,15,17,15,13,7,14,15,12,9,12,2,14,10,12,3,3,2,3,2,2,1,2,2,4,2,11,17,10,10,12,12,13,15,1,1,1,1,1,1,1,18,1,15,20,16,18,16,71,12,20,14136321,7150,7050,5750,African_Caribbean,130,4,1,44423.0,Unknown,29141828,12050000.0,3.0,32,858,70,0,1,1,31,12,0.6831172267795713,0.6096256684491979,0.5955882352941175,0.042886925252533,0.0263157894736842,0.0131578947368421,0.1997999499874969,0.1997999499874969,0.0669185255145976,0.2857142857142857,0.2558139534883721,0.375,305,81,43,25,0,5724,11,34,36,55000000,2369565.217391304,55000000.0,3500000.0,1500000.0,20000000.0,7,31500000,0.375,0.8333333333333334
406609,Can,Bozdogan,2024,200,Germany,KÃ¶ln,Germany,05-04-01,Central Midfield,Midfield,Left,174.0,30-06-26,ROOF,https://img.a.transfermarkt.technology/portrait/header/406609-1723461140.jpg?lm=1,NL1,Football Club Utrecht,4500000.0,5000000.0,23,122,138,14,14,13,9,13,13,7,13,4,12,13,11,13,14,14,11,12,12,12,13,12,13,13,8,12,12,12,13,12,13,12,7,12,12,13,11,12,10,11,9,12,1,1,3,2,1,2,2,4,1,1,2,12,13,7,13,11,12,9,9,1,1,1,1,1,1,14,15,20,12,15,18,14,1,72,20,11,1999999,6095,6095,4495,Mediterranean_Hispanic,122,0,0,9588.0,FC Utrecht,91178618,850000.0,2.0,38,777,40,3,0,3,92,1,0.5567610478962689,0.4754010695187165,0.536764705882353,0.0092496477911022,0.0,0.0,0.0222555638909727,0.0247561890472618,0.0046945748493013,0.1428571428571428,0.2558139534883721,0.2083333333333332,185,19,17,24,0,2907,11,38,63,4500000,250000.0,5000000.0,500000.0,,4000000.0,2,500000,0.0,-0.1
406625,Lautaro,Martínez,2024,46,Argentina,BahÃ­a Blanca,Argentina,22-08-97,Centre-Forward,Attack,Right,174.0,30-06-29,Footfeel ISM  ,https://img.a.transfermarkt.technology/portrait/header/406625-1695024988.jpg?lm=1,IT1,Football Club Internazionale Milano S.p.A.,110000000.0,110000000.0,27,161,170,4,8,14,15,16,8,16,14,3,5,12,15,8,16,18,15,18,13,12,12,13,19,16,12,16,7,15,18,16,17,14,11,16,17,15,13,15,14,13,6,11,2,3,3,1,1,3,3,2,3,3,2,16,18,4,14,13,19,11,9,1,1,1,1,1,1,1,1,1,1,1,13,1,20,79,12,20,127462502,8050,8000,7900,Mediterranean_Hispanic,160,38,20,213653.0,Unknown,14110660,25000000.0,1.0,4,128,4,0,1,3,89,3,0.808811854988092,0.8395721925133689,0.8161764705882353,0.2062983351792716,0.25,0.2631578947368421,0.549887471867967,0.549887471867967,0.1388649684713464,0.0,0.2558139534883721,0.375,378,171,55,60,1,6084,10,34,115,100000000,4343478.260869565,110000000.0,16000000.0,500000.0,25000000.0,1,0,-0.09090909090909091,-0.09090909090909091
406634,Matt,O'Riley,2024,1237,England,London,Denmark,21-11-00,Central Midfield,Midfield,Left,189.0,30-06-29,Unknown,https://img.a.transfermarkt.technology/portrait/header/406634-1661800636.jpg?lm=1,GB1,Brighton and Hove Albion Football Club,20000000.0,20000000.0,24,127,159,13,12,13,12,16,8,11,10,4,8,14,8,10,15,12,12,8,14,12,13,11,14,13,9,13,11,13,14,13,12,15,14,14,13,13,12,16,7,14,4,10,3,1,1,3,1,1,2,1,1,3,2,12,12,7,10,12,13,10,16,1,1,1,1,1,1,15,1,20,1,1,13,1,1,77,20,13,23946350,6350,6000,3506,Northern_European,128,0,0,17399.0,Unknown,29186052,15650000.0,2.0,32,858,30,3,0,7,44,1,0.5441915850754168,0.3696256684491978,0.5808823529411764,0.0167920842559001,0.0,0.0,0.0997749437359339,0.0997749437359339,0.0869190810855857,0.1428571428571428,0.6046511627906974,0.25,256,43,53,14,0,8484,1,11,74,22000000,1977272.7272727273,22000000.0,50000.0,250000.0,,2,3850000,0.1,0.6923076923076923
406635,Phil,Foden,2024,281,England,Stockport,England,28-05-00,Right Winger,Attack,Left,171.0,30-06-27,Unknown,https://img.a.transfermarkt.technology/portrait/header/406635-1668524492.jpg?lm=1,GB1,Manchester City Football Club,150000000.0,150000000.0,24,163,180,13,13,17,14,17,13,8,12,5,8,17,12,8,17,7,14,13,15,15,16,14,14,16,8,16,9,14,16,15,17,15,7,14,16,15,9,15,6,16,4,13,2,3,2,2,1,2,1,3,2,1,3,12,15,12,13,12,14,14,16,1,1,1,1,1,1,1,1,14,1,20,20,17,14,64,20,9,147976457,8150,8150,8000,Northern_European,161,16,2,139190.0,Unknown,28108494,9111392.0,2.0,32,1427,33,0,0,7,131,10,0.8286583752315428,0.8502673796791443,0.8235294117647058,0.1343955767004278,0.1052631578947368,0.0263157894736842,0.7499374843710929,0.7499374843710929,0.0505924720131114,0.1428571428571428,0.1860465116279068,0.25,344,118,71,12,0,9852,7,32,51,140000000,6136363.636363637,150000000.0,10000000.0,25000000.0,70000000.0,0,0,-0.06666666666666667,0.2727272727272727
406638,Oliver,Skipp,2024,1003,England,Welwyn Garden City,England,16-09-00,Defensive Midfield,Midfield,Right,175.0,30-06-29,ARETÃ‰,https://img.a.transfermarkt.technology/portrait/header/406638-1572887410.jpg?lm=1,GB1,Leicester City Football Club,18000000.0,20000000.0,24,141,156,8,6,10,7,13,7,12,9,6,13,14,7,16,12,15,15,17,16,11,12,14,14,7,11,13,14,15,17,13,12,13,9,15,14,16,14,15,8,14,5,7,3,2,2,1,1,1,1,1,1,2,1,10,13,6,11,14,15,14,15,1,8,12,9,1,1,20,1,20,1,1,1,1,1,70,11,20,40481116,7050,7050,5500,Northern_European,140,0,0,57996.0,Unknown,28116496,23500000.0,1.0,32,1654,33,3,1,7,127,4,0.6831172267795713,0.5828877005347594,0.6691176470588234,0.055993248404076,0.0,0.0,0.0897724431107777,0.0997749437359339,0.1305314036501014,0.0,0.2790697674418605,0.25,241,3,12,40,1,6930,5,50,146,14000000,529411.7647058824,20000000.0,4000000.0,8000000.0,10000000.0,3,5000000,-0.06666666666666667,-0.06666666666666667
406640,Felix,Nmecha,2024,16,Germany,Hamburg,Germany,10-10-00,Central Midfield,Midfield,Right,190.0,30-06-28,Unknown,https://img.a.transfermarkt.technology/portrait/header/406640-1709560961.jpg?lm=1,L1,Borussia Dortmund,20000000.0,25000000.0,24,122,142,12,8,13,11,14,12,12,12,5,9,13,13,10,15,12,12,11,12,10,13,12,12,15,5,12,10,12,11,13,12,14,14,12,15,12,12,11,7,10,8,13,1,3,1,3,3,1,1,3,4,3,1,15,13,4,8,12,12,12,9,1,1,1,1,1,1,10,12,18,12,15,20,15,14,73,9,20,3739999,6100,6100,4600,Mixed_Race,122,0,0,14383.0,Unknown,28113827,30000000.0,1.0,38,594,40,3,1,4,41,1,0.5574225985710506,0.4866310160427807,0.536764705882353,0.0138797825816163,0.0,0.0,0.0997749437359339,0.1247811952988247,0.1666435178754965,0.0,0.6279069767441858,0.25,195,35,26,19,1,4467,8,52,123,28000000,2291666.6666666665,28000000.0,5000000.0,,,2,10250000,0.4,0.12
406806,Emil,Bohinen,2024,252,England,Derby,Norway,12-03-99,Defensive Midfield,Midfield,Left,189.0,30-06-27,Unknown,https://img.a.transfermarkt.technology/portrait/header/406806-1663667682.jpg?lm=1,IT1,Genoa Cricket and Football Club,1800000.0,4000000.0,25,128,147,10,12,11,8,14,11,7,13,4,7,15,13,13,14,9,13,10,15,13,14,13,15,14,6,10,14,14,14,13,13,14,12,10,12,13,10,15,12,12,10,12,3,3,1,2,2,3,3,2,3,1,3,9,15,7,14,13,15,14,9,1,1,1,1,1,1,18,1,20,1,1,10,5,1,78,20,11,3906629,6400,6350,3000,Northern_European,128,0,0,18000.0,Unknown,53126104,2450000.0,3.0,32,410,73,3,0,7,104,4,0.590500132310135,0.3155080213903743,0.5808823529411764,0.0173724202327716,0.0,0.0,0.0087521880470117,0.0197549387346836,0.0135837106586294,0.2857142857142857,0.6046511627906974,0.2916666666666665,166,13,12,24,0,3779,5,24,70,1800000,92105.26315789473,4000000.0,1200000.0,50000.0,600000.0,3,4200000,0.0,-0.4375
407098,Jakub,Kaminski,2024,82,Poland,Ruda ?l?ska,Poland,05-06-02,Left Winger,Attack,Right,179.0,30-06-27,BMG-SPORT,https://img.a.transfermarkt.technology/portrait/header/407098-1724770940.jpg?lm=1,L1,Verein fÃ¼r LeibesÃ¼bungen Wolfsburg,6000000.0,12000000.0,22,123,-8,9,10,14,11,12,7,8,10,5,8,12,7,9,13,11,11,13,12,10,12,10,13,14,11,13,8,12,14,15,13,11,8,15,15,13,8,12,8,12,5,19,1,2,2,1,3,2,1,2,2,2,2,12,15,5,12,12,15,13,13,1,12,1,12,12,12,1,15,8,15,20,10,18,10,68,11,20,60800000,6150,5600,4650,Northern_European,119,3,1,19177.0,Unknown,96121228,9111392.0,2.0,75,1258,78,0,1,7,213,7,0.4912675310928817,0.4919786096256684,0.5147058823529411,0.0185089517548645,0.0197368421052631,0.0131578947368421,0.0297574393598399,0.0597649412353088,0.0505924720131114,0.1428571428571428,0.3720930232558141,0.1666666666666666,205,32,28,12,0,4127,3,4,17,6000000,371875.0,12000000.0,3000000.0,5000000.0,10000000.0,1,0,0.0,-0.4
408471,Javi,Puado,2024,714,Spain,Barcelona,Spain,25-05-98,Left Winger,Attack,Right,177.0,30-06-25,DCGLOBALSL,https://img.a.transfermarkt.technology/portrait/header/408471-1698158226.jpg?lm=1,ES1,Reial Club Deportiu Espanyol de Barcelona S.A.D.,8000000.0,8000000.0,26,127,142,8,11,13,13,12,8,9,12,5,8,11,12,7,14,9,12,11,14,12,13,13,13,13,9,16,8,13,13,15,15,10,9,13,14,11,11,12,7,11,7,14,1,2,2,2,1,1,2,1,1,1,3,20,10,6,11,11,10,9,19,1,1,1,1,1,1,1,1,1,1,17,17,16,20,69,8,20,2374688,6150,6150,4400,Mediterranean_Hispanic,121,1,1,5724.0,Unknown,67222737,9111392.0,2.0,89,141,89,0,1,3,170,7,0.5640381053188674,0.4652406417112299,0.5294117647058822,0.0055185026752426,0.006578947368421,0.0131578947368421,0.0397599399849962,0.0397599399849962,0.0505924720131114,0.1428571428571428,0.3255813953488373,0.3333333333333332,225,60,21,26,0,2018,5,19,28,8000000,433333.3333333333,8000000.0,1000000.0,,600000.0,2,100000,0.0,0.0
408574,Joey,Veerman,2024,383,Netherlands,Purmerend,Netherlands,19-11-98,Central Midfield,Midfield,Right,185.0,30-06-26,Muy Manero,https://img.a.transfermarkt.technology/portrait/header/408574-1682332276.jpg?lm=1,NL1,Eindhovense Voetbalvereniging Philips Sport Vereniging,40000000.0,40000000.0,26,136,149,13,8,12,9,13,13,11,15,12,7,17,15,7,13,12,13,13,12,14,15,13,16,12,14,13,15,14,15,11,13,14,12,15,12,14,10,16,5,12,11,12,1,4,1,3,2,1,1,3,3,2,1,5,16,14,13,15,14,12,7,1,1,1,1,1,1,17,1,20,10,1,16,1,1,75,12,20,15102784,6793,6793,4993,Northern_European,135,0,0,6999.0,Unknown,37060896,3275000.0,2.0,67,1194,68,3,1,7,62,1,0.6491135220957925,0.528663101604278,0.6323529411764706,0.0067496646894043,0.0,0.0,0.1997999499874969,0.1997999499874969,0.0181671713103141,0.1428571428571428,0.5116279069767438,0.3333333333333332,350,62,94,37,0,8345,12,70,124,32000000,1141964.2857142857,40000000.0,5000000.0,350000.0,500000.0,2,1150000,-0.2,0.3333333333333333
409153,Teddy,Teuma,2024,1421,France,Toulon,Malta,30-09-93,Central Midfield,Midfield,Left,176.0,30-06-27,Libera Sports,https://img.a.transfermarkt.technology/portrait/header/409153-1723821029.png?lm=1,FR1,Stade de Reims,7000000.0,7000000.0,31,124,128,14,7,9,8,12,14,9,13,11,9,14,14,11,12,13,14,17,11,14,14,15,17,8,19,13,11,14,14,11,14,13,8,14,11,15,11,16,12,11,8,8,3,1,3,2,3,3,1,1,1,3,3,19,13,12,13,10,14,10,10,1,1,1,1,1,1,15,1,20,1,1,17,1,1,73,20,7,6522835,6189,6192,4242,Northern_European,125,23,1,10000.0,Unknown,49033030,2700000.0,2.0,34,1511,62,3,0,7,197,1,0.5695951309870336,0.4483422459893048,0.5588235294117647,0.009647482104698,0.1513157894736842,0.0131578947368421,0.0347586896724181,0.0347586896724181,0.0149726381288369,0.1428571428571428,0.3023255813953489,0.5416666666666665,320,47,53,60,1,6799,7,17,41,5000000,250000.0,7000000.0,2000000.0,,,3,1200000,-0.2857142857142857,-0.2857142857142857
409344,Calvin,Stengs,2024,234,Netherlands,Nieuw-Vennep,Netherlands,18-12-98,Attacking Midfield,Midfield,Left,187.0,30-06-27,Team Raiola,https://img.a.transfermarkt.technology/portrait/header/409344-1697637081.jpg?lm=1,NL1,Feyenoord Rotterdam,15000000.0,20000000.0,26,133,144,15,11,15,9,14,12,9,12,5,5,15,13,6,15,11,14,10,11,11,16,12,14,18,5,14,6,14,14,13,14,14,12,12,15,13,11,12,3,14,12,12,1,1,3,1,1,3,1,4,3,3,3,12,10,6,15,11,14,13,10,1,1,1,1,1,1,1,12,1,18,14,16,20,1,68,20,10,11771364,6752,6751,5394,Mixed_Race,132,7,0,19999.0,R Antwerp FC,37059574,10500000.0,2.0,67,1043,68,3,0,4,85,0,0.6435564964276264,0.5715508021390374,0.6102941176470589,0.0193026891475241,0.0460526315789473,0.0,0.0747686921730432,0.0997749437359339,0.058307175199311,0.1428571428571428,0.5581395348837206,0.3333333333333332,282,45,65,27,2,7583,14,116,433,12000000,519565.2173913043,20000000.0,3000000.0,500000.0,12000000.0,4,8000000,-0.2,-0.2
409517,Yorbe,Vertessen,2024,89,Belgium,Tienen,Belgium,08-01-01,Centre-Forward,Attack,Right,174.0,30-06-28,TEAM VERTESSEN,https://img.a.transfermarkt.technology/portrait/header/409517-1726351379.jpg?lm=1,L1,1. FC Union Berlin,5000000.0,5000000.0,23,124,145,11,9,12,11,14,11,10,10,11,7,11,8,6,12,5,10,13,12,12,9,13,11,11,6,10,6,12,15,15,13,13,9,12,15,12,13,12,11,8,12,12,3,1,4,3,2,3,2,3,2,1,2,7,11,6,11,11,11,12,14,1,1,1,1,1,1,1,1,1,1,16,1,13,20,0,12,20,8549999,6148,5164,4916,Northern_European,116,0,0,3999.0,Unknown,37074626,4750000.0,1.0,7,1489,8,0,1,7,0,3,0.4335803122519185,0.520427807486631,0.4926470588235294,0.0038528128913767,0.0,0.0,0.0247561890472618,0.0247561890472618,0.0263618433845384,0.0,0.2558139534883721,0.2083333333333332,227,71,23,9,0,9407,12,83,143,6000000,347058.82352941175,6000000.0,700000.0,500000.0,3500000.0,3,1900000,0.2,0.5
410158,Unknown,Rodrigo Becão,2024,36,Brazil,Salvador,Brazil,19-01-96,Centre-Back,Defender,Right,191.0,30-06-28,Antoniu's Assessoria,https://img.a.transfermarkt.technology/portrait/header/410158-1728392628.JPG?lm=1,TR1,FenerbahÃ§e Spor KulÃ¼bÃ¼,8000000.0,11000000.0,28,140,146,4,5,6,6,10,7,15,6,4,15,12,6,16,10,13,15,15,14,15,9,13,16,8,13,10,14,16,16,13,12,15,15,15,14,14,14,14,11,12,4,5,1,3,1,2,3,1,3,3,2,1,1,16,12,9,12,13,15,11,16,1,1,20,1,1,1,1,1,1,1,1,1,1,1,79,8,20,8047415,7000,6600,5150,African_Caribbean,140,0,0,14808.0,Unknown,19249501,5580000.0,2.0,10,1289,11,1,1,1,84,2,0.6235776660492194,0.5454545454545454,0.6691176470588234,0.0142901699196702,0.0,0.0,0.0397599399849962,0.0547636909227306,0.0309730825856273,0.1428571428571428,0.6511627906976742,0.4166666666666665,216,8,4,55,1,3241,11,75,213,8000000,331250.0,11000000.0,1200000.0,,50000.0,4,1750000,0.0,-0.2
410225,Ismaïla,Sarr,2024,873,Senegal,Saint-Louis,Senegal,25-02-98,Right Winger,Attack,Right,185.0,30-06-29,Teranga Sports,https://img.a.transfermarkt.technology/portrait/header/410225-1668162683.jpg?lm=1,GB1,Crystal Palace Football Club,18000000.0,30000000.0,26,144,153,10,12,15,14,12,10,8,15,6,6,12,14,7,13,11,12,14,13,11,11,12,14,14,6,14,7,10,13,15,14,15,11,15,18,14,13,13,11,14,8,13,1,2,2,2,3,1,1,3,2,1,3,12,15,7,13,10,14,10,11,1,1,1,1,1,1,1,10,1,14,18,10,20,15,76,8,20,32477686,7200,7000,6000,African_Caribbean,138,46,10,44657.0,Unknown,48042766,18750000.0,4.0,83,1275,84,0,1,1,58,10,0.6765017200317545,0.6363636363636364,0.6544117647058822,0.0431128796927792,0.3026315789473684,0.131578947368421,0.0897724431107777,0.1497874468617154,0.1041417817161587,0.4285714285714285,0.5116279069767438,0.3333333333333332,308,66,47,31,0,2827,9,56,101,20000000,763461.5384615385,30000000.0,5000000.0,1500000.0,20000000.0,4,15500000,0.1111111111111111,0.0
410425,Yves,Bissouma,2024,148,Cote d'Ivoire,Issia,Mali,30-08-96,Defensive Midfield,Midfield,Right,182.0,30-06-26,AMS CONSULTING,https://img.a.transfermarkt.technology/portrait/header/410425-1665607355.jpg?lm=1,GB1,Tottenham Hotspur Football Club,35000000.0,35000000.0,28,158,165,8,11,14,9,16,13,12,13,7,14,16,13,17,16,13,15,14,15,15,10,14,14,14,11,12,16,15,16,16,14,13,12,14,14,16,15,13,9,13,7,15,2,2,1,1,2,3,2,2,4,2,3,15,14,4,12,13,14,13,14,1,1,1,1,1,12,17,1,20,1,1,1,1,1,78,8,20,206180525,7900,7900,6250,African_Caribbean,156,26,3,104393.0,Unknown,13174979,23000000.0,2.0,23,666,61,3,1,1,202,4,0.7955808414924583,0.6631016042780749,0.7867647058823528,0.1007949926951053,0.1710526315789473,0.0394736842105263,0.1747936984246061,0.1747936984246061,0.1277535487096864,0.1428571428571428,0.4418604651162785,0.4166666666666665,276,15,5,64,3,4211,7,46,103,35000000,1447916.6666666667,35000000.0,7000000.0,,800000.0,2,10000000,0.0,0.16666666666666666
411295,Unknown,Raphinha,2024,131,Brazil,Porto Alegre,Brazil,14-12-96,Right Winger,Attack,Left,176.0,30-06-27,Unknown,https://img.a.transfermarkt.technology/portrait/header/411295-1724406375.jpg?lm=1,ES1,Futbol Club Barcelona,50000000.0,60000000.0,28,155,163,15,14,17,13,16,14,8,14,11,8,14,14,11,17,14,14,13,15,12,14,14,15,17,6,15,8,12,14,16,16,14,7,11,15,14,7,12,11,13,6,7,3,1,2,1,3,3,3,4,1,2,2,14,14,7,10,15,14,10,12,1,1,1,1,1,1,1,13,1,19,19,1,20,10,68,20,9,63083943,7749,8149,7099,Mixed_Race,156,9,3,230768.0,Unknown,19242277,20940000.0,5.0,10,1171,11,0,0,4,96,10,0.8285260650965864,0.7539037433155079,0.7867647058823528,0.2228248746870193,0.0592105263157894,0.0394736842105263,0.2498124531132783,0.2998249562390597,0.1163087863551765,0.5714285714285714,0.3023255813953489,0.4166666666666665,369,106,78,60,1,7251,10,37,64,80000000,2953703.703703704,80000000.0,10000000.0,,4000000.0,5,13750000,0.6,0.6
411838,Unknown,Bruno Viana,2024,2832,Brazil,MacaÃ©,Brazil,05-02-95,Centre-Back,Defender,Right,186.0,30-06-25,MACAR SPORTS,https://img.a.transfermarkt.technology/portrait/header/411838-1725480338.jpg?lm=1,TR1,Gaziantep Futbol KulÃ¼bÃ¼ A.?.,1200000.0,7000000.0,29,124,135,6,8,8,7,11,6,13,7,7,13,13,7,11,12,12,13,13,12,11,11,13,11,5,11,7,13,14,14,13,13,14,15,13,13,13,13,12,6,10,4,5,2,4,2,1,3,1,2,1,2,3,1,15,12,9,9,10,8,12,8,1,1,20,1,1,1,1,1,1,1,1,1,1,1,83,10,20,551304,6130,6206,5006,African_Caribbean,124,0,0,10714.0,Wuhan Changjiang,19197239,2000000.0,3.0,10,890,11,1,1,1,103,2,0.5714474728764224,0.5300534759358289,0.5514705882352942,0.0103369328326285,0.0,0.0,0.0057514378594648,0.0347586896724181,0.0110836412122558,0.2857142857142857,0.5348837209302322,0.4583333333333332,324,16,6,63,3,9691,1,2,10,1200000,33333.333333333336,7000000.0,3500000.0,,,7,1650000,0.0,-0.14285714285714285
411975,Jules,Koundé,2024,131,France,Paris,France,12-11-98,Right-Back,Defender,Right,180.0,30-06-27,ESN,https://img.a.transfermarkt.technology/portrait/header/411975-1702502639.jpg?lm=1,ES1,Futbol Club Barcelona,45000000.0,60000000.0,26,162,175,6,13,12,9,13,5,16,7,8,16,14,8,16,13,14,17,16,14,16,14,14,16,12,14,12,15,16,16,15,16,16,13,15,14,15,14,15,7,14,9,15,3,1,1,1,2,1,1,1,3,2,1,15,15,6,13,13,16,13,12,1,1,20,15,1,15,1,1,1,1,1,1,1,1,70,10,20,122512503,8000,7750,7250,African_Caribbean,165,11,0,182692.0,Unknown,48036304,42500000.0,2.0,34,1122,36,1,1,1,96,11,0.7757343212490078,0.7700534759358288,0.8529411764705881,0.1764018590063605,0.0723684210526315,0.0,0.2248062015503876,0.2998249562390597,0.2360898913858718,0.1428571428571428,0.3953488372093026,0.3333333333333332,352,20,21,34,3,8652,4,15,23,60000000,2458333.3333333335,60000000.0,10000000.0,,25000000.0,2,10000000,0.3333333333333333,0.0
412045,Pol,Lozano,2024,714,Spain,Sant Quirze del VallÃ¨s,Spain,06-10-99,Central Midfield,Midfield,Right,176.0,30-06-27,MagicPlayers,https://img.a.transfermarkt.technology/portrait/header/412045-1568028635.jpg?lm=1,ES1,Reial Club Deportiu Espanyol de Barcelona S.A.D.,2000000.0,2000000.0,25,118,145,9,8,10,7,14,12,8,15,8,9,14,9,8,14,8,15,8,11,8,13,13,18,5,12,14,12,11,10,13,16,13,7,14,14,12,9,14,12,5,7,14,3,4,1,2,2,2,2,2,2,1,1,17,12,7,13,13,9,10,14,1,1,1,1,1,1,15,1,20,1,1,9,1,1,68,13,20,4335998,5599,5599,2749,Mediterranean_Hispanic,124,0,0,3000.0,Unknown,67246431,9111392.0,2.0,89,1323,89,3,1,3,170,1,0.4911352209579254,0.288663101604278,0.5514705882352942,0.0028881612426335,0.0,0.0,0.0097524381095273,0.0097524381095273,0.0505924720131114,0.1428571428571428,0.3023255813953489,0.2916666666666665,184,1,3,43,1,4284,1,7,39,1800000,84210.52631578948,2000000.0,300000.0,,1300000.0,5,500000,-0.1,-0.1
412363,Unknown,Rodrygo,2024,418,Brazil,Osasco,Brazil,09-01-01,Right Winger,Attack,Right,174.0,30-06-28,Un1que Football,https://img.a.transfermarkt.technology/portrait/header/412363-1693988167.jpg?lm=1,ES1,Real Madrid Club de FÃºtbol,110000000.0,110000000.0,23,152,175,7,12,15,17,15,8,12,12,8,5,14,12,6,15,11,13,13,14,14,12,14,14,15,11,15,9,12,14,15,16,14,9,12,15,14,13,13,7,13,9,11,1,3,3,2,2,2,1,3,4,2,1,12,13,5,14,13,15,15,15,1,1,1,1,1,1,1,12,1,14,19,1,20,16,64,10,20,55200001,7595,7495,6995,African_Caribbean,148,5,1,154109.0,Unknown,19306929,45000000.0,1.0,10,1094,11,0,1,1,167,10,0.7419952368351416,0.7427807486631015,0.7279411764705881,0.1488016206920193,0.0328947368421052,0.0131578947368421,0.549887471867967,0.549887471867967,0.2499791660879468,0.0,0.2558139534883721,0.2083333333333332,333,86,56,20,0,8168,13,36,66,100000000,5876470.588235294,110000000.0,10000000.0,50000000.0,40000000.0,1,0,-0.09090909090909091,0.0
412366,Unknown,Brenner,2024,410,Brazil,CuiabÃ¡,Brazil,16-01-00,Centre-Forward,Attack,Right,175.0,30-06-28,Bertolucci Sports,https://img.a.transfermarkt.technology/portrait/header/412366-1692880573.jpg?lm=1,IT1,Udinese Calcio,7000000.0,9000000.0,24,131,140,10,9,14,15,14,10,13,10,10,7,11,15,7,13,12,13,12,13,13,12,12,15,13,11,15,8,12,13,15,15,10,6,15,14,13,10,9,5,11,9,8,2,2,3,1,2,1,2,3,2,2,2,7,14,5,12,15,14,10,12,1,1,1,1,1,1,1,1,1,1,1,1,1,20,70,12,20,8235028,6073,6475,4283,Mixed_Race,132,0,0,43017.0,Unknown,19302917,10910000.0,2.0,10,396,11,0,1,4,205,3,0.6070388991796771,0.4527272727272727,0.6102941176470589,0.0415292673765241,0.0,0.0,0.0347586896724181,0.0447611902975743,0.0605850162504513,0.1428571428571428,0.2790697674418605,0.25,171,55,13,17,1,3802,3,31,159,8000000,443750.0,9000000.0,2000000.0,900000.0,1300000.0,5,7900000,0.14285714285714285,0.0
412367,Unknown,Weverson,2024,8024,Brazil,Brasilia,Brazil,05-07-00,Left-Back,Defender,Right,185.0,30-06-25,Roc Nation Sports,https://img.a.transfermarkt.technology/portrait/header/412367-1654715390.png?lm=1,PO1,Futebol Clube de Arouca,1500000.0,1500000.0,24,148,148,2,3,3,2,10,5,2,1,10,3,12,5,3,10,15,13,14,13,14,10,13,15,7,13,1,16,13,13,12,14,13,16,17,11,14,16,15,13,14,7,12,14,14,15,11,15,12,16,15,16,14,13,12,15,10,14,11,14,8,10,20,1,1,1,1,1,1,1,1,1,1,1,1,1,91,10,20,347975206,7560,7560,4744,Mediterranean_Hispanic,151,8,0,20127.0,Unknown,19034819,300000.0,1.0,10,243,11,1,1,3,98,8,0.7505953956073035,0.5020320855614973,0.75,0.0194262881575732,0.0526315789473684,0.0,0.0072518129532383,0.0072518129532383,0.0016389344148448,0.0,0.5116279069767438,0.25,96,1,2,14,1,2567,3,4,24,1000000,56818.181818181816,1500000.0,500000.0,,500000.0,1,300000,-0.3333333333333333,0.6666666666666666
412517,Zan,Zaletel,2024,1063,Unknown,Unknown,Slovenia,16-09-99,Centre-Back,Defender,Right,185.0,31-12-27,MSC GROUP,https://img.a.transfermarkt.technology/portrait/header/412517-1716317120.jpg?lm=1,DK1,Viborg Fodsports Forening,1800000.0,1800000.0,25,116,135,8,7,7,5,11,8,13,7,6,13,10,5,13,9,13,11,12,12,13,9,13,11,6,14,10,12,11,12,10,12,13,12,15,10,13,14,14,11,13,10,17,2,1,1,1,1,3,3,4,2,3,2,12,13,9,12,13,14,13,13,1,5,20,10,1,1,1,1,1,1,1,1,1,1,77,9,20,1279846,5850,5550,3250,Northern_European,111,0,0,2352.0,Unknown,62220556,9111392.0,2.0,105,1549,87,1,1,7,215,2,0.4846520243450648,0.3422459893048128,0.4558823529411764,0.0022624412542595,0.0,0.0,0.0087521880470117,0.0087521880470117,0.0505924720131114,0.1428571428571428,0.5116279069767438,0.2916666666666665,219,8,4,24,0,3794,1,24,316,1800000,110937.5,1800000.0,300000.0,50000.0,700000.0,2,125000,0.0,0.5
412615,Giorgi,Kutsia,2024,26459,Georgia,Tiflis,Georgia,27-10-99,Central Midfield,Midfield,Right,175.0,30-06-27,GBM Sports Group.bv ,https://img.a.transfermarkt.technology/portrait/header/412615-1723642172.png?lm=1,UKR1,NK Veres Rivne,150000.0,500000.0,25,97,140,4,8,10,6,15,6,9,10,5,6,15,5,12,14,7,14,9,11,11,10,11,5,5,10,7,15,10,13,12,13,10,9,15,11,8,9,10,8,9,6,16,2,2,3,3,1,2,1,2,1,3,2,20,13,7,11,9,8,13,13,1,1,1,16,1,1,18,1,20,1,1,1,1,1,0,9,20,496999,5240,5240,3743,Northern_European,96,0,0,1221.0,Unknown,59124935,9111392.0,2.0,37,1490,39,3,1,7,136,1,0.4436358825086002,0.3949732620320855,0.3455882352941176,0.0011703281264031,0.0,0.0,0.0005001250312578,0.0022505626406601,0.0505924720131114,0.1428571428571428,0.2790697674418605,0.2916666666666665,222,13,15,53,0,5748,0,0,0,300000,10227.272727272728,500000.0,100000.0,250000.0,450000.0,6,650000,1.0,0.5
412660,Keinan,Davis,2024,410,England,Stevenage,England,13-02-98,Centre-Forward,Attack,Left,189.0,30-06-27,Tier One,https://img.a.transfermarkt.technology/portrait/header/412660-1707127382.jpg?lm=1,IT1,Udinese Calcio,3000000.0,3000000.0,26,126,140,5,7,11,12,14,7,13,10,5,5,11,10,10,13,14,11,15,11,10,12,10,12,11,6,14,7,17,13,13,13,15,14,12,14,13,17,12,9,12,13,11,3,1,2,1,3,1,2,1,1,2,1,7,13,5,13,12,12,11,11,1,1,1,1,1,1,1,1,1,1,1,1,1,20,0,20,12,8672569,6250,6250,4006,African_Caribbean,125,0,0,28998.0,Watford,28107730,2300000.0,1.0,32,1423,33,0,0,1,205,3,0.5772691188145012,0.4231016042780748,0.5588235294117647,0.0279922789243409,0.0,0.0,0.0147536884221055,0.0147536884221055,0.0127503541765049,0.0,0.6046511627906974,0.3333333333333332,202,32,19,22,0,4034,12,77,119,4000000,234375.0,4000000.0,500000.0,,2000000.0,4,1000000,0.3333333333333333,0.3333333333333333
412932,Myron,Boadu,2024,80,Netherlands,Amsterdam,Netherlands,14-01-01,Centre-Forward,Attack,Right,181.0,30-06-25,Team Raiola,https://img.a.transfermarkt.technology/portrait/header/412932-1666692057.jpg?lm=1,L1,Verein fÃ¼r LeibesÃ¼bungen Bochum 1848 FuÃŸballgemeinschaft,5000000.0,20000000.0,23,134,156,6,8,12,11,13,5,9,7,3,4,12,13,5,13,13,12,11,11,10,10,9,14,12,4,14,4,8,12,17,14,14,14,13,16,13,12,10,4,16,12,12,1,3,2,1,4,2,2,4,2,2,1,8,13,5,12,13,12,14,12,1,1,1,1,1,1,1,14,10,14,17,14,17,20,71,16,20,17600000,6891,6591,5491,African_Caribbean,123,1,1,23014.0,Unknown,37060951,17000000.0,1.0,67,64,68,0,1,1,212,3,0.6223868748346123,0.5819251336898396,0.5441176470588236,0.0222140252045418,0.006578947368421,0.0131578947368421,0.0247561890472618,0.0997749437359339,0.0944192894247062,0.0,0.418604651162791,0.2083333333333332,205,73,22,11,0,7142,13,146,253,5000000,202173.91304347827,20000000.0,3000000.0,20000000.0,15000000.0,3,2000000,0.0,-0.16666666666666666
412954,Vicente,Besuijen,2024,370,Colombia,BogotÃ¡,Netherlands,10-04-01,Right Winger,Attack,Right,169.0,31-05-26,SEG,https://img.a.transfermarkt.technology/portrait/header/412954-1697115708.jpg?lm=1,SC1,Aberdeen Football Club,500000.0,600000.0,23,114,137,9,10,14,11,12,10,5,6,11,3,11,10,4,13,9,8,13,12,7,8,10,9,15,6,12,4,7,13,15,15,15,5,14,15,11,4,8,12,8,7,13,2,1,1,1,3,2,2,2,2,3,3,12,10,4,7,13,10,3,8,1,1,1,1,1,1,1,14,1,14,18,15,20,12,63,14,20,4310253,5683,5335,3236,African_Caribbean,108,0,0,2320.0,Unknown,37060949,450000.0,2.0,20,216,68,0,1,1,12,10,0.4562053453294522,0.3407486631016042,0.4338235294117646,0.0022315415017472,0.0,0.0,0.0022505626406601,0.0027506876719179,0.0024722908969693,0.1428571428571428,0.13953488372093,0.2083333333333332,223,34,27,16,0,6678,6,55,136,500000,32692.30769230769,600000.0,100000.0,,450000.0,6,200000,0.0,0.1111111111111111
413039,Bryan,Mbeumo,2024,1148,France,Avallon,Cameroon,07-08-99,Right Winger,Attack,Left,171.0,30-06-26,ESN,https://img.a.transfermarkt.technology/portrait/header/413039-1668505084.jpg?lm=1,GB1,Brentford Football Club,40000000.0,40000000.0,25,136,152,11,13,14,13,11,9,10,13,6,6,13,13,6,13,12,12,14,12,12,13,12,14,14,7,13,8,14,16,15,13,12,8,14,15,13,12,13,8,12,6,13,1,1,3,1,1,1,1,1,1,3,2,12,13,8,12,12,13,11,12,1,1,1,1,1,1,1,17,1,1,19,1,20,18,70,20,8,74438852,7000,6800,5750,African_Caribbean,129,0,0,52196.0,Unknown,48042658,6500000.0,1.0,34,109,15,0,0,1,43,10,0.6500396930404869,0.6096256684491979,0.588235294117647,0.0503926682612226,0.0,0.0,0.1997999499874969,0.1997999499874969,0.0360843356759909,0.0,0.1860465116279068,0.2916666666666665,276,78,49,26,0,1788,2,20,97,50000000,2769444.4444444445,50000000.0,1000000.0,300000.0,8000000.0,2,2100000,0.25,0.3157894736842105
413112,Aurélien,Tchouaméni,2024,418,France,Rouen,France,27-01-00,Defensive Midfield,Midfield,Right,188.0,30-06-28,ESN,https://img.a.transfermarkt.technology/portrait/header/413112-1668500754.jpg?lm=1,ES1,Real Madrid Club de FÃºtbol,100000000.0,100000000.0,24,159,180,8,10,12,6,14,6,14,13,8,15,15,10,16,14,16,17,16,15,15,15,15,16,13,11,13,15,15,16,14,14,15,14,16,14,17,16,15,7,13,5,11,4,2,3,3,1,2,2,3,1,3,1,20,15,7,13,16,15,14,13,1,1,1,1,1,1,15,1,20,1,1,1,1,1,81,10,20,131900410,7950,7950,5500,African_Caribbean,160,12,1,138081.0,Unknown,48042326,49000000.0,2.0,34,1256,36,3,1,1,167,4,0.8021963482402752,0.5828877005347594,0.8161764705882353,0.1333247071524236,0.0789473684210526,0.0131578947368421,0.4998749687421855,0.4998749687421855,0.2722020056112669,0.1428571428571428,0.581395348837209,0.25,253,12,14,48,0,5839,9,32,48,80000000,3571428.5714285714,100000000.0,20000000.0,5000000.0,16000000.0,2,23000000,-0.2,-0.1111111111111111
413118,Sikou,Niakaté,2024,1075,France,Montreuil,Mali,10-07-99,Centre-Back,Defender,Left,186.0,30-06-28,Unknown,https://img.a.transfermarkt.technology/portrait/header/413118-1605023058.jpg?lm=1,PO1,Sporting Clube de Braga,6000000.0,6000000.0,25,128,138,5,9,11,8,11,7,14,6,10,14,11,9,12,12,14,14,13,12,11,12,12,13,12,9,8,13,13,13,14,13,15,14,12,13,14,14,12,13,11,7,10,2,3,3,1,4,3,1,1,3,1,4,7,13,7,10,10,10,11,12,1,14,20,1,1,1,1,1,1,1,1,1,1,1,80,20,9,3886786,6400,5734,4910,African_Caribbean,128,0,0,14529.0,Sporting Clube de Braga,49037484,2150000.0,2.0,34,979,61,1,0,1,192,2,0.508997089177031,0.5197860962566845,0.5808823529411764,0.0140207627024537,0.0,0.0,0.0297574393598399,0.0297574393598399,0.0119169976943803,0.1428571428571428,0.5348837209302322,0.2916666666666665,217,10,3,44,5,5762,7,49,60,6000000,305882.35294117645,6000000.0,200000.0,800000.0,1100000.0,3,1200000,0.0,0.5
413220,James,Justin,2024,1003,England,Luton,England,23-02-98,Left-Back,Defender,Right,183.0,30-06-26,CAA Stellar,https://img.a.transfermarkt.technology/portrait/header/413220-1600097627.jpg?lm=1,GB1,Leicester City Football Club,15000000.0,25000000.0,26,143,161,9,11,13,5,11,9,12,8,11,13,12,6,12,12,12,12,11,12,12,11,12,16,7,8,10,13,14,15,15,13,11,12,14,15,16,12,16,8,9,8,15,1,2,2,3,4,1,1,1,1,1,2,8,12,8,12,14,12,14,12,1,19,16,20,18,18,10,1,10,1,1,1,1,1,80,13,20,39368175,7150,7150,5500,African_Caribbean,130,1,0,115992.0,Unknown,29140167,6700000.0,1.0,32,879,33,1,1,1,127,8,0.696348240275205,0.5828877005347594,0.5955882352941175,0.1119951873635462,0.006578947368421,0.0,0.0747686921730432,0.1247811952988247,0.037195477652157,0.0,0.4651162790697669,0.3333333333333332,272,17,20,17,0,6300,3,100,332,15000000,687500.0,25000000.0,5000000.0,,,0,0,0.0,0.0
413262,Dani,Raba,2024,1244,Spain,Santander,Spain,29-10-95,Right Winger,Attack,Left,185.0,30-06-25,Identity Sports,https://img.a.transfermarkt.technology/portrait/header/413262-1530299369.jpg?lm=1,ES1,Club Deportivo LeganÃ©s S.A.D.,2200000.0,5000000.0,29,122,135,8,11,13,8,14,9,11,11,9,9,14,5,6,14,13,14,8,9,9,14,14,18,11,6,13,9,10,11,14,14,10,10,5,14,13,7,15,5,15,5,13,2,1,3,2,2,2,1,4,2,4,1,13,10,6,13,11,12,11,17,1,1,1,1,1,1,1,1,1,1,10,18,14,20,76,20,8,1904698,6100,6100,2500,Mediterranean_Hispanic,107,0,0,5565.0,Unknown,67216778,9111392.0,2.0,89,1331,89,0,0,3,54,10,0.5574225985710506,0.2620320855614972,0.4264705882352941,0.0053649695299471,0.0,0.0,0.010752688172043,0.0247561890472618,0.0505924720131114,0.1428571428571428,0.5116279069767438,0.4583333333333332,220,35,26,46,1,4360,1,2,18,1800000,73913.04347826086,5000000.0,2000000.0,,200000.0,5,3900000,-0.18181818181818182,-0.1
413268,Kevin,Yakob,2024,678,Sweden,GÃ¶teborg,Iraq,10-10-00,Attacking Midfield,Midfield,Right,184.0,30-06-27,ICON MGMT,https://img.a.transfermarkt.technology/portrait/header/413268-1689244158.jpg?lm=1,DK1,Aarhus Gymnastik Forening,700000.0,1500000.0,24,109,135,9,12,14,11,13,8,8,11,5,7,12,10,8,13,9,11,9,12,11,13,11,13,13,8,12,8,10,11,13,12,11,10,10,13,11,10,11,7,7,13,11,3,4,3,3,3,1,3,2,1,1,2,13,13,6,12,12,12,12,8,1,1,1,1,1,1,10,1,15,1,17,20,14,14,74,10,20,1465370,5450,5600,1250,Northern_European,107,0,0,4033.0,Unknown,93083206,190000.0,1.0,91,582,51,3,1,7,11,0,0.4912675310928817,0.1283422459893048,0.4264705882352941,0.003885643878421,0.0,0.0,0.0032508127031757,0.0072518129532383,0.0010278063279535,0.0,0.4883720930232553,0.25,102,34,10,10,1,5231,3,101,472,700000,41666.666666666664,1500000.0,600000.0,100000.0,400000.0,2,650000,0.0,-0.2222222222222222
413403,Ezri,Konsa,2024,405,England,London,England,23-10-97,Centre-Back,Defender,Right,183.0,30-06-28,CAA Stellar,https://img.a.transfermarkt.technology/portrait/header/413403-1700651779.jpg?lm=1,GB1,Aston Villa Football Club,35000000.0,35000000.0,27,138,150,4,7,12,5,13,3,15,3,7,13,14,4,15,14,13,14,14,15,12,14,13,13,10,10,9,14,15,16,14,14,13,14,14,14,15,14,11,11,13,9,13,1,2,1,3,3,2,3,3,3,2,2,13,13,3,15,13,12,13,13,1,1,20,14,1,1,1,1,1,1,1,1,1,1,77,9,20,31004591,6900,6900,5750,African_Caribbean,138,0,0,81194.0,Unknown,29141827,8075000.0,2.0,32,858,33,1,1,1,30,2,0.6632707065361206,0.6096256684491979,0.6544117647058822,0.0783936377409577,0.0,0.0,0.1747936984246061,0.1747936984246061,0.0448345787382982,0.1428571428571428,0.4651162790697669,0.375,352,9,3,49,2,4570,6,13,57,35000000,1836842.105263158,35000000.0,3000000.0,100000.0,3000000.0,2,7000000,0.0,0.0
413507,Nikola,Milenkovi?,2024,703,Yugoslavia (Republic),Belgrade,Serbia,12-10-97,Centre-Back,Defender,Right,195.0,30-06-29,LIAN Sports Group,https://img.a.transfermarkt.technology/portrait/header/413507-1661166461.jpg?lm=1,GB1,Nottingham Forest Football Club,18000000.0,35000000.0,27,148,162,4,9,9,10,11,4,16,8,9,15,13,6,15,11,17,14,16,13,14,11,13,15,7,11,8,15,15,15,13,12,14,17,16,14,15,16,12,14,12,8,11,3,2,4,1,3,1,3,2,3,2,3,14,14,12,13,13,15,14,11,1,1,20,16,1,1,1,1,1,1,1,1,1,1,92,9,20,23000363,7500,7150,6000,Mediterranean_Hispanic,148,37,3,106922.0,Unknown,62191195,9900000.0,2.0,110,167,85,1,1,3,140,2,0.696348240275205,0.6363636363636364,0.7279411764705881,0.1032370387608426,0.2434210526315789,0.0394736842105263,0.0897724431107777,0.1747936984246061,0.054973749270813,0.1428571428571428,0.7441860465116279,0.375,333,23,7,59,3,5336,8,14,23,25000000,1127272.7272727273,35000000.0,6000000.0,200000.0,15000000.0,2,3000000,0.6666666666666666,0.5625
413565,Jhon,Lucumí,2024,1025,Colombia,Cali,Colombia,26-06-98,Centre-Back,Defender,Left,187.0,30-06-26,Wasserman,https://img.a.transfermarkt.technology/portrait/header/413565-1663657119.jpg?lm=1,IT1,Bologna Football Club 1909,17000000.0,17000000.0,26,131,145,4,11,12,7,11,5,13,6,11,13,13,9,14,12,14,14,14,12,13,11,14,12,13,13,10,13,14,11,13,11,14,13,13,13,13,15,14,14,11,5,12,2,1,2,4,3,1,3,2,3,1,3,16,11,9,12,12,15,13,13,1,13,20,1,10,1,9,1,1,1,1,1,1,1,84,20,10,15877494,6550,6500,4950,African_Caribbean,131,6,0,29230.0,Unknown,76042952,5250000.0,2.0,20,303,20,1,0,1,40,2,0.6103466525535857,0.5240641711229946,0.6029411764705883,0.0282163021300551,0.0394736842105263,0.0,0.0847711927981995,0.0847711927981995,0.0291396983249534,0.1428571428571428,0.5581395348837206,0.3333333333333332,284,4,5,38,2,8980,4,20,57,18000000,745833.3333333334,18000000.0,2000000.0,300000.0,8000000.0,2,1800000,0.058823529411764705,0.6363636363636364
413605,David,Okereke,2024,2832,Nigeria,Lagos,Nigeria,29-08-97,Centre-Forward,Attack,Right,181.0,30-06-25,Patrick Bastianelli,https://img.a.transfermarkt.technology/portrait/header/413605-1663683547.jpg?lm=1,TR1,Gaziantep Futbol KulÃ¼bÃ¼ A.?.,2400000.0,11000000.0,27,127,135,5,8,13,14,13,8,11,11,6,5,12,13,5,14,12,13,11,13,9,11,11,14,14,9,14,9,12,11,14,15,14,11,13,14,14,14,12,9,10,12,11,3,2,2,2,3,1,2,1,2,2,3,14,13,6,10,14,13,11,12,1,1,1,1,1,1,1,1,1,1,14,1,16,20,77,10,20,3116002,6350,6500,4850,African_Caribbean,127,0,0,19751.0,Unknown,43273310,5330000.0,2.0,69,789,70,0,1,1,103,3,0.6103466525535857,0.5133689839572192,0.5735294117647058,0.0190632160655538,0.0,0.0,0.0117529382345586,0.0547636909227306,0.0295841551154198,0.1428571428571428,0.418604651162791,0.375,286,63,28,29,1,6574,6,15,26,2400000,95833.33333333333,11000000.0,3000000.0,100000.0,350000.0,7,9400000,0.0,-0.1111111111111111
413843,Keven,Schlotterbeck,2024,167,Germany,Weinstadt,Germany,28-04-97,Centre-Back,Defender,Left,189.0,30-06-27,Robert Schneider,https://img.a.transfermarkt.technology/portrait/header/413843-1722849820.jpg?lm=1,L1,FC Augsburg 1907,6000000.0,7500000.0,27,125,135,4,6,8,8,10,8,15,12,6,14,13,12,15,11,16,11,16,14,11,12,14,13,11,12,7,12,14,12,11,8,13,15,11,12,13,14,14,12,14,4,5,4,1,2,2,3,4,3,2,4,3,3,5,10,8,13,14,12,12,14,1,1,20,1,1,1,16,1,1,1,1,1,1,1,85,20,10,1819703,6041,6041,4591,Northern_European,124,0,0,2749.0,Unknown,90087316,2500000.0,1.0,38,1651,40,1,0,7,67,2,0.5496163006086267,0.4856684491978609,0.5514705882352942,0.0026457913088652,0.0,0.0,0.0297574393598399,0.0372593148287071,0.0138614961526709,0.0,0.6046511627906974,0.375,249,26,9,45,1,4568,12,20,46,7000000,302173.9130434783,7500000.0,1500000.0,,75000.0,5,2725000,0.16666666666666666,1.0
414774,Jhon,Velásquez,2024,4294,Colombia,BogotÃ¡,Colombia,02-05-95,Attacking Midfield,Midfield,Right,174.0,30-06-25,GestiSports,https://img.a.transfermarkt.technology/portrait/header/414774-1640098502.jpg?lm=1,PO1,Sporting Clube Farense,300000.0,900000.0,29,126,132,12,13,14,13,12,11,12,10,11,5,12,13,8,14,10,12,12,13,11,10,12,12,12,11,13,8,13,13,13,13,12,9,13,13,13,12,13,8,11,9,11,1,1,3,1,3,2,2,2,2,1,3,11,10,9,12,11,12,10,11,1,1,1,1,1,1,1,1,1,1,20,10,18,12,78,12,20,1100298,6289,6292,2800,Mixed_Race,125,0,0,8762.0,CEA,76033393,9111392.0,2.0,20,216,20,3,1,4,191,0,0.5828261444826673,0.2941176470588235,0.5588235294117647,0.0084520479293786,0.0,0.0,0.0012503125781445,0.0042510627656914,0.0505924720131114,0.1428571428571428,0.2558139534883721,0.4583333333333332,173,23,25,30,0,5913,1,38,339,200000,10714.285714285714,900000.0,200000.0,,,2,200000,-0.3333333333333333,-0.3333333333333333
414908,Marshall,Munetsi,2024,1421,Zimbabwe,Harare,Zimbabwe,22-06-96,Central Midfield,Midfield,Right,188.0,30-06-27,Wasserman,https://img.a.transfermarkt.technology/portrait/header/414908-1723836952.png?lm=1,FR1,Stade de Reims,10000000.0,12000000.0,28,120,127,6,8,12,10,14,8,9,11,8,12,13,10,13,13,12,12,13,11,11,11,12,4,11,11,12,12,12,14,12,11,12,12,11,11,15,15,10,11,11,11,11,1,3,2,2,1,2,3,2,2,4,2,14,11,2,9,12,11,11,17,1,1,10,1,1,1,20,1,15,1,1,1,1,1,83,11,20,1432639,5996,5996,2996,African_Caribbean,120,22,1,6547.0,Unknown,13167102,9111392.0,2.0,113,597,108,3,1,1,197,1,0.5436623445355915,0.3150802139037433,0.5220588235294117,0.0063132056851682,0.1447368421052631,0.0131578947368421,0.0497624406101525,0.0597649412353088,0.0505924720131114,0.1428571428571428,0.581395348837209,0.4166666666666665,230,24,15,41,3,3831,4,15,47,10000000,453409.0909090909,12000000.0,2000000.0,,200000.0,3,675000,0.0,-0.16666666666666666
415383,Hervé,Koffi,2024,826,Burkina Faso,Bobo-Dioulasso,Burkina Faso,16-10-96,Goalkeeper,Goalkeeper,Right,186.0,30-06-28,ASR SPORT,https://img.a.transfermarkt.technology/portrait/header/415383-1672499883.jpg?lm=1,FR1,Racing Club de Lens,2000000.0,2500000.0,28,120,132,4,2,3,1,9,8,7,2,2,1,10,4,3,8,12,13,14,11,11,10,12,11,1,10,1,12,12,13,12,14,13,12,14,12,12,13,13,12,8,11,12,13,11,10,11,12,10,12,16,9,11,10,15,11,6,10,14,13,14,14,20,1,1,1,1,1,1,1,1,1,1,1,1,1,81,7,20,1796105,5973,5978,3978,African_Caribbean,119,44,0,10857.0,Unknown,13175645,1500000.0,2.0,12,209,13,2,1,1,158,5,0.5412807621063773,0.4201069518716577,0.5147058823529411,0.0104750161016679,0.2894736842105263,0.0,0.0097524381095273,0.0122530632658164,0.0083057862718408,0.1428571428571428,0.5348837209302322,0.4166666666666665,0,0,0,0,0,0,9,32,67,1500000,70000.0,2500000.0,500000.0,,500000.0,5,1400000,-0.25,0.15384615384615385
415525,Kanya,Fujimoto,2024,2424,Japan,"---, Yamanashi",Japan,01-07-99,Attacking Midfield,Midfield,Left,176.0,30-06-25,CAA Base Ltd,https://img.a.transfermarkt.technology/portrait/header/415525-1710239374.jpg?lm=1,PO1,Gil Vicente Futebol Clube,4000000.0,4000000.0,25,128,142,14,15,14,12,15,12,6,13,5,4,15,10,6,16,8,10,10,15,12,16,14,13,14,12,8,12,14,14,12,14,14,7,12,13,13,8,14,5,12,6,10,1,3,3,1,3,2,2,1,3,2,1,12,11,2,12,15,15,11,14,1,1,1,1,1,1,1,1,18,1,10,20,19,1,67,20,8,3556999,6400,5421,5085,10,128,0,0,2450.0,Unknown,45109737,600000.0,1.0,54,1,56,3,0,0,106,0,0.4675840169356973,0.5385026737967914,0.5808823529411764,0.0023570717463284,0.0,0.0,0.0197549387346836,0.0197549387346836,0.0033056473790938,0.0,0.3023255813953489,0.2916666666666665,221,19,27,14,1,4098,1,16,253,4000000,209210.52631578947,4000000.0,200000.0,25000.0,450000.0,2,375000,0.3333333333333333,0.3333333333333333
415912,Konstantinos,Mavropanos,2024,379,Greece,Athens,Greece,11-12-97,Centre-Back,Defender,Right,194.0,30-06-28,Konstantinos Farras,https://img.a.transfermarkt.technology/portrait/header/415912-1691999569.jpg?lm=1,GB1,West Ham United Football Club,20000000.0,20000000.0,27,135,145,4,8,12,7,12,6,14,11,9,13,12,6,16,12,16,12,17,12,11,11,12,18,11,12,11,13,13,17,14,11,15,16,13,14,13,16,13,13,13,11,6,3,3,1,2,3,2,3,2,2,1,2,15,17,6,12,16,16,12,13,1,1,20,16,1,13,13,1,1,1,1,1,1,1,89,8,20,8139896,6750,6250,5250,Mediterranean_Hispanic,135,13,0,25000.0,Unknown,36116501,8433333.333,3.0,40,104,42,1,1,3,220,2,0.5772691188145012,0.5561497326203209,0.6323529411764706,0.0241317410948361,0.0855263157894736,0.0,0.0997749437359339,0.0997749437359339,0.0468253747770771,0.2857142857142857,0.7209302325581395,0.375,229,19,3,46,1,6500,15,81,127,20000000,905681.8181818182,20000000.0,2000000.0,100000.0,3000000.0,4,3250000,0.0,0.42857142857142855
416386,Abdou,Harroui,2024,276,Netherlands,Leiden,Morocco,13-01-98,Central Midfield,Midfield,Right,182.0,30-06-28,PRO10 Sports,https://img.a.transfermarkt.technology/portrait/header/416386-1661514825.jpg?lm=1,IT1,Verona Hellas Football Club,2700000.0,3500000.0,26,122,135,5,8,13,11,12,10,11,13,10,10,13,10,12,13,14,12,14,13,11,13,12,14,10,10,13,11,15,15,11,12,13,11,14,11,14,12,10,8,12,6,14,1,1,2,1,2,3,4,2,2,3,2,12,15,6,12,14,14,11,14,1,1,1,1,1,1,18,1,20,13,1,12,1,1,76,12,20,2869296,6098,6198,4998,North_African__Middle_Eastern,122,0,0,4999.0,Unknown,37064635,966666.6667,3.0,67,814,67,3,1,6,214,1,0.5703889917967716,0.5291978609625668,0.536764705882353,0.0048184301573859,0.0,0.0,0.013253313328332,0.0172543135783946,0.00534274100225,0.2857142857142857,0.4418604651162785,0.3333333333333332,238,42,26,22,0,3605,10,60,169,2500000,128947.36842105263,3500000.0,500000.0,,150000.0,4,850000,-0.07407407407407407,-0.07407407407407407
416660,Ramiz,Zerrouki,2024,234,Netherlands,Amsterdam,Algeria,26-05-98,Defensive Midfield,Midfield,Right,183.0,30-06-27,Muy Manero,https://img.a.transfermarkt.technology/portrait/header/416660-1699461610.jpg?lm=1,NL1,Feyenoord Rotterdam,9000000.0,10000000.0,26,120,131,13,11,12,9,12,14,11,14,4,12,13,8,10,14,15,12,15,13,13,11,13,15,9,14,12,11,14,16,10,13,13,10,15,11,14,12,13,12,13,10,11,1,4,3,3,3,3,3,3,1,1,3,11,12,1,10,17,14,12,11,1,1,1,1,1,1,20,1,18,10,1,10,1,1,0,8,20,3456333,5900,5600,4750,North_African__Middle_Eastern,118,16,1,2500.0,Unknown,37055855,9111392.0,2.0,67,64,1,3,1,6,85,4,0.4912675310928817,0.5026737967914437,0.5073529411764706,0.0024053526096289,0.1052631578947368,0.0131578947368421,0.0447611902975743,0.0497624406101525,0.0505924720131114,0.1428571428571428,0.4651162790697669,0.3333333333333332,273,15,11,29,0,8217,4,13,35,6500000,428333.3333333333,10000000.0,2500000.0,,,2,2075000,-0.2777777777777778,-0.35
416802,Thierry,Lutonda,2024,1269,DR Congo,Kinshasa,Belgium,27-10-00,Left-Back,Defender,Left,167.0,30-06-26,TTMA,https://img.a.transfermarkt.technology/portrait/header/416802-1690902693.jpg?lm=1,NL1,Prins Hendrik Ende Desespereert Nimmer Combinatie Zwolle,400000.0,600000.0,24,107,135,10,10,12,7,12,10,7,10,6,8,13,7,7,14,5,11,9,11,10,9,7,13,11,10,12,7,8,11,14,12,7,8,6,14,12,7,10,15,11,13,14,1,2,1,2,2,1,2,3,2,3,1,7,14,6,11,11,12,11,16,1,19,1,14,20,14,12,18,12,10,19,1,1,1,0,20,5,3139998,5100,5100,2500,African_Caribbean,85,0,0,1437.0,Unknown,18106043,9111392.0,2.0,27,729,8,1,0,1,156,8,0.4251124636147129,0.2620320855614972,0.2647058823529412,0.0013789014558611,0.0,0.0,0.0017504376094023,0.0027506876719179,0.0505924720131114,0.1428571428571428,0.0930232558139532,0.25,98,2,3,3,0,2829,3,11,44,350000,-3125.0,600000.0,100000.0,400000.0,300000.0,2,50000,-0.125,-0.125
417228,Danylo,Sikan,2024,660,Ukraine,Zhytomyr,Ukraine,16-04-01,Centre-Forward,Attack,Right,187.0,30-06-28,GG11 ,https://img.a.transfermarkt.technology/portrait/header/417228-1723486871.png?lm=1,UKR1,FC Shakhtar Donetsk,7000000.0,7000000.0,23,125,135,7,7,11,13,13,7,11,11,8,6,11,13,6,11,11,13,13,13,10,11,10,15,13,5,13,11,10,14,15,14,13,14,11,14,13,12,10,8,11,9,9,1,1,2,2,3,1,1,1,1,3,3,10,11,4,13,9,14,12,10,1,1,1,1,1,1,1,1,1,1,14,1,14,20,75,12,20,5720235,5750,5750,3500,Northern_European,124,6,1,5220.0,Unknown,71106198,150000.0,1.0,103,1706,101,0,1,7,72,3,0.5111140513363324,0.3689839572192513,0.5514705882352942,0.0050318315731739,0.0394736842105263,0.0131578947368421,0.0347586896724181,0.0347586896724181,0.0008055779327203,0.0,0.5581395348837206,0.2083333333333332,157,36,15,19,1,4617,3,12,53,6000000,386666.6666666667,7000000.0,1000000.0,1800000.0,1500000.0,6,2100000,-0.14285714285714285,0.0
417242,Ruslan,Neshcheret,2024,338,Ukraine,"Mukacheve, Zakarpattya Oblast",Ukraine,22-01-02,Goalkeeper,Goalkeeper,Right,190.0,31-12-27,ProStar,https://img.a.transfermarkt.technology/portrait/header/417242-1726134629.png?lm=1,UKR1,Futbolniy Klub Dynamo Kyiv,2000000.0,3000000.0,22,110,-8,2,3,1,1,7,7,8,7,1,1,9,1,1,6,10,14,13,13,11,9,14,8,2,8,2,11,12,9,7,12,10,11,14,7,6,9,10,7,10,5,14,12,12,13,9,11,14,13,13,10,15,13,8,9,5,12,12,11,13,12,20,1,1,1,1,1,1,1,1,1,1,1,1,1,81,6,20,22630493,4988,4988,2488,Northern_European,106,0,0,1511.0,Unknown,71113690,9111392.0,2.0,103,991,101,2,1,7,97,5,0.4102937284996031,0.2607486631016042,0.4191176470588235,0.0014503571335458,0.0,0.0,0.0097524381095273,0.0147536884221055,0.0505924720131114,0.1428571428571428,0.6279069767441858,0.1666666666666666,0,0,0,0,0,0,6,20,150,1500000,108333.33333333333,3000000.0,1000000.0,1000000.0,1500000.0,0,0,-0.25,-0.25
417278,Arnaud,Bodart,2024,3057,Belgium,Seraing,Belgium,11-03-98,Goalkeeper,Goalkeeper,Right,187.0,30-06-25,Unknown,https://img.a.transfermarkt.technology/portrait/header/417278-1704961747.jpg?lm=1,BE1,Royal Standard Club de LiÃ¨ge,4000000.0,6500000.0,26,122,137,4,2,1,2,9,6,3,1,2,1,9,2,3,11,9,12,14,11,14,12,12,12,12,9,1,11,12,11,13,11,9,12,11,12,11,11,12,10,10,9,10,12,12,12,5,12,11,12,16,11,6,11,13,15,5,10,14,11,9,17,20,1,1,1,1,1,1,1,1,1,1,1,1,1,80,7,20,1181249,5750,5750,3500,Northern_European,117,0,0,7499.0,Unknown,18089257,9111392.0,2.0,7,1361,8,2,1,7,176,5,0.5111140513363324,0.3689839572192513,0.4999999999999999,0.0072324733224089,0.0,0.0,0.0197549387346836,0.032258064516129,0.0505924720131114,0.1428571428571428,0.5581395348837206,0.3333333333333332,0,0,0,0,0,0,5,40,96,3000000,133333.33333333334,6500000.0,2500000.0,,200000.0,0,0,-0.5,-0.5
417346,Jack,Harrison,2024,29,England,Stoke-on-Trent,England,20-11-96,Right Winger,Attack,Left,175.0,30-06-25,Unknown,https://img.a.transfermarkt.technology/portrait/header/417346-1711746777.jpg?lm=1,GB1,Everton Football Club,18000000.0,28000000.0,28,139,148,13,12,13,12,17,8,5,11,5,4,11,10,6,13,11,11,13,11,10,12,9,17,14,7,13,10,14,15,14,13,14,7,16,15,17,8,9,9,9,8,12,3,3,4,1,3,1,2,2,4,1,1,19,16,6,11,16,18,12,13,1,1,1,1,1,1,1,17,4,15,20,12,19,4,70,20,17,28815131,6941,6941,5991,Northern_European,135,0,0,69595.0,Unknown,72045910,8400000.0,2.0,32,1428,33,0,0,7,65,10,0.6686954220693305,0.6354010695187166,0.6323529411764706,0.0671934430725168,0.0,0.0,0.0897724431107777,0.1397849462365591,0.046640184449568,0.1428571428571428,0.2790697674418605,0.4166666666666665,335,52,46,16,1,2538,4,22,83,16000000,684782.6086956522,28000000.0,4000000.0,,850000.0,5,1750000,-0.1111111111111111,-0.2727272727272727
418543,Perr,Schuurs,2024,416,Netherlands,Nieuwstadt,Netherlands,26-11-99,Centre-Back,Defender,Right,191.0,30-06-26,Muy Manero,https://img.a.transfermarkt.technology/portrait/header/418543-1694614988.jpg?lm=1,IT1,Torino Calcio,25000000.0,25000000.0,25,132,157,7,9,7,7,11,15,15,14,7,14,13,8,14,12,8,15,10,13,14,13,12,15,9,12,8,14,12,13,11,12,13,15,14,12,13,13,13,4,11,9,10,4,2,1,4,2,2,3,2,2,1,2,15,12,8,15,14,15,16,15,1,1,20,14,1,12,16,1,1,1,1,1,1,1,87,9,20,12258749,6600,6050,5000,Northern_European,131,0,0,49999.0,Unknown,37062161,5700000.0,2.0,67,1045,68,1,1,7,201,2,0.5508070918232336,0.5294117647058822,0.6029411764705883,0.0482712071278004,0.0,0.0,0.1247811952988247,0.1247811952988247,0.0316397677713269,0.1428571428571428,0.6511627906976742,0.2916666666666665,238,22,16,22,1,5239,9,73,286,15000000,554629.6296296297,25000000.0,8000000.0,2000000.0,9000000.0,3,2000000,-0.4,-0.4
418557,Johan,Hove,2024,202,Norway,Sogndal,Norway,07-09-00,Central Midfield,Midfield,Right,178.0,30-06-26,TPSportManagement,https://img.a.transfermarkt.technology/portrait/header/418557-1723456286.jpg?lm=1,NL1,Football Club Groningen,1300000.0,2300000.0,24,119,136,12,12,12,12,14,11,5,13,5,12,14,10,11,13,6,12,9,11,10,14,11,11,12,7,14,11,12,14,11,11,12,10,11,12,15,10,13,5,5,6,10,1,2,3,3,3,1,3,1,1,1,1,11,12,4,10,14,12,12,6,1,1,1,1,1,1,10,4,20,10,5,16,12,1,72,10,20,1946904,5975,5975,3311,Northern_European,118,0,0,2320.0,Unknown,53139180,1030000.0,1.0,71,1390,73,3,1,7,88,1,0.5408838317015083,0.3487700534759358,0.5073529411764706,0.0022315415017472,0.0,0.0,0.0062515628907226,0.0112528132033008,0.0056946026278507,0.0,0.3488372093023257,0.25,233,37,19,12,0,2323,0,0,0,1500000,96666.66666666667,2300000.0,800000.0,200000.0,1000000.0,2,700000,0.15384615384615385,0.0
418560,Erling,Haaland,2024,281,England,Leeds,Norway,21-07-00,Centre-Forward,Attack,Left,195.0,30-06-27,Rafaela Pimenta,https://img.a.transfermarkt.technology/portrait/header/418560-1709108116.png?lm=1,GB1,Manchester City Football Club,200000000.0,200000000.0,24,185,195,7,10,14,18,16,13,15,13,5,6,13,17,7,15,13,18,15,18,15,14,13,20,16,13,18,7,13,13,17,16,17,18,19,19,14,17,17,9,17,12,10,2,4,1,3,2,2,2,2,3,3,2,16,20,12,15,18,17,10,12,1,1,1,1,1,1,1,1,1,1,1,1,1,20,88,20,11,347975206,9250,9250,8750,Northern_European,185,21,20,394372.0,Unknown,29179241,22025000.0,4.0,32,810,73,0,0,7,131,3,0.974199523683514,0.9304812834224598,1.0,0.38080372187519,0.1381578947368421,0.2631578947368421,1.0,1.0,0.1223367315758771,0.4285714285714285,0.7441860465116279,0.25,316,252,53,26,0,8361,20,65,54,200000000,8325000.0,200000000.0,8000000.0,5000000.0,130000000.0,4,35100000,0.1111111111111111,0.1111111111111111
418561,Kristoffer,Klaesson,2024,678,Norway,Oslo,Norway,27-11-00,Goalkeeper,Goalkeeper,Left,189.0,30-06-25,Keypass AS,https://img.a.transfermarkt.technology/portrait/header/418561-1721899700.png?lm=1,DK1,Aarhus Gymnastik Forening,1800000.0,2000000.0,24,105,139,1,3,1,3,7,4,3,1,3,1,10,2,1,6,11,9,15,8,9,8,8,17,9,12,5,12,12,7,11,13,9,15,11,9,9,12,12,4,10,5,7,15,11,12,11,12,13,11,15,12,14,7,6,14,2,16,12,12,12,15,20,1,1,1,1,1,1,1,1,1,1,1,1,1,76,20,8,7210046,5250,5855,4231,Northern_European,103,0,0,17399.0,Unknown,53131627,2400000.0,1.0,71,1096,73,2,0,7,11,5,0.5250066155067479,0.4471657754010695,0.3970588235294117,0.0167920842559001,0.0,0.0,0.0087521880470117,0.0097524381095273,0.0133059251645879,0.0,0.6046511627906974,0.25,0,0,0,0,0,0,1,6,29,1500000,120833.33333333333,2000000.0,300000.0,50000.0,2000000.0,3,550000,-0.16666666666666666,-0.16666666666666666
418571,Hamza,Rafia,2024,1005,Tunisia,Kalaat Senan,Tunisia,02-04-99,Central Midfield,Midfield,Right,181.0,30-06-26,Scuderia,https://img.a.transfermarkt.technology/portrait/header/418571-1725530321.jpg?lm=1,IT1,Unione Sportiva Lecce,1700000.0,1700000.0,25,112,135,14,14,15,11,15,13,7,13,5,5,14,11,5,14,10,10,9,12,10,13,11,13,14,9,12,10,10,10,13,13,13,8,12,13,13,10,11,11,8,9,13,2,1,3,3,1,3,3,2,2,3,3,16,13,5,12,10,12,9,17,1,1,1,1,1,1,1,12,14,13,15,20,18,1,75,4,20,104553,5597,5497,4497,North_African__Middle_Eastern,109,19,0,7070.0,Unknown,48044736,478000.0,3.0,99,701,99,3,1,6,206,1,0.477639587192379,0.475614973262032,0.4411764705882353,0.006818223515291,0.125,0.0,0.0082520630157539,0.0082520630157539,0.0026278507736326,0.2857142857142857,0.418604651162791,0.2916666666666665,192,17,30,30,0,6395,5,13,33,1700000,135416.66666666666,1700000.0,0.0,,75000.0,5,500000,0.0,0.13333333333333333
418651,Yahia,Fofana,2024,1420,France,Paris,Cote d'Ivoire,21-08-00,Goalkeeper,Goalkeeper,Right,194.0,30-06-26,AIS SPORT SERVICE,https://img.a.transfermarkt.technology/portrait/header/418651-1672669760.jpg?lm=1,FR1,Angers Sporting Club de l'Ouest,3500000.0,3500000.0,24,112,148,2,2,2,1,7,3,7,3,1,3,8,3,2,8,10,12,12,8,11,8,10,13,8,8,6,12,10,8,10,14,10,14,12,10,10,14,12,8,12,7,1,12,11,12,15,12,13,12,15,11,11,11,11,12,10,10,11,10,12,10,20,1,1,1,1,1,1,1,1,1,1,1,1,1,89,6,20,4495999,5588,5588,2738,African_Caribbean,106,0,0,3939.0,Unknown,48043476,9111392.0,2.0,34,1122,24,2,1,1,18,5,0.4896798094734057,0.2874866310160427,0.4191176470588235,0.0037948758554161,0.0,0.0,0.0172543135783946,0.0172543135783946,0.0505924720131114,0.1428571428571428,0.7209302325581395,0.25,0,0,0,0,0,0,2,18,93,4500000,271875.0,4500000.0,500000.0,150000.0,350000.0,2,750000,0.2857142857142857,0.8
418659,Amine,Gouiri,2024,273,France,Bourgoin-Jallieu,Algeria,16-02-00,Centre-Forward,Attack,Right,181.0,30-06-27,Unknown,https://img.a.transfermarkt.technology/portrait/header/418659-1649428727.jpg?lm=1,FR1,Stade Rennais Football Club,25000000.0,50000000.0,24,132,156,6,10,15,14,15,8,11,13,4,4,13,12,4,15,13,12,14,14,13,14,13,16,16,10,15,9,15,14,14,14,15,12,15,14,13,12,13,8,15,7,11,3,2,2,2,2,1,1,2,3,1,4,16,15,8,14,16,16,11,14,1,1,1,1,1,1,1,12,1,1,20,1,1,19,72,8,20,32213997,6600,6600,4750,North_African__Middle_Eastern,134,0,0,20106.0,Unknown,48044735,17500000.0,2.0,34,234,1,0,1,6,195,3,0.6235776660492194,0.5026737967914437,0.625,0.019406010194987,0.0,0.0,0.1247811952988247,0.2498124531132783,0.0971971443651212,0.1428571428571428,0.418604651162791,0.25,253,78,39,25,0,5878,4,77,227,20000000,863043.4782608695,50000000.0,8000000.0,4500000.0,20000000.0,2,10000000,-0.2,-0.2857142857142857
419061,Vladyslav,Supryaga,2024,10690,Ukraine,"Sarata, Odesa Oblast",Ukraine,15-02-00,Centre-Forward,Attack,Right,185.0,30-06-25,Unknown,https://img.a.transfermarkt.technology/portrait/header/419061-1665388396.png?lm=1,UKR1,FK Zarya Lugansk,600000.0,7500000.0,24,114,135,6,8,12,10,12,7,10,8,6,5,12,11,3,13,7,10,8,9,8,9,9,9,8,8,12,9,11,9,16,16,14,14,8,16,13,12,10,5,5,6,5,3,1,3,2,2,1,3,3,2,1,2,4,15,5,11,5,14,15,5,1,1,1,1,1,1,1,1,1,1,5,1,5,20,76,9,20,3015138,5700,5700,4250,Northern_European,109,0,0,4320.0,Unknown,71099061,6500000.0,1.0,103,1343,101,0,1,7,83,3,0.5044985445885155,0.4491978609625668,0.4411764705882353,0.0041627760337657,0.0,0.0,0.0027506876719179,0.0372593148287071,0.0360843356759909,0.0,0.5116279069767438,0.25,105,18,9,6,0,3971,14,79,142,500000,12500.0,7500000.0,2000000.0,4500000.0,7500000.0,6,10100000,-0.16666666666666666,-0.375
419672,Mikhail,Ignatov,2024,232,Russia,Moskau,Russia,04-05-00,Attacking Midfield,Midfield,Right,187.0,31-12-25,Unknown,https://img.a.transfermarkt.technology/portrait/header/419672-1632578022.png?lm=1,RU1,FK Spartak Moskva,2000000.0,2800000.0,24,116,140,11,11,15,12,15,10,10,10,7,7,12,5,8,16,11,13,11,11,10,12,13,16,13,13,13,8,13,12,11,12,12,11,12,12,11,10,14,10,11,7,12,1,2,1,2,1,1,3,2,3,1,2,15,11,1,15,11,13,13,20,1,1,1,1,1,1,12,5,16,7,9,20,12,14,74,10,20,5795873,5496,5496,2998,Northern_European,114,0,0,3083.0,Unknown,58133578,9111392.0,2.0,78,985,81,3,1,7,82,0,0.4775072770574226,0.3152941176470588,0.4779411764705882,0.0029683074757123,0.0,0.0,0.0097524381095273,0.0137534383595899,0.0505924720131114,0.1428571428571428,0.5581395348837206,0.25,209,23,28,22,0,4890,6,13,47,1200000,52380.95238095238,2800000.0,800000.0,750000.0,600000.0,4,775000,-0.52,-0.5714285714285714
419845,Ivan,Oblyakov,2024,2410,Russia,"Vyndin Ostrov, Leningrad Oblast",Russia,05-07-98,Attacking Midfield,Midfield,Left,176.0,30-06-27,GreenField,https://img.a.transfermarkt.technology/portrait/header/419845-1629034911.png?lm=1,RU1,PFK CSKA Moskva,9000000.0,10000000.0,26,124,138,12,12,11,10,13,13,7,12,6,8,13,8,9,13,9,13,13,14,11,13,13,12,13,7,12,12,17,15,13,13,12,8,8,12,14,10,14,5,11,10,14,3,4,1,3,1,3,2,1,3,2,1,12,13,5,11,13,12,12,10,1,15,1,1,15,1,20,14,17,7,12,12,10,1,74,20,10,4582956,6144,6144,4244,Northern_European,117,2,0,33277.0,Unknown,58133140,2004500.0,2.0,78,1635,81,3,0,7,148,0,0.5632442445091295,0.4485561497326202,0.4999999999999999,0.0321241552055944,0.0131578947368421,0.0,0.0447611902975743,0.0497624406101525,0.0111086419067196,0.1428571428571428,0.3023255813953489,0.3333333333333332,291,29,43,42,0,6104,5,11,52,9000000,381818.1818181818,10000000.0,1500000.0,1200000.0,7500000.0,1,1300000,0.0,-0.1
420002,Jean-Philippe,Mateta,2024,873,France,Sevran,France,28-06-97,Centre-Forward,Attack,Right,192.0,30-06-26,Paul Latouche,https://img.a.transfermarkt.technology/portrait/header/420002-1723202650.jpg?lm=1,GB1,Crystal Palace Football Club,20000000.0,22000000.0,27,137,148,7,8,13,15,13,8,14,11,4,7,10,10,6,13,12,13,14,14,10,10,12,12,14,8,15,10,13,15,14,13,16,16,13,14,13,15,12,5,12,7,5,4,1,1,1,3,3,2,1,1,1,3,12,13,11,7,10,12,12,12,1,1,1,1,1,1,1,1,1,1,1,11,1,20,88,10,20,23662314,6850,6850,5500,African_Caribbean,137,0,0,57996.0,Unknown,49034219,7700000.0,3.0,34,1365,36,0,1,1,58,3,0.6566551997883038,0.5828877005347594,0.6470588235294117,0.055993248404076,0.0,0.0,0.0997749437359339,0.1097774443610902,0.042751187532987,0.2857142857142857,0.6744186046511627,0.375,292,116,16,23,1,3372,2,21,132,20000000,795454.5454545454,22000000.0,5000000.0,,2500000.0,3,5500000,0.0,1.8571428571428572
420064,Unknown,Caio Henrique,2024,162,Brazil,Santos,Brazil,31-07-97,Left-Back,Defender,Left,178.0,30-06-27,Bertolucci Sports,https://img.a.transfermarkt.technology/portrait/header/420064-1614091193.jpg?lm=1,FR1,Association sportive de Monaco Football Club,20000000.0,20000000.0,27,138,145,10,14,14,10,13,13,8,13,12,11,14,12,14,14,12,14,12,12,14,14,13,13,14,8,14,11,13,13,15,14,11,8,16,14,14,11,14,5,12,6,15,2,1,2,1,2,3,2,2,1,3,3,10,13,6,12,12,13,11,12,1,20,1,1,20,1,10,15,13,1,10,1,1,1,68,20,8,13557171,6897,6897,4297,Mediterranean_Hispanic,132,0,0,37767.0,Unknown,19258927,4150000.0,2.0,10,1340,11,1,0,3,24,8,0.6628737761312516,0.4542245989304812,0.6102941176470589,0.0364597767299757,0.0,0.0,0.0997749437359339,0.0997749437359339,0.0230284174560404,0.1428571428571428,0.3488372093023257,0.375,267,5,44,20,1,7340,4,33,213,18000000,983333.3333333334,20000000.0,2000000.0,,800000.0,4,5050000,-0.1,-0.1
420189,Tom,Van De Looi,2024,3329,Netherlands,Breda,Netherlands,02-07-99,Defensive Midfield,Midfield,Right,186.0,30-06-27,V4S,https://img.a.transfermarkt.technology/portrait/header/420189-1632545699.png?lm=1,PO1,Futebol Clube de FamalicÃ£o,750000.0,1300000.0,25,120,141,10,9,11,8,13,10,10,10,9,12,13,8,10,13,12,13,10,13,13,12,13,4,8,8,12,14,14,14,12,12,12,10,14,12,15,11,12,8,10,5,12,3,1,2,1,1,1,1,3,2,1,3,7,10,8,11,12,12,14,17,1,1,1,1,1,1,20,1,18,1,1,1,1,1,80,10,20,2138014,6000,5236,4112,Northern_European,118,0,0,9749.0,Unknown,37060618,9111392.0,2.0,67,248,68,3,1,7,99,4,0.4431066419687748,0.4344385026737967,0.5073529411764706,0.0094051121709297,0.0,0.0,0.0035008752188047,0.0062515628907226,0.0505924720131114,0.1428571428571428,0.5348837209302322,0.2916666666666665,0,0,0,0,0,0,2,9,31,750000,29411.764705882353,1300000.0,250000.0,500000.0,425000.0,3,425000,0.0,-0.0625
420210,Lutsharel,Geertruida,2024,23826,Netherlands,Rotterdam,Netherlands,18-07-00,Right-Back,Defender,Right,184.0,30-06-29,Wasserman,https://img.a.transfermarkt.technology/portrait/header/420210-1676465675.jpg?lm=1,L1,RasenBallsport Leipzig,32000000.0,35000000.0,24,130,155,11,9,9,8,11,10,14,9,12,11,11,7,11,13,12,11,13,14,13,11,12,15,8,6,14,12,14,15,12,14,14,12,15,12,14,12,12,13,13,11,16,1,3,2,2,4,1,1,2,2,2,4,8,9,7,14,15,15,15,14,1,14,20,19,12,17,18,12,13,13,1,1,1,1,0,9,20,18134999,6350,6350,5250,African_Caribbean,116,0,0,9588.0,Unknown,37064720,18000000.0,1.0,67,1253,68,1,1,1,162,11,0.590500132310135,0.5561497326203209,0.4926470588235294,0.0092496477911022,0.0,0.0,0.1597899474868717,0.1747936984246061,0.0999749993055362,0.0,0.4883720930232553,0.25,309,40,13,20,0,11572,10,52,118,32000000,1322916.6666666667,35000000.0,3000000.0,500000.0,8000000.0,1,0,0.0,-0.08571428571428572
420213,Quinten,Timber,2024,234,Netherlands,Utrecht,Netherlands,17-06-01,Central Midfield,Midfield,Right,179.0,30-06-26,Forza Sports Group,https://img.a.transfermarkt.technology/portrait/header/420213-1673870004.jpg?lm=1,NL1,Feyenoord Rotterdam,28000000.0,28000000.0,23,128,153,5,9,13,6,14,10,7,9,6,11,13,8,12,14,8,14,12,14,10,12,14,14,12,8,12,12,15,14,12,14,14,10,14,12,14,14,16,6,11,6,14,2,2,3,1,1,3,3,2,2,2,3,16,13,3,11,15,14,11,10,1,1,17,13,1,12,19,1,20,10,1,12,1,1,71,10,20,17257500,6300,6300,4400,African_Caribbean,125,0,0,10000.0,Unknown,37060952,7400000.0,1.0,67,1551,68,3,1,1,85,1,0.5838846255623181,0.4652406417112299,0.5588235294117647,0.009647482104698,0.0,0.0,0.1397849462365591,0.1397849462365591,0.041084474568738,0.0,0.3720930232558141,0.2083333333333332,266,29,38,30,1,7581,11,93,140,32000000,1870588.2352941176,35000000.0,3000000.0,450000.0,4000000.0,2,4900000,0.14285714285714285,0.45454545454545453
420243,Jurrien,Timber,2024,11,Netherlands,Utrecht,Netherlands,17-06-01,Centre-Back,Defender,Right,179.0,30-06-28,Forza Sports Group,https://img.a.transfermarkt.technology/portrait/header/420243-1702413077.jpg?lm=1,GB1,Arsenal Football Club,38000000.0,45000000.0,23,149,175,4,8,10,7,14,9,13,7,7,13,15,8,13,15,13,14,14,15,14,12,14,16,12,10,13,15,16,15,14,15,13,13,12,15,14,12,15,6,12,7,11,2,3,1,1,1,1,3,3,3,3,3,14,12,2,11,15,12,14,8,1,14,20,18,10,17,18,1,13,10,1,1,1,1,79,10,20,104490004,7250,7250,6100,African_Caribbean,142,7,0,74999.0,Unknown,37063644,40000000.0,1.0,67,1551,68,1,1,1,21,2,0.7095792537708389,0.6470588235294117,0.6838235294117647,0.0724116387780306,0.0460526315789473,0.0,0.1897974493623406,0.2248062015503876,0.2222006166837967,0.0,0.3720930232558141,0.2083333333333332,270,14,10,30,1,11064,13,89,253,45000000,2365789.4736842103,45000000.0,3000000.0,800000.0,35000000.0,2,4000000,0.18421052631578946,0.125
420465,Tiago,Djaló,2024,720,Portugal,Amadora,Portugal,09-04-00,Centre-Back,Defender,Right,190.0,30-06-25,Invictus Team,https://img.a.transfermarkt.technology/portrait/header/420465-1666690517.jpg?lm=1,PO1,Futebol Clube do Porto,12000000.0,16000000.0,24,125,150,4,10,10,6,9,4,14,11,11,14,10,7,14,10,14,14,13,10,11,11,10,15,6,11,9,14,11,12,14,10,14,15,15,14,13,15,12,14,9,5,8,1,2,1,2,3,1,2,1,1,3,3,12,14,5,13,14,14,13,14,1,15,20,13,1,1,1,1,1,1,1,1,1,1,85,10,20,8454999,6240,6918,3270,African_Caribbean,124,0,0,9204.0,Unknown,83169969,3366666.667,3.0,76,57,79,1,1,1,100,2,0.6656522889653348,0.3443850267379679,0.5514705882352942,0.0088788507609546,0.0,0.0,0.0597649412353088,0.0797699424856214,0.0186764447179088,0.2857142857142857,0.6279069767441858,0.25,153,6,2,34,1,5519,3,56,300,12000000,737500.0,16000000.0,3000000.0,200000.0,4500000.0,4,5850000,0.0,-0.2
420808,George,Hirst,2024,677,England,Sheffield,England,15-02-99,Centre-Forward,Attack,Right,191.0,30-06-27,KIN Partners,https://img.a.transfermarkt.technology/portrait/header/420808-1548432046.jpg?lm=1,GB1,Ipswich Town Football Club,4000000.0,4000000.0,25,113,135,8,9,11,13,11,9,15,10,7,9,10,12,7,11,12,11,12,12,11,9,11,13,9,8,12,11,12,14,10,8,12,15,11,12,13,16,11,9,10,8,10,3,3,2,1,3,2,3,3,1,3,2,9,13,7,11,11,10,10,10,1,1,1,1,1,1,1,1,1,1,12,10,12,20,0,12,20,4403433,5646,5646,2764,Northern_European,112,0,0,17399.0,Blackburn Rovers,29137250,1750000.0,1.0,32,1366,33,0,1,7,115,3,0.4973537973008732,0.2902673796791443,0.463235294117647,0.0167920842559001,0.0,0.0,0.0197549387346836,0.0197549387346836,0.0096947137420483,0.0,0.6511627906976742,0.2916666666666665,208,49,22,16,0,3141,4,37,119,5000000,328571.4285714286,5000000.0,50000.0,,500000.0,6,1400000,0.25,0.5625
420931,Daizen,Maeda,2024,371,Japan,"Taishi, Osaka",Japan,20-10-97,Left Winger,Attack,Right,173.0,31-05-27,Unknown,https://img.a.transfermarkt.technology/portrait/header/420931-1669207346.jpg?lm=1,SC1,The Celtic Football Club,7500000.0,7500000.0,27,132,139,8,10,10,11,7,8,9,9,4,7,10,11,8,6,16,11,12,10,11,8,12,16,11,8,14,7,11,19,19,13,8,7,18,19,17,8,9,2,10,3,10,3,2,2,1,2,1,3,2,2,4,2,17,14,5,11,12,16,11,15,1,1,1,1,1,1,1,10,1,10,20,1,14,19,67,8,20,15152789,6646,6896,5496,10,121,7,1,18559.0,Unknown,45101691,1530000.0,1.0,54,1466,56,0,1,0,200,7,0.6627414659962954,0.5824598930481283,0.5294117647058822,0.0179122002844708,0.0460526315789473,0.0131578947368421,0.0372593148287071,0.0372593148287071,0.0084724575682657,0.0,0.2325581395348837,0.375,330,104,36,22,2,5438,7,32,47,8000000,418421.05263157893,8000000.0,200000.0,50000.0,350000.0,5,1100000,0.14285714285714285,0.23076923076923078
421637,Frank,Onyeka,2024,167,Nigeria,Abuya,Nigeria,01-01-98,Central Midfield,Midfield,Right,183.0,30-06-25,Wonder Sports,https://img.a.transfermarkt.technology/portrait/header/421637-1726605377.jpg?lm=1,L1,FC Augsburg 1907,9000000.0,10000000.0,26,130,148,6,9,12,11,12,7,11,10,6,11,13,8,13,12,15,13,15,13,13,12,12,17,11,7,14,14,15,17,14,13,13,11,14,14,15,13,12,8,12,3,17,3,4,1,1,3,1,2,1,2,2,3,13,12,7,13,12,12,13,8,1,1,1,1,1,1,20,1,18,7,1,9,11,8,0,10,20,13107405,6500,6650,5500,African_Caribbean,130,7,0,40597.0,Unknown,27129125,10000000.0,1.0,69,19,70,3,1,1,67,1,0.6301931727970362,0.5828877005347594,0.5955882352941175,0.0391924735927818,0.0460526315789473,0.0,0.0447611902975743,0.0497624406101525,0.055529320258896,0.0,0.4651162790697669,0.3333333333333332,251,22,16,50,0,8802,3,20,77,9000000,497222.22222222225,10000000.0,1000000.0,,600000.0,2,3000000,0.0,0.0
421873,Elia,Caprile,2024,6195,Italy,Verona,Italy,25-08-01,Goalkeeper,Goalkeeper,Right,191.0,30-06-28,GB1,https://img.a.transfermarkt.technology/portrait/header/421873-1704902651.jpg?lm=1,IT1,SocietÃ  Sportiva Calcio Napoli,6000000.0,6000000.0,23,121,157,4,1,3,1,6,6,6,3,1,1,10,3,3,6,12,12,11,11,12,11,11,14,7,8,4,15,12,12,10,12,10,13,14,11,15,10,13,4,15,3,12,13,14,13,10,15,13,14,14,14,12,12,10,15,3,12,14,14,12,14,20,1,1,1,1,1,1,1,1,1,1,1,1,1,74,8,20,3022500,6050,6050,3252,Mediterranean_Hispanic,120,0,0,1000.0,Unknown,43391659,4375000.0,2.0,52,1577,54,2,1,3,184,5,0.5508070918232336,0.3424598930481283,0.5220588235294117,0.0009569267106151,0.0,0.0,0.0297574393598399,0.0297574393598399,0.0242784521792271,0.1428571428571428,0.6511627906976742,0.2083333333333332,0,0,0,0,0,0,1,7,42,6000000,371875.0,6000000.0,500000.0,100000.0,275000.0,5,2225000,0.0,0.09090909090909091
422281,Unknown,Muhammed Cham,2024,449,Austria,Wien,Austria,26-09-00,Attacking Midfield,Midfield,Left,180.0,30-06-28,CAA Stellar,https://img.a.transfermarkt.technology/portrait/header/422281-1725013078.jpg?lm=1,TR1,Trabzonspor KulÃ¼bÃ¼,6000000.0,6000000.0,24,120,143,12,11,14,13,13,12,9,13,8,7,13,10,8,14,10,12,12,12,11,12,13,12,11,9,12,10,11,11,14,14,12,9,11,13,13,11,12,8,9,8,10,2,2,2,2,2,1,3,1,1,1,2,10,12,10,10,11,10,10,11,1,1,1,1,1,1,1,11,20,17,10,20,15,1,0,20,8,5072000,6000,6000,3002,African_Caribbean,117,0,0,6344.0,Unknown,91194543,2475000.0,2.0,6,1663,7,3,0,1,204,0,0.5441915850754168,0.3157219251336898,0.4999999999999999,0.0061171853801683,0.0,0.0,0.0297574393598399,0.0297574393598399,0.0137226034056501,0.1428571428571428,0.3953488372093026,0.25,235,46,41,20,0,3645,0,0,0,5500000,361666.6666666667,6000000.0,500000.0,75000.0,150000.0,5,2725000,-0.08333333333333333,-0.08333333333333333
422460,Dani,Gómez,2024,1049,Spain,AlcorcÃ³n,Spain,30-07-98,Centre-Forward,Attack,Right,178.0,30-06-25,Unknown,https://img.a.transfermarkt.technology/portrait/header/422460-1603806732.jpg?lm=1,ES1,Valencia Club de FÃºtbol S. A. D.,1200000.0,2500000.0,26,125,138,7,10,14,13,13,11,11,11,6,5,12,13,6,14,12,14,12,13,12,12,12,13,13,12,15,7,10,13,14,14,12,10,13,13,13,9,12,8,12,8,7,1,4,1,3,3,2,1,2,3,3,2,12,14,7,12,12,13,14,12,1,1,1,1,1,1,1,1,1,1,12,14,8,20,73,12,20,3836699,6300,6300,4250,Mediterranean_Hispanic,125,0,0,10032.0,Espanyol,67231837,2000000.0,1.0,89,36,89,0,1,3,208,3,0.5838846255623181,0.4491978609625668,0.5588235294117647,0.0096783818572103,0.0,0.0,0.0057514378594648,0.0122530632658164,0.0110836412122558,0.0,0.3488372093023257,0.3333333333333332,243,58,15,21,3,2505,3,4,39,1000000,50000.0,2500000.0,500000.0,,1000000.0,5,1600000,-0.16666666666666666,-0.16666666666666666
422763,Nicolas,Raskin,2024,124,Belgium,LiÃ¨ge,Belgium,23-02-01,Central Midfield,Midfield,Right,178.0,31-05-27,TEAM RASKIN,https://img.a.transfermarkt.technology/portrait/header/422763-1616873075.jpg?lm=1,SC1,Rangers Football Club,6500000.0,8000000.0,23,122,145,8,12,13,9,15,11,6,10,7,9,14,6,14,14,16,14,16,12,13,14,14,12,14,10,13,8,12,13,14,12,10,9,6,13,10,11,11,5,12,9,12,1,4,3,1,4,1,1,1,1,3,1,14,14,8,13,14,12,14,14,1,1,1,1,1,1,19,1,20,1,1,1,1,1,74,10,20,11399999,6097,5997,2262,Northern_European,122,0,0,8500.0,Unknown,18104192,850000.0,2.0,7,849,8,3,1,7,161,1,0.5437946546705478,0.2365775401069518,0.536764705882353,0.0081990562056842,0.0,0.0,0.032258064516129,0.0397599399849962,0.0046945748493013,0.1428571428571428,0.3488372093023257,0.2083333333333332,177,7,20,35,0,5203,6,42,85,6500000,352777.77777777775,8000000.0,1000000.0,350000.0,5000000.0,2,700000,0.0,-0.1875
422838,Roman,Evgenjev,2024,2696,Russia,"Spasskoe, Primorje Region",Russia,23-02-99,Centre-Back,Defender,Right,193.0,30-06-26,Pavel Andreev,https://img.a.transfermarkt.technology/portrait/header/422838-1722144327.png?lm=1,RU1,PFK Krylya Sovetov Samara,2500000.0,4000000.0,25,118,137,5,6,8,7,7,7,16,9,7,15,12,7,15,9,15,13,14,11,13,12,10,16,9,12,5,14,11,13,11,7,13,15,16,11,12,14,11,13,12,6,5,4,3,2,1,1,3,3,1,3,3,1,11,14,17,11,12,12,15,18,1,1,20,5,1,1,5,1,1,1,1,1,1,1,84,9,20,3505502,5750,5750,3357,Northern_European,116,1,0,20557.0,Unknown,58129557,60000.0,1.0,78,1406,81,1,1,7,149,2,0.5111140513363324,0.3536898395721924,0.4926470588235294,0.0198415035819572,0.006578947368421,0.0,0.0122530632658164,0.0197549387346836,0.0003055640434456,0.0,0.6976744186046511,0.2916666666666665,211,5,4,36,0,3187,0,0,0,2000000,82608.69565217392,4000000.0,500000.0,250000.0,2500000.0,3,775000,-0.2857142857142857,-0.3333333333333333
422950,Mads Emil,Madsen,2024,678,Denmark,Skanderborg,Denmark,14-01-98,Central Midfield,Midfield,Left,189.0,31-12-26,Elite Consulting,https://img.a.transfermarkt.technology/portrait/header/422950-1632250258.png?lm=1,DK1,Aarhus Gymnastik Forening,800000.0,1500000.0,26,120,131,11,9,11,8,12,10,9,9,8,10,14,7,11,13,12,15,12,13,13,14,14,14,5,13,12,11,14,13,11,12,11,11,12,11,14,11,12,5,11,5,11,1,2,1,2,3,3,1,1,2,1,3,19,13,4,14,12,13,15,14,1,1,1,1,1,1,15,12,20,10,1,10,1,1,82,20,11,1264384,6000,6000,3800,Northern_European,120,0,0,3470.0,Unknown,27110484,9111392.0,2.0,28,1380,30,3,0,7,11,1,0.5441915850754168,0.4010695187165775,0.5220588235294117,0.0033420013576578,0.0,0.0,0.0037509377344336,0.0072518129532383,0.0505924720131114,0.1428571428571428,0.6046511627906974,0.3333333333333332,231,28,20,21,0,7703,5,31,98,1500000,72500.0,1500000.0,300000.0,50000.0,350000.0,4,1575000,0.875,0.875
422951,Victor,Nelsson,2024,141,Denmark,HornbÃ¦k,Denmark,14-10-98,Centre-Back,Defender,Right,185.0,30-06-26,Unknown,https://img.a.transfermarkt.technology/portrait/header/422951-1671036376.png?lm=1,TR1,Galatasaray Spor KulÃ¼bÃ¼,16000000.0,19000000.0,26,135,150,5,7,10,5,12,6,13,6,4,15,13,7,14,12,15,14,16,14,16,12,14,15,4,15,10,14,14,15,11,11,12,14,15,11,14,15,18,13,15,7,15,3,2,2,3,2,3,3,3,3,4,3,16,15,3,15,16,16,11,13,1,1,20,8,1,1,15,5,10,5,1,1,1,1,83,9,20,9195838,6950,6500,5600,Northern_European,135,7,0,41665.0,Unknown,27107366,5300000.0,2.0,28,635,30,1,1,7,102,2,0.6103466525535857,0.5935828877005347,0.6323529411764706,0.0402237528328796,0.0460526315789473,0.0,0.0797699424856214,0.0947736934233558,0.0294174838189949,0.1428571428571428,0.5116279069767438,0.3333333333333332,337,7,4,55,3,10413,2,6,29,14000000,546000.0,19000000.0,4000000.0,350000.0,3000000.0,2,5500000,-0.17647058823529413,-0.06666666666666667
423440,Martín,Zubimendi,2024,681,Spain,Donostia-San SebastiÃ¡n,Spain,02-02-99,Defensive Midfield,Midfield,Right,181.0,30-06-27,IDUB GLOBAL,https://img.a.transfermarkt.technology/portrait/header/423440-1684149419.jpg?lm=1,ES1,Real Sociedad de FÃºtbol S.A.D.,50000000.0,50000000.0,25,146,153,9,10,13,11,14,8,14,13,9,15,16,12,13,15,14,14,12,13,15,14,14,11,8,12,7,14,16,15,12,13,12,11,15,11,14,14,14,9,14,8,12,2,1,3,2,2,2,3,2,3,1,2,18,11,8,16,15,14,12,13,1,1,1,1,1,1,20,1,20,1,1,1,1,1,74,12,20,41233256,7300,7300,5500,Mediterranean_Hispanic,145,1,0,34472.0,Unknown,67246385,9111392.0,2.0,89,423,89,3,1,3,168,4,0.7161947605186557,0.5828877005347594,0.7058823529411764,0.0332780678384754,0.006578947368421,0.0,0.2498124531132783,0.2498124531132783,0.0505924720131114,0.1428571428571428,0.418604651162791,0.2916666666666665,270,13,10,56,1,4616,5,10,34,60000000,3523529.411764706,60000000.0,0.0,,100000.0,1,7750000,0.2,0.2
423444,Fran,Beltrán,2024,940,Spain,Madrid,Spain,03-02-99,Central Midfield,Midfield,Right,165.0,30-06-26,InterStarDeporte,https://img.a.transfermarkt.technology/portrait/header/423444-1693921591.jpg?lm=1,ES1,Real Club Celta de Vigo S. A. D.,6000000.0,18000000.0,25,137,156,9,10,12,10,14,8,7,12,13,12,16,8,13,14,12,15,12,13,12,14,15,12,13,9,14,14,15,14,12,13,13,7,13,12,13,10,12,9,12,7,8,3,2,2,1,2,1,1,3,2,3,3,8,11,8,12,14,15,12,14,1,1,1,1,1,1,20,5,20,1,1,14,1,1,64,11,20,10760075,6550,6550,4300,Mediterranean_Hispanic,135,1,0,11317.0,Unknown,67232115,8000000.0,1.0,89,892,89,3,1,3,165,1,0.6169621593014025,0.4545454545454545,0.6323529411764706,0.0109192000440321,0.006578947368421,0.0,0.0297574393598399,0.0897724431107777,0.044417900497236,0.0,0.0465116279069768,0.2916666666666665,308,9,3,33,1,1522,3,8,15,6000000,239130.4347826087,18000000.0,5000000.0,1500000.0,15000000.0,1,6000000,0.0,0.0
423604,Francis,Amuzu,2024,58,Ghana,Accra,Belgium,23-08-99,Left Winger,Attack,Right,169.0,30-06-25,Christophe Henrotay,https://img.a.transfermarkt.technology/portrait/header/423604-1704981793.jpg?lm=1,BE1,Royal Sporting Club Anderlecht,5000000.0,8000000.0,25,122,133,13,10,15,10,12,7,5,7,8,5,9,7,6,13,13,8,12,10,12,9,11,14,14,8,11,8,11,11,16,14,9,7,15,16,12,10,8,10,12,8,12,1,1,2,2,3,2,1,3,1,1,3,12,15,6,12,12,11,11,11,1,9,1,1,16,14,1,12,1,12,20,1,15,1,65,10,20,3624999,6000,5600,4000,African_Caribbean,113,0,0,14999.0,Unknown,18101803,9111392.0,2.0,39,20,8,0,1,1,175,7,0.4912675310928817,0.4224598930481283,0.4705882352941176,0.014474602817478,0.0,0.0,0.0247561890472618,0.0397599399849962,0.0505924720131114,0.1428571428571428,0.13953488372093,0.2916666666666665,261,29,31,24,0,6394,14,39,98,4500000,190476.19047619047,8000000.0,2000000.0,500000.0,3600000.0,0,0,-0.1,-0.1
423744,Billy,Gilmour,2024,6195,Scotland,Irvine,Scotland,11-06-01,Defensive Midfield,Midfield,Right,170.0,30-06-29,CAA Stellar,https://img.a.transfermarkt.technology/portrait/header/423744-1701544195.jpg?lm=1,IT1,SocietÃ  Sportiva Calcio Napoli,18000000.0,18000000.0,23,125,-85,13,9,10,9,15,13,6,10,9,6,15,15,11,16,11,15,9,16,12,16,13,15,8,12,11,11,12,13,13,12,9,6,9,12,12,7,11,3,4,9,4,3,3,2,1,3,3,1,2,2,4,1,9,15,2,11,11,16,14,15,1,1,1,1,1,1,19,10,20,12,12,14,14,1,65,12,20,65883306,6250,6250,5500,Northern_European,125,15,0,40597.0,Unknown,61078265,9111392.0,2.0,82,661,83,3,1,7,184,4,0.5772691188145012,0.5828877005347594,0.5588235294117647,0.0391924735927818,0.0986842105263157,0.0,0.0897724431107777,0.0897724431107777,0.0505924720131114,0.1428571428571428,0.1627906976744184,0.2083333333333332,205,20,20,19,1,7117,4,38,132,16000000,750000.0,18000000.0,3000000.0,5400000.0,12000000.0,5,10000000,-0.1111111111111111,-0.1111111111111111
424015,Nathan,Patterson,2024,29,Scotland,Glasgow,Scotland,16-10-01,Right-Back,Defender,Right,189.0,30-06-27,TaP23,https://img.a.transfermarkt.technology/portrait/header/424015-1596699245.jpg?lm=1,GB1,Everton Football Club,15000000.0,16000000.0,23,129,162,12,13,11,11,12,6,8,11,10,10,12,5,13,9,9,12,10,13,14,14,7,15,7,4,13,12,13,13,15,11,12,11,14,15,17,12,11,13,14,6,11,3,3,1,3,3,3,1,1,1,2,3,12,12,6,17,14,15,16,16,1,14,14,20,14,19,1,1,1,12,1,1,1,1,0,10,20,53211209,6450,6450,5000,Northern_European,117,10,0,46397.0,Unknown,61083649,9111392.0,2.0,82,545,83,1,1,7,65,11,0.6037311458057687,0.5294117647058822,0.4999999999999999,0.0447930537356352,0.0657894736842105,0.0,0.0747686921730432,0.0797699424856214,0.0505924720131114,0.1428571428571428,0.6046511627906974,0.2083333333333332,0,0,0,0,0,0,8,37,160,15000000,1340909.0909090908,16000000.0,1000000.0,,14000000.0,1,5000000,0.0,0.0
424042,Nahuel,Molina,2024,13,Argentina,Embalse,Argentina,06-04-98,Right-Back,Defender,Right,175.0,30-06-27,Unknown,https://img.a.transfermarkt.technology/portrait/header/424042-1697037362.jpg?lm=1,ES1,Club AtlÃ©tico de Madrid S.A.D.,28000000.0,50000000.0,26,140,154,14,14,13,11,13,12,8,12,13,11,14,6,13,14,10,12,13,11,13,13,12,14,12,8,13,12,12,15,15,14,12,8,15,15,13,12,13,10,11,3,13,1,3,2,3,2,3,2,1,1,2,2,14,14,5,9,15,14,13,11,1,1,1,20,1,20,1,1,1,18,1,1,1,1,70,11,20,30000000,6900,6750,5400,Native_American,132,17,0,21883.0,Unknown,14129337,9111392.0,2.0,4,460,4,1,1,5,52,11,0.6434241862926701,0.5721925133689839,0.6102941176470589,0.0211219120766854,0.1118421052631578,0.0,0.1397849462365591,0.2498124531132783,0.0505924720131114,0.1428571428571428,0.2790697674418605,0.3333333333333332,250,19,26,23,2,5921,7,20,38,25000000,1016666.6666666666,50000000.0,10000000.0,400000.0,750000.0,5,5950000,-0.10714285714285714,-0.4444444444444444
424072,Mathias,Pereira Lage,2024,3911,France,Clermont-Ferrand,France,30-11-96,Left Winger,Attack,Right,180.0,30-06-25,NexSt11,https://img.a.transfermarkt.technology/portrait/header/424072-1559892187.png?lm=1,FR1,Stade brestois 29,2500000.0,3500000.0,28,124,127,12,12,13,10,13,14,11,14,11,8,13,12,9,13,10,12,11,12,12,13,13,14,13,10,13,11,13,12,13,13,11,11,14,13,13,11,13,9,10,6,14,2,3,1,2,3,1,1,2,2,3,3,10,13,6,15,12,14,12,13,1,1,1,1,1,10,1,1,20,10,17,17,1,1,67,10,20,1691758,6196,6196,3796,Northern_European,122,0,0,9693.0,Unknown,48039548,1500000.0,1.0,34,368,36,0,1,7,196,7,0.570124371526859,0.4006417112299464,0.536764705882353,0.0093510376040331,0.0,0.0,0.0122530632658164,0.0172543135783946,0.0083057862718408,0.0,0.3953488372093026,0.4166666666666665,288,39,24,22,0,2769,8,33,68,2000000,97368.42105263157,3500000.0,1000000.0,,400000.0,2,2000000,-0.2,0.1111111111111111
424204,Alphonso,Davies,2024,27,Ghana,Buduburam,Canada,02-11-00,Left-Back,Defender,Left,185.0,30-06-25,ATG Sports,https://img.a.transfermarkt.technology/portrait/header/424204-1711745534.jpg?lm=1,L1,FC Bayern MÃ¼nchen,50000000.0,80000000.0,24,160,172,6,12,17,9,12,6,7,9,12,11,12,10,14,14,15,12,15,12,11,12,12,17,16,7,14,11,15,16,19,14,12,10,16,19,16,12,12,7,13,7,15,1,2,1,3,1,2,3,1,2,1,1,18,19,4,14,13,14,12,11,1,20,1,1,18,8,1,15,1,10,15,1,12,10,77,20,10,95234402,8100,7500,7500,African_Caribbean,141,32,12,191781.0,Unknown,20041862,14000000.0,1.0,39,274,16,1,0,1,68,8,0.7426567875099233,0.7967914438502673,0.6764705882352942,0.1851783543371182,0.2105263157894736,0.1578947368421052,0.2498124531132783,0.3998499624906226,0.0777521597822161,0.0,0.5116279069767438,0.25,320,26,50,19,1,7735,14,65,85,50000000,2075000.0,80000000.0,10000000.0,15000000.0,70000000.0,1,0,0.0,-0.2857142857142857
424881,Omar,Richards,2024,2425,England,London,England,15-02-98,Left-Back,Defender,Left,174.0,30-06-25,CAA Stellar,https://img.a.transfermarkt.technology/portrait/header/424881-1596807986.jpg?lm=1,PO1,Rio Ave Futebol Clube,2500000.0,7000000.0,26,130,142,9,11,14,8,13,6,6,7,12,12,12,8,14,14,13,12,12,12,11,11,11,15,14,7,13,12,16,16,15,14,12,7,18,15,15,9,13,8,12,3,15,2,1,1,2,3,3,3,1,3,3,4,13,16,5,9,12,13,15,16,1,20,1,1,18,1,1,14,1,1,12,1,1,1,70,20,10,12286139,6500,6500,5500,African_Caribbean,123,0,0,57996.0,Unknown,29165729,8500000.0,1.0,32,858,33,1,0,1,171,8,0.6103466525535857,0.5828877005347594,0.5441176470588236,0.055993248404076,0.0,0.0,0.0122530632658164,0.0347586896724181,0.047195755437651,0.0,0.2558139534883721,0.3333333333333332,182,4,6,24,0,4825,3,49,346,2500000,126315.78947368421,7000000.0,2000000.0,,100000.0,4,1000000,0.0,-0.375
425306,Matt,Turner,2024,873,United States,"Park Ridge, New Jersey",United States,24-06-94,Goalkeeper,Goalkeeper,Right,191.0,30-06-25,Wasserman,https://img.a.transfermarkt.technology/portrait/header/425306-1682689678.jpg?lm=1,GB1,Crystal Palace Football Club,5000000.0,10000000.0,30,135,140,3,3,8,1,9,7,1,1,1,1,9,2,3,4,6,12,12,12,14,9,13,12,6,8,3,15,11,10,11,15,6,12,6,10,12,14,12,6,10,6,12,14,15,13,10,15,12,14,15,7,6,10,12,12,6,12,12,12,13,13,20,1,1,1,1,1,1,1,1,1,1,1,1,1,89,10,20,9494887,6739,6739,4739,Northern_European,133,17,0,46397.0,Unknown,72046884,7025000.0,2.0,104,1123,102,2,1,7,58,5,0.6419687748081503,0.5014973262032085,0.6176470588235294,0.0447930537356352,0.1118421052631578,0.0,0.0247561890472618,0.0497624406101525,0.0390010833634267,0.1428571428571428,0.6511627906976742,0.5,0,0,0,0,0,0,2,13,70,4000000,179545.45454545456,10000000.0,2000000.0,,,6,4150000,-0.42857142857142855,-0.6
425334,Matty,Cash,2024,405,England,Slough,Poland,07-08-97,Right-Back,Defender,Right,185.0,30-06-27,Two Touch Agency,https://img.a.transfermarkt.technology/portrait/header/425334-1668091733.jpg?lm=1,GB1,Aston Villa Football Club,28000000.0,28000000.0,27,138,148,10,11,13,11,14,10,12,12,17,9,13,8,13,12,15,15,13,11,11,11,11,15,11,9,13,11,16,16,14,14,13,11,15,14,15,12,13,13,10,6,12,2,2,2,3,3,3,3,3,1,3,3,13,13,2,13,12,13,12,13,1,1,1,20,1,17,1,1,12,15,1,1,14,1,0,14,20,29282114,6900,6800,5500,Northern_European,134,7,1,75395.0,Unknown,29147447,15750000.0,1.0,32,1384,78,1,1,7,30,11,0.6500396930404869,0.5828877005347594,0.625,0.0727940232153703,0.0460526315789473,0.0131578947368421,0.1397849462365591,0.1397849462365591,0.0874746520736687,0.0,0.5116279069767438,0.375,318,27,27,52,0,2705,10,50,75,28000000,1547222.2222222222,28000000.0,3000000.0,,1500000.0,1,7200000,0.0,0.0
425902,Ryan,Yates,2024,703,England,Nottingham,England,21-11-97,Central Midfield,Midfield,Right,190.0,30-06-28,CAA Base Ltd,https://img.a.transfermarkt.technology/portrait/header/425902-1684239778.jpg?lm=1,GB1,Nottingham Forest Football Club,12000000.0,12000000.0,27,128,138,7,10,10,11,12,10,15,9,4,12,13,4,14,12,12,12,15,11,12,12,12,15,6,12,13,14,15,15,11,13,12,14,14,13,16,13,13,8,13,4,12,4,3,2,3,2,3,2,2,1,3,1,10,12,8,14,13,14,13,10,1,1,12,1,1,1,16,1,20,10,1,12,1,1,0,13,20,8821307,6400,6400,4500,Northern_European,127,0,0,28998.0,Unknown,29136230,9111392.0,2.0,32,1055,33,3,1,7,140,1,0.5971156390579518,0.4759358288770053,0.5735294117647058,0.0279922789243409,0.0,0.0,0.0597649412353088,0.0597649412353088,0.0505924720131114,0.1428571428571428,0.6279069767441858,0.375,308,30,17,46,2,3754,2,15,53,13000000,857142.8571428572,13000000.0,200000.0,,,0,0,0.08333333333333333,0.08333333333333333
425918,Jakub,Kiwior,2024,11,Poland,Tychy,Poland,15-02-00,Centre-Back,Defender,Left,189.0,30-06-28,FairSport,https://img.a.transfermarkt.technology/portrait/header/425918-1683101307.jpg?lm=1,GB1,Arsenal Football Club,30000000.0,30000000.0,24,131,159,9,11,12,7,12,12,13,8,7,14,12,8,13,13,12,15,13,13,14,12,12,14,9,11,7,15,15,13,12,12,11,14,15,13,13,12,14,11,12,5,11,3,3,2,1,3,2,2,1,3,2,1,15,14,1,10,12,15,9,12,1,15,20,1,14,1,17,1,10,1,1,1,1,1,78,20,8,10016000,6550,6100,2006,Northern_European,129,2,0,25443.0,Unknown,96102946,4434600.0,5.0,75,1538,78,1,0,7,21,2,0.5574225985710506,0.2091978609625668,0.588235294117647,0.0245595095436782,0.0131578947368421,0.0,0.1497874468617154,0.1497874468617154,0.0246095724881246,0.5714285714285714,0.6046511627906974,0.25,187,7,11,27,2,9059,1,6,23,28000000,1635294.1176470588,30000000.0,2000000.0,,350000.0,3,12700000,-0.06666666666666667,0.12
426192,Ben,Brereton Díaz,2024,180,England,Stoke-on-Trent,Chile,18-04-99,Centre-Forward,Attack,Right,185.0,30-06-28,Wasserman,https://img.a.transfermarkt.technology/portrait/header/426192-1684144984.jpg?lm=1,GB1,Southampton Football Club,8000000.0,16000000.0,25,135,145,5,9,14,14,12,11,12,12,3,5,11,13,4,13,10,12,12,13,11,10,11,13,10,7,12,5,15,15,15,12,12,13,15,15,14,15,12,3,11,3,12,1,3,2,2,3,2,1,2,1,2,3,13,15,1,14,14,16,6,15,1,1,1,1,1,1,1,1,1,1,20,12,15,20,80,14,20,15614983,6744,6744,5994,Northern_European,129,15,4,8699.0,Unknown,29159400,8300000.0,2.0,32,1428,19,0,1,7,186,3,0.642630325482932,0.6357219251336897,0.588235294117647,0.00839121404162,0.0986842105263157,0.0526315789473684,0.0397599399849962,0.0797699424856214,0.046084613461485,0.1428571428571428,0.5116279069767438,0.2916666666666665,293,66,24,35,1,4570,1,9,42,8000000,369047.61904761905,16000000.0,6000000.0,5000000.0,2300000.0,4,7000000,0.0,0.14285714285714285
426620,Pedro,Gonçalves,2024,336,Portugal,Chaves,Portugal,28-06-98,Left Winger,Attack,Right,173.0,30-06-27,Gestifute,https://img.a.transfermarkt.technology/portrait/header/426620-1602774745.jpg?lm=1,PO1,Sporting Clube de Portugal,32000000.0,38000000.0,26,153,161,11,12,15,17,15,14,8,14,10,6,14,8,9,16,11,16,9,15,12,15,14,14,14,8,15,10,11,13,15,16,14,8,13,15,14,9,13,12,12,8,10,2,4,3,3,3,3,1,3,2,2,1,17,12,6,13,16,15,14,13,1,1,1,1,1,1,1,12,18,10,18,20,16,14,67,12,20,34748999,7600,7250,6100,Mediterranean_Hispanic,153,2,0,30249.0,Unknown,29192705,7400000.0,2.0,76,348,79,0,1,3,193,7,0.7095792537708389,0.6470588235294117,0.7647058823529411,0.0292002661241185,0.0131578947368421,0.0,0.1597899474868717,0.1897974493623406,0.041084474568738,0.1428571428571428,0.2325581395348837,0.3333333333333332,269,97,69,46,1,5387,9,48,103,32000000,1835294.1176470588,38000000.0,5000000.0,,,1,1000000,0.0,0.14285714285714285
427568,Aaron,Ramsdale,2024,180,England,Stoke-on-Trent,England,14-05-98,Goalkeeper,Goalkeeper,Right,190.0,30-06-28,World in Motion,https://img.a.transfermarkt.technology/portrait/header/427568-1681828000.jpg?lm=1,GB1,Southampton Football Club,22000000.0,40000000.0,26,150,162,2,3,3,3,12,6,6,3,2,2,13,1,1,12,12,13,15,14,13,15,14,16,10,13,9,13,15,10,8,16,10,14,11,7,12,14,15,7,15,4,15,14,15,14,10,15,16,16,16,11,10,16,17,16,5,13,17,16,12,14,20,1,1,1,1,1,1,1,1,1,1,1,1,1,85,8,20,136841241,7500,7500,6400,Northern_European,152,3,0,92793.0,Unknown,29137172,9111392.0,2.0,32,1428,33,2,1,7,186,5,0.7426567875099233,0.6791443850267379,0.7573529411764706,0.0895938324093985,0.0197368421052631,0.0,0.1097774443610902,0.1997999499874969,0.0505924720131114,0.1428571428571428,0.6279069767441858,0.3333333333333332,0,0,0,0,0,0,4,9,40,20000000,798000.0,40000000.0,8000000.0,500000.0,500000.0,4,14950000,-0.2,-0.2857142857142857
427572,Zuriko,Davitashvili,2024,618,Georgia,Tiflis,Georgia,15-02-01,Right Winger,Attack,Right,175.0,30-06-28,Unknown,https://img.a.transfermarkt.technology/portrait/header/427572-1727721934.jpg?lm=1,FR1,Association sportive de Saint-Ã‰tienne Loire,5000000.0,5000000.0,23,112,135,9,8,15,10,13,11,7,12,5,4,11,10,6,15,11,9,12,10,11,10,11,3,12,2,12,8,8,11,14,14,13,7,11,13,12,7,13,4,14,5,15,2,1,2,3,1,2,2,4,2,3,1,8,13,2,12,13,12,12,12,1,1,1,1,1,1,1,18,13,13,20,15,15,12,63,12,20,483499,5400,5750,3154,Mediterranean_Hispanic,108,19,3,1368.0,FC Girondins de Bordeaux,59133252,3625000.0,2.0,37,1490,39,0,1,3,25,10,0.5111140513363324,0.3319786096256684,0.4338235294117646,0.0013122738645065,0.125,0.0394736842105263,0.0247561890472618,0.0247561890472618,0.0201116697686046,0.1428571428571428,0.2790697674418605,0.2083333333333332,218,37,21,23,0,2801,3,7,37,8000000,395000.0,8000000.0,500000.0,2500000.0,2500000.0,7,3750000,1.6666666666666667,2.2
428563,Lewis,Ferguson,2024,1025,Scotland,Hamilton,Scotland,24-08-99,Attacking Midfield,Midfield,Right,181.0,30-06-27,Unknown,https://img.a.transfermarkt.technology/portrait/header/428563-1663656344.jpg?lm=1,IT1,Bologna Football Club 1909,24000000.0,24000000.0,25,121,139,8,8,11,10,13,12,13,12,3,10,13,15,13,13,15,12,15,12,10,10,11,16,8,13,14,11,14,16,13,12,13,12,17,13,16,13,14,13,15,2,9,3,4,3,3,2,3,1,2,1,2,3,9,14,8,13,15,13,8,14,1,1,1,1,1,1,14,1,20,1,1,15,1,5,75,8,20,3488040,6050,5900,4000,Northern_European,121,4,0,14230.0,Unknown,61078132,1132500.0,2.0,82,595,83,3,1,7,40,0,0.530960571579783,0.4224598930481283,0.5294117647058822,0.0137320431399169,0.0263157894736842,0.0,0.1197799449862465,0.1197799449862465,0.0062640628906358,0.1428571428571428,0.418604651162791,0.2916666666666665,264,51,34,67,2,6756,7,37,201,22000000,1150000.0,24000000.0,2000000.0,300000.0,1500000.0,2,1650000,-0.08333333333333333,0.2222222222222222
428786,Unknown,Alan,2024,979,Brazil,SÃ£o Paulo,Brazil,08-03-00,Attacking Midfield,Midfield,Right,165.0,30-06-26,Unknown,https://img.a.transfermarkt.technology/portrait/header/428786-1705663806.png?lm=1,PO1,Moreirense Futebol Clube,3000000.0,3000000.0,24,144,160,3,9,13,10,13,6,10,12,6,14,15,10,18,14,16,14,16,12,14,12,13,17,13,12,14,16,16,17,10,13,18,7,14,12,15,15,12,12,13,12,11,3,1,3,2,3,2,2,2,2,2,1,13,14,9,11,15,8,12,13,1,1,1,5,1,8,20,1,18,10,1,1,1,1,74,8,20,347975206,7200,7500,6150,Mixed_Race,144,10,0,86270.0,Unknown,19101228,9111392.0,2.0,10,1456,11,3,1,4,134,0,0.7426567875099233,0.6524064171122994,0.6985294117647058,0.0832951109832204,0.0657894736842105,0.0,0.0147536884221055,0.0147536884221055,0.0505924720131114,0.1428571428571428,0.0465116279069768,0.25,125,20,19,19,0,1879,3,47,181,3000000,263636.36363636365,3000000.0,0.0,,250000.0,2,0,0.0,0.5
428920,Kevin,Mac Allister,2024,3948,Argentina,Buenos Aires,Argentina,07-11-97,Centre-Back,Defender,Right,175.0,30-06-26,Primotempo,https://img.a.transfermarkt.technology/portrait/header/428920-1714467434.png?lm=1,BE1,Royale Union Saint-Gilloise,6000000.0,6000000.0,27,125,132,8,11,12,8,11,7,14,10,13,14,12,10,15,12,16,15,10,11,11,11,11,11,12,10,13,14,12,12,13,13,8,10,12,13,11,9,12,10,14,12,14,1,3,3,2,3,1,1,2,1,2,2,13,12,5,11,9,13,15,13,1,16,17,20,14,18,1,1,1,1,1,1,1,1,68,12,20,3763336,6071,6071,3238,Mediterranean_Hispanic,116,0,0,2268.0,Unknown,14154663,1500000.0,1.0,4,275,4,1,1,3,177,2,0.5535856046573168,0.3409625668449197,0.4926470588235294,0.0021813294039148,0.0,0.0,0.0297574393598399,0.0297574393598399,0.0083057862718408,0.0,0.2790697674418605,0.375,238,19,2,71,3,8448,6,14,121,6000000,370312.5,6000000.0,800000.0,75000.0,1500000.0,4,1450000,0.0,0.2
429014,Morgan,Gibbs-White,2024,703,England,Stafford,England,27-01-00,Attacking Midfield,Midfield,Right,171.0,30-06-27,CAA Stellar,https://img.a.transfermarkt.technology/portrait/header/429014-1687975822.jpg?lm=1,GB1,Nottingham Forest Football Club,40000000.0,40000000.0,24,129,155,13,12,14,11,14,8,9,11,5,6,15,10,9,15,12,13,9,13,12,16,12,13,16,8,14,8,13,14,13,15,14,10,11,14,12,12,11,11,12,10,12,1,2,3,3,1,2,3,2,3,2,1,11,13,13,13,12,11,12,14,1,1,1,1,1,1,1,1,20,1,12,20,15,10,72,8,20,33331385,6450,6450,4750,Mixed_Race,126,0,0,57996.0,Unknown,29175220,29500000.0,1.0,32,1416,33,3,1,4,140,0,0.6037311458057687,0.5026737967914437,0.5661764705882353,0.055993248404076,0.0,0.0,0.1997999499874969,0.1997999499874969,0.1638656629350815,0.0,0.1860465116279068,0.25,250,34,40,34,0,5657,4,41,95,40000000,2166666.6666666665,40000000.0,1200000.0,3000000.0,6000000.0,4,17200000,0.0,0.0
429070,Vladan,Kova?Evi?,2024,336,Bosnia-Herzegovina,Banja Luka,Bosnia-Herzegovina,11-04-98,Goalkeeper,Goalkeeper,Right,192.0,30-06-29,LIAN Sports Group,https://img.a.transfermarkt.technology/portrait/header/429070-1725522865.jpg?lm=1,PO1,Sporting Clube de Portugal,6000000.0,8000000.0,26,122,146,4,1,3,2,6,7,6,3,3,3,9,2,3,6,16,14,15,14,13,7,11,17,2,13,3,11,14,12,12,14,11,16,14,10,8,9,16,8,8,8,12,15,12,10,5,12,12,14,16,12,12,9,15,14,5,13,17,14,14,14,20,1,1,1,1,1,1,1,1,1,1,1,1,1,81,5,20,920602,5981,5483,2981,Northern_European,120,0,0,3169.0,Unknown,21028824,2910000.0,2.0,9,136,10,2,1,7,193,5,0.4757872453029902,0.3134759358288769,0.5220588235294117,0.0030513505605891,0.0,0.0,0.0297574393598399,0.0397599399849962,0.0161393372038112,0.1428571428571428,0.6744186046511627,0.3333333333333332,0,0,0,0,0,0,6,17,22,5000000,213043.47826086957,8000000.0,1000000.0,100000.0,400000.0,5,1550000,-0.16666666666666666,-0.2857142857142857
429259,Mark,Mckenzie,2024,415,United States,"New York City, New York",United States,25-02-99,Centre-Back,Defender,Left,184.0,30-06-27,Wasserman,https://img.a.transfermarkt.technology/portrait/header/429259-1714036622.png?lm=1,FR1,Toulouse Football Club,6000000.0,8000000.0,25,122,138,6,8,8,6,9,7,13,6,10,14,9,6,13,10,9,13,13,12,12,8,12,12,6,10,9,13,12,13,14,11,12,12,12,14,12,14,14,6,11,5,9,7,1,1,1,1,8,1,1,1,1,1,8,11,6,12,10,11,10,10,1,10,20,13,1,1,1,1,1,1,1,1,1,1,83,20,15,6137396,6201,6100,2916,African_Caribbean,123,8,0,6499.0,Unknown,20041987,4810000.0,2.0,104,1035,102,1,0,1,203,2,0.5574225985710506,0.3065240641711229,0.5441176470588236,0.0062668560563997,0.0526315789473684,0.0,0.0297574393598399,0.0397599399849962,0.0266951859773882,0.1428571428571428,0.4883720930232553,0.2916666666666665,227,8,5,28,0,8171,4,11,24,6000000,296250.0,8000000.0,1000000.0,75000.0,500000.0,7,1450000,0.0,-0.14285714285714285
429874,Ansgar,Knauff,2024,24,Germany,GÃ¶ttingen,Germany,10-01-02,Right Winger,Attack,Right,180.0,30-06-28,Unknown,https://img.a.transfermarkt.technology/portrait/header/429874-1663065826.jpg?lm=1,L1,Eintracht Frankfurt FuÃŸball AG,10000000.0,10000000.0,22,128,152,5,11,14,10,12,5,8,10,12,9,11,8,11,13,12,11,12,10,10,11,10,15,14,4,13,10,12,13,16,14,10,10,15,15,12,9,12,7,14,4,17,1,1,3,1,3,2,1,2,1,4,2,10,14,8,16,11,11,10,9,1,10,1,14,16,18,1,16,1,18,16,10,20,10,73,8,20,17399999,6399,6399,4999,African_Caribbean,117,0,0,10000.0,Eintracht Frankfurt,91203087,5000000.0,1.0,38,583,40,0,1,1,63,10,0.5969833289229955,0.5293048128342246,0.4999999999999999,0.009647482104698,0.0,0.0,0.0497624406101525,0.0497624406101525,0.0277507708547459,0.0,0.3953488372093026,0.1666666666666666,226,38,38,26,0,4467,5,12,64,10000000,757692.3076923077,10000000.0,2000000.0,500000.0,10000000.0,2,2000000,0.0,0.25
429901,Paul,Akouokou,2024,1041,Cote d'Ivoire,Abidjan,Cote d'Ivoire,20-12-97,Defensive Midfield,Midfield,Right,181.0,30-06-27,Unknown,https://img.a.transfermarkt.technology/portrait/header/429901-1702991425.jpg?lm=1,FR1,Olympique Lyonnais,1000000.0,5000000.0,27,127,140,6,7,8,6,11,8,13,9,11,12,10,11,15,12,14,14,13,12,14,11,13,13,12,10,9,13,14,14,14,13,12,14,14,13,15,14,12,12,11,12,9,1,2,3,1,1,3,1,1,2,3,3,14,14,10,10,11,9,12,14,1,1,1,1,1,1,20,1,18,1,1,5,1,1,68,11,20,2926862,6249,4776,2767,African_Caribbean,127,4,0,7386.0,Unknown,33066648,3000000.0,1.0,23,14,24,3,1,1,143,4,0.3822439798888595,0.2905882352941176,0.5735294117647058,0.0071233585713499,0.0263157894736842,0.0,0.0047511877969492,0.0247561890472618,0.0166393510930859,0.0,0.418604651162791,0.375,124,4,6,29,1,3754,2,6,22,800000,43055.555555555555,5000000.0,1000000.0,25000.0,0.0,2,1025000,-0.4666666666666667,-0.68
429915,Maxim,De Cuyper,2024,2282,Belgium,Knokke-Heist,Belgium,22-12-00,Left-Back,Defender,Left,182.0,30-06-28,AXL,https://img.a.transfermarkt.technology/portrait/header/429915-1685694494.jpg?lm=1,BE1,Club Brugge Koninklijke Voetbalvereniging,12000000.0,12000000.0,24,114,140,10,13,11,9,12,8,9,9,9,11,11,8,14,12,12,10,12,11,12,10,11,10,11,11,12,11,14,12,15,11,10,11,13,15,12,7,13,6,16,5,18,3,2,1,2,1,1,2,3,3,3,1,19,11,5,12,11,12,11,20,1,20,1,1,19,1,1,16,12,1,11,1,1,1,66,20,5,6324999,5309,5309,2522,Northern_European,105,0,0,2000.0,KVC Westerlo,18110473,9111392.0,2.0,7,738,8,1,0,7,53,8,0.4527652818205875,0.2643850267379679,0.411764705882353,0.0019225439766243,0.0,0.0,0.0597649412353088,0.0597649412353088,0.0505924720131114,0.1428571428571428,0.4418604651162785,0.25,202,27,43,29,2,5753,5,9,14,12000000,725000.0,12000000.0,50000.0,,600000.0,2,3000000,0.3333333333333333,0.5
429983,Jørgen Strand,Larsen,2024,543,Norway,Halden,Norway,06-02-00,Centre-Forward,Attack,Right,193.0,30-06-25,TPSportManagement,https://img.a.transfermarkt.technology/portrait/header/429983-1680524510.jpeg?lm=1,GB1,Wolverhampton Wanderers Football Club,25000000.0,25000000.0,24,122,140,5,6,11,15,13,6,14,13,6,6,10,12,6,12,10,13,12,13,12,9,11,12,13,10,14,6,12,12,12,12,15,14,13,12,14,17,12,8,11,6,7,2,2,1,3,3,3,1,3,1,3,2,14,17,6,4,6,11,11,13,1,1,1,1,1,1,1,1,1,1,1,1,1,20,79,8,20,11924001,6100,6100,4250,Northern_European,122,1,0,5071.0,Unknown,53143395,6750000.0,2.0,71,589,73,0,1,7,222,3,0.5574225985710506,0.4491978609625668,0.536764705882353,0.0048879546005386,0.006578947368421,0.0,0.1247811952988247,0.1247811952988247,0.0374732631461985,0.1428571428571428,0.6976744186046511,0.25,261,66,31,23,0,2820,4,14,40,27000000,1283333.3333333333,27000000.0,500000.0,100000.0,1500000.0,3,7300000,0.08,0.8
430190,Yegor,Nazaryna,2024,660,Ukraine,"Pryluky, Chernigiv Oblast",Ukraine,10-07-97,Central Midfield,Midfield,Right,183.0,30-06-27,ProStar,https://img.a.transfermarkt.technology/portrait/header/430190-1723486761.png?lm=1,UKR1,FC Shakhtar Donetsk,1500000.0,1500000.0,27,125,128,8,11,12,10,13,8,13,14,10,14,15,12,13,12,11,14,14,12,13,11,12,9,7,10,13,14,14,12,14,12,13,13,12,14,13,14,12,8,12,8,11,1,1,1,3,2,2,2,3,2,1,2,11,11,6,11,12,13,13,11,1,1,1,15,1,10,20,1,15,10,1,1,10,1,69,5,20,1367884,5250,5325,2028,Northern_European,128,0,0,2703.0,Unknown,71088117,800000.0,1.0,103,1190,101,3,1,7,72,1,0.4548822439798888,0.2115508021390374,0.5808823529411764,0.0026013729146288,0.0,0.0,0.0072518129532383,0.0072518129532383,0.0044167893552598,0.0,0.4651162790697669,0.375,147,11,7,24,1,5204,2,6,22,1000000,50000.0,1500000.0,500000.0,,500000.0,4,200000,-0.3333333333333333,-0.3333333333333333
430280,Hans,Nicolussi Caviglia,2024,607,Italy,Aosta,Italy,18-06-00,Central Midfield,Midfield,Right,184.0,30-06-25,World Soccer Agency,https://img.a.transfermarkt.technology/portrait/header/430280-1675245071.jpg?lm=1,IT1,Venezia Football Club,3000000.0,3000000.0,24,109,144,9,10,9,10,12,9,8,9,12,8,12,12,9,13,9,11,10,11,11,13,12,10,11,12,13,12,13,13,14,12,11,9,14,13,13,9,9,8,11,13,13,3,1,2,1,2,3,3,1,2,2,3,10,13,1,13,9,13,11,8,1,1,1,1,1,1,11,13,20,18,12,17,15,1,71,8,20,84196,5442,5442,3242,Northern_European,108,0,0,5181.0,SÃ¼dtirol - Alto Adige,43296764,9111392.0,2.0,52,77,54,3,1,7,210,1,0.4703625297697804,0.3413903743315508,0.4338235294117646,0.0049941724997996,0.0,0.0,0.0147536884221055,0.0147536884221055,0.0505924720131114,0.1428571428571428,0.4883720930232553,0.25,201,23,17,18,0,3799,5,70,174,6000000,392857.14285714284,6000000.0,300000.0,,1500000.0,7,6500000,1.0,1.0
431190,Carlos,Protesoni,2024,1108,Uruguay,Montevideo,Uruguay,30-03-98,Defensive Midfield,Midfield,Left,185.0,30-06-26,Soccer Promotions,https://img.a.transfermarkt.technology/portrait/header/431190-1635923163.JPG?lm=1,ES1,Deportivo AlavÃ©s S.A.D.,1500000.0,2000000.0,26,124,124,10,14,14,12,13,9,10,12,5,8,11,9,7,13,13,14,14,11,10,12,12,12,10,11,12,7,13,14,14,12,13,9,11,12,11,12,11,8,11,8,9,1,1,3,1,2,3,1,1,2,1,2,7,11,7,11,12,12,13,8,1,1,1,1,1,1,1,16,1,10,20,13,12,12,77,20,10,22479,5000,5116,2046,Mediterranean_Hispanic,119,0,0,1027.0,Unknown,14183182,2150000.0,1.0,106,975,103,3,0,3,59,4,0.4272294257740143,0.213475935828877,0.5147058823529411,0.0009829983767973,0.0,0.0,0.0072518129532383,0.0097524381095273,0.0119169976943803,0.0,0.5116279069767438,0.3333333333333332,180,16,6,54,2,7812,13,102,316,1500000,60000.0,2000000.0,750000.0,650000.0,1250000.0,2,800000,0.0,2.0
431755,Dejan,Kulusevski,2024,148,Sweden,Stockholm,Sweden,25-04-00,Attacking Midfield,Midfield,Left,186.0,30-06-28,World Soccer Agency,https://img.a.transfermarkt.technology/portrait/header/431755-1684943454.jpg?lm=1,GB1,Tottenham Hotspur Football Club,55000000.0,55000000.0,24,153,171,11,14,16,13,15,9,7,11,4,4,17,11,7,16,7,15,8,13,12,16,16,15,15,6,14,6,14,14,13,14,17,12,14,14,16,15,14,11,14,6,15,3,1,3,2,3,2,2,3,1,3,1,16,14,8,12,15,14,13,10,1,1,1,1,1,9,1,12,14,18,14,20,20,14,79,20,14,35000000,7650,7250,6850,Northern_European,153,25,2,88941.0,Tottenham Hotspur,43295814,24166666.67,3.0,91,1426,91,3,0,7,202,0,0.7095792537708389,0.7272727272727272,0.7647058823529411,0.085874274700731,0.1644736842105263,0.0263157894736842,0.274818704676169,0.274818704676169,0.1342352102558404,0.2857142857142857,0.5348837209302322,0.25,333,77,74,40,0,5015,6,17,38,60000000,2950000.0,60000000.0,5000000.0,,45000000.0,3,15000000,0.09090909090909091,0.09090909090909091
431811,Ola,Solbakken,2024,749,Norway,Oslo,Norway,07-09-98,Right Winger,Attack,Left,189.0,30-06-25,Nordic Sky,https://img.a.transfermarkt.technology/portrait/header/431811-1673251136.jpg?lm=1,IT1,Empoli Football Club S.r.l.,2500000.0,3500000.0,26,132,141,13,12,14,13,13,12,10,12,8,8,10,13,8,13,10,12,7,13,13,10,12,13,13,12,14,8,14,14,16,14,14,13,14,15,14,12,13,5,18,8,10,3,1,2,1,1,1,2,2,2,3,3,12,18,6,12,10,14,14,13,1,1,1,1,1,1,1,13,1,13,19,1,20,12,76,20,5,1925445,6300,6300,4250,Northern_European,132,0,0,1210.0,Unknown,53116125,65000.0,1.0,71,1096,73,0,0,7,64,10,0.5838846255623181,0.4491978609625668,0.6102941176470589,0.001159706336477,0.0,0.0,0.0122530632658164,0.0172543135783946,0.0003333425928498,0.0,0.6046511627906974,0.3333333333333332,183,27,37,19,0,4181,8,64,90,2500000,222727.27272727274,3500000.0,500000.0,,100000.0,5,1100000,0.0,-0.16666666666666666
432090,Nicolò,Fagioli,2024,506,Italy,Piacenza,Italy,12-02-01,Central Midfield,Midfield,Right,178.0,30-06-28,CAA Stellar,https://img.a.transfermarkt.technology/portrait/header/432090-1695025310.jpg?lm=1,IT1,Juventus Football Club,20000000.0,35000000.0,23,129,155,12,13,14,8,15,12,9,11,7,10,14,13,12,14,15,14,14,12,14,15,12,15,15,10,12,12,13,12,13,16,12,9,15,12,13,11,13,7,12,9,14,1,3,1,2,2,3,2,2,1,2,2,14,18,10,11,13,13,13,13,1,1,1,1,1,1,19,1,20,1,1,18,1,1,71,7,20,11675000,6550,6550,4250,Mediterranean_Hispanic,128,0,0,35577.0,Unknown,43372948,650000.0,1.0,52,1141,54,3,1,3,116,1,0.6169621593014025,0.4491978609625668,0.5808823529411764,0.0343450749174155,0.0,0.0,0.0997749437359339,0.1747936984246061,0.0035834328731353,0.0,0.3488372093023257,0.2083333333333332,222,33,32,33,1,5848,10,36,62,20000000,1364285.7142857143,35000000.0,20000000.0,,3500000.0,3,3800000,0.0,0.3333333333333333
432092,Roberto,Piccoli,2024,1390,Italy,Bergamo,Italy,27-01-01,Centre-Forward,Attack,Right,190.0,30-06-25,World Soccer Agency,https://img.a.transfermarkt.technology/portrait/header/432092-1663672767.jpg?lm=1,IT1,Cagliari Calcio,4000000.0,4000000.0,23,124,154,5,7,10,13,12,5,15,9,6,5,11,12,6,12,10,14,12,14,12,9,13,14,8,9,13,5,15,14,11,12,14,15,16,13,14,16,13,8,12,5,7,3,3,3,2,3,2,2,2,1,1,1,12,14,7,13,13,15,14,13,1,1,1,1,1,1,1,1,1,1,1,1,1,20,84,11,20,7878750,6200,6200,4001,Northern_European,124,0,0,10672.0,Hellas Verona,43372280,9111392.0,2.0,52,176,54,0,1,7,46,3,0.5706536120666843,0.4225668449197861,0.5514705882352942,0.0102963769074562,0.0,0.0,0.0197549387346836,0.0197549387346836,0.0505924720131114,0.1428571428571428,0.6279069767441858,0.2083333333333332,189,61,8,12,0,5226,9,28,71,6000000,454545.45454545453,6000000.0,500000.0,,4000000.0,7,4000000,0.5,0.7142857142857143
432112,Aleksandr,Chernikov,2024,16704,Russia,"Vyselki, Krasnodar Region",Russia,01-02-00,Defensive Midfield,Midfield,Right,184.0,30-06-29,AKA Global GmbH,https://img.a.transfermarkt.technology/portrait/header/432112-1632564318.png?lm=1,RU1,FK Krasnodar,5000000.0,5000000.0,24,121,145,10,9,10,8,10,8,14,12,8,11,13,7,15,10,16,13,18,11,13,9,11,8,5,12,10,13,15,16,12,12,14,12,13,12,15,13,13,14,12,9,16,4,1,3,3,3,4,4,2,1,1,3,14,12,6,8,11,9,9,20,1,1,14,10,1,1,20,6,13,8,5,8,7,1,80,7,20,7294805,5896,5896,3896,Mediterranean_Hispanic,118,0,0,27031.0,Unknown,58133486,9111392.0,2.0,78,1636,81,3,1,3,78,4,0.5304313310399577,0.4113368983957219,0.5073529411764706,0.0260929097621008,0.0,0.0,0.0247561890472618,0.0247561890472618,0.0505924720131114,0.1428571428571428,0.4883720930232553,0.25,211,11,7,71,2,3902,4,46,152,6000000,280952.38095238095,6000000.0,100000.0,200000.0,600000.0,3,550000,0.2,0.2
432175,Marcos,López,2024,190,Peru,Lima,Peru,20-11-99,Left-Back,Defender,Left,176.0,30-06-25,Vibra Futbol,https://img.a.transfermarkt.technology/portrait/header/432175-1706610541.jpg?lm=1,DK1,Football Club KÃ¸benhavn,3000000.0,4000000.0,25,127,142,14,13,15,7,10,15,12,9,15,12,15,9,12,13,12,13,10,10,11,9,11,12,8,7,12,11,11,12,16,11,10,11,11,15,13,11,8,6,7,7,15,1,2,4,1,2,3,2,3,1,3,1,12,13,5,10,10,12,11,13,1,20,1,1,20,1,12,17,12,1,14,1,1,1,69,20,7,6729999,6350,5503,4190,African_Caribbean,116,19,0,10000.0,Unknown,77051575,775000.0,2.0,74,836,76,1,0,1,90,8,0.4784334480021169,0.4427807486631016,0.4926470588235294,0.009647482104698,0.125,0.0,0.0147536884221055,0.0197549387346836,0.0042778966082391,0.1428571428571428,0.3023255813953489,0.2916666666666665,161,9,17,29,2,6421,6,7,10,2500000,127631.57894736843,4000000.0,1000000.0,75000.0,350000.0,4,875000,-0.16666666666666666,-0.375
432671,Luca,Philipp,2024,533,Germany,Stuttgart,Germany,28-11-00,Goalkeeper,Goalkeeper,Right,192.0,30-06-25,Unique Sports Group,https://img.a.transfermarkt.technology/portrait/header/432671-1657200196.jpg?lm=1,L1,TSG 1899 Hoffenheim FuÃŸball-Spielbetriebs GmbH,300000.0,300000.0,24,107,137,5,3,1,3,6,7,1,2,2,1,12,5,3,6,11,9,14,9,11,8,14,5,3,12,1,9,9,8,12,13,9,14,17,12,6,7,13,5,11,5,12,14,10,10,5,8,13,13,14,8,5,11,13,13,2,11,9,13,10,10,20,1,1,1,1,1,1,1,1,1,1,1,1,1,83,11,20,3100000,5300,5300,2772,Northern_European,105,0,0,3122.0,Unknown,91207263,9111392.0,2.0,38,1432,40,2,1,7,199,5,0.4515744906059804,0.2911229946524064,0.411764705882353,0.0030059665490866,0.0,0.0,0.0012503125781445,0.0012503125781445,0.0505924720131114,0.1428571428571428,0.6744186046511627,0.25,0,0,0,0,0,0,3,9,53,300000,21153.846153846152,300000.0,0.0,25000.0,100000.0,1,50000,0.0,0.0
432694,Joshua,Kitolano,2024,468,Unknown,Unknown,Norway,03-08-01,Central Midfield,Midfield,Right,170.0,30-06-26,Aneke/PMG ,https://img.a.transfermarkt.technology/portrait/header/432694-1723809985.jpg?lm=1,NL1,Sparta Rotterdam,4500000.0,4500000.0,23,112,-75,10,10,13,8,13,10,6,8,8,10,12,8,10,13,15,9,12,12,12,11,12,14,13,8,13,11,14,13,13,13,10,6,15,13,16,9,12,8,12,7,13,2,3,3,2,3,3,3,3,1,3,1,14,10,6,7,13,13,13,19,1,1,1,1,1,1,14,13,20,13,13,13,13,1,63,10,20,35400003,5700,5700,3000,African_Caribbean,111,0,0,3000.0,Unknown,53151876,610000.0,1.0,105,1549,73,3,1,1,187,1,0.5044985445885155,0.3155080213903743,0.4558823529411764,0.0028881612426335,0.0,0.0,0.0222555638909727,0.0222555638909727,0.0033612044779021,0.0,0.1627906976744184,0.2083333333333332,233,23,13,23,0,4695,6,18,132,3500000,230000.0,4500000.0,500000.0,500000.0,800000.0,1,400000,-0.2222222222222222,-0.2222222222222222
432772,Samuel,Grandsir,2024,738,France,Evreux,France,14-08-96,Right Winger,Attack,Right,170.0,30-06-25,Unknown,https://img.a.transfermarkt.technology/portrait/header/432772-1646080113.JPG?lm=1,FR1,Le Havre Athletic Club,1500000.0,5000000.0,28,124,131,12,13,14,10,13,8,6,11,4,4,12,11,4,13,13,11,14,13,10,11,10,12,13,8,14,5,11,12,16,14,14,7,14,15,13,10,12,12,11,9,12,2,2,2,3,1,3,2,4,2,3,1,17,15,12,11,11,10,8,8,1,1,1,1,1,1,1,10,1,12,17,16,20,10,65,8,20,3351725,6255,6287,3913,African_Caribbean,121,0,0,19164.0,Unknown,48037146,3000000.0,1.0,34,479,36,0,1,1,126,10,0.5821645938078857,0.4131550802139037,0.5294117647058822,0.0184963987304064,0.0,0.0,0.0072518129532383,0.0247561890472618,0.0166393510930859,0.0,0.1627906976744184,0.4166666666666665,280,27,24,22,5,4443,3,37,200,1200000,52380.95238095238,5000000.0,1500000.0,,700000.0,6,2600000,-0.2,-0.3333333333333333
432982,Andreas,Skov Olsen,2024,2282,Denmark,HillerÃ¸d,Denmark,29-12-99,Right Winger,Attack,Left,187.0,30-06-26,MB Sports,https://img.a.transfermarkt.technology/portrait/header/432982-1725019885.jpg?lm=1,BE1,Club Brugge Koninklijke Voetbalvereniging,18000000.0,20000000.0,24,134,150,11,14,13,14,14,11,11,12,5,6,13,12,7,15,7,13,12,13,13,13,12,8,14,7,13,7,13,13,14,11,12,13,12,15,12,12,12,4,13,7,11,3,4,2,2,2,1,3,2,3,3,3,7,12,4,10,9,14,15,12,1,1,1,6,1,12,1,10,1,14,12,7,20,12,70,20,15,15000000,6350,6750,5000,Northern_European,136,21,7,22499.0,Unknown,27128912,6200000.0,2.0,28,626,30,0,0,7,53,10,0.6434241862926701,0.5294117647058822,0.6397058823529411,0.0217167323125471,0.1381578947368421,0.0921052631578947,0.0897724431107777,0.0997749437359339,0.0344176227117419,0.1428571428571428,0.5581395348837206,0.25,281,103,45,24,0,7367,18,62,82,16000000,797500.0,20000000.0,3000000.0,1750000.0,6500000.0,2,4000000,-0.1111111111111111,-0.1111111111111111
433049,Youssef,En-Nesyri,2024,36,Morocco,FÃ¨s,Morocco,01-06-97,Centre-Forward,Attack,Left,188.0,30-06-29,11MANGMT,https://img.a.transfermarkt.technology/portrait/header/433049-1728392433.JPG?lm=1,TR1,FenerbahÃ§e Spor KulÃ¼bÃ¼,22000000.0,40000000.0,27,148,159,9,11,14,15,12,9,14,13,7,5,11,12,6,14,6,15,14,12,13,11,12,13,12,11,16,6,13,14,16,14,10,15,13,15,13,12,12,13,9,4,8,2,1,2,2,2,3,3,2,1,3,1,9,17,9,10,11,12,12,7,1,1,1,1,1,1,1,1,1,1,15,9,10,20,73,20,15,30481155,7400,7250,6500,African_Caribbean,147,48,14,57496.0,Unknown,67229630,11406250.0,4.0,66,519,67,0,0,1,84,3,0.7095792537708389,0.6898395721925134,0.7205882352941175,0.0555104397710714,0.3157894736842105,0.1842105263157894,0.1097774443610902,0.1997999499874969,0.0633420372788133,0.4285714285714285,0.581395348837209,0.375,325,116,16,32,0,5347,6,29,48,22000000,750000.0,40000000.0,10000000.0,,1800000.0,4,5000000,0.1,0.2222222222222222
433177,Bukayo,Saka,2024,11,England,London,England,05-09-01,Right Winger,Attack,Left,178.0,30-06-27,Unknown,https://img.a.transfermarkt.technology/portrait/header/433177-1684155052.jpg?lm=1,GB1,Arsenal Football Club,140000000.0,140000000.0,23,161,177,12,14,15,11,14,8,7,12,7,9,13,12,10,15,11,16,11,14,14,15,16,16,16,6,16,9,15,15,17,16,16,9,15,15,15,11,14,8,14,9,18,1,1,1,3,1,3,3,3,1,2,3,7,14,7,14,16,15,13,14,1,13,1,1,14,10,1,12,8,12,19,1,20,1,0,20,11,303538754,8050,8050,7000,African_Caribbean,160,18,4,57996.0,Unknown,28122642,9111392.0,2.0,32,858,33,0,0,1,21,10,0.8154273617359089,0.7433155080213903,0.8161764705882353,0.055993248404076,0.1184210526315789,0.0526315789473684,0.6999249812453114,0.6999249812453114,0.0505924720131114,0.1428571428571428,0.3488372093023257,0.2083333333333332,303,89,79,30,0,5699,10,37,101,150000000,7526315.7894736845,150000000.0,2000000.0,35000000.0,65000000.0,0,0,0.07142857142857142,0.25
433181,Tino,Anjorin,2024,749,England,Poole,England,23-11-01,Attacking Midfield,Midfield,Right,186.0,03-06-27,FA Sport,https://img.a.transfermarkt.technology/portrait/header/433181-1724330041.jpg?lm=1,IT1,Empoli Football Club S.r.l.,700000.0,3000000.0,23,117,-85,10,9,10,14,11,10,9,13,6,6,11,15,7,13,12,8,10,12,9,12,12,16,14,8,10,6,10,12,15,9,15,12,14,14,12,14,10,6,15,8,11,1,3,3,2,2,3,3,2,1,2,1,15,12,6,12,10,11,12,10,1,1,1,1,1,1,10,1,17,1,14,20,14,1,81,14,20,42870545,5846,5996,4996,African_Caribbean,114,0,0,28998.0,Huddersfield Town,28121366,9111392.0,2.0,32,1167,33,3,1,1,64,0,0.5436623445355915,0.5289839572192513,0.4779411764705882,0.0279922789243409,0.0,0.0,0.0032508127031757,0.0147536884221055,0.0505924720131114,0.1428571428571428,0.5348837209302322,0.2083333333333332,140,41,21,7,0,7562,6,53,174,2500000,0.0,3000000.0,1000000.0,2300000.0,2500000.0,5,2300000,2.5714285714285716,2.5714285714285716
433183,Tommy,Doyle,2024,543,England,Manchester,England,17-10-01,Central Midfield,Midfield,Right,172.0,30-06-28,Unique Sports Group,https://img.a.transfermarkt.technology/portrait/header/433183-1682690588.jpg?lm=1,GB1,Wolverhampton Wanderers Football Club,10000000.0,10000000.0,23,120,-8,14,13,11,10,13,13,7,11,5,8,14,13,12,13,13,12,13,13,12,14,12,16,12,14,12,11,13,14,13,13,13,8,13,13,13,11,12,12,11,5,13,1,1,2,3,2,4,3,3,2,2,2,10,13,4,17,10,15,15,13,1,1,1,1,1,1,15,1,20,1,1,1,1,1,0,8,20,34658331,5999,5999,3499,Northern_European,121,0,0,11599.0,Sheffield United,28120038,5000000.0,1.0,32,905,33,3,1,7,222,1,0.5440592749404605,0.3688770053475935,0.5294117647058822,0.0111915041130467,0.0,0.0,0.0497624406101525,0.0497624406101525,0.0277507708547459,0.0,0.2093023255813952,0.2083333333333332,212,22,32,18,0,4576,3,7,43,10000000,900000.0,10000000.0,0.0,1000000.0,3000000.0,5,4000000,0.0,0.42857142857142855
433188,Curtis,Jones,2024,31,England,Liverpool,England,30-01-01,Central Midfield,Midfield,Right,185.0,30-06-27,Wasserman,https://img.a.transfermarkt.technology/portrait/header/433188-1701681163.jpg?lm=1,GB1,Liverpool Football Club,35000000.0,35000000.0,23,143,160,12,13,16,12,16,11,9,13,7,11,14,13,9,15,11,14,11,15,14,14,13,15,15,11,14,10,15,14,14,15,14,9,12,13,13,11,12,8,13,8,11,3,4,1,3,2,3,3,3,3,3,3,14,16,8,16,15,15,12,15,1,1,1,1,1,1,12,1,20,1,19,16,14,12,75,9,20,66985227,7150,7150,6000,Northern_European,140,0,0,52196.0,Unknown,28115788,9111392.0,2.0,32,845,33,3,1,7,129,1,0.696348240275205,0.6363636363636364,0.6691176470588234,0.0503926682612226,0.0,0.0,0.1747936984246061,0.1747936984246061,0.0505924720131114,0.1428571428571428,0.5116279069767438,0.2083333333333332,244,60,34,18,1,8788,7,45,62,45000000,2175000.0,45000000.0,5000000.0,2000000.0,30000000.0,0,0,0.2857142857142857,0.5
433257,Arvin,Appiah,2024,982,Netherlands,Amsterdam,England,05-01-01,Right Winger,Attack,Right,177.0,30-06-25,Unknown,https://img.a.transfermarkt.technology/portrait/header/433257-1544622521.jpg?lm=1,PO1,Clube Desportivo Nacional,400000.0,5000000.0,23,114,141,7,9,14,11,11,5,8,7,3,4,11,12,5,13,7,10,7,9,10,11,8,11,12,7,13,5,9,12,15,14,11,8,12,14,12,10,9,3,11,4,7,1,3,1,4,1,2,2,1,2,1,3,10,12,7,10,10,12,11,9,1,1,1,1,1,1,1,10,1,14,16,10,20,17,63,14,20,2239999,5696,5696,4596,African_Caribbean,106,0,0,8000.0,Tenerife,29189401,8850000.0,1.0,67,64,33,0,1,1,56,10,0.5039693040486901,0.4862032085561497,0.4191176470588235,0.0077162475726795,0.0,0.0,0.0017504376094023,0.0247561890472618,0.0491402538959415,0.0,0.3255813953488373,0.2083333333333332,157,6,5,9,0,4818,0,0,0,400000,10000.0,5000000.0,3000000.0,2000000.0,600000.0,7,5050000,0.0,-0.2
433358,Tomás,Ribeiro,2024,2420,Portugal,Lisboa,Portugal,30-04-99,Centre-Back,Defender,Left,185.0,30-06-27,Gestifute,https://img.a.transfermarkt.technology/portrait/header/433358-1695207229.jpg?lm=1,PO1,VitÃ³ria Sport Clube,3000000.0,3000000.0,25,122,135,5,10,10,8,11,7,11,7,5,14,11,5,13,12,12,15,13,11,15,12,13,14,11,13,10,13,14,14,12,12,14,13,14,12,13,13,13,12,11,12,10,3,2,2,3,3,2,3,2,3,2,3,12,11,5,18,17,16,14,11,1,10,20,1,1,1,14,1,5,1,1,1,1,1,79,20,7,1031833,6055,6071,4571,Mediterranean_Hispanic,123,0,0,7517.0,Unknown,83191209,625000.0,2.0,76,843,79,1,0,3,217,2,0.5535856046573168,0.4835294117647058,0.5441176470588236,0.0072498544331971,0.0,0.0,0.0147536884221055,0.0147536884221055,0.0034445401261146,0.1428571428571428,0.5116279069767438,0.2916666666666665,155,8,5,28,1,2933,6,48,193,2000000,112500.0,3000000.0,1000000.0,,525000.0,2,500000,-0.3333333333333333,0.3333333333333333
433584,Alessio,Zerbin,2024,6195,Italy,Novara,Italy,03-03-99,Left Winger,Attack,Right,182.0,30-06-28,Unknown,https://img.a.transfermarkt.technology/portrait/header/433584-1641998849.jpg?lm=1,IT1,SocietÃ  Sportiva Calcio Napoli,4000000.0,4000000.0,25,131,149,10,13,12,13,13,6,9,12,7,5,12,10,6,12,10,14,10,13,12,12,12,14,16,7,14,8,14,14,14,14,13,10,15,14,14,10,14,5,16,4,13,3,1,1,2,2,4,4,3,2,2,2,10,15,6,14,14,14,14,13,1,1,1,1,1,1,1,13,1,12,20,1,18,16,77,10,20,3916536,6550,7000,4750,Northern_European,126,1,0,8846.0,Unknown,43280475,9111392.0,2.0,52,1057,54,0,1,7,184,7,0.6765017200317545,0.5026737967914437,0.5661764705882353,0.0085331597797233,0.006578947368421,0.0,0.0197549387346836,0.0197549387346836,0.0505924720131114,0.1428571428571428,0.4418604651162785,0.2916666666666665,233,43,27,30,0,5170,5,19,50,3500000,193055.55555555556,4000000.0,500000.0,100000.0,150000.0,8,2825000,-0.125,0.0
433805,Patrick,Vroegh,2024,235,Netherlands,Herwijnen,Netherlands,29-11-99,Central Midfield,Midfield,Left,175.0,30-06-25,V4S,https://img.a.transfermarkt.technology/portrait/header/433805-1690903028.jpg?lm=1,NL1,Rooms Katholieke Combinatie Waalwijk,225000.0,450000.0,25,109,137,7,10,10,5,13,9,9,11,4,10,15,3,12,14,13,9,10,10,5,11,14,10,5,8,10,12,13,12,11,12,13,7,12,11,12,12,13,5,12,8,16,2,3,3,3,1,1,3,1,1,1,2,19,11,8,11,12,12,10,17,1,17,1,1,17,1,19,13,20,1,1,10,1,1,0,20,8,2959998,4850,4881,2761,Northern_European,101,0,0,2000.0,Unknown,37064938,9111392.0,2.0,67,623,68,3,0,7,172,1,0.396136544059275,0.2899465240641711,0.3823529411764706,0.0019225439766243,0.0,0.0,0.0008752188047011,0.0020005001250312,0.0505924720131114,0.1428571428571428,0.2790697674418605,0.2916666666666665,186,11,15,4,0,6314,5,16,70,175000,11363.636363636364,450000.0,100000.0,,200000.0,1,50000,-0.2222222222222222,-0.36363636363636365
433984,Sam,Beukema,2024,1025,Netherlands,Deventer,Netherlands,17-11-98,Centre-Back,Defender,Right,188.0,30-06-27,GFM,https://img.a.transfermarkt.technology/portrait/header/433984-1696837343.jpg?lm=1,IT1,Bologna Football Club 1909,18000000.0,18000000.0,26,118,135,4,5,7,8,9,12,15,6,8,13,10,11,13,10,13,12,13,13,14,8,12,15,9,15,9,12,13,15,12,12,14,13,13,13,13,13,14,5,13,4,10,3,3,3,4,1,2,3,2,1,3,3,11,11,4,12,9,15,12,13,1,1,20,1,1,1,1,1,1,1,1,1,1,1,85,7,20,2828936,5850,5850,3700,Northern_European,119,0,0,3000.0,Unknown,37063774,4950000.0,2.0,67,412,68,1,1,7,40,2,0.5243450648319662,0.3903743315508021,0.5147058823529411,0.0028881612426335,0.0,0.0,0.0897724431107777,0.0897724431107777,0.0274729853607044,0.1428571428571428,0.581395348837209,0.3333333333333332,252,20,6,20,0,8112,6,32,74,22000000,1097500.0,22000000.0,50000.0,50000.0,50000.0,2,5675000,0.2222222222222222,0.4666666666666667
434110,Leo,Greiml,2024,132,Austria,Horn,Austria,03-07-01,Centre-Back,Defender,Right,187.0,30-06-26,YOU FIRST,https://img.a.transfermarkt.technology/portrait/header/434110-1657108555.jpg?lm=1,NL1,Nooit Opgeven Altijd Doorzetten Aangenaam Door Vermaak En Nuttig Door Ontspanning Combinatie Breda,400000.0,2500000.0,23,121,147,4,8,10,6,11,6,13,7,7,13,12,8,15,11,16,13,16,12,12,11,12,16,8,6,8,13,12,14,12,11,14,14,12,12,12,13,12,11,11,8,7,3,1,3,1,3,3,2,4,2,3,2,10,15,7,10,14,15,12,10,1,1,20,13,1,1,1,1,1,1,1,1,1,1,73,12,20,2449999,6038,6038,4045,Northern_European,121,0,0,19177.0,Unknown,16191211,9111392.0,2.0,6,634,7,1,1,7,139,2,0.5492193702037577,0.4272727272727272,0.5294117647058822,0.0185089517548645,0.0,0.0,0.0017504376094023,0.0122530632658164,0.0505924720131114,0.1428571428571428,0.5581395348837206,0.2083333333333332,156,6,1,46,0,4506,5,80,346,900000,38235.294117647056,2500000.0,1000000.0,250000.0,2500000.0,2,350000,1.25,0.125
434116,Alexander,Prass,2024,533,Austria,HellmonsÃ¶dt,Austria,26-05-01,Left Midfield,Midfield,Left,180.0,30-06-28,Sports360 GmbH,https://img.a.transfermarkt.technology/portrait/header/434116-1723921044.jpg?lm=1,L1,TSG 1899 Hoffenheim FuÃŸball-Spielbetriebs GmbH,12000000.0,12000000.0,23,123,146,9,8,13,7,12,7,9,13,7,10,13,8,11,14,7,11,12,11,11,10,12,16,7,8,14,9,13,13,14,12,8,10,12,15,17,9,9,6,8,7,9,1,3,3,2,3,2,2,1,2,3,2,19,17,5,13,11,13,12,19,1,16,1,1,13,1,1,20,15,1,14,13,1,6,72,20,12,6610000,6147,6147,3547,Northern_European,117,0,0,4973.0,Unknown,16191722,4800000.0,2.0,6,609,7,3,0,7,199,6,0.5636411749139985,0.3740106951871657,0.4999999999999999,0.0047933241084697,0.0,0.0,0.0597649412353088,0.0597649412353088,0.0266396288785799,0.1428571428571428,0.3953488372093026,0.2083333333333332,264,38,47,29,1,5080,6,12,43,9000000,557812.5,12000000.0,3000000.0,300000.0,1000000.0,2,3000000,-0.25,0.125
434223,Adam,Idah,2024,371,Ireland,Cork,Ireland,11-02-01,Centre-Forward,Attack,Right,190.0,30-06-29,Unique Sports Group,https://img.a.transfermarkt.technology/portrait/header/434223-1706829362.jpg?lm=1,SC1,The Celtic Football Club,5000000.0,5000000.0,23,124,-8,5,8,12,14,11,6,13,10,4,5,11,16,4,12,11,14,11,13,9,11,11,14,7,5,13,4,14,14,16,13,14,14,10,15,12,16,10,3,11,10,6,3,1,1,2,1,1,3,1,2,1,4,14,16,8,14,12,14,10,12,1,1,1,1,1,1,1,1,1,1,12,1,1,20,0,7,20,56696760,6200,6200,4650,Mixed_Race,124,13,0,23198.0,Unknown,29190795,9900000.0,1.0,49,384,52,0,1,4,200,3,0.5706536120666843,0.4919786096256684,0.5514705882352942,0.0223916987814875,0.0855263157894736,0.0,0.0247561890472618,0.0247561890472618,0.054973749270813,0.0,0.6279069767441858,0.2083333333333332,225,63,14,14,1,4873,8,97,196,5000000,266666.6666666667,5000000.0,500000.0,,3000000.0,1,700000,0.42857142857142855,0.7857142857142857
434224,Maxence,Lacroix,2024,873,France,Villeneuve-Saint-Georges,France,06-04-00,Centre-Back,Defender,Right,190.0,30-06-29,Unique Sports Group,https://img.a.transfermarkt.technology/portrait/header/434224-1657202248.jpg?lm=1,GB1,Crystal Palace Football Club,20000000.0,28000000.0,24,140,160,4,6,13,6,12,4,14,6,5,14,13,6,14,13,15,14,14,12,12,12,13,17,13,9,8,14,13,12,16,12,15,15,16,17,13,14,13,11,12,3,8,2,2,1,3,2,3,1,1,3,1,3,16,16,12,12,12,14,12,9,1,1,20,1,1,1,14,1,1,1,1,1,1,1,88,11,20,40000001,7000,6074,5904,Mixed_Race,139,0,0,76711.0,Unknown,49038271,11500000.0,2.0,34,1604,36,1,1,4,58,2,0.5539825350621858,0.6260962566844919,0.6617647058823528,0.0740647755374384,0.0,0.0,0.0997749437359339,0.1397849462365591,0.0638628850801411,0.1428571428571428,0.6279069767441858,0.25,196,8,3,28,4,2714,3,6,71,20000000,1042105.2631578947,28000000.0,5000000.0,200000.0,25000000.0,2,3000000,0.0,0.0
434675,Cody,Gakpo,2024,31,Netherlands,Eindhoven,Netherlands,07-05-99,Left Winger,Attack,Right,193.0,30-06-28,SEG,https://img.a.transfermarkt.technology/portrait/header/434675-1682690965.jpg?lm=1,GB1,Liverpool Football Club,55000000.0,60000000.0,25,152,162,17,14,16,13,15,12,12,15,5,5,12,11,4,14,8,13,12,13,13,13,12,14,14,14,13,6,13,12,15,16,13,14,10,14,13,12,10,3,14,10,7,2,3,1,1,1,2,2,1,3,4,1,10,10,3,13,16,15,14,18,1,1,1,1,1,1,1,16,12,13,20,14,17,19,76,11,20,55007104,7598,7598,6648,African_Caribbean,143,7,2,19177.0,Unknown,37062185,42000000.0,1.0,67,450,68,0,1,1,129,7,0.7556231807356444,0.7056684491978609,0.6911764705882353,0.0185089517548645,0.0460526315789473,0.0263157894736842,0.274818704676169,0.2998249562390597,0.2333120364454568,0.0,0.6976744186046511,0.2916666666666665,337,121,75,19,0,10313,9,37,63,60000000,2141964.285714286,60000000.0,5000000.0,250000.0,7200000.0,1,5000000,0.09090909090909091,0.2
435228,Ardian,Ismajli,2024,749,Yugoslavia (Republic),Majance,Albania,30-09-96,Centre-Back,Defender,Right,187.0,30-06-25,Gol International,https://img.a.transfermarkt.technology/portrait/header/435228-1663677962.jpg?lm=1,IT1,Empoli Football Club S.r.l.,3000000.0,3500000.0,28,126,135,5,8,8,8,10,7,14,8,14,14,12,6,14,9,14,14,15,12,12,11,10,13,7,12,9,14,14,14,12,12,14,14,12,13,15,15,10,11,11,9,11,2,1,4,2,3,1,2,1,1,3,1,11,12,14,12,11,14,8,12,1,1,20,16,1,10,1,1,1,1,1,1,1,1,80,8,20,2621506,6300,5950,5000,Mediterranean_Hispanic,127,27,1,32115.0,Unknown,24052869,2100000.0,2.0,110,896,0,1,1,3,64,2,0.5375760783275999,0.5294117647058822,0.5735294117647058,0.0310021079424916,0.1776315789473684,0.0131578947368421,0.0147536884221055,0.0172543135783946,0.0116392122003388,0.1428571428571428,0.5581395348837206,0.4166666666666665,219,3,4,47,0,2356,15,37,55,6000000,243181.81818181818,6000000.0,500000.0,,650000.0,2,1350000,1.0,1.0
435648,Joshua,Zirkzee,2024,985,Netherlands,Schiedam,Netherlands,22-05-01,Centre-Forward,Attack,Right,193.0,30-06-29,Sports Invest UK ltd,https://img.a.transfermarkt.technology/portrait/header/435648-1651087961.jpg?lm=1,GB1,Manchester United Football Club,50000000.0,50000000.0,23,127,152,4,7,12,14,13,13,12,11,3,5,13,12,7,15,14,14,12,13,12,13,12,11,14,3,15,5,12,10,13,12,15,15,14,13,12,13,12,11,14,8,8,4,3,2,1,1,1,1,2,2,2,2,13,15,15,8,11,8,8,6,1,1,1,1,1,1,1,1,1,1,10,15,10,20,89,12,20,8499040,6350,6000,5500,Mixed_Race,127,0,0,47944.0,Unknown,37060922,23383333.33,3.0,67,1349,68,0,1,4,132,3,0.5441915850754168,0.5828877005347594,0.5735294117647058,0.0462868636461514,0.0,0.0,0.2498124531132783,0.2498124531132783,0.1298832374788188,0.2857142857142857,0.6976744186046511,0.2083333333333332,250,88,51,19,3,7602,9,38,73,42000000,2205263.1578947366,50000000.0,8000000.0,6300000.0,11000000.0,4,8000000,-0.16,0.4
435772,Charles,De Ketelaere,2024,800,Belgium,Brugge,Belgium,10-03-01,Attacking Midfield,Midfield,Left,192.0,30-06-27,Unknown,https://img.a.transfermarkt.technology/portrait/header/435772-1659601388.jpg?lm=1,IT1,Atalanta Bergamasca Calcio S.p.a.,34000000.0,34000000.0,23,145,169,10,11,15,13,16,10,13,12,11,7,15,12,10,16,12,14,13,14,14,15,14,15,17,8,14,10,15,13,13,12,14,15,12,14,13,12,13,8,10,6,18,2,3,2,2,2,4,1,2,2,2,3,11,14,11,13,14,15,15,7,1,1,1,1,1,1,1,12,16,12,13,20,13,18,80,20,9,72036004,7250,7000,6250,Northern_European,142,8,1,54231.0,Unknown,18110528,29250000.0,2.0,7,264,8,3,0,7,31,0,0.6765017200317545,0.6631016042780749,0.6838235294117647,0.0523576993975513,0.0526315789473684,0.0131578947368421,0.169792448112028,0.169792448112028,0.162476735464874,0.1428571428571428,0.6744186046511627,0.2083333333333332,260,54,44,13,0,6794,7,18,18,38000000,1895000.0,38000000.0,5000000.0,5000000.0,27000000.0,2,3000000,0.11764705882352941,0.52
435796,Kilian,Fischer,2024,82,Germany,Miltenberg,Germany,12-10-00,Right-Back,Defender,Right,182.0,30-06-27,Robert Schneider,https://img.a.transfermarkt.technology/portrait/header/435796-1657202527.jpg?lm=1,L1,Verein fÃ¼r LeibesÃ¼bungen Wolfsburg,2500000.0,2500000.0,24,122,142,4,13,11,7,11,4,7,7,13,11,12,7,13,12,14,12,13,12,11,12,11,16,12,6,12,11,15,16,14,12,12,9,14,15,15,11,14,11,13,7,18,1,1,1,3,2,3,3,2,1,2,2,15,17,3,8,16,19,14,16,1,15,10,20,15,15,12,10,13,10,1,1,1,1,77,12,20,4674999,6100,6100,4100,Northern_European,117,0,0,18219.0,Unknown,91207901,1300000.0,2.0,38,954,40,1,1,7,213,11,0.5574225985710506,0.4331550802139037,0.4999999999999999,0.0175838904140277,0.0,0.0,0.0122530632658164,0.0122530632658164,0.0071946442956748,0.1428571428571428,0.4418604651162785,0.25,134,0,10,22,0,3004,8,41,250,4000000,282142.85714285716,4000000.0,500000.0,50000.0,350000.0,2,500000,1.6666666666666667,1.6666666666666667
438001,Santiago,Bueno,2024,543,Uruguay,Montevideo,Uruguay,09-11-98,Centre-Back,Defender,Right,190.0,30-06-28,Unknown,https://img.a.transfermarkt.technology/portrait/header/438001-1567158917.jpg?lm=1,GB1,Wolverhampton Wanderers Football Club,8000000.0,8000000.0,26,127,143,4,7,8,7,12,5,14,9,8,14,12,8,14,10,14,14,13,12,14,9,13,13,7,6,6,14,14,13,11,11,12,14,11,13,14,13,12,13,9,11,5,2,3,2,1,1,1,2,1,1,2,2,15,12,5,9,12,13,13,15,1,1,20,1,1,1,5,1,1,1,1,1,1,1,71,12,20,3091343,6250,5750,4251,Mediterranean_Hispanic,127,0,0,3320.0,Unknown,78076996,6500000.0,2.0,106,975,103,1,1,3,222,2,0.5111140513363324,0.4493048128342246,0.5735294117647058,0.0031971587677564,0.0,0.0,0.0397599399849962,0.0397599399849962,0.0360843356759909,0.1428571428571428,0.6279069767441858,0.3333333333333332,202,7,5,31,1,3258,8,25,90,8000000,343478.26086956525,8000000.0,0.0,200000.0,300000.0,5,150000,0.0,0.0
439022,Unknown,Marcão,2024,368,Brazil,Londrina (PR),Brazil,05-06-96,Centre-Back,Defender,Left,185.0,30-06-27,Master Talents,https://img.a.transfermarkt.technology/portrait/header/439022-1681476532.jpg?lm=1,ES1,Sevilla FÃºtbol Club S.A.D.,4000000.0,15000000.0,28,140,145,8,8,10,7,13,8,13,7,8,13,15,13,14,14,16,14,16,15,13,14,14,14,10,12,10,14,14,15,13,13,15,13,18,13,14,15,14,16,12,12,10,2,2,3,4,1,3,2,3,1,3,2,14,14,12,10,12,14,12,9,1,5,20,1,1,1,10,1,1,1,1,1,1,1,80,20,9,25323845,7000,6120,7082,African_Caribbean,141,0,0,23877.0,Unknown,19190440,9111392.0,2.0,10,860,11,1,0,1,181,2,0.5600688012701773,0.7520855614973262,0.6764705882352942,0.0230473529051078,0.0,0.0,0.0197549387346836,0.0747686921730432,0.0505924720131114,0.1428571428571428,0.5116279069767438,0.4166666666666665,255,8,2,73,4,7003,13,77,151,4000000,140000.0,15000000.0,2500000.0,,500000.0,4,4200000,0.0,-0.2
440658,Unknown,Artur,2024,964,Brazil,Fortaleza,Brazil,15-02-98,Right Winger,Attack,Left,168.0,30-06-27,Talents Sports,https://img.a.transfermarkt.technology/portrait/header/440658-1721723683.png?lm=1,RU1,AO FK Zenit Sankt-Peterburg,10000000.0,12000000.0,26,132,138,12,12,14,12,14,11,7,13,4,9,13,10,9,13,12,12,13,12,11,13,12,13,14,7,13,6,9,13,16,15,15,4,12,15,14,9,12,6,11,11,6,2,2,1,1,1,1,2,3,2,1,3,19,13,4,12,12,12,13,13,1,1,1,1,1,1,1,14,9,14,18,13,20,14,65,20,7,14281636,6720,6720,3508,Mediterranean_Hispanic,130,0,0,6997.0,Unknown,19261284,9666666.667,3.0,10,502,11,0,0,3,7,10,0.63945488224398,0.3698395721925133,0.5955882352941175,0.0067477334548723,0.0,0.0,0.0497624406101525,0.0597649412353088,0.0536774169671379,0.2857142857142857,0.1162790697674416,0.3333333333333332,353,72,59,40,0,8634,1,2,9,8000000,345454.54545454547,12000000.0,2000000.0,,400000.0,5,3600000,-0.2727272727272727,-0.2
441170,Valentin,Rosier,2024,1244,France,Montauban,France,19-08-96,Right-Back,Defender,Right,175.0,30-06-25,Gol International,https://img.a.transfermarkt.technology/portrait/header/441170-1666619891.png?lm=1,ES1,Club Deportivo LeganÃ©s S.A.D.,4000000.0,8000000.0,28,135,145,8,14,15,10,14,5,11,6,12,13,13,4,13,15,17,13,14,13,14,13,13,14,14,7,14,12,14,13,14,14,13,9,14,14,15,12,12,14,14,8,14,1,2,1,2,1,4,3,3,1,2,3,12,15,6,15,13,13,14,14,1,10,1,20,1,14,1,1,1,14,1,1,1,1,71,10,20,6103899,6794,6294,5594,African_Caribbean,135,0,0,48075.0,Unknown,50047466,4900000.0,2.0,34,972,36,1,1,1,54,11,0.58309076475258,0.5929411764705882,0.6323529411764706,0.0464133595079986,0.0,0.0,0.0197549387346836,0.0397599399849962,0.0271951998666629,0.1428571428571428,0.2790697674418605,0.4166666666666665,256,6,27,42,1,5245,11,85,242,2500000,90384.61538461539,8000000.0,2000000.0,,150000.0,4,5000000,-0.375,-0.5
441216,Thijs,Oosting,2024,202,Netherlands,Emmen,Netherlands,02-05-00,Attacking Midfield,Midfield,Left,176.0,30-06-27,V4S,https://img.a.transfermarkt.technology/portrait/header/441216-1723455783.jpg?lm=1,NL1,Football Club Groningen,700000.0,700000.0,24,111,135,10,11,12,10,11,12,6,12,9,8,11,14,9,11,14,13,11,10,11,9,12,15,9,12,12,9,13,15,12,12,13,7,12,13,12,10,14,8,11,12,15,1,1,2,1,3,1,2,2,3,3,2,19,12,1,12,9,11,9,17,1,16,1,1,16,1,1,17,20,10,16,18,10,13,0,20,8,3699998,5750,5750,4250,Northern_European,100,0,0,2000.0,Unknown,37061843,1000000.0,2.0,67,461,68,3,0,7,88,0,0.5111140513363324,0.4491978609625668,0.3749999999999999,0.0019225439766243,0.0,0.0,0.0032508127031757,0.0032508127031757,0.0055279313314258,0.1428571428571428,0.3023255813953489,0.25,231,69,28,10,0,3955,3,39,311,700000,40909.09090909091,700000.0,100000.0,,600000.0,5,0,0.0,0.16666666666666666
441892,Leopold,Wahlstedt,2024,678,Sweden,Stockholm,Sweden,04-07-99,Goalkeeper,Goalkeeper,Right,190.0,30-06-29,BHM Sports Agency,https://img.a.transfermarkt.technology/portrait/header/441892-1671209083.jpg?lm=1,DK1,Aarhus Gymnastik Forening,1800000.0,2200000.0,25,114,136,4,1,1,3,9,7,9,2,2,3,11,3,1,9,12,13,11,10,8,8,12,15,14,10,3,14,12,12,12,15,12,16,11,8,8,13,15,13,12,11,14,13,13,11,15,11,11,15,14,16,12,11,15,15,7,10,14,15,14,12,20,1,1,1,1,1,1,1,1,1,1,1,1,1,80,7,20,1007474,5638,5218,2681,Northern_European,116,0,0,907.0,Unknown,93087487,1000000.0,2.0,91,1426,91,2,1,7,11,5,0.4407250595395607,0.2813903743315508,0.4926470588235294,0.0008671243048762,0.0,0.0,0.0087521880470117,0.010752688172043,0.0055279313314258,0.1428571428571428,0.6279069767441858,0.2916666666666665,0,0,0,0,0,0,1,11,128,1500000,120833.33333333333,2200000.0,400000.0,50000.0,,4,1000000,-0.16666666666666666,-0.3181818181818182
442248,Ethan,Pinnock,2024,1148,England,London,Jamaica,29-05-93,Centre-Back,Defender,Left,194.0,30-06-27,Two Touch Agency,https://img.a.transfermarkt.technology/portrait/header/442248-1719836196.jpg?lm=1,GB1,Brentford Football Club,10000000.0,15000000.0,31,134,137,5,7,10,7,11,6,15,5,13,13,12,5,14,11,12,14,15,14,14,11,13,16,6,13,8,14,13,14,12,11,14,17,14,12,14,15,14,6,14,8,10,4,1,3,3,3,3,1,2,2,1,1,14,14,4,14,14,18,14,18,1,10,20,1,1,1,10,1,1,1,1,1,1,1,77,20,7,22664384,6700,6700,5350,African_Caribbean,134,5,0,34798.0,Unknown,89040516,1960000.0,2.0,32,858,55,1,0,1,43,2,0.6368086795448531,0.5668449197860962,0.625,0.0335928590671944,0.0328947368421052,0.0,0.0497624406101525,0.0747686921730432,0.0108614128170226,0.1428571428571428,0.7209302325581395,0.5416666666666665,310,18,9,16,1,3708,3,20,64,8000000,478125.0,15000000.0,3000000.0,,,1,1500000,-0.3333333333333333,-0.4666666666666667
442891,Martin,Terrier,2024,15,France,ArmentiÃ¨res,France,04-03-97,Left Winger,Attack,Right,184.0,30-06-29,FAIR SPORT MNG,https://img.a.transfermarkt.technology/portrait/header/442891-1727378397.jpg?lm=1,L1,Bayer 04 Leverkusen FuÃŸball,20000000.0,35000000.0,27,147,151,12,11,13,15,16,12,13,12,4,5,14,11,5,16,10,13,11,13,12,13,13,15,15,8,14,8,14,13,15,13,13,12,14,14,14,12,13,7,12,8,16,1,2,1,1,1,1,2,2,3,1,3,19,14,6,13,12,16,9,14,1,1,1,1,1,1,1,13,11,13,20,18,16,19,73,10,20,36540000,7350,7350,4750,Northern_European,137,0,0,59999.0,Unknown,48042204,14333333.33,3.0,34,88,36,0,1,7,36,7,0.7228102672664726,0.5026737967914437,0.6470588235294117,0.0579273797878925,0.0,0.0,0.0997749437359339,0.1747936984246061,0.0796040630573071,0.2857142857142857,0.4883720930232553,0.375,295,80,32,19,3,5685,12,65,270,20000000,940476.1904761905,35000000.0,8000000.0,,12000000.0,4,13100000,0.0,-0.09090909090909091
443710,Angelo,Stiller,2024,79,Germany,MÃ¼nchen,Germany,04-04-01,Defensive Midfield,Midfield,Left,183.0,30-06-27,Gol International,https://img.a.transfermarkt.technology/portrait/header/443710-1723707618.jpg?lm=1,L1,Verein fÃ¼r Bewegungsspiele Stuttgart 1893,28000000.0,28000000.0,23,124,150,13,13,12,8,15,14,7,10,6,11,15,8,11,14,12,13,11,15,12,14,12,15,13,13,12,12,13,14,11,12,13,10,14,10,14,11,16,8,13,5,8,2,2,2,3,2,2,3,3,3,1,3,12,17,8,14,13,15,9,11,1,1,1,1,1,1,20,1,18,1,1,1,1,1,75,20,10,8999999,6099,6099,4399,Northern_European,120,0,0,14999.0,Unknown,91184426,5500000.0,1.0,38,1006,40,3,0,7,211,4,0.5572902884360942,0.4651336898395721,0.5220588235294117,0.014474602817478,0.0,0.0,0.1397849462365591,0.1397849462365591,0.0305286257951609,0.0,0.4651162790697669,0.2083333333333332,252,16,45,32,0,5007,10,27,40,32000000,1673684.2105263157,32000000.0,1000000.0,450000.0,6000000.0,2,3500000,0.6,1.2857142857142858
443726,James,Scott,2024,465,Scotland,Glasgow,Scotland,30-08-00,Centre-Forward,Attack,Right,189.0,31-05-26,StormSportsX,https://img.a.transfermarkt.technology/portrait/header/443726-1634026402.jpg?lm=1,SC1,Saint Mirren Football Club,375000.0,900000.0,24,104,135,9,10,12,11,12,8,10,9,7,4,11,13,8,12,9,9,12,10,9,10,9,13,13,14,10,6,12,11,12,11,10,12,14,12,10,11,8,9,10,14,11,1,2,3,3,1,3,3,1,1,1,2,13,12,7,15,9,13,10,12,1,1,1,1,1,1,1,13,1,12,19,14,18,20,87,14,20,3994755,5200,5200,2250,Northern_European,96,0,0,7539.0,Unknown,61078239,1750000.0,1.0,82,545,83,0,1,7,179,3,0.4383434771103467,0.2352941176470588,0.3455882352941176,0.0072710980130493,0.0,0.0,0.0016254063515878,0.0042510627656914,0.0096947137420483,0.0,0.6046511627906974,0.25,176,20,9,8,0,6161,3,3,14,375000,17307.69230769231,900000.0,200000.0,150000.0,700000.0,5,1000000,0.0,0.0
444211,Will,Smallbone,2024,180,England,Basingstoke,Ireland,21-02-00,Central Midfield,Midfield,Right,183.0,30-06-26,CAA Base Ltd,https://img.a.transfermarkt.technology/portrait/header/444211-1595844096.jpg?lm=1,GB1,Southampton Football Club,5000000.0,5000000.0,24,120,140,9,12,13,10,13,9,9,9,6,6,14,9,11,14,7,13,7,13,13,12,13,12,12,9,13,9,14,13,12,13,13,11,12,12,14,9,11,7,10,6,10,2,1,1,1,3,1,3,2,2,2,1,13,12,1,8,13,8,12,15,1,1,1,1,1,1,1,1,18,1,12,20,12,1,61,12,20,7704171,5993,5743,4493,Northern_European,120,0,0,11599.0,Stoke City,28109942,9111392.0,2.0,32,153,52,3,1,7,186,1,0.510187880391638,0.475187165775401,0.5220588235294117,0.0111915041130467,0.0,0.0,0.0247561890472618,0.0247561890472618,0.0505924720131114,0.1428571428571428,0.4651162790697669,0.25,225,24,24,19,0,4354,6,87,261,7000000,500000.0,7000000.0,500000.0,,3000000.0,2,1500000,0.4,1.0
444523,Unknown,Lucas Paquetá,2024,379,Brazil,PaquetÃ¡,Brazil,27-08-97,Attacking Midfield,Midfield,Left,180.0,30-06-27,Roc Nation Sports,https://img.a.transfermarkt.technology/portrait/header/444523-1695370009.jpg?lm=1,GB1,West Ham United Football Club,55000000.0,65000000.0,27,147,161,12,12,15,12,16,12,12,13,6,10,16,13,10,17,13,13,16,14,12,16,13,13,17,11,14,10,13,14,13,16,14,11,13,13,13,14,11,11,14,8,14,1,3,3,3,1,3,2,1,2,2,2,11,14,9,9,9,14,8,10,1,1,1,1,1,1,1,13,19,14,13,20,15,12,72,20,9,57424604,7350,8097,5897,Mixed_Race,147,21,5,150789.0,Unknown,19226741,34783333.33,3.0,10,1116,11,3,0,4,220,0,0.8216459380788568,0.6253475935828876,0.7205882352941175,0.1455957713688687,0.1381578947368421,0.0657894736842105,0.274818704676169,0.3248312078019504,0.1932183301202811,0.2857142857142857,0.3953488372093026,0.375,328,58,38,69,1,7874,7,21,46,40000000,1662500.0,65000000.0,15000000.0,,15000000.0,3,30000000,-0.38461538461538464,-0.38461538461538464
445126,Emanuele,Valeri,2024,130,Italy,Roma,Italy,07-12-98,Left-Back,Defender,Left,180.0,30-06-27,Daniele Ferri,https://img.a.transfermarkt.technology/portrait/header/445126-1663684061.jpg?lm=1,IT1,Parma Calcio 1913,2300000.0,3500000.0,26,128,150,11,14,14,10,12,13,8,13,12,10,12,10,14,13,15,15,13,13,12,13,12,18,13,8,14,9,13,14,14,14,12,8,14,14,15,10,15,8,16,6,13,3,2,2,2,1,2,3,3,3,1,2,11,16,12,17,11,12,8,10,1,20,1,1,20,1,1,18,1,1,1,1,1,1,78,20,5,3502421,6400,6400,4265,Mediterranean_Hispanic,123,0,0,2115.0,Unknown,43315140,100000.0,1.0,52,1244,54,1,0,3,155,8,0.5971156390579518,0.4508021390374331,0.5441176470588236,0.0020335899622153,0.0,0.0,0.0112528132033008,0.0172543135783946,0.0005277924386788,0.0,0.3953488372093026,0.3333333333333332,251,17,31,39,0,1538,4,8,19,3000000,147500.0,3500000.0,800000.0,125000.0,200000.0,5,1075000,0.30434782608695654,0.30434782608695654
445616,Gift,Links,2024,678,South Africa,"Rustenburg, North West",South Africa,02-10-98,Left Midfield,Midfield,Left,170.0,30-06-26,SSG,https://img.a.transfermarkt.technology/portrait/header/445616-1674745861.jpg?lm=1,DK1,Aarhus Gymnastik Forening,750000.0,800000.0,26,114,136,8,11,13,9,11,9,9,9,6,8,8,9,7,11,10,11,11,10,11,11,12,14,13,6,12,9,12,16,16,14,12,8,11,15,14,5,8,7,12,5,11,1,3,2,2,3,4,1,2,2,4,1,13,12,4,15,11,12,13,12,1,1,1,1,13,1,1,12,1,1,20,15,18,1,60,20,10,1077518,5450,6200,1500,African_Caribbean,117,5,0,2016.0,Unknown,65036461,475000.0,2.0,88,1261,88,3,0,1,11,6,0.5706536120666843,0.1550802139037433,0.4999999999999999,0.0019379938528804,0.0328947368421052,0.0,0.0035008752188047,0.0037509377344336,0.0026111836439901,0.1428571428571428,0.1627906976744184,0.3333333333333332,236,20,25,22,0,8911,3,19,48,900000,46052.63157894737,900000.0,100000.0,50000.0,350000.0,3,250000,0.2,1.25
445939,Omar,Marmoush,2024,24,Egypt,Kairo,Egypt,07-02-99,Centre-Forward,Attack,Right,183.0,30-06-27,CAA Stellar,https://img.a.transfermarkt.technology/portrait/header/445939-1696508916.jpg?lm=1,L1,Eintracht Frankfurt FuÃŸball AG,40000000.0,40000000.0,25,135,148,13,11,16,11,12,14,11,12,6,8,12,12,8,15,13,13,12,12,10,12,11,13,16,6,13,8,12,12,16,15,12,11,13,15,12,11,11,9,12,7,16,1,3,1,3,2,1,2,1,1,2,3,16,14,8,11,12,12,12,12,1,1,1,1,10,10,1,11,1,10,18,10,15,20,81,8,20,5128346,6748,6248,5748,North_African__Middle_Eastern,124,13,1,28009.0,Unknown,91205962,9111392.0,2.0,31,699,32,0,1,6,63,3,0.5770044985445886,0.6094117647058823,0.5514705882352942,0.0270372834482578,0.0855263157894736,0.0131578947368421,0.1997999499874969,0.1997999499874969,0.0505924720131114,0.1428571428571428,0.4651162790697669,0.2916666666666665,219,73,32,24,0,4662,6,11,34,60000000,2498958.3333333335,60000000.0,25000.0,100000.0,75000.0,6,4625000,1.7272727272727273,3.0
447661,Unknown,Douglas Luiz,2024,506,Brazil,Rio de Janeiro,Brazil,09-05-98,Central Midfield,Midfield,Right,177.0,30-06-29,Bertolucci Sports,https://img.a.transfermarkt.technology/portrait/header/447661-1696598670.jpg?lm=1,IT1,Juventus Football Club,70000000.0,70000000.0,26,140,155,7,8,12,12,14,10,12,13,9,14,14,11,14,15,13,14,12,14,12,13,12,13,14,12,13,11,13,14,14,14,13,11,14,13,15,13,11,14,12,9,11,1,3,3,2,3,2,2,2,3,2,4,12,12,6,12,14,12,13,12,1,1,1,1,1,1,20,1,19,1,1,1,1,1,65,11,20,42447176,7000,6900,6000,Mediterranean_Hispanic,138,9,0,75395.0,Unknown,19302456,26766666.67,3.0,10,1234,11,3,1,3,116,1,0.6632707065361206,0.6363636363636364,0.6544117647058822,0.0727940232153703,0.0592105263157894,0.0,0.3498374593648412,0.3498374593648412,0.1486800559459985,0.2857142857142857,0.3255813953488373,0.3333333333333332,310,27,24,70,2,6159,8,30,49,45000000,1560000.0,70000000.0,15000000.0,,2500000.0,2,22500000,-0.35714285714285715,-0.25
448258,Josha,Vagnoman,2024,79,Germany,Hamburg,Germany,11-12-00,Right-Back,Defender,Right,190.0,30-06-26,FTC,https://img.a.transfermarkt.technology/portrait/header/448258-1691999620.jpg?lm=1,L1,Verein fÃ¼r Bewegungsspiele Stuttgart 1893,10000000.0,10000000.0,24,125,147,7,12,13,7,11,6,8,9,14,11,10,9,11,12,12,9,13,12,9,10,10,11,12,7,10,11,13,14,14,10,14,12,13,16,13,14,11,11,13,13,14,2,2,1,2,2,2,4,2,1,3,3,8,12,7,13,15,10,14,12,1,18,12,20,18,20,12,10,10,14,1,1,10,1,86,12,20,6839999,6245,6245,4495,Mixed_Race,110,0,0,11999.0,Unknown,91184445,3700000.0,1.0,38,594,40,1,1,4,211,11,0.5766075681397195,0.4754010695187165,0.4485294117647059,0.0115777510194504,0.0,0.0,0.0497624406101525,0.0497624406101525,0.0205283480096669,0.0,0.6279069767441858,0.25,206,27,18,18,0,3677,19,128,162,12000000,590000.0,12000000.0,1000000.0,1500000.0,4000000.0,1,700000,0.2,0.5
448466,Jovane,Cabral,2024,2431,Cape Verde,Assomada,Cape Verde,14-06-98,Left Winger,Attack,Right,174.0,30-06-26,Invictus Team,https://img.a.transfermarkt.technology/portrait/header/448466-1696837471.jpg?lm=1,PO1,Club Football Estrela da Amadora,1500000.0,10000000.0,26,133,144,12,12,14,13,13,14,6,13,5,5,12,12,7,13,11,13,11,10,8,13,11,14,16,8,14,6,7,8,15,14,13,7,14,15,11,14,11,3,13,4,7,1,1,3,3,1,3,3,1,1,3,2,13,11,6,12,13,14,12,13,1,1,1,1,1,1,1,5,1,10,20,15,20,17,71,14,20,2580186,6650,6900,5150,African_Caribbean,125,5,1,13499.0,Unknown,83111471,800000.0,1.0,17,102,17,0,1,1,55,7,0.6632707065361206,0.5454545454545454,0.5588235294117647,0.0130261769184642,0.0328947368421052,0.0131578947368421,0.0072518129532383,0.0497624406101525,0.0044167893552598,0.0,0.2558139534883721,0.3333333333333332,181,27,22,21,1,7008,10,95,124,1500000,65909.09090909091,10000000.0,2000000.0,50000.0,6000000.0,6,6725000,-0.4,-0.5714285714285714
448470,André,Franco,2024,720,Portugal,Lisboa,Portugal,12-04-98,Attacking Midfield,Midfield,Left,177.0,30-06-27,Promoesport,https://img.a.transfermarkt.technology/portrait/header/448470-1669112459.png?lm=1,PO1,Futebol Clube do Porto,3000000.0,4000000.0,26,133,145,14,14,16,14,15,12,8,13,4,4,14,13,5,17,11,13,9,14,11,15,14,11,12,8,14,9,14,11,12,14,16,7,13,12,13,7,12,8,12,6,4,2,4,3,1,2,1,3,2,1,4,3,18,10,6,11,12,13,10,13,1,1,1,1,1,1,1,12,18,12,18,20,17,1,69,20,10,5629499,6650,6650,5150,Mediterranean_Hispanic,131,0,0,13750.0,Unknown,83111737,4070000.0,1.0,76,843,79,3,0,3,100,0,0.6301931727970362,0.5454545454545454,0.6029411764705883,0.0132685468522325,0.0,0.0,0.0147536884221055,0.0197549387346836,0.022583960665574,0.0,0.3255813953488373,0.3333333333333332,143,21,16,18,1,4026,1,6,29,2500000,171428.57142857142,4000000.0,500000.0,,,1,0,-0.16666666666666666,-0.375
448628,Javi,Galán,2024,13,Spain,Badajoz,Spain,19-11-94,Left-Back,Defender,Left,172.0,30-06-26,CAA Base Ltd,https://img.a.transfermarkt.technology/portrait/header/448628-1706112804.jpg?lm=1,ES1,Club AtlÃ©tico de Madrid S.A.D.,7000000.0,12000000.0,30,149,155,13,16,16,11,11,11,6,7,13,11,14,9,15,13,14,15,14,12,13,12,14,16,13,10,14,14,15,17,15,15,14,9,15,14,16,12,16,6,16,3,15,1,1,3,2,3,3,1,2,3,1,3,12,13,3,15,15,18,15,11,1,20,1,1,20,1,1,13,1,1,8,1,1,1,0,20,7,13198635,6997,6997,4747,Mediterranean_Hispanic,143,0,0,28766.0,Unknown,67243881,3333333.333,3.0,89,123,89,1,0,3,52,8,0.6761047896268855,0.5023529411764706,0.6911764705882353,0.0277682557186268,0.0,0.0,0.0347586896724181,0.0597649412353088,0.018491254384844,0.2857142857142857,0.2093023255813952,0.5,318,8,27,71,0,3218,2,3,13,4000000,158000.0,12000000.0,5000000.0,,,6,7600000,-0.42857142857142855,-0.42857142857142855
448854,Emmanuel,Dennis,2024,703,Nigeria,Abuja,Nigeria,15-11-97,Centre-Forward,Attack,Right,175.0,30-06-26,Unknown,https://img.a.transfermarkt.technology/portrait/header/448854-1695644743.png?lm=1,GB1,Nottingham Forest Football Club,4200000.0,17000000.0,27,136,145,9,12,14,13,13,9,9,10,5,6,12,14,8,14,14,12,16,14,10,7,9,12,14,8,10,5,10,10,18,15,12,7,13,18,13,13,8,12,12,5,10,1,3,3,2,3,3,4,4,1,1,3,12,16,8,8,11,7,8,9,1,1,1,1,1,14,1,1,1,15,17,14,20,14,66,6,20,21927753,6800,6800,5250,African_Caribbean,130,7,1,46397.0,Unknown,71099020,6733333.333,3.0,69,18,70,0,1,1,140,3,0.6500396930404869,0.5561497326203209,0.5955882352941175,0.0447930537356352,0.0460526315789473,0.0131578947368421,0.0207551887971993,0.0847711927981995,0.0373806679796661,0.2857142857142857,0.2790697674418605,0.375,241,52,24,45,1,6793,3,7,98,4000000,148000.0,17000000.0,6000000.0,,5000000.0,7,15500000,-0.047619047619047616,-0.2727272727272727
448981,Maksim,Glushenkov,2024,964,Russia,Smolensk,Russia,28-07-99,Second Striker,Attack,Left,179.0,30-06-28,Pavel Andreev,https://img.a.transfermarkt.technology/portrait/header/448981-1721723711.png?lm=1,RU1,AO FK Zenit Sankt-Peterburg,16000000.0,16000000.0,25,118,135,10,9,11,13,14,12,10,13,8,7,11,13,7,13,7,10,10,12,11,13,14,14,16,1,12,7,9,12,14,13,13,8,9,13,12,9,12,15,16,13,11,2,1,3,2,1,1,1,1,2,1,1,12,14,2,11,10,10,11,10,1,1,1,1,1,1,1,1,6,10,10,17,16,20,70,20,9,4396869,5734,5734,3491,Northern_European,109,0,0,2497.0,Unknown,58132627,2750000.0,4.0,78,1386,81,0,0,7,7,12,0.508997089177031,0.3680213903743315,0.4411764705882353,0.0024024557578309,0.0,0.0,0.0797699424856214,0.0797699424856214,0.0152504236228784,0.4285714285714285,0.3720930232558141,0.2916666666666665,227,76,50,25,2,5741,5,40,124,15000000,650000.0,16000000.0,1000000.0,250000.0,800000.0,7,6200000,0.36363636363636365,1.1428571428571428
449020,Warren,O'Hora,2024,903,Ireland,"Cabra, Dublin",Ireland,19-04-99,Centre-Back,Defender,Right,188.0,31-05-27,Unknown,https://img.a.transfermarkt.technology/portrait/header/default.jpg?lm=1,SC1,Hibernian Football Club,350000.0,600000.0,25,109,135,5,6,9,8,12,6,12,6,7,12,13,6,13,12,10,11,13,11,10,9,10,13,7,12,10,13,14,11,11,11,11,14,12,13,15,12,12,7,10,3,4,3,2,1,1,1,1,2,3,3,2,2,10,11,5,8,13,14,12,10,1,1,20,1,1,1,1,1,1,1,1,1,1,1,84,11,20,1757426,5442,5492,2750,Northern_European,108,0,0,2320.0,Unknown,52081987,222000.0,1.0,49,294,52,1,1,7,114,2,0.4769780365175973,0.2887700534759358,0.4338235294117646,0.0022315415017472,0.0,0.0,0.0015003750937734,0.0027506876719179,0.0012055890441401,0.0,0.581395348837209,0.2916666666666665,253,16,2,20,0,3941,0,0,0,350000,-41666.666666666664,600000.0,200000.0,,,1,0,0.0,-0.125
449151,Junior,Messias,2024,252,Brazil,Belo Horizonte,Brazil,13-05-91,Right Winger,Attack,Left,174.0,30-06-25,GG11 ,https://img.a.transfermarkt.technology/portrait/header/449151-1663575000.jpg?lm=1,IT1,Genoa Cricket and Football Club,2500000.0,6500000.0,33,142,145,13,13,15,12,14,11,13,11,6,7,13,11,8,14,12,13,12,12,13,13,13,18,15,10,13,6,14,12,15,14,13,11,15,14,14,12,12,8,11,9,14,2,2,3,3,3,1,3,2,2,2,1,18,18,6,15,12,19,15,14,1,1,1,1,1,1,1,10,1,13,12,17,20,18,70,20,11,8590006,7100,5598,5027,Mixed_Race,139,0,0,35577.0,Unknown,43315178,2055000.0,4.0,10,168,11,0,0,4,104,10,0.4910029108229691,0.5322994652406416,0.6617647058823528,0.0343450749174155,0.0,0.0,0.0122530632658164,0.032258064516129,0.0113892052557015,0.4285714285714285,0.2558139534883721,0.625,260,55,22,26,0,2102,17,68,79,2000000,98750.0,6500000.0,1500000.0,,,4,3200000,-0.2,-0.3333333333333333
449496,Álvaro,Aguado,2024,714,Spain,JaÃ©n,Spain,01-05-96,Central Midfield,Midfield,Right,175.0,30-06-25,YOU FIRST,https://img.a.transfermarkt.technology/portrait/header/449496-1659984006.jpeg?lm=1,ES1,Reial Club Deportiu Espanyol de Barcelona S.A.D.,2800000.0,3000000.0,28,130,135,11,11,12,9,13,8,7,10,5,10,13,8,11,13,12,12,13,13,13,14,15,13,14,12,12,13,14,14,12,14,14,8,14,13,13,11,13,14,14,5,12,2,2,3,1,1,3,1,1,1,1,4,7,13,5,10,12,14,13,13,1,1,1,1,1,1,12,1,20,1,1,16,1,1,66,12,20,2556749,6500,6500,4001,Mediterranean_Hispanic,128,0,0,4861.0,Unknown,67245476,2000000.0,1.0,89,686,89,3,1,3,170,1,0.6103466525535857,0.4225668449197861,0.5808823529411764,0.0046851749746766,0.0,0.0,0.0137534383595899,0.0147536884221055,0.0110836412122558,0.0,0.2790697674418605,0.4166666666666665,232,14,12,24,1,3495,1,0,12,2000000,84782.60869565218,3000000.0,800000.0,,100000.0,6,850000,-0.2857142857142857,-0.3333333333333333
449796,Alejandro,Catena,2024,331,Spain,MÃ³stoles,Spain,28-10-94,Centre-Back,Defender,Right,194.0,30-06-28,Universal Sport,https://img.a.transfermarkt.technology/portrait/header/449796-1635498719.jpg?lm=1,ES1,Club AtlÃ©tico Osasuna,4000000.0,8000000.0,30,137,142,7,6,11,8,11,7,15,8,10,15,12,8,14,12,12,13,14,14,14,10,14,11,8,14,8,14,14,15,12,12,9,15,14,12,14,15,14,9,10,6,7,4,3,1,3,2,1,2,3,3,1,1,11,12,1,14,9,14,10,10,1,1,20,1,1,1,1,1,1,1,1,1,1,1,78,8,20,6068917,6850,6850,4850,Mediterranean_Hispanic,137,0,0,16532.0,Unknown,67210735,9111392.0,2.0,89,1000,89,1,1,3,51,2,0.6566551997883038,0.5133689839572192,0.6470588235294117,0.0159548940862701,0.0,0.0,0.0197549387346836,0.0397599399849962,0.0505924720131114,0.1428571428571428,0.7209302325581395,0.5,308,15,10,87,4,2105,0,0,0,4000000,158000.0,8000000.0,2000000.0,,,4,2100000,0.0,-0.2
450050,Jean-Ricner,Bellegarde,2024,543,France,Colombes,France,27-06-98,Central Midfield,Midfield,Right,172.0,30-06-28,Unknown,https://img.a.transfermarkt.technology/portrait/header/450050-1618501758.jpg?lm=1,GB1,Wolverhampton Wanderers Football Club,18000000.0,18000000.0,26,130,141,9,12,15,9,14,10,8,12,6,8,14,12,9,15,10,13,11,12,11,11,12,14,12,7,12,8,13,14,15,14,12,7,13,15,14,13,11,5,6,11,12,1,3,3,2,3,1,3,2,2,2,2,18,13,5,12,11,12,11,20,1,1,1,1,1,1,10,1,20,1,1,17,16,1,66,8,20,4097280,6488,6488,3988,African_Caribbean,122,0,0,15042.0,Unknown,48036558,8500000.0,2.0,34,375,36,3,1,1,222,1,0.6087589309341096,0.4211764705882352,0.536764705882353,0.0145161243599164,0.0,0.0,0.0897724431107777,0.0897724431107777,0.047195755437651,0.1428571428571428,0.2093023255813952,0.3333333333333332,306,19,25,30,1,6321,4,16,59,18000000,800000.0,18000000.0,500000.0,400000.0,1000000.0,2,6000000,0.2,0.2
450173,Gaius,Makouta,2024,11282,France,Beaumont,Congo,25-07-97,Central Midfield,Midfield,Right,180.0,30-06-27,CAA Stellar,https://img.a.transfermarkt.technology/portrait/header/450173-1724671526.jpg?lm=1,TR1,Alanyaspor,2600000.0,3000000.0,27,128,134,11,12,13,11,12,13,12,14,8,12,11,11,13,12,15,13,13,12,11,11,10,15,8,7,14,13,12,14,13,13,16,13,17,14,16,17,14,9,11,6,13,1,2,2,2,2,2,1,4,3,1,3,16,14,14,10,12,11,10,9,1,1,1,1,1,1,20,1,20,1,1,14,1,1,74,8,20,2257198,6400,6400,4900,African_Caribbean,128,14,1,3499.0,Unknown,52082234,200000.0,2.0,34,159,22,3,1,1,15,1,0.5971156390579518,0.5187165775401069,0.5808823529411764,0.0033700042583721,0.0921052631578947,0.0131578947368421,0.0127531882970742,0.0147536884221055,0.0010833634267618,0.1428571428571428,0.3953488372093026,0.375,247,24,26,55,0,3208,0,0,0,2300000,112500.0,3000000.0,400000.0,,375000.0,5,925000,-0.23333333333333334,-0.23333333333333334
450211,José,Cifuentes,2024,605,Ecuador,Esmeraldas,Ecuador,12-03-99,Central Midfield,Midfield,Right,178.0,30-06-25,SPORTSMANAGEMENTS,https://img.a.transfermarkt.technology/portrait/header/450211-1678025921.jpg?lm=1,GR1,Aris Thessalonikis,6000000.0,12000000.0,25,127,143,8,9,13,13,14,13,8,12,8,9,15,10,12,14,8,13,8,11,11,14,11,13,5,9,12,10,12,12,14,15,16,7,16,13,16,9,13,7,10,2,10,1,2,3,1,2,3,1,1,3,3,3,10,11,2,8,8,10,11,12,1,1,1,1,1,1,17,10,20,10,5,14,5,2,72,10,20,6482637,6508,5757,4554,African_Caribbean,128,10,0,7983.0,Unknown,86060139,2050000.0,2.0,30,471,31,3,1,1,20,1,0.5120402222810267,0.481711229946524,0.5808823529411764,0.0076998320791574,0.0657894736842105,0.0,0.0297574393598399,0.0597649412353088,0.0113614267062973,0.1428571428571428,0.3488372093023257,0.2916666666666665,200,17,24,32,2,3368,3,8,15,6000000,338235.29411764705,12000000.0,3500000.0,,2000000.0,5,5750000,-0.14285714285714285,-0.14285714285714285
450218,Ortwin,De Wolf,2024,354,Unknown,Unknown,Belgium,23-04-97,Goalkeeper,Goalkeeper,Left,190.0,30-06-27,Stirr Associates,https://img.a.transfermarkt.technology/portrait/header/450218-1709893883.jpg?lm=1,BE1,Yellow-Red Koninklijke Voetbalclub Mechelen,750000.0,900000.0,27,121,125,3,3,3,2,7,6,1,1,3,3,11,1,2,11,13,11,12,11,16,12,12,12,1,11,3,13,11,11,11,13,14,15,11,12,12,14,12,9,12,8,11,14,10,11,8,12,15,10,12,11,11,13,8,14,6,10,13,12,11,20,20,1,1,1,1,1,1,1,1,1,1,1,1,1,83,20,7,1063123,5750,5750,500,Northern_European,120,0,0,3999.0,Unknown,18100347,750000.0,1.0,105,1549,8,2,0,7,223,5,0.5111140513363324,0.0481283422459893,0.5220588235294117,0.0038528128913767,0.0,0.0,0.0035008752188047,0.0042510627656914,0.0041390038612183,0.0,0.6279069767441858,0.375,0,0,0,0,0,0,1,11,60,1200000,57500.0,1200000.0,250000.0,,150000.0,4,600000,3.0,3.0
450234,Marco,John,2024,533,Germany,Bad Friedrichshall,Germany,02-04-02,Left-Back,Defender,Left,184.0,30-06-25,Unknown,https://img.a.transfermarkt.technology/portrait/header/450234-1657201014.jpg?lm=1,L1,TSG 1899 Hoffenheim FuÃŸball-Spielbetriebs GmbH,1500000.0,4000000.0,22,121,-75,9,12,13,9,12,8,8,9,11,10,13,9,11,13,11,11,13,13,11,13,11,15,13,11,12,11,13,16,13,12,12,10,14,12,13,8,13,6,8,14,16,2,3,1,2,1,2,3,1,1,1,4,16,9,5,10,12,11,13,19,1,16,11,1,20,1,17,18,16,12,12,14,12,1,73,20,8,45200000,6011,6011,3514,Northern_European,111,0,0,8663.0,SpVgg Greuther FÃ¼rth,91187801,9111392.0,2.0,38,119,40,1,0,7,199,8,0.5456469965599365,0.3704812834224598,0.4558823529411764,0.0083564518200437,0.0,0.0,0.0072518129532383,0.0197549387346836,0.0505924720131114,0.1428571428571428,0.4883720930232553,0.1666666666666666,135,13,17,9,1,3460,17,74,203,1000000,81250.0,4000000.0,1500000.0,4000000.0,2000000.0,2,500000,-0.3333333333333333,-0.5
450936,Tanguy,Ndombélé,2024,417,France,Longjumeau,France,28-12-96,Central Midfield,Midfield,Right,181.0,30-06-26,CANTERASPORT,https://img.a.transfermarkt.technology/portrait/header/450936-1561540648.jpg?lm=1,FR1,Olympique Gymnaste Club Nice CÃ´te d'Azur,8000000.0,65000000.0,27,143,155,6,10,16,10,15,8,10,12,4,12,16,7,14,16,12,13,14,15,10,14,13,12,15,9,12,13,14,11,15,14,16,10,12,13,12,16,11,10,15,6,12,3,2,1,1,2,3,3,2,1,1,2,10,16,6,12,12,14,10,10,1,1,1,1,1,1,20,1,20,1,1,15,1,1,76,10,20,32727068,7150,7350,6350,African_Caribbean,140,7,0,139190.0,Parthenope,85128159,35000000.0,2.0,34,861,36,3,1,1,142,1,0.7228102672664726,0.6737967914438502,0.6691176470588234,0.1343955767004278,0.0460526315789473,0.0,0.0397599399849962,0.3248312078019504,0.1944220672796466,0.1428571428571428,0.418604651162791,0.375,328,21,38,30,0,7778,20,43,34,10000000,342857.14285714284,65000000.0,13000000.0,,5000000.0,6,12000000,0.25,-0.3333333333333333
451154,Federico,Brancolini,2024,749,Italy,Modena,Italy,14-07-01,Goalkeeper,Goalkeeper,Right,192.0,30-06-27,Daniele Ferri,https://img.a.transfermarkt.technology/portrait/header/451154-1655122974.jpg?lm=1,IT1,Empoli Football Club S.r.l.,200000.0,500000.0,23,95,136,4,3,1,1,1,9,1,2,3,2,10,1,2,5,7,9,8,9,14,8,14,9,3,4,1,12,9,8,12,8,5,11,18,14,6,7,13,11,6,6,13,8,11,9,5,14,10,9,14,12,13,12,9,12,8,14,11,10,11,17,20,1,1,1,1,1,1,1,1,1,1,1,1,1,81,10,20,1092799,4750,4650,1500,Mediterranean_Hispanic,89,0,0,1481.0,Unknown,43357008,500000.0,1.0,52,961,54,2,1,3,64,5,0.3655729028843609,0.1550802139037433,0.2941176470588235,0.0014213886155655,0.0,0.0,0.0007501875468867,0.0022505626406601,0.0027500763910108,0.0,0.6744186046511627,0.2083333333333332,0,0,0,0,0,0,1,4,31,200000,10416.666666666666,500000.0,300000.0,300000.0,200000.0,2,0,0.0,0.0
451276,Dominik,Szoboszlai,2024,31,Hungary,SzÃ©kesfehÃ©rvÃ¡r,Hungary,25-10-00,Central Midfield,Midfield,Right,187.0,30-06-28,EM Sports Consulting,https://img.a.transfermarkt.technology/portrait/header/451276-1700209677.jpg?lm=1,GB1,Liverpool Football Club,75000000.0,75000000.0,24,143,-9,16,13,13,12,14,16,9,15,5,8,14,16,9,16,8,13,12,12,12,14,13,15,16,9,14,9,14,14,15,12,12,13,13,15,13,11,14,5,12,5,12,1,3,2,1,1,2,3,1,3,3,3,12,14,8,12,13,13,11,12,1,1,1,1,1,1,1,16,20,12,16,18,11,1,74,13,20,102384003,7000,7000,6000,Northern_European,138,24,6,37806.0,Unknown,16202373,35500000.0,3.0,45,1446,47,3,1,7,129,1,0.6765017200317545,0.6363636363636364,0.6544117647058822,0.0364974358033501,0.1578947368421052,0.0789473684210526,0.3748437109277319,0.3748437109277319,0.1971999222200616,0.2857142857142857,0.5581395348837206,0.25,304,76,82,24,1,8201,6,59,192,75000000,3561904.761904762,75000000.0,1500000.0,12000000.0,25000000.0,3,20500000,0.0,0.0
451677,Christos,Tzolis,2024,2282,Greece,Thessaloniki,Greece,30-01-02,Left Winger,Attack,Right,179.0,30-06-28,Wasserman,https://img.a.transfermarkt.technology/portrait/header/451677-1716534999.jpg?lm=1,BE1,Club Brugge Koninklijke Voetbalvereniging,12000000.0,12000000.0,22,122,-8,8,12,14,13,15,8,6,11,5,6,11,9,6,14,12,13,11,10,9,12,10,13,14,10,13,13,11,13,13,15,8,8,11,13,12,8,15,6,14,12,10,1,1,1,1,2,2,1,2,4,2,1,17,15,2,12,14,15,10,14,1,1,1,1,1,1,1,14,1,14,20,10,16,19,61,12,20,20934188,6100,6100,4750,Mediterranean_Hispanic,116,13,1,23198.0,FC Twente,36152916,7000000.0,3.0,40,1486,42,0,1,3,53,7,0.5574225985710506,0.5026737967914437,0.4926470588235294,0.0223916987814875,0.0855263157894736,0.0131578947368421,0.0597649412353088,0.0597649412353088,0.038862190616406,0.2857142857142857,0.3720930232558141,0.1666666666666666,208,80,31,21,0,5597,3,15,91,18000000,1257142.857142857,18000000.0,2000000.0,4000000.0,7000000.0,5,7000000,0.8,2.6
451801,Abdul,Mumin,2024,367,Ghana,Accra,Ghana,06-06-98,Centre-Back,Defender,Right,188.0,30-06-26,HC,https://img.a.transfermarkt.technology/portrait/header/451801-1631003939.jpg?lm=1,ES1,Rayo Vallecano de Madrid S.A.D.,2500000.0,3000000.0,26,132,140,5,5,11,6,12,5,12,6,10,15,13,6,11,12,13,13,16,13,15,11,12,8,15,4,9,14,13,12,13,14,13,15,15,16,13,14,13,15,10,7,1,3,2,1,1,1,2,2,1,2,2,2,19,14,5,11,14,12,10,9,1,1,20,8,1,1,1,1,1,1,1,1,1,1,80,9,20,4630645,6600,6600,5100,African_Caribbean,131,0,0,11664.0,Unknown,27128916,1500000.0,1.0,39,20,41,1,1,1,163,2,0.6235776660492194,0.5401069518716577,0.6029411764705883,0.0112542692353373,0.0,0.0,0.0122530632658164,0.0147536884221055,0.0083057862718408,0.0,0.581395348837209,0.3333333333333332,209,5,1,38,4,4938,2,7,35,5000000,247500.0,5000000.0,1500000.0,100000.0,200000.0,4,2600000,1.0,1.5
451906,David,Nemeth,2024,35,Austria,Eisenstadt,Austria,18-03-01,Centre-Back,Defender,Right,191.0,30-06-26,YOU FIRST,https://img.a.transfermarkt.technology/portrait/header/451906-1723630981.jpeg?lm=1,L1,FuÃŸball-Club St. Pauli von 1910,800000.0,4000000.0,23,115,-75,4,6,10,6,12,5,12,6,6,13,12,6,13,12,8,12,13,12,12,11,11,14,10,6,7,13,12,12,11,10,13,16,14,12,12,14,13,3,12,5,8,1,3,3,3,1,3,1,3,3,2,1,16,15,5,8,11,12,15,17,1,1,20,1,1,1,14,1,1,1,1,1,1,1,89,13,20,17100000,5755,5502,3758,Northern_European,114,0,0,9588.0,Unknown,16202269,1300000.0,1.0,6,451,7,1,1,7,101,2,0.4783011378671606,0.3965775401069518,0.4779411764705882,0.0092496477911022,0.0,0.0,0.0037509377344336,0.0197549387346836,0.0071946442956748,0.0,0.6511627906976742,0.2083333333333332,132,7,2,17,0,3952,5,41,236,1000000,41666.666666666664,4000000.0,1000000.0,250000.0,4000000.0,4,850000,0.25,0.0
452084,Ahmed,Kutucu,2024,7160,Germany,Gelsenkirchen,TÃ¼rkiye,01-03-00,Left Winger,Attack,Right,181.0,30-06-25,EMG Mundial,https://img.a.transfermarkt.technology/portrait/header/452084-1657047623.jpg?lm=1,TR1,EyÃ¼p Spor KulÃ¼bÃ¼,2400000.0,6000000.0,24,115,135,13,11,12,13,12,12,10,13,4,6,12,10,8,14,16,10,15,12,10,11,9,14,13,10,13,7,13,15,12,13,13,11,15,12,14,10,14,7,15,9,11,1,1,1,1,1,3,3,2,3,4,1,10,14,9,13,15,12,13,10,1,1,1,1,1,1,1,1,10,12,1,15,12,20,76,14,20,3188336,5800,5800,3800,North_African__Middle_Eastern,115,2,0,7499.0,SV Sandhausen,91177154,500000.0,1.0,38,526,100,0,1,6,66,7,0.5177295580841492,0.4010695187165775,0.4852941176470588,0.0072324733224089,0.0131578947368421,0.0,0.0117529382345586,0.0297574393598399,0.0027500763910108,0.0,0.418604651162791,0.25,230,76,38,36,0,4759,13,44,71,3500000,155000.0,6000000.0,1900000.0,400000.0,3500000.0,5,6650000,1.3333333333333333,1.3333333333333333
452477,Junior,Adamu,2024,60,Nigeria,Kano,Austria,06-06-01,Centre-Forward,Attack,Right,183.0,Unknown,Sports360 GmbH,https://img.a.transfermarkt.technology/portrait/header/452477-1691998414.jpg?lm=1,L1,Sport-Club Freiburg,6000000.0,8000000.0,23,122,147,6,8,11,13,11,7,9,9,5,6,9,9,7,12,7,11,13,11,11,11,11,16,11,5,15,6,12,13,16,14,11,14,14,15,13,11,11,6,6,12,7,3,2,1,1,1,3,3,3,1,1,3,16,16,3,15,14,13,14,8,1,1,1,1,1,1,1,1,1,1,1,1,12,20,77,13,20,6610000,6100,6100,3700,African_Caribbean,119,1,0,4499.0,Unknown,16202374,9111392.0,2.0,69,707,7,0,1,1,189,3,0.5574225985710506,0.3903743315508021,0.5147058823529411,0.0043356215243813,0.006578947368421,0.0,0.0297574393598399,0.0397599399849962,0.0505924720131114,0.1428571428571428,0.4651162790697669,0.2083333333333332,236,87,27,16,2,5126,9,32,65,6000000,310526.3157894737,8000000.0,3000000.0,900000.0,6000000.0,4,1500000,0.5,-0.25
452607,Alexander,Bah,2024,294,Denmark,Ã…rslev,Denmark,09-12-97,Right-Back,Defender,Right,183.0,30-06-27,Elite Consulting,https://img.a.transfermarkt.technology/portrait/header/452607-1701334276.jpg?lm=1,PO1,Sport Lisboa e Benfica,13000000.0,14000000.0,27,138,150,10,12,13,8,12,7,11,7,10,10,11,11,12,13,15,13,15,9,11,13,11,14,14,4,13,9,11,15,16,14,11,11,13,15,14,12,12,8,10,7,15,1,2,2,2,1,2,3,3,2,3,2,15,11,4,9,12,11,12,14,1,1,1,18,1,20,1,12,1,17,12,1,16,12,79,12,20,9715499,6900,6250,5400,African_Caribbean,126,3,1,20250.0,Unknown,27129532,3426666.667,3.0,28,1720,30,1,1,1,188,11,0.5772691188145012,0.5721925133689839,0.5661764705882353,0.0195450590812924,0.0197368421052631,0.0131578947368421,0.0647661915478869,0.0697674418604651,0.0190097873107586,0.2857142857142857,0.4651162790697669,0.375,314,29,50,50,1,7354,17,63,95,14000000,697500.0,14000000.0,1000000.0,50000.0,350000.0,3,1600000,0.07692307692307693,0.0
453016,Anthony,Caci,2024,39,France,Forbach,France,01-07-97,Left-Back,Defender,Right,184.0,30-06-26,Classico,https://img.a.transfermarkt.technology/portrait/header/453016-1657706767.jpg?lm=1,L1,1. FuÃŸball- und Sportverein Mainz 05,7000000.0,8500000.0,27,132,140,5,15,11,8,12,6,12,7,8,13,13,6,14,12,12,12,13,12,12,12,12,13,12,7,13,13,15,12,13,12,12,12,13,13,14,12,13,6,13,7,18,3,1,1,2,3,3,1,2,3,3,3,9,12,4,14,12,12,15,16,1,20,18,15,18,15,10,10,10,10,1,1,1,1,76,15,20,5381376,6600,6250,5100,Northern_European,126,0,0,28766.0,Unknown,49034179,9111392.0,2.0,34,500,36,1,1,7,1,8,0.5772691188145012,0.5401069518716577,0.5661764705882353,0.0277682557186268,0.0,0.0,0.0347586896724181,0.0422605651412853,0.0505924720131114,0.1428571428571428,0.4883720930232553,0.375,210,7,21,27,1,2196,3,14,64,7000000,342500.0,8500000.0,1500000.0,,,1,0,0.0,0.0
453376,Joseph,Okumu,2024,1421,Kenya,Kisumu,Kenya,26-05-97,Centre-Back,Defender,Right,190.0,30-06-28,Unknown,https://img.a.transfermarkt.technology/portrait/header/453376-1723832031.png?lm=1,FR1,Stade de Reims,9000000.0,9000000.0,27,127,131,6,13,8,6,12,8,13,8,8,12,13,6,13,12,15,13,14,13,13,14,13,14,8,10,8,13,11,11,13,10,14,17,14,13,13,14,13,14,11,5,4,1,1,1,2,2,1,2,2,1,4,2,14,14,5,10,14,12,12,11,1,1,20,10,1,1,1,1,1,1,1,1,1,1,75,9,20,6825059,6344,6342,3769,African_Caribbean,126,17,0,1863.0,Unknown,20046877,4560000.0,3.0,56,735,57,1,1,1,197,2,0.5894416512304843,0.3977540106951871,0.5661764705882353,0.001790254411181,0.1118421052631578,0.0,0.0447611902975743,0.0447611902975743,0.0253062585071807,0.2857142857142857,0.6279069767441858,0.375,190,6,3,27,2,7147,11,36,54,9000000,523529.4117647059,9000000.0,2000000.0,,150000.0,4,6900000,0.0,0.0
453704,Álvaro,Fernández,2024,368,Spain,Arnedo,Spain,13-04-98,Goalkeeper,Goalkeeper,Right,185.0,30-06-25,Footfeel ISM  ,https://img.a.transfermarkt.technology/portrait/header/453704-1694431085.jpg?lm=1,ES1,Sevilla FÃºtbol Club S.A.D.,2500000.0,4000000.0,26,133,148,5,1,1,1,11,7,3,1,2,2,10,3,2,9,12,13,13,12,13,11,14,15,7,8,8,12,12,13,11,13,11,13,15,11,12,12,11,3,12,4,12,13,13,13,8,14,12,14,15,14,7,13,14,15,7,13,14,15,14,15,20,1,1,1,1,1,1,1,1,1,1,1,1,1,75,11,20,4438630,6650,6650,5400,Mediterranean_Hispanic,131,1,0,14802.0,Espanyol,67246951,9111392.0,2.0,89,89,89,2,1,3,181,5,0.6301931727970362,0.5721925133689839,0.6029411764705883,0.0142843762160742,0.006578947368421,0.0,0.0122530632658164,0.0197549387346836,0.0505924720131114,0.1428571428571428,0.5116279069767438,0.3333333333333332,0,0,0,0,0,0,0,0,0,2500000,111363.63636363637,4000000.0,1000000.0,250000.0,400000.0,6,2200000,0.0,0.25
453737,Marcel,Lotka,2024,16,Germany,Duisburg,Germany,25-05-01,Goalkeeper,Goalkeeper,Right,190.0,30-06-25,SEG,https://img.a.transfermarkt.technology/portrait/header/453737-1657285168.jpg?lm=1,L1,Borussia Dortmund,1300000.0,1500000.0,23,117,-8,4,2,2,1,3,6,1,2,3,2,8,2,2,8,15,8,16,10,8,10,10,16,2,13,1,8,11,12,13,12,11,14,13,12,9,9,13,14,12,5,11,15,14,11,13,15,15,12,15,16,12,14,8,12,5,12,11,13,12,13,20,1,1,1,1,1,1,1,1,1,1,1,1,1,85,7,20,34199998,4991,4438,3750,Northern_European,115,0,0,1749.0,Unknown,96116939,9111392.0,2.0,38,436,40,2,1,7,41,5,0.3375231542736173,0.3957219251336898,0.4852941176470588,0.001680174042856,0.0,0.0,0.0062515628907226,0.0072518129532383,0.0505924720131114,0.1428571428571428,0.6279069767441858,0.2083333333333332,0,0,0,0,0,0,2,4,15,1300000,106818.18181818182,1500000.0,200000.0,,400000.0,2,200000,0.0,0.0
453742,Ben,Voll,2024,35,Germany,Bergisch Gladbach,Germany,09-12-00,Goalkeeper,Goalkeeper,Right,195.0,Unknown,Soccer and more,https://img.a.transfermarkt.technology/portrait/header/453742-1723630455.jpeg?lm=1,L1,FuÃŸball-Club St. Pauli von 1910,500000.0,500000.0,24,101,137,1,2,1,3,3,6,1,3,2,1,12,3,2,1,5,10,15,8,10,7,13,17,1,1,3,11,8,6,12,16,9,15,12,10,1,8,10,5,10,9,13,13,7,13,5,14,11,13,14,5,10,8,18,12,5,11,10,11,9,17,20,1,1,1,1,1,1,1,1,1,1,1,1,1,0,12,20,258000,5050,5050,3350,Northern_European,106,0,0,849.0,Unknown,2000049977,100000.0,1.0,38,177,40,2,1,7,101,5,0.418496956866896,0.3529411764705882,0.4191176470588235,0.0008111185034477,0.0,0.0,0.0022505626406601,0.0022505626406601,0.0005277924386788,0.0,0.7441860465116279,0.25,0,0,0,0,0,0,6,27,110,500000,28333.333333333332,500000.0,25000.0,75000.0,150000.0,2,100000,0.0,0.25
453807,Vincent,Müller,2024,1053,Germany,KÃ¶ln,Germany,23-08-00,Goalkeeper,Goalkeeper,Right,190.0,30-06-28,YOU FIRST,https://img.a.transfermarkt.technology/portrait/header/453807-1674415037.JPG?lm=1,DK1,Aalborg Boldspilklub,400000.0,500000.0,24,107,137,4,2,1,3,2,8,1,2,2,2,12,2,3,7,5,13,15,4,12,6,14,13,1,8,2,12,9,7,12,14,9,14,15,13,2,6,11,11,18,13,11,14,12,7,7,14,13,12,14,8,10,9,7,13,7,13,13,13,13,13,20,1,1,1,1,1,1,1,1,1,1,1,1,1,0,4,20,1325000,5334,5334,3541,Northern_European,110,0,0,2500.0,Unknown,92101511,500000.0,1.0,38,777,40,2,1,7,10,5,0.4560730351944959,0.3733689839572192,0.4485294117647059,0.0024053526096289,0.0,0.0,0.0017504376094023,0.0022505626406601,0.0027500763910108,0.0,0.6279069767441858,0.25,0,0,0,0,0,0,9,28,52,700000,37500.0,700000.0,50000.0,50000.0,300000.0,4,525000,0.75,0.75
454121,Unknown,Galeno,2024,720,Brazil,Barra do Corda,Brazil,22-10-97,Left Winger,Attack,Right,179.0,30-06-28,Bertolucci Sports,https://img.a.transfermarkt.technology/portrait/header/454121-1702502076.jpg?lm=1,PO1,Futebol Clube do Porto,27000000.0,27000000.0,27,139,146,11,11,16,12,12,13,6,13,13,6,10,14,8,13,12,10,8,8,8,12,8,13,16,4,13,8,7,13,18,16,13,11,16,18,13,10,8,5,13,6,4,1,4,3,3,3,2,2,3,4,1,3,16,14,6,12,13,15,11,13,1,1,1,5,12,10,1,15,1,14,20,1,20,12,72,9,20,11218499,6950,5760,6001,Mixed_Race,131,0,0,17850.0,Unknown,83152910,4970000.0,3.0,10,148,11,0,1,4,100,7,0.5124371526858957,0.636470588235294,0.6029411764705883,0.0172275776428703,0.0,0.0,0.134783695923981,0.134783695923981,0.027584099558321,0.2857142857142857,0.3720930232558141,0.375,368,93,75,48,0,9712,9,20,28,27000000,1170652.1739130435,27000000.0,1500000.0,75000.0,2000000.0,6,6925000,0.08,0.22727272727272727
454567,Orkun,Kökçü,2024,294,Netherlands,Haarlem,TÃ¼rkiye,29-12-00,Central Midfield,Midfield,Right,175.0,30-06-28,Unknown,https://img.a.transfermarkt.technology/portrait/header/454567-1701333892.jpg?lm=1,PO1,Sport Lisboa e Benfica,28000000.0,35000000.0,23,135,155,13,12,13,11,14,15,7,13,12,6,14,14,6,14,10,12,14,14,14,13,13,14,13,15,13,7,13,14,12,14,13,7,13,13,15,11,13,10,12,12,16,1,2,1,2,3,2,3,3,1,3,1,18,16,6,11,12,13,13,11,1,1,1,1,1,1,12,12,20,12,10,20,10,7,0,13,20,41339997,6848,6248,5248,North_African__Middle_Eastern,130,16,1,9110.0,Unknown,37061602,12520000.0,2.0,67,585,100,3,1,6,188,1,0.5770044985445886,0.5559358288770053,0.5955882352941175,0.0087880827379498,0.1052631578947368,0.0131578947368421,0.1397849462365591,0.1747936984246061,0.0695297091585877,0.1428571428571428,0.2790697674418605,0.2083333333333332,324,69,54,53,1,10914,12,28,30,28000000,1285714.2857142857,35000000.0,5000000.0,7000000.0,12000000.0,1,5000000,0.037037037037037035,-0.06666666666666667
454863,András,Schäfer,2024,89,Hungary,Szombathely,Hungary,13-04-99,Central Midfield,Midfield,Right,178.0,Unknown,EM Sports Consulting,https://img.a.transfermarkt.technology/portrait/header/454863-1726351222.jpg?lm=1,L1,1. FC Union Berlin,5000000.0,5000000.0,25,135,142,9,10,12,11,13,8,9,11,4,8,12,9,11,13,11,16,15,11,15,15,17,14,12,11,13,12,15,16,13,13,11,8,13,12,11,10,12,4,10,5,13,1,2,1,1,3,1,1,4,4,3,2,12,12,4,12,13,15,14,15,1,1,1,1,1,1,17,14,20,1,10,1,1,1,67,14,20,4497930,6397,6497,4797,Northern_European,131,20,3,26694.0,Unknown,38045397,1000000.0,2.0,45,1445,47,3,1,7,0,1,0.6099497221487166,0.5077005347593583,0.6029411764705883,0.0257674967434557,0.131578947368421,0.0394736842105263,0.0247561890472618,0.0247561890472618,0.0055279313314258,0.1428571428571428,0.3488372093023257,0.2916666666666665,190,14,17,25,2,5658,10,64,143,5000000,255263.15789473685,5000000.0,1000000.0,175000.0,350000.0,4,450000,0.0,0.25
455181,Jorge,De Frutos,2024,367,Spain,Navares de Enmedio,Spain,20-02-97,Right Winger,Attack,Right,173.0,30-06-28,Unknown,https://img.a.transfermarkt.technology/portrait/header/455181-1613121992.jpg?lm=1,ES1,Rayo Vallecano de Madrid S.A.D.,4000000.0,15000000.0,27,140,148,11,15,14,13,12,8,8,13,6,7,12,9,8,13,15,12,13,12,12,12,13,13,13,8,14,8,14,14,16,13,13,8,14,15,14,11,14,8,13,7,10,2,3,2,3,4,3,3,1,3,2,1,14,13,7,13,14,14,14,9,1,1,1,1,1,1,1,15,1,18,16,12,20,8,71,11,20,12571018,6900,6900,4350,Mediterranean_Hispanic,137,0,0,12466.0,Unknown,67231100,4700000.0,3.0,89,1020,89,0,1,3,163,10,0.6632707065361206,0.4598930481283422,0.6470588235294117,0.0120286942826767,0.0,0.0,0.0197549387346836,0.0747686921730432,0.0260840578904969,0.2857142857142857,0.2325581395348837,0.375,293,40,36,28,1,2485,4,17,138,4000000,188095.2380952381,15000000.0,3000000.0,,200000.0,5,6500000,0.0,-0.2
456292,Ellery,Balcombe,2024,465,England,Bedfordshire,England,15-10-99,Goalkeeper,Goalkeeper,Right,190.0,31-05-25,Straight Ace Sports,https://img.a.transfermarkt.technology/portrait/header/456292-1659706694.jpg?lm=1,SC1,Saint Mirren Football Club,400000.0,400000.0,25,103,141,2,3,3,1,8,2,6,2,3,3,11,3,3,8,8,11,14,13,12,8,9,13,3,6,3,13,12,13,10,12,11,16,12,10,11,12,8,3,11,3,1,12,11,9,11,12,12,12,13,13,13,12,12,14,3,12,9,14,12,15,20,1,1,1,1,1,1,1,1,1,1,1,1,1,0,7,20,10346463,5138,5138,2488,African_Caribbean,104,0,0,9279.0,Crawley Town,29174476,9111392.0,2.0,32,162,33,2,1,1,179,5,0.4301402487430538,0.2607486631016042,0.4044117647058823,0.0089512720559053,0.0,0.0,0.0017504376094023,0.0017504376094023,0.0505924720131114,0.1428571428571428,0.6279069767441858,0.2916666666666665,0,0,0,0,0,0,0,0,0,400000,29166.666666666668,400000.0,0.0,,200000.0,5,250000,0.3333333333333333,0.3333333333333333
456492,Faride,Alidou,2024,276,Germany,Hamburg,Germany,18-07-01,Left Winger,Attack,Right,186.0,30-06-25,Dirk Hebel,https://img.a.transfermarkt.technology/portrait/header/456492-1663065628.jpg?lm=1,IT1,Verona Hellas Football Club,2500000.0,2500000.0,23,118,-8,6,11,13,10,11,7,8,10,8,6,9,12,7,13,12,9,11,9,8,10,9,12,14,4,11,7,11,12,16,12,12,12,14,16,11,12,12,6,13,5,14,1,2,1,2,3,2,2,3,3,2,2,19,14,8,12,10,11,10,13,1,1,1,1,12,13,1,16,8,16,20,10,18,14,0,10,20,54000001,5895,5895,3745,African_Caribbean,109,0,0,7614.0,Unknown,91206292,9111392.0,2.0,38,594,40,0,1,1,214,7,0.5302990209050014,0.395187165775401,0.4411764705882353,0.007343519308,0.0,0.0,0.0122530632658164,0.0122530632658164,0.0505924720131114,0.1428571428571428,0.5348837209302322,0.2083333333333332,145,24,19,16,0,2719,4,4,21,2000000,160416.66666666666,2500000.0,700000.0,75000.0,1500000.0,3,2200000,-0.2,0.1111111111111111
456623,Esequiel,Barco,2024,232,Argentina,Villa Gobernador GÃ¡lvez,Argentina,29-03-99,Attacking Midfield,Midfield,Right,166.0,30-06-27,Unknown,https://img.a.transfermarkt.technology/portrait/header/456623-1721914216.png?lm=1,RU1,FK Spartak Moskva,12000000.0,12000000.0,25,129,140,12,12,15,12,15,13,6,13,3,7,14,16,7,15,13,9,14,12,10,13,8,13,16,12,13,9,11,16,14,14,15,7,14,13,15,10,10,8,14,13,11,1,3,1,3,2,1,2,3,3,3,3,9,16,14,12,5,8,13,10,1,1,1,1,1,1,1,1,16,1,20,15,17,12,65,10,20,12777110,6553,6553,4238,Native_American,129,0,0,27630.0,Club AtlÃ©tico River Plate,14181052,9115000.0,4.0,4,1597,4,3,1,5,82,0,0.6173590897062715,0.4479144385026737,0.588235294117647,0.0266713145044403,0.0,0.0,0.0597649412353088,0.0597649412353088,0.0506125170143615,0.4285714285714285,0.0697674418604648,0.2916666666666665,313,53,50,33,1,9642,8,36,46,14000000,625000.0,14000000.0,2000000.0,8000000.0,10000000.0,3,4500000,0.5555555555555556,0.5555555555555556
457673,Gabriel,Strefezza,2024,1047,Brazil,SÃ£o Paulo,Brazil,18-04-97,Right Winger,Attack,Right,168.0,30-06-27,World Soccer Agency,https://img.a.transfermarkt.technology/portrait/header/457673-1692962752.jpg?lm=1,IT1,Calcio Como,6000000.0,10000000.0,27,131,139,12,14,14,14,13,11,6,13,5,9,14,11,10,15,15,12,13,10,10,13,12,14,13,9,13,12,14,14,15,15,9,6,13,15,12,7,14,7,13,9,14,4,3,4,1,1,3,2,2,1,2,3,10,14,8,10,10,14,7,8,1,1,1,1,12,13,1,15,1,18,18,11,20,11,63,7,20,4582555,6550,6350,5050,Mediterranean_Hispanic,129,0,0,2214.0,Unknown,19223093,2775000.0,2.0,10,1456,11,0,1,3,47,10,0.590500132310135,0.53475935828877,0.588235294117647,0.0021291860715503,0.0,0.0,0.0297574393598399,0.0497624406101525,0.0153893163698991,0.1428571428571428,0.1162790697674416,0.375,286,49,32,49,2,1399,4,7,19,6000000,271590.9090909091,10000000.0,2000000.0,,100000.0,6,4325000,0.0,-0.25
458734,Tommy,St. Jago,2024,403,Netherlands,Utrecht,Netherlands,03-01-00,Centre-Back,Defender,Right,186.0,30-06-25,Forza Sports Group,https://img.a.transfermarkt.technology/portrait/header/458734-1718022607.jpg?lm=1,NL1,Willem II,700000.0,1200000.0,24,125,147,9,8,9,7,11,7,12,7,3,13,11,8,14,12,8,14,11,13,12,11,14,15,11,10,11,13,14,14,12,12,13,14,13,11,12,15,14,13,11,16,13,2,2,2,1,3,1,3,1,2,2,3,12,14,4,15,15,15,16,16,1,1,20,14,1,1,11,1,1,1,1,1,1,1,84,8,20,8268748,6200,6200,4750,African_Caribbean,124,0,0,4130.0,Unknown,37064140,9111392.0,2.0,67,1551,68,1,1,1,221,2,0.5706536120666843,0.5026737967914437,0.5514705882352942,0.0039793087532239,0.0,0.0,0.0032508127031757,0.0057514378594648,0.0505924720131114,0.1428571428571428,0.5348837209302322,0.25,162,5,1,15,1,4434,3,57,295,1000000,66071.42857142857,1200000.0,200000.0,,500000.0,1,0,0.42857142857142855,0.42857142857142855
459128,Marco,Brescianini,2024,800,Italy,Calcinate,Italy,20-01-00,Central Midfield,Midfield,Left,188.0,30-06-25,GR Sports,https://img.a.transfermarkt.technology/portrait/header/459128-1727853390.JPG?lm=1,IT1,Atalanta Bergamasca Calcio S.p.a.,3500000.0,3500000.0,24,112,146,4,8,10,11,13,13,10,13,7,11,13,12,12,13,8,12,11,11,10,11,10,15,8,12,12,12,12,13,13,12,14,13,16,14,13,11,13,6,8,6,15,3,3,3,1,2,3,1,1,3,2,2,13,14,4,16,12,15,14,14,1,1,10,1,1,1,18,10,20,10,8,8,8,1,80,20,8,132726,5600,5600,3400,Mediterranean_Hispanic,113,0,0,7070.0,Cosenza,43318320,1200000.0,1.0,52,300,54,3,0,3,31,1,0.4912675310928817,0.3582887700534758,0.4705882352941176,0.006818223515291,0.0,0.0,0.0172543135783946,0.0172543135783946,0.0066390733075918,0.0,0.581395348837209,0.25,232,26,12,17,0,3586,3,19,36,8000000,611538.4615384615,8000000.0,200000.0,,100000.0,5,5900000,1.2857142857142858,4.333333333333333
459151,Nicolò,Cambiaghi,2024,1025,Italy,Monza,Italy,28-12-00,Second Striker,Attack,Right,173.0,30-06-29,MM-Management,https://img.a.transfermarkt.technology/portrait/header/459151-1695031545.jpg?lm=1,IT1,Bologna Football Club 1909,7000000.0,8000000.0,23,118,146,12,13,13,12,13,10,11,12,8,8,12,11,10,12,12,11,11,11,12,12,13,16,16,11,12,12,12,12,13,13,11,10,15,12,12,11,13,12,13,8,13,2,1,1,2,3,2,3,3,2,3,1,11,12,4,11,11,11,7,14,1,1,1,1,1,1,1,12,1,1,20,12,1,18,65,10,20,4368749,5900,5900,2750,Northern_European,118,0,0,11120.0,Empoli Football Club,43295822,10000000.0,1.0,52,980,54,0,1,7,40,12,0.530960571579783,0.2887700534759358,0.5073529411764706,0.0107289734426283,0.0,0.0,0.0347586896724181,0.0397599399849962,0.055529320258896,0.0,0.2325581395348837,0.2083333333333332,211,34,20,22,1,1804,3,39,159,7000000,507692.3076923077,8000000.0,500000.0,400000.0,350000.0,4,300000,0.0,-0.06666666666666667
459658,Andrea,Cambiaso,2024,506,Italy,Genova,Italy,20-02-00,Left-Back,Defender,Left,182.0,30-06-29,BC Group,https://img.a.transfermarkt.technology/portrait/header/459658-1662127057.jpg?lm=1,IT1,Juventus Football Club,25000000.0,25000000.0,24,128,151,4,13,14,9,11,4,7,9,10,9,12,5,13,12,11,11,12,9,10,10,8,15,10,6,12,8,12,14,15,14,11,10,13,15,14,9,12,7,11,8,20,2,1,4,2,2,1,1,1,2,2,1,16,12,10,12,13,15,14,11,1,18,1,16,20,18,1,20,12,18,7,1,7,1,70,20,14,8487717,6400,6150,4750,Mediterranean_Hispanic,113,0,0,19230.0,Bologna FC 1909,43339195,13300000.0,1.0,52,531,54,1,0,3,116,8,0.5640381053188674,0.5026737967914437,0.4705882352941176,0.018560129469963,0.0,0.0,0.1247811952988247,0.1247811952988247,0.0738631628656351,0.0,0.4418604651162785,0.25,242,8,27,33,0,1866,8,43,180,40000000,1818181.8181818181,40000000.0,25000.0,100000.0,150000.0,7,6425000,0.6,1.6666666666666667
459661,Eddie,Salcedo,2024,653,Italy,Genova,Italy,01-10-01,Centre-Forward,Attack,Right,178.0,30-06-25,Gea World,https://img.a.transfermarkt.technology/portrait/header/459661-1686207251.jpg?lm=1,GR1,Omilos Filathlon Irakliou FC,1000000.0,10000000.0,23,112,139,6,10,12,12,12,6,12,11,4,4,12,12,5,12,8,11,10,11,9,10,10,14,13,6,12,3,12,10,14,14,13,12,15,14,12,11,11,4,12,8,11,4,3,2,2,2,3,3,2,3,2,1,13,16,9,13,13,15,12,9,1,1,1,1,1,1,1,1,1,1,16,18,15,20,74,10,20,4299999,5600,5600,4102,African_Caribbean,107,0,0,5599.0,Bari,43372893,10000000.0,1.0,52,531,54,0,1,1,145,3,0.4912675310928817,0.4333689839572192,0.4264705882352941,0.0053978005169914,0.0,0.0,0.0047511877969492,0.0497624406101525,0.055529320258896,0.0,0.3488372093023257,0.2083333333333332,192,40,12,18,0,5623,7,28,72,1000000,-58823.529411764706,10000000.0,2500000.0,10000000.0,3500000.0,8,12000000,0.0,-0.3333333333333333
459763,Marco,Carnesecchi,2024,800,Italy,Rimini,Italy,01-07-00,Goalkeeper,Goalkeeper,Right,191.0,30-06-26,World Soccer Agency,https://img.a.transfermarkt.technology/portrait/header/459763-1695027944.jpg?lm=1,IT1,Atalanta Bergamasca Calcio S.p.a.,16000000.0,16000000.0,24,129,159,2,3,1,1,8,6,5,3,3,1,8,3,2,8,9,13,10,10,15,8,12,15,7,13,7,15,13,15,10,14,13,15,15,10,15,13,15,6,15,6,14,14,16,15,10,15,9,12,14,14,13,10,12,16,6,15,12,18,14,14,20,1,1,1,1,1,1,1,1,1,1,1,1,1,80,5,20,14860000,6450,6450,4250,Mediterranean_Hispanic,129,0,0,3557.0,Cremonese,43298002,1370000.0,1.0,52,1233,54,2,1,3,31,5,0.6037311458057687,0.4491978609625668,0.588235294117647,0.0034260100598006,0.0,0.0,0.0797699424856214,0.0797699424856214,0.0075835439873329,0.0,0.6511627906976742,0.25,0,0,0,0,0,0,5,50,115,20000000,1313333.3333333333,20000000.0,300000.0,300000.0,2500000.0,4,2600000,0.25,0.5384615384615384
460245,Moritz,Jenz,2024,39,Germany,Berlin,Germany,30-04-99,Centre-Back,Defender,Right,190.0,30-06-25,Sports360 GmbH,https://img.a.transfermarkt.technology/portrait/header/460245-1689865901.jpg?lm=1,L1,1. FuÃŸball- und Sportverein Mainz 05,7500000.0,7500000.0,25,118,140,5,6,6,7,9,6,14,6,8,13,10,10,13,10,11,11,15,12,12,8,12,14,6,12,7,13,13,12,12,9,15,15,16,13,14,15,11,11,11,8,8,1,3,4,3,4,3,3,1,3,4,2,13,13,4,12,12,16,13,13,1,1,20,10,1,1,1,1,1,1,1,1,1,1,0,8,20,1984064,5900,5900,3250,Mixed_Race,117,0,0,5757.0,Celtic,29162924,9111392.0,2.0,38,178,40,1,1,4,1,2,0.530960571579783,0.3422459893048128,0.4999999999999999,0.0055503680450209,0.0,0.0,0.0372593148287071,0.0372593148287071,0.0505924720131114,0.1428571428571428,0.6279069767441858,0.2916666666666665,189,7,3,36,0,5734,7,21,42,6000000,509090.9090909091,7500000.0,1500000.0,,,5,7400000,-0.2,-0.2
460629,Colin,Dagba,2024,41274,France,BÃ©thune,France,09-09-98,Right-Back,Defender,Right,170.0,30-06-26,Gol International,https://img.a.transfermarkt.technology/portrait/header/460629-1602849414.jpg?lm=1,BE1,Koninklijke Beerschot Voetbalclub Antwerpen,1200000.0,18000000.0,26,124,136,9,13,13,7,13,6,10,8,8,11,13,6,11,13,10,11,8,13,14,10,12,12,11,8,14,12,14,14,16,14,10,5,13,15,14,10,12,8,6,12,12,2,1,2,2,3,1,2,1,1,1,1,10,14,6,10,12,14,11,13,1,15,1,20,1,14,1,1,1,1,1,1,1,1,62,10,20,438355,6198,6198,3998,African_Caribbean,120,0,0,23014.0,RC Strasbourg Alsace,49034905,9111392.0,2.0,34,288,36,1,1,1,121,11,0.5703889917967716,0.4222459893048128,0.5220588235294117,0.0222140252045418,0.0,0.0,0.0057514378594648,0.0897724431107777,0.0505924720131114,0.1428571428571428,0.1627906976744184,0.3333333333333332,164,1,8,18,0,5376,7,34,94,800000,-60000.0,18000000.0,4000000.0,,12000000.0,3,4400000,-0.3333333333333333,-0.5555555555555556
460651,Antoine,Makoumbou,2024,1390,France,Paris,Congo,18-07-98,Defensive Midfield,Midfield,Right,187.0,30-06-26,Pro transfer,https://img.a.transfermarkt.technology/portrait/header/460651-1667406168.jpg?lm=1,IT1,Cagliari Calcio,4500000.0,4500000.0,26,122,135,10,10,12,8,13,10,8,9,7,8,11,10,10,13,12,12,12,13,13,13,12,14,10,10,12,13,12,12,13,12,12,7,12,13,16,12,12,10,14,8,12,1,2,4,2,1,3,1,2,3,3,4,13,13,4,8,13,14,13,13,1,1,1,1,1,1,16,12,20,1,14,18,1,1,62,10,20,2613262,6099,5246,2610,African_Caribbean,116,10,1,12976.0,Unknown,85144802,1920000.0,1.0,34,1122,22,3,1,1,46,4,0.4444297433183382,0.2737967914438502,0.4926470588235294,0.0125211590883414,0.0657894736842105,0.0131578947368421,0.0222555638909727,0.0222555638909727,0.0106391844217894,0.0,0.5581395348837206,0.3333333333333332,167,3,5,17,1,1517,3,5,22,4000000,275000.0,4500000.0,500000.0,,0.0,5,1750000,-0.1111111111111111,-0.1111111111111111
460939,Tijjani,Reijnders,2024,5,Netherlands,Zwolle,Netherlands,29-07-98,Central Midfield,Midfield,Right,185.0,30-06-28,Unknown,https://img.a.transfermarkt.technology/portrait/header/460939-1676466080.jpg?lm=1,IT1,Associazione Calcio Milan,30000000.0,30000000.0,26,128,135,11,11,14,11,15,12,5,13,4,6,13,11,7,15,7,12,10,13,10,14,12,13,15,7,12,9,13,13,13,15,13,8,13,13,13,12,10,5,9,5,12,2,1,4,3,1,3,1,1,2,3,2,8,10,6,12,11,9,14,12,1,1,1,1,1,1,18,12,20,12,17,19,14,1,73,8,20,5017997,5800,5800,3857,South_East_Asian,119,0,0,2617.0,Unknown,37071126,20500000.0,1.0,67,1710,68,3,1,9,27,1,0.5177295580841492,0.4071657754010694,0.5147058823529411,0.002518329829752,0.0,0.0,0.1497874468617154,0.1497874468617154,0.1138642740076113,0.0,0.5116279069767438,0.3333333333333332,340,50,38,32,1,6187,1,1,12,50000000,2270454.5454545454,50000000.0,75000.0,,700000.0,5,6325000,0.6666666666666666,1.173913043478261
461019,Samuele,Birindelli,2024,2919,Italy,Pisa,Italy,19-07-99,Right-Back,Defender,Right,176.0,30-06-26,Piccioli&Lombardi,https://img.a.transfermarkt.technology/portrait/header/461019-1613547152.jpg?lm=1,IT1,Associazione Calcio Monza,3500000.0,3500000.0,25,127,144,11,15,13,8,13,7,9,11,13,10,12,7,12,13,10,13,11,11,12,10,12,13,11,9,13,11,12,13,15,14,11,8,12,14,12,11,12,9,12,8,14,1,1,3,1,3,1,4,1,3,1,3,11,12,7,15,12,12,14,13,1,13,8,20,13,18,1,12,1,14,1,1,1,1,68,10,20,2936301,6350,6350,4250,Mediterranean_Hispanic,119,0,0,19751.0,Unknown,43274094,1600000.0,1.0,52,1151,54,1,1,3,28,11,0.590500132310135,0.4491978609625668,0.5147058823529411,0.0190632160655538,0.0,0.0,0.0172543135783946,0.0172543135783946,0.0088613572599238,0.0,0.3023255813953489,0.2916666666666665,279,8,21,52,2,4046,4,15,40,3500000,172500.0,3500000.0,200000.0,200000.0,450000.0,2,250000,0.0,0.4
461496,Morten,Hjulmand,2024,336,Denmark,Kastrup,Denmark,25-06-99,Defensive Midfield,Midfield,Right,185.0,30-06-28,Boutique Transfers,https://img.a.transfermarkt.technology/portrait/header/461496-1725633200.jpg?lm=1,PO1,Sporting Clube de Portugal,40000000.0,40000000.0,25,126,148,8,10,10,9,14,7,10,10,9,12,14,7,13,14,12,12,14,12,11,14,11,14,9,8,15,15,13,14,13,11,14,12,14,13,13,12,12,9,10,7,10,1,2,3,2,1,3,1,2,2,1,1,11,14,5,11,13,14,13,13,1,1,1,1,1,1,20,13,19,5,1,11,1,1,77,11,20,3673929,6300,6200,3556,Northern_European,124,0,0,4038.0,Unknown,27132703,11000000.0,2.0,28,713,30,3,1,7,193,4,0.5706536120666843,0.3749732620320855,0.5514705882352942,0.0038904719647511,0.0,0.0,0.1997999499874969,0.1997999499874969,0.0610850301397261,0.1428571428571428,0.5116279069767438,0.2916666666666665,300,12,20,81,1,4657,4,8,22,45000000,2140476.1904761903,45000000.0,100000.0,50000.0,625000.0,3,9650000,0.125,0.7307692307692307
461512,Oleg,Reabciuk,2024,232,Moldova,Ialoveni,Moldova,16-01-98,Left-Back,Defender,Left,177.0,30-06-26,FMA Sports,https://img.a.transfermarkt.technology/portrait/header/461512-1692623528.png?lm=1,RU1,FK Spartak Moskva,4000000.0,5000000.0,26,120,130,7,10,9,8,10,6,9,8,13,12,10,6,12,10,15,11,16,10,9,10,10,16,7,6,11,11,16,17,16,13,12,10,17,15,16,12,12,12,12,3,8,1,2,1,1,1,1,1,2,2,3,3,14,15,5,14,11,16,10,13,1,20,1,1,19,1,1,6,1,1,1,1,1,1,72,20,6,1157062,6000,6000,4252,Northern_European,113,37,0,28384.0,Unknown,83111579,4000000.0,2.0,64,648,65,1,0,7,82,8,0.5441915850754168,0.4494117647058823,0.4705882352941176,0.0273993899230113,0.2434210526315789,0.0,0.0197549387346836,0.0247561890472618,0.0221950609739159,0.1428571428571428,0.3255813953488373,0.3333333333333332,260,9,18,47,2,10010,4,8,13,4000000,220833.33333333334,5000000.0,1000000.0,,350000.0,3,1650000,0.0,-0.2
461617,Rodrigo,Riquelme,2024,13,Spain,Madrid,Spain,02-04-00,Left Winger,Attack,Right,174.0,30-06-28,Wasserman,https://img.a.transfermarkt.technology/portrait/header/461617-1701212385.jpg?lm=1,ES1,Club AtlÃ©tico de Madrid S.A.D.,25000000.0,25000000.0,24,123,148,11,11,14,12,14,13,7,11,7,7,12,13,7,15,11,13,10,10,11,14,13,14,15,8,12,7,11,11,14,13,12,8,12,12,10,9,11,8,9,8,14,2,4,1,2,2,3,1,3,4,1,3,14,11,8,12,10,12,14,15,1,1,1,1,1,1,10,15,15,15,18,20,19,13,0,12,20,4837499,6149,6149,3999,Mediterranean_Hispanic,118,0,0,6759.0,Girona,67259880,9111392.0,2.0,89,892,89,0,1,3,52,7,0.5639057951839112,0.4223529411764705,0.5073529411764706,0.0065179165455621,0.0,0.0,0.1247811952988247,0.1247811952988247,0.0505924720131114,0.1428571428571428,0.2558139534883721,0.25,203,28,30,9,0,3031,0,0,0,22000000,1147058.8235294118,25000000.0,3000000.0,,1800000.0,5,8300000,-0.12,-0.12
461629,Gustavo,Assunção,2024,110302,Brazil,SÃ£o Paulo,Brazil,30-03-00,Defensive Midfield,Midfield,Right,178.0,30-06-25,YES SPORTS,https://img.a.transfermarkt.technology/portrait/header/461629-1591609013.jpg?lm=1,PO1,Avs Futebol SAD,1500000.0,8000000.0,24,126,142,11,12,13,9,13,7,9,8,12,11,14,9,13,15,14,13,11,15,14,15,14,13,11,13,12,12,15,13,11,13,14,7,13,12,13,8,14,10,13,4,8,3,2,1,3,2,2,2,2,4,3,1,10,16,6,12,15,11,13,13,1,1,1,1,1,1,20,1,16,1,1,1,1,1,66,12,20,3539999,6295,5745,4495,Mixed_Race,126,0,0,3499.0,Unknown,67258040,9111392.0,2.0,10,1456,11,3,1,4,35,4,0.5104525006615507,0.4754010695187165,0.5661764705882353,0.0033700042583721,0.0,0.0,0.0072518129532383,0.0397599399849962,0.0505924720131114,0.1428571428571428,0.3488372093023257,0.25,147,4,3,56,1,3717,6,13,32,1000000,-35714.28571428572,8000000.0,2500000.0,,8000000.0,3,500000,-0.3333333333333333,-0.3333333333333333
461701,Nair,Tiknizyan,2024,932,Russia,St.Petersburg,Armenia,12-05-99,Left Midfield,Midfield,Left,181.0,30-06-26,Unknown,https://img.a.transfermarkt.technology/portrait/header/461701-1721715754.png?lm=1,RU1,"?????????? ???? ""?????????"" ??????",6500000.0,7000000.0,25,118,135,11,11,12,9,11,10,18,7,5,10,11,6,13,10,12,11,8,11,12,9,11,12,12,12,8,11,15,14,13,14,15,10,17,13,14,10,12,5,10,5,16,3,3,2,1,1,1,2,2,2,2,1,19,12,7,15,11,12,13,14,1,19,1,10,20,1,13,16,11,1,15,10,1,1,74,20,8,4509289,6000,6000,3907,Mediterranean_Hispanic,111,0,0,28962.0,Unknown,58133443,5500000.0,1.0,78,1414,5,3,0,3,3,6,0.5441915850754168,0.4125133689839572,0.4558823529411764,0.0279575167027646,0.0,0.0,0.032258064516129,0.0347586896724181,0.0305286257951609,0.0,0.418604651162791,0.2916666666666665,257,43,32,44,2,5521,3,11,23,6000000,283333.3333333333,7000000.0,500000.0,150000.0,325000.0,4,850000,-0.07692307692307693,-0.14285714285714285
461833,Caleb,Okoli,2024,1003,Italy,Vicenza,Italy,13-07-01,Centre-Back,Defender,Right,191.0,30-06-29,CAA Base Ltd,https://img.a.transfermarkt.technology/portrait/header/461833-1652094910.jpg?lm=1,GB1,Leicester City Football Club,12000000.0,12000000.0,23,133,164,7,7,8,6,9,6,14,6,10,15,9,7,14,9,14,14,13,14,13,8,12,14,7,12,8,14,12,14,14,14,13,14,16,14,15,14,14,11,16,5,10,2,2,1,1,1,1,2,2,3,1,1,14,15,8,13,14,15,15,10,1,1,20,1,1,1,1,1,1,1,1,1,1,1,76,8,20,20710001,6650,6650,4256,African_Caribbean,133,0,0,19999.0,Unknown,43372285,7001500.0,2.0,52,1582,54,1,1,1,127,2,0.6301931727970362,0.4498395721925133,0.6176470588235294,0.0193026891475241,0.0,0.0,0.0597649412353088,0.0597649412353088,0.0388705241812272,0.1428571428571428,0.6511627906976742,0.2083333333333332,204,8,3,36,0,4729,3,7,24,12000000,800000.0,12000000.0,2000000.0,800000.0,5000000.0,5,11650000,0.5,0.5
461843,Juan,Berrocal,2024,3709,Spain,Jerez de la Frontera,Spain,05-02-99,Centre-Back,Defender,Right,187.0,30-06-27,Unknown,https://img.a.transfermarkt.technology/portrait/header/461843-1626938167.jpg?lm=1,ES1,Getafe Club de FÃºtbol S.A.D. Team Dubai,1000000.0,1500000.0,25,106,144,7,7,7,8,10,11,11,9,8,12,11,7,12,10,10,11,12,9,11,9,10,12,7,7,7,12,15,12,11,11,8,14,13,12,15,15,9,12,12,10,9,1,4,3,3,3,2,1,2,3,3,3,8,11,7,12,8,14,11,13,1,1,20,1,1,1,1,1,1,1,1,1,1,1,80,12,20,780991,5300,5300,3300,Mediterranean_Hispanic,105,0,0,2022.0,Unknown,67248397,2200000.0,1.0,89,688,89,1,1,3,105,2,0.4515744906059804,0.3475935828877005,0.411764705882353,0.0019437875564765,0.0,0.0,0.0047511877969492,0.0072518129532383,0.0121947831884219,0.0,0.5581395348837206,0.2916666666666665,243,4,1,67,4,2475,1,1,9,2000000,78947.36842105263,2200000.0,500000.0,500000.0,300000.0,4,1800000,1.0,1.0
461883,Calvin,Bassey,2024,931,Italy,Aosta,Nigeria,31-12-99,Centre-Back,Defender,Left,185.0,30-06-27,Unique Sports Group,https://img.a.transfermarkt.technology/portrait/header/461883-1662989506.jpg?lm=1,GB1,Fulham Football Club,16000000.0,18000000.0,24,136,150,9,14,12,7,12,7,14,7,14,12,10,9,13,12,12,13,13,13,11,10,12,12,11,8,13,12,11,14,12,10,12,15,16,17,19,18,10,11,9,5,13,2,3,1,3,2,2,3,2,3,1,2,15,16,7,14,15,15,18,17,1,20,19,1,1,1,1,1,1,1,1,1,1,1,78,20,8,45740877,6744,6494,4994,African_Caribbean,132,6,0,29999.0,Unknown,28111079,22750000.0,2.0,52,77,70,1,0,1,95,2,0.6095527917438476,0.5287700534759358,0.6102941176470589,0.0289588618076162,0.0394736842105263,0.0,0.0797699424856214,0.0897724431107777,0.1263646212394788,0.1428571428571428,0.5116279069767438,0.25,251,7,15,26,3,5664,2,3,10,16000000,1440909.0909090908,18000000.0,3000000.0,,150000.0,2,9000000,0.0,0.0
461937,Nuno,Moreira,2024,3268,Portugal,Espinho,Portugal,16-06-99,Left Winger,Attack,Right,175.0,30-06-26,Team of Future,https://img.a.transfermarkt.technology/portrait/header/default.jpg?lm=1,PO1,Casa Pia AtlÃ©tico Clube,1000000.0,1000000.0,25,124,138,14,14,14,10,14,13,4,12,3,7,13,10,9,16,11,11,10,12,11,13,12,12,13,7,12,8,11,13,13,14,14,7,13,12,12,9,12,5,12,4,10,2,1,1,3,3,3,1,2,1,1,1,13,12,9,13,13,13,8,14,1,1,1,1,1,1,1,15,15,15,20,18,19,1,66,11,20,1611999,6200,6200,4700,Mediterranean_Hispanic,121,0,0,1749.0,Unknown,83111513,9111392.0,2.0,76,472,79,0,1,3,48,7,0.5706536120666843,0.4973262032085561,0.5294117647058822,0.001680174042856,0.0,0.0,0.0047511877969492,0.0047511877969492,0.0505924720131114,0.1428571428571428,0.2790697674418605,0.2916666666666665,154,19,19,20,1,3011,1,5,37,1500000,133333.33333333334,1500000.0,0.0,,,1,200000,0.5,0.875
461943,Daniel,Bragança,2024,336,Portugal,Almeirim,Portugal,27-05-99,Central Midfield,Midfield,Left,178.0,30-06-27,Gestifute,https://img.a.transfermarkt.technology/portrait/header/461943-1602774752.jpg?lm=1,PO1,Sporting Clube de Portugal,12000000.0,12000000.0,25,126,146,13,13,13,11,14,12,6,12,7,8,15,11,12,16,11,13,11,16,13,15,14,14,12,13,12,14,13,12,12,13,16,6,13,12,12,8,14,8,10,3,10,3,1,2,1,3,2,2,2,2,2,1,20,13,8,15,16,12,12,12,1,10,1,1,7,1,20,1,19,1,1,1,1,1,72,20,8,1968983,6300,6300,5000,Mediterranean_Hispanic,126,0,0,9734.0,Unknown,83111519,9111392.0,2.0,76,48,79,3,0,3,193,1,0.5838846255623181,0.5294117647058822,0.5661764705882353,0.0093906279119395,0.0,0.0,0.0597649412353088,0.0597649412353088,0.0505924720131114,0.1428571428571428,0.3488372093023257,0.2916666666666665,189,18,18,23,2,5759,4,64,359,14000000,862500.0,14000000.0,2000000.0,,475000.0,2,1200000,0.75,1.8
462250,Unknown,João Félix,2024,631,Portugal,Viseu,Portugal,10-11-99,Second Striker,Attack,Right,181.0,30-06-31,Gestifute,https://img.a.transfermarkt.technology/portrait/header/462250-1668165358.jpg?lm=1,GB1,Chelsea Football Club,30000000.0,100000000.0,25,159,177,11,12,17,15,16,12,12,13,4,4,17,14,7,18,14,15,11,15,13,16,16,16,19,7,18,6,12,11,13,15,13,9,14,12,12,9,12,14,15,9,8,2,1,2,1,1,3,1,2,1,4,2,15,18,13,8,17,15,10,10,1,1,1,1,1,1,1,12,10,12,18,20,15,19,74,15,20,95220000,7800,7800,7200,Mediterranean_Hispanic,152,22,3,180287.0,Unknown,83169822,89600000.0,2.0,76,1615,79,0,1,3,50,12,0.7823498279968246,0.7647058823529411,0.7573529411764706,0.1740795494816084,0.1447368421052631,0.0394736842105263,0.1497874468617154,0.4998749687421855,0.4977638267729659,0.1428571428571428,0.418604651162791,0.2916666666666665,306,90,43,46,1,9268,17,61,75,30000000,1070535.7142857143,100000000.0,20000000.0,12000000.0,80000000.0,6,50500000,0.0,-0.25
462285,Fabian,De Keijzer,2024,1304,Netherlands,Leusden,Netherlands,10-05-00,Goalkeeper,Goalkeeper,Right,193.0,30-06-27,Prime11,https://img.a.transfermarkt.technology/portrait/header/462285-1629450783.jpg?lm=1,NL1,Heracles Almelo,500000.0,900000.0,24,118,142,4,2,1,2,11,9,1,3,3,1,12,3,3,9,12,13,12,12,13,11,11,13,3,14,2,12,12,8,16,11,7,16,13,14,7,9,10,7,15,8,13,14,10,11,2,12,12,13,15,12,16,13,14,11,1,11,13,13,15,16,20,1,1,1,1,1,1,1,1,1,1,1,1,1,83,5,20,5785000,5600,5600,3601,Northern_European,117,0,0,1970.0,Unknown,37064134,9111392.0,2.0,67,825,68,2,1,7,113,5,0.4912675310928817,0.3797860962566844,0.4999999999999999,0.001893575458644,0.0,0.0,0.0022505626406601,0.0042510627656914,0.0505924720131114,0.1428571428571428,0.6976744186046511,0.25,0,0,0,0,0,0,3,45,192,1000000,60937.5,1000000.0,100000.0,25000.0,375000.0,1,100000,1.0,0.6666666666666666
462329,Stanislav,Magkeev,2024,49702,Russia,Vladikavkaz,Russia,27-03-99,Centre-Back,Defender,Right,187.0,30-06-25,Unknown,https://img.a.transfermarkt.technology/portrait/header/462329-1722314284.png?lm=1,RU1,FK Nizhny Novgorod,1200000.0,2500000.0,25,118,140,9,9,9,8,9,9,13,12,6,13,12,9,14,9,13,11,13,12,15,8,12,11,12,12,10,14,14,14,10,9,12,14,14,10,14,14,15,11,10,9,9,3,2,1,1,3,1,3,2,3,3,3,10,8,9,10,13,3,13,10,1,1,19,1,1,1,20,1,12,1,1,1,1,1,84,10,20,4349922,5758,5758,3082,Northern_European,109,0,0,9588.0,Unknown,58133896,9111392.0,2.0,78,1621,81,1,1,7,79,2,0.512172532415983,0.3242780748663101,0.4411764705882353,0.0092496477911022,0.0,0.0,0.0057514378594648,0.0122530632658164,0.0505924720131114,0.1428571428571428,0.5581395348837206,0.2916666666666665,145,4,3,27,3,5695,9,68,268,1200000,54761.90476190476,2500000.0,500000.0,50000.0,300000.0,3,925000,-0.2,-0.4
462348,Unknown,Mostafa Mohamed,2024,995,Egypt,Giza,Egypt,28-11-97,Centre-Forward,Attack,Right,185.0,30-06-27,Unknown,https://img.a.transfermarkt.technology/portrait/header/462348-1703065403.jpg?lm=1,FR1,Football Club de Nantes,7000000.0,10000000.0,27,125,140,6,8,9,14,11,7,16,12,8,6,11,13,6,11,12,14,16,14,10,10,10,12,10,7,11,8,12,14,12,13,16,15,18,13,11,16,12,6,14,5,6,3,2,4,3,1,1,2,1,3,1,3,4,15,4,8,6,8,14,13,1,1,1,1,1,1,1,1,1,1,1,1,1,20,80,11,20,5055540,6346,5996,5246,North_African__Middle_Eastern,122,21,4,24236.0,FC Nantes,13231887,4800000.0,2.0,31,543,32,0,1,6,93,3,0.5436623445355915,0.5557219251336898,0.536764705882353,0.0233940095036051,0.1381578947368421,0.0526315789473684,0.0347586896724181,0.0497624406101525,0.0266396288785799,0.1428571428571428,0.5116279069767438,0.375,281,81,23,32,2,5789,6,9,14,6000000,248958.33333333334,10000000.0,3000000.0,25000.0,300000.0,7,4475000,-0.4,-0.3333333333333333
462699,Franz,Stolz,2024,252,Austria,Bruck an der Mur,Austria,14-02-01,Goalkeeper,Goalkeeper,Right,193.0,30-06-27,More than Sport GmbH,https://img.a.transfermarkt.technology/portrait/header/462699-1693220230.png?lm=1,IT1,Genoa Cricket and Football Club,200000.0,300000.0,23,101,137,4,2,2,1,6,5,9,3,1,2,11,4,2,1,9,10,13,8,8,7,14,8,3,11,1,8,8,7,11,15,8,14,15,11,2,11,20,5,10,8,14,9,7,9,5,13,14,11,14,8,12,6,17,10,2,12,12,11,10,18,20,1,1,1,1,1,1,1,1,1,1,1,1,1,83,6,20,1436250,5500,4321,2210,Northern_European,94,0,0,1149.0,Unknown,16248921,250000.0,1.0,6,262,7,2,1,7,104,5,0.3220428684837259,0.2310160427807486,0.3308823529411764,0.0011008036832504,0.0,0.0,0.0007501875468867,0.0012503125781445,0.0013611489208033,0.0,0.6976744186046511,0.2083333333333332,0,0,0,0,0,0,1,6,85,200000,10000.0,300000.0,100000.0,75000.0,175000.0,2,75000,0.0,0.0
462772,Tayyip Talha,Sanuç,2024,114,TÃ¼rkiye,KarabÃ¼k,TÃ¼rkiye,17-12-99,Centre-Back,Defender,Right,188.0,30-06-27,MEC Management,https://img.a.transfermarkt.technology/portrait/header/462772-1666279231.png?lm=1,TR1,Be?ikta? Jimnastik KulÃ¼bÃ¼,2800000.0,5000000.0,25,120,140,5,6,11,8,8,3,13,6,6,14,11,6,14,7,13,12,13,12,12,8,12,14,3,7,8,13,13,14,13,13,12,15,15,13,13,14,15,7,14,2,5,3,1,2,2,2,1,1,3,2,1,1,13,13,12,11,10,14,17,14,1,1,20,1,1,1,1,1,1,1,1,1,1,1,74,10,20,5362200,6200,6200,5000,Mediterranean_Hispanic,121,0,0,7958.0,Unknown,70104072,872500.0,2.0,100,709,100,1,1,3,37,2,0.5706536120666843,0.5294117647058822,0.5294117647058822,0.0076756916475072,0.0,0.0,0.0137534383595899,0.0247561890472618,0.00481957832162,0.1428571428571428,0.581395348837209,0.2916666666666665,153,10,5,22,2,3595,7,50,221,2800000,114583.33333333333,5000000.0,800000.0,250000.0,300000.0,2,650000,-0.06666666666666667,-0.2631578947368421
462823,Gustav,Isaksen,2024,398,Denmark,Hjerk,Denmark,19-04-01,Right Winger,Attack,Right,181.0,30-06-28,Boutique Transfers,https://img.a.transfermarkt.technology/portrait/header/462823-1695026324.jpg?lm=1,IT1,SocietÃ  Sportiva Lazio S.p.A.,12000000.0,12000000.0,23,122,145,6,9,14,11,12,7,9,9,5,7,10,6,5,13,14,8,7,11,9,9,10,15,14,6,15,5,10,11,15,14,11,8,12,16,10,7,11,12,10,8,15,3,1,1,1,2,1,2,3,2,4,3,10,12,8,11,7,8,6,7,1,1,1,1,1,1,1,14,1,15,18,12,20,15,65,15,20,4443165,6094,6094,3494,Northern_European,109,0,0,1848.0,Unknown,27129146,9111392.0,2.0,28,628,30,0,1,7,185,10,0.5566287377613125,0.3683422459893047,0.4411764705882353,0.0017757701521909,0.0,0.0,0.0597649412353088,0.0597649412353088,0.0505924720131114,0.1428571428571428,0.418604651162791,0.2083333333333332,244,61,37,21,0,7332,3,20,76,15000000,934375.0,15000000.0,25000.0,325000.0,3500000.0,2,4550000,0.25,0.25
462837,Nikolas,Dyhr,2024,5724,Denmark,Horsens,Denmark,18-06-01,Left-Back,Defender,Left,179.0,30-06-28,Stirr Associates,https://img.a.transfermarkt.technology/portrait/header/462837-1712492689.jpg?lm=1,DK1,Randers Fodbold Club,1200000.0,1500000.0,23,113,-75,10,11,12,10,12,7,8,9,9,10,12,8,10,12,13,10,12,9,9,11,10,16,14,7,15,11,12,16,13,12,12,8,15,14,14,9,10,10,10,5,15,2,3,3,1,2,3,2,3,3,3,2,10,13,13,10,10,9,12,8,1,17,1,1,15,1,1,20,1,1,14,1,1,1,0,20,13,8590569,5600,5300,2506,Northern_European,111,0,0,3013.0,Unknown,27129140,371500.0,2.0,28,636,30,1,0,7,160,8,0.4515744906059804,0.2626737967914438,0.4558823529411764,0.0029007142670916,0.0,0.0,0.0057514378594648,0.0072518129532383,0.0020361676713242,0.1428571428571428,0.3720930232558141,0.2083333333333332,185,4,19,11,0,7003,0,0,0,1200000,83928.57142857143,1500000.0,500000.0,1300000.0,1000000.0,7,1875000,0.0,-0.2
462977,Benjamín,Garré,2024,2696,Argentina,Buenos Aires,Argentina,11-07-00,Left Winger,Attack,Left,172.0,30-06-26,Footfeel ISM  ,https://img.a.transfermarkt.technology/portrait/header/462977-1722144651.png?lm=1,RU1,PFK Krylya Sovetov Samara,7000000.0,8000000.0,24,125,135,14,14,15,13,15,12,4,12,7,5,13,10,6,15,10,10,9,9,9,14,12,11,15,8,12,11,10,11,14,14,11,6,11,15,12,7,7,11,10,13,10,3,1,1,3,3,2,2,3,3,1,3,8,11,9,8,10,10,9,9,1,1,1,1,1,1,1,1,13,1,18,14,20,12,66,20,8,5052598,6135,6135,3485,Mediterranean_Hispanic,121,0,0,2683.0,Club AtlÃ©tico HuracÃ¡n,28110305,1975000.0,2.0,4,275,4,0,0,3,149,7,0.5620534532945224,0.3673796791443849,0.5294117647058822,0.0025820605693086,0.0,0.0,0.0347586896724181,0.0397599399849962,0.0109447484652351,0.1428571428571428,0.2093023255813952,0.25,180,35,17,17,0,6187,3,19,85,6000000,487500.0,8000000.0,1000000.0,,300000.0,2,1375000,-0.25,-0.25
463233,Daniel,Bielica,2024,132,Poland,Zabrze,Poland,30-04-99,Goalkeeper,Goalkeeper,Right,191.0,30-06-26,FairSport,https://img.a.transfermarkt.technology/portrait/header/463233-1670768191.png?lm=1,NL1,Nooit Opgeven Altijd Doorzetten Aangenaam Door Vermaak En Nuttig Door Ontspanning Combinatie Breda,800000.0,800000.0,25,99,135,5,1,3,1,10,9,7,1,1,1,9,1,2,10,5,11,12,12,13,4,10,12,4,7,5,12,11,14,11,12,11,14,12,8,9,14,11,3,9,2,13,12,9,10,6,12,8,12,13,9,10,12,8,13,6,12,11,13,14,13,20,1,1,1,1,1,1,1,1,1,1,1,1,1,80,7,20,240276,4750,4750,1250,Northern_European,99,0,0,253.0,Unknown,96142783,9111392.0,2.0,75,1694,78,2,1,7,139,5,0.3788039163799948,0.1283422459893048,0.3676470588235294,0.0002356106129062,0.0,0.0,0.0037509377344336,0.0037509377344336,0.0505924720131114,0.1428571428571428,0.6511627906976742,0.2916666666666665,0,0,0,0,0,0,0,0,0,850000,47058.82352941176,850000.0,150000.0,,200000.0,4,100000,0.0625,0.3076923076923077
463600,Lucas,Chevalier,2024,1082,France,Calais,France,06-11-01,Goalkeeper,Goalkeeper,Right,189.0,30-06-27,Beckster Int.,https://img.a.transfermarkt.technology/portrait/header/463600-1708342501.jpg?lm=1,FR1,Lille Olympique Sporting Club Lille MÃ©tropole,25000000.0,25000000.0,23,117,-85,6,3,3,3,11,8,1,3,3,1,11,3,1,9,6,15,14,11,11,10,15,14,1,11,2,11,11,10,10,16,7,13,13,10,10,11,12,8,15,5,12,11,12,10,8,11,11,11,12,11,6,10,13,13,7,14,12,15,13,16,20,1,1,1,1,1,1,1,1,1,1,1,1,1,84,6,20,32173876,6250,5850,2770,Northern_European,111,0,0,11832.0,Unknown,49048357,9111392.0,2.0,34,298,36,2,1,7,128,5,0.5243450648319662,0.2909090909090909,0.4558823529411764,0.0114164929360268,0.0,0.0,0.1247811952988247,0.1247811952988247,0.0505924720131114,0.1428571428571428,0.6046511627906974,0.2083333333333332,0,0,0,0,0,0,3,13,60,30000000,1980000.0,30000000.0,0.0,300000.0,5000000.0,2,2800000,0.2,0.6666666666666666
463603,Benoît,Badiashile,2024,631,France,Limoges,France,26-03-01,Centre-Back,Defender,Left,194.0,30-06-30,CANTERASPORT,https://img.a.transfermarkt.technology/portrait/header/463603-1714721596.jpg?lm=1,GB1,Chelsea Football Club,30000000.0,40000000.0,23,133,158,3,5,9,6,12,4,15,7,8,14,13,7,14,12,10,14,14,13,11,11,12,15,9,11,6,14,14,12,13,11,14,17,15,14,14,16,13,6,13,5,5,3,2,2,1,1,4,1,1,2,3,4,12,15,6,16,14,15,14,14,1,1,20,1,1,1,10,1,1,1,1,1,1,1,75,20,7,31039996,6638,6638,4988,African_Caribbean,132,0,0,12657.0,Unknown,49038942,38000000.0,1.0,34,837,36,1,0,1,50,2,0.6286054511775602,0.5281283422459893,0.6102941176470589,0.0122131271804844,0.0,0.0,0.1497874468617154,0.1997999499874969,0.2110891969221367,0.0,0.7209302325581395,0.2083333333333332,202,8,5,28,0,7418,11,63,112,28000000,1465789.4736842106,40000000.0,5000000.0,20000000.0,28000000.0,1,0,-0.06666666666666667,-0.2
463605,Bafodé,Diakité,2024,1082,France,Toulouse,France,06-01-01,Centre-Back,Defender,Right,184.0,30-06-28,Classico,https://img.a.transfermarkt.technology/portrait/header/463605-1666691072.jpg?lm=1,FR1,Lille Olympique Sporting Club Lille MÃ©tropole,18000000.0,18000000.0,23,120,156,5,12,10,12,11,4,14,8,11,13,11,9,13,8,12,13,13,10,10,9,12,15,11,12,13,11,13,13,13,13,14,14,14,13,12,14,12,10,10,5,13,3,2,4,1,2,1,3,2,1,2,3,8,14,6,14,9,14,12,17,1,12,20,16,1,1,1,1,1,1,1,1,1,1,74,8,20,12280000,6000,6000,3500,African_Caribbean,120,0,0,7256.0,Unknown,49038967,3000000.0,1.0,34,1512,36,1,1,1,128,2,0.5441915850754168,0.3689839572192513,0.5220588235294117,0.0069978283267687,0.0,0.0,0.0897724431107777,0.0897724431107777,0.0166393510930859,0.0,0.4883720930232553,0.2083333333333332,194,22,3,25,1,4671,7,59,69,25000000,1263157.894736842,25000000.0,2000000.0,8000000.0,3500000.0,1,1000000,0.3888888888888889,0.6666666666666666
463610,Loïc,Mbe Soh,2024,41274,Cameroon,Souza Gare,France,13-06-01,Centre-Back,Defender,Right,187.0,Unknown,Pinnacle Sports,https://img.a.transfermarkt.technology/portrait/header/463610-1557735619.jpg?lm=1,BE1,Koninklijke Beerschot Voetbalclub Antwerpen,1500000.0,5000000.0,23,110,-75,5,8,9,6,10,5,12,5,9,13,10,6,13,10,12,11,14,11,12,10,9,12,8,10,10,12,13,15,11,13,14,13,15,13,14,15,10,7,14,10,7,3,3,3,2,1,3,1,1,4,1,1,12,14,3,12,10,13,11,14,1,1,20,10,1,1,10,1,1,1,1,1,1,1,0,8,20,28580364,5494,5494,3497,African_Caribbean,109,0,0,4640.0,Unknown,49038939,5000000.0,1.0,15,1405,36,1,1,1,121,2,0.47724265678751,0.368663101604278,0.4411764705882353,0.0044717735588886,0.0,0.0,0.0072518129532383,0.0247561890472618,0.0277507708547459,0.0,0.5581395348837206,0.2083333333333332,124,7,1,7,0,4329,2,42,99,1500000,-115384.61538461539,5000000.0,1500000.0,4500000.0,2500000.0,4,500000,0.0,-0.25
463613,Yann,Gboho,2024,415,Cote d'Ivoire,Man,France,14-01-01,Left Winger,Attack,Right,178.0,30-06-26,ND SPORTS MANAGEMENT,https://img.a.transfermarkt.technology/portrait/header/463613-1672485001.jpg?lm=1,FR1,Toulouse Football Club,4000000.0,5000000.0,23,112,137,11,13,14,12,14,11,11,7,8,9,11,10,12,14,5,10,7,13,7,13,12,11,11,11,10,12,10,12,13,12,11,8,12,11,9,8,12,7,4,7,15,3,2,2,1,3,3,3,1,1,1,1,14,14,7,14,13,14,9,12,1,1,1,1,1,1,1,1,12,1,15,20,12,1,63,10,20,3979999,5500,5500,2750,African_Caribbean,105,0,0,4499.0,Unknown,49038961,2500000.0,1.0,23,903,36,0,1,1,203,7,0.4780365175972479,0.2887700534759358,0.411764705882353,0.0043356215243813,0.0,0.0,0.0197549387346836,0.0247561890472618,0.0138614961526709,0.0,0.3488372093023257,0.2083333333333332,177,21,20,6,0,4823,1,11,58,6000000,325000.0,6000000.0,1000000.0,1500000.0,3500000.0,4,3850000,0.5,1.4
463618,Khéphren,Thuram,2024,506,Italy,Reggio Emilia,France,26-03-01,Central Midfield,Midfield,Right,192.0,30-06-29,Sport Cover,https://img.a.transfermarkt.technology/portrait/header/463618-1683889273.jpg?lm=1,IT1,Juventus Football Club,35000000.0,40000000.0,23,130,155,6,7,14,12,14,7,12,13,5,12,15,9,11,15,12,12,10,12,11,12,13,17,14,13,14,13,15,13,14,12,14,15,16,14,15,12,14,6,15,6,16,2,2,3,3,3,2,1,3,1,1,4,13,16,8,15,15,16,13,15,1,1,1,1,1,1,18,1,20,1,1,1,1,1,80,8,20,15800000,6500,6500,3502,African_Caribbean,132,0,0,16305.0,Unknown,49038952,20600000.0,1.0,52,1215,36,3,1,1,116,1,0.6103466525535857,0.3691978609625668,0.6102941176470589,0.015735698966886,0.0,0.0,0.1747936984246061,0.1997999499874969,0.1144198449956943,0.0,0.6744186046511627,0.2083333333333332,231,13,17,31,0,4832,6,16,33,35000000,1725000.0,40000000.0,5000000.0,4000000.0,14000000.0,2,1000000,0.0,-0.125
464259,Aleksandr,Sobolev,2024,964,Russia,Barnaul,Russia,07-03-97,Centre-Forward,Attack,Right,195.0,30-06-27,Pavel Andreev,https://img.a.transfermarkt.technology/portrait/header/464259-1725040929.png?lm=1,RU1,AO FK Zenit Sankt-Peterburg,7500000.0,11000000.0,27,128,135,8,7,12,15,13,10,15,12,1,8,12,16,9,14,12,12,13,12,14,13,11,16,14,12,14,11,13,10,10,11,12,16,12,12,13,14,12,14,11,9,5,3,1,1,1,4,1,1,3,1,4,1,10,15,13,9,14,16,7,9,1,1,1,1,1,1,1,1,1,1,1,1,1,20,85,12,20,6628278,6255,6255,4267,Northern_European,127,8,3,38500.0,Unknown,58133082,3717250.0,4.0,78,143,81,0,1,7,7,3,0.5779306694892828,0.4510160427807486,0.5735294117647058,0.0371675741859605,0.0526315789473684,0.0394736842105263,0.0372593148287071,0.0547636909227306,0.0206241840051112,0.4285714285714285,0.7441860465116279,0.375,266,106,39,83,3,5752,3,7,68,6000000,270454.54545454547,11000000.0,1500000.0,,350000.0,5,3950000,-0.2,-0.25
464373,Elías,ÃÂLafsson,2024,865,Iceland,ReykjavÃ­k,Iceland,11-03-00,Goalkeeper,Goalkeeper,Right,201.0,30-06-26,CAA Stellar,https://img.a.transfermarkt.technology/portrait/header/464373-1727290455.jpg?lm=1,DK1,Fodbold Club Midtjylland,650000.0,700000.0,24,117,145,6,2,3,1,9,7,10,2,1,3,8,3,2,9,11,12,11,11,11,8,11,14,2,7,3,10,12,10,11,13,10,19,11,9,7,15,8,6,13,8,14,17,14,11,13,13,8,14,14,7,7,9,8,9,5,10,13,10,11,7,20,1,1,1,1,1,1,1,1,1,1,1,1,1,94,12,20,2735807,5950,5900,2500,Northern_European,115,4,0,2016.0,Unknown,39049583,9111392.0,2.0,46,1222,48,2,1,7,86,5,0.530960571579783,0.2620320855614972,0.4852941176470588,0.0019379938528804,0.0263157894736842,0.0,0.0030007501875468,0.0032508127031757,0.0505924720131114,0.1428571428571428,0.8837209302325584,0.25,0,0,0,0,0,0,4,26,102,1500000,120833.33333333333,1500000.0,100000.0,50000.0,200000.0,5,1400000,1.3076923076923077,1.5
464598,Casper,Tengstedt,2024,276,Denmark,Herning,Denmark,01-06-00,Centre-Forward,Attack,Right,184.0,30-06-25,People In Sport,https://img.a.transfermarkt.technology/portrait/header/464598-1676541542.jpg?lm=1,IT1,Verona Hellas Football Club,5000000.0,7000000.0,24,123,138,6,11,12,14,13,11,10,10,6,6,12,12,7,11,12,12,12,14,10,11,12,15,13,8,12,6,11,12,13,12,12,12,12,13,11,10,12,8,15,6,14,2,2,3,1,2,3,1,2,3,1,3,12,10,7,11,9,12,9,8,1,1,1,1,1,1,1,13,1,12,18,16,18,20,77,14,20,3163720,6050,5650,3000,Northern_European,116,0,0,2161.0,Unknown,27129143,4000000.0,2.0,28,620,30,0,1,7,214,3,0.4978830378406986,0.3155080213903743,0.4926470588235294,0.0020780083564518,0.0,0.0,0.0247561890472618,0.0347586896724181,0.0221950609739159,0.1428571428571428,0.4883720930232553,0.25,202,84,39,18,0,6051,4,17,41,7000000,579166.6666666666,7000000.0,2000000.0,,300000.0,4,7800000,0.4,0.0
465555,Djordje,Petrovic,2024,667,Yugoslavia (Republic),PoÅ¾arevac,Serbia,08-10-99,Goalkeeper,Goalkeeper,Right,194.0,30-06-25,Rabona Sports,https://img.a.transfermarkt.technology/portrait/header/465555-1714721408.jpg?lm=1,FR1,Racing Club de Strasbourg Alsace,20000000.0,20000000.0,25,117,138,4,2,2,3,11,8,2,1,3,1,15,3,3,8,7,13,12,6,13,11,13,16,3,2,2,14,7,11,10,11,12,15,13,13,11,11,12,9,14,8,11,12,11,12,9,13,12,12,14,11,13,11,10,12,3,13,10,12,5,13,20,1,1,1,1,1,1,1,1,1,1,1,1,1,89,7,20,3992741,6005,5352,3400,Mediterranean_Hispanic,112,1,0,4362.0,Unknown,62216198,9111392.0,2.0,110,1179,85,2,1,3,159,5,0.45845461762371,0.3582887700534758,0.463235294117647,0.004203331958938,0.006578947368421,0.0,0.0997749437359339,0.0997749437359339,0.0505924720131114,0.1428571428571428,0.7209302325581395,0.2916666666666665,0,0,0,0,0,0,0,0,0,18000000,1052941.1764705882,20000000.0,2000000.0,100000.0,600000.0,5,6100000,-0.1,1.0
465606,Halil,Dervi?O?Lu,2024,2832,Netherlands,Rotterdam,TÃ¼rkiye,08-12-99,Centre-Forward,Attack,Right,183.0,30-06-25,Ersan Dervisoglu,https://img.a.transfermarkt.technology/portrait/header/465606-1689610312.png?lm=1,TR1,Gaziantep Futbol KulÃ¼bÃ¼ A.?.,1000000.0,4300000.0,25,125,144,8,8,15,11,17,8,11,11,5,5,13,11,5,15,9,12,7,13,9,13,12,12,17,7,12,7,12,11,12,13,13,10,13,12,11,11,12,8,12,5,12,1,1,2,3,2,4,3,2,1,3,1,10,13,6,11,13,12,12,12,1,1,1,1,1,1,1,1,1,1,15,18,15,20,75,15,20,17027587,6500,6500,5850,North_African__Middle_Eastern,118,13,6,17399.0,Burnley,37071106,1750000.0,2.0,67,1253,100,0,1,6,103,3,0.6103466525535857,0.6203208556149732,0.5073529411764706,0.0167920842559001,0.0855263157894736,0.0789473684210526,0.0047511877969492,0.0212553138284571,0.0096947137420483,0.1428571428571428,0.4651162790697669,0.2916666666666665,232,61,35,16,0,5772,3,6,14,900000,32000.0,4300000.0,1000000.0,200000.0,1800000.0,10,1800000,-0.1,-0.25
465830,Mattéo,Guendouzi,2024,398,France,Poissy,France,14-04-99,Central Midfield,Midfield,Right,185.0,30-06-28,Unknown,https://img.a.transfermarkt.technology/portrait/header/465830-1646212708.jpg?lm=1,IT1,SocietÃ  Sportiva Lazio S.p.A.,25000000.0,50000000.0,25,142,163,9,11,14,9,15,11,12,11,5,12,15,7,15,16,14,14,15,12,12,15,13,14,14,12,13,13,14,16,15,15,14,11,13,14,15,11,15,15,13,7,8,1,1,4,1,3,3,2,3,4,3,2,15,13,15,8,10,11,7,13,1,1,1,1,1,1,17,1,20,1,1,14,1,1,68,8,20,41628469,7100,7100,6250,North_African__Middle_Eastern,145,6,1,49999.0,Unknown,48037391,10666666.67,3.0,34,1160,36,3,1,6,185,1,0.6897327335273882,0.6631016042780749,0.7058823529411764,0.0482712071278004,0.0394736842105263,0.0131578947368421,0.1247811952988247,0.2498124531132783,0.0592331268646351,0.2857142857142857,0.5116279069767438,0.2916666666666665,340,17,34,59,2,6476,10,29,105,32000000,1179629.6296296297,50000000.0,8500000.0,600000.0,40500000.0,4,18500000,0.28,0.6
465955,Marcin,Bulka,2024,417,Poland,P?ock,Poland,04-10-99,Goalkeeper,Goalkeeper,Right,199.0,30-06-26,Gol International,https://img.a.transfermarkt.technology/portrait/header/465955-1611915733.jpg?lm=1,FR1,Olympique Gymnaste Club Nice CÃ´te d'Azur,20000000.0,20000000.0,25,110,138,3,2,1,3,7,6,3,1,3,1,7,2,2,6,11,11,10,10,10,11,12,14,1,8,2,13,12,11,12,9,16,18,10,11,6,14,14,5,15,13,11,17,11,9,8,11,15,12,11,12,8,10,15,14,3,11,14,15,11,19,20,1,1,1,1,1,1,1,1,1,1,1,1,1,99,10,20,2188000,5083,4854,2766,Northern_European,105,0,0,5293.0,Unknown,28111106,2000000.0,1.0,75,1106,78,2,1,7,142,5,0.3925641704154539,0.2904812834224599,0.411764705882353,0.0051023216335926,0.0,0.0,0.0997749437359339,0.0997749437359339,0.0110836412122558,0.0,0.8372093023255816,0.2916666666666665,0,0,0,0,0,0,2,29,121,20000000,1218750.0,20000000.0,100000.0,,900000.0,3,100000,0.0,0.3333333333333333
465967,Ander,Guevara,2024,1108,Spain,Vitoria-Gasteiz,Spain,07-07-97,Central Midfield,Midfield,Right,180.0,30-06-27,YOU FIRST,https://img.a.transfermarkt.technology/portrait/header/465967-1705338008.jpg?lm=1,ES1,Deportivo AlavÃ©s S.A.D.,5000000.0,7500000.0,27,131,145,9,8,12,10,12,8,11,14,8,14,14,8,13,14,14,13,14,10,12,14,10,13,8,10,9,13,16,16,12,14,13,10,14,11,15,13,12,15,12,11,18,3,3,2,1,3,3,3,3,1,2,1,14,9,7,15,13,14,11,12,1,1,1,1,1,1,20,1,20,1,1,1,1,1,73,13,20,7296605,6550,6550,4400,Mediterranean_Hispanic,130,0,0,12466.0,Unknown,67246381,1800000.0,1.0,89,1617,89,3,1,3,59,1,0.6169621593014025,0.4652406417112299,0.5955882352941175,0.0120286942826767,0.0,0.0,0.0247561890472618,0.0372593148287071,0.0099724992360898,0.0,0.3953488372093026,0.375,238,4,4,40,0,5075,5,27,93,5000000,288235.29411764705,7500000.0,2500000.0,,250000.0,2,7500000,0.0,0.0
466121,Nikola,Terzic,2024,3385,Yugoslavia (Republic),Jagodina,Serbia,28-09-00,Right Winger,Attack,Left,177.0,30-06-27,Football Dreams,https://img.a.transfermarkt.technology/portrait/header/466121-1676456865.png?lm=1,GR1,Panserraikos Serres,500000.0,1800000.0,24,116,137,10,11,12,12,11,9,8,13,11,9,12,6,11,12,10,12,11,13,10,13,12,11,13,12,12,12,13,15,12,12,11,11,12,12,11,10,13,14,13,8,13,3,1,3,1,1,2,3,2,3,3,2,11,12,9,12,12,12,11,12,1,1,1,1,1,1,5,12,14,14,15,18,20,1,68,20,10,1813999,5550,5550,3000,Mediterranean_Hispanic,111,0,0,1119.0,Unknown,62235795,9111392.0,2.0,110,684,85,0,0,3,152,10,0.4846520243450648,0.3155080213903743,0.4558823529411764,0.0010718351652702,0.0,0.0,0.0022505626406601,0.0087521880470117,0.0505924720131114,0.1428571428571428,0.3255813953488373,0.25,124,21,8,12,1,3928,1,1,9,450000,33333.333333333336,1800000.0,300000.0,50000.0,250000.0,6,850000,-0.1,-0.1
466783,Arnau,Tenas,2024,583,Spain,Vic,Spain,30-05-01,Goalkeeper,Goalkeeper,Right,185.0,30-06-26,Unknown,https://img.a.transfermarkt.technology/portrait/header/466783-1701444229.jpg?lm=1,FR1,Paris Saint-Germain Football Club,5000000.0,5000000.0,23,120,160,4,3,3,3,13,7,2,3,3,2,13,7,3,11,12,11,11,11,11,11,12,14,10,13,2,12,7,7,12,14,12,13,14,11,9,11,12,6,15,6,2,12,12,12,11,14,12,13,14,8,7,11,11,13,5,14,17,15,13,15,20,1,1,1,1,1,1,1,1,1,1,1,1,1,78,12,20,11760000,5990,5990,3740,Mediterranean_Hispanic,120,0,0,3989.0,Unknown,67265794,9111392.0,2.0,89,1581,89,2,1,3,154,5,0.5428684837258534,0.3946524064171122,0.5220588235294117,0.0038431567187166,0.0,0.0,0.0247561890472618,0.0247561890472618,0.0505924720131114,0.1428571428571428,0.5116279069767438,0.2083333333333332,0,0,0,0,0,0,2,7,34,4000000,250000.0,5000000.0,1000000.0,,1500000.0,1,0,-0.2,-0.2
466794,Eric,García,2024,131,Spain,Barcelona,Spain,09-01-01,Centre-Back,Defender,Right,182.0,30-06-26,Unknown,https://img.a.transfermarkt.technology/portrait/header/466794-1693604801.jpg?lm=1,ES1,Futbol Club Barcelona,20000000.0,20000000.0,23,144,165,4,9,12,7,14,6,13,7,8,15,15,9,15,14,12,14,13,15,12,14,14,16,12,14,12,15,15,14,13,14,12,12,12,13,14,13,13,8,13,5,10,1,2,4,2,3,2,3,1,1,2,2,13,16,3,10,12,16,14,15,1,1,20,12,1,8,1,1,1,1,1,1,1,1,79,12,20,33000000,7240,7240,6490,Mediterranean_Hispanic,144,17,0,57692.0,Unknown,28116427,1700000.0,1.0,89,141,89,1,1,3,96,2,0.7082561524212755,0.6887700534759358,0.6985294117647058,0.0556997007552092,0.1118421052631578,0.0,0.0997749437359339,0.0997749437359339,0.0094169282480068,0.0,0.4418604651162785,0.2083333333333332,209,15,5,20,2,7529,12,40,37,18000000,733333.3333333334,20000000.0,6000000.0,7000000.0,18000000.0,3,6000000,-0.1,0.2
466802,Adrián,Bernabé,2024,130,Spain,Barcelona,Spain,26-05-01,Central Midfield,Midfield,Left,170.0,30-06-27,Unknown,https://img.a.transfermarkt.technology/portrait/header/466802-1714503707.jpg?lm=1,IT1,Parma Calcio 1913,12000000.0,12000000.0,23,125,159,10,12,13,11,14,13,9,9,8,9,14,10,12,15,12,11,13,12,13,14,14,13,13,9,12,13,12,13,13,14,10,5,14,14,13,12,14,7,11,3,15,1,2,2,2,3,2,2,1,1,2,3,15,12,3,10,12,15,13,11,1,10,1,1,12,1,8,12,20,1,12,10,1,1,71,20,10,8532001,6250,5532,4318,Mediterranean_Hispanic,128,0,0,16324.0,Unknown,67271025,9111392.0,2.0,89,141,89,3,0,3,155,1,0.4822704419158508,0.4564705882352941,0.5808823529411764,0.0157540456949402,0.0,0.0,0.0597649412353088,0.0597649412353088,0.0505924720131114,0.1428571428571428,0.1627906976744184,0.2083333333333332,173,29,30,33,1,2209,5,53,172,15000000,1136363.6363636365,15000000.0,500000.0,2300000.0,1800000.0,1,500000,0.25,1.0
466805,Nico,González,2024,720,Spain,A CoruÃ±a,Spain,03-01-02,Central Midfield,Midfield,Left,188.0,30-06-28,Gestifute,https://img.a.transfermarkt.technology/portrait/header/466805-1693590295.png?lm=1,PO1,Futebol Clube do Porto,15000000.0,25000000.0,22,147,158,9,14,16,12,15,7,15,12,4,4,14,15,6,14,16,13,16,14,10,13,11,17,15,7,15,6,11,15,16,14,13,12,14,16,12,11,14,9,12,9,12,3,3,2,2,3,2,2,1,2,3,1,16,15,12,12,14,14,10,7,1,1,1,1,1,1,1,15,1,11,20,10,18,17,75,20,8,24227050,7450,7100,6000,Native_American,139,21,3,61731.0,Unknown,14181375,8440000.0,1.0,89,7,89,3,0,5,100,1,0.6897327335273882,0.6363636363636364,0.6617647058823528,0.0595998288926204,0.1381578947368421,0.0394736842105263,0.0747686921730432,0.1247811952988247,0.0468624128448012,0.0,0.581395348837209,0.1666666666666666,174,14,15,32,1,3745,6,23,60,18000000,1278571.4285714286,25000000.0,6000000.0,100000.0,14000000.0,3,14500000,0.2,1.0
466810,Ansu,Fati,2024,131,Guinea-Bissau,Bissau,Spain,31-10-02,Left Winger,Attack,Right,178.0,30-06-27,Unknown,https://img.a.transfermarkt.technology/portrait/header/466810-1721828228.jpg?lm=1,ES1,Futbol Club Barcelona,25000000.0,80000000.0,22,149,-95,7,13,16,16,14,7,11,14,6,4,12,12,5,16,8,14,12,14,13,14,13,16,19,9,16,5,10,10,16,17,13,8,15,15,11,10,14,5,15,14,15,3,2,1,3,3,1,1,1,2,2,1,15,14,5,15,15,14,13,15,1,1,1,1,1,1,1,14,1,13,20,10,19,19,66,12,20,74100001,7800,7800,6900,African_Caribbean,143,4,1,230768.0,Unknown,67276122,9111392.0,2.0,44,202,89,0,1,1,96,7,0.7823498279968246,0.7326203208556149,0.6911764705882353,0.2228248746870193,0.0263157894736842,0.0131578947368421,0.1247811952988247,0.3998499624906226,0.0505924720131114,0.1428571428571428,0.3488372093023257,0.1666666666666666,156,37,12,13,1,3771,14,131,306,10000000,-937500.0,80000000.0,20000000.0,60000000.0,35000000.0,4,60000000,-0.6,-0.6666666666666666
467243,Viktor,Kornienko,2024,2740,Ukraine,Poltava,Ukraine,14-02-99,Left-Back,Defender,Left,178.0,30-06-25,ProStar,https://img.a.transfermarkt.technology/portrait/header/467243-1690179509.png?lm=1,UKR1,Vorskla Poltava,1000000.0,3000000.0,25,128,140,11,13,12,8,10,14,12,10,13,11,12,8,12,12,14,12,16,13,12,11,11,16,5,5,13,12,12,17,15,12,14,12,10,15,15,14,15,2,15,13,9,3,1,1,2,1,3,3,2,2,1,3,5,13,4,20,13,16,15,6,1,17,1,1,20,1,1,10,1,1,1,1,1,1,65,20,5,9322629,6000,5752,4501,Northern_European,128,2,1,8119.0,Unknown,71099086,9111392.0,2.0,103,1162,101,1,0,7,219,8,0.5113786716062451,0.4760427807486631,0.5808823529411764,0.0078311560273346,0.0131578947368421,0.0131578947368421,0.0047511877969492,0.0147536884221055,0.0505924720131114,0.1428571428571428,0.3488372093023257,0.2916666666666665,87,4,11,8,0,4206,8,39,204,700000,46428.57142857143,3000000.0,1000000.0,,400000.0,3,350000,-0.3,-0.4166666666666667
467250,Yukhym,Konoplya,2024,660,Ukraine,Donetsk,Ukraine,26-08-99,Right-Back,Defender,Right,180.0,30-09-26,Unknown,https://img.a.transfermarkt.technology/portrait/header/467250-1723486422.png?lm=1,UKR1,FC Shakhtar Donetsk,6000000.0,6000000.0,25,126,137,11,13,11,7,14,13,10,6,14,13,15,8,11,11,9,12,10,11,12,9,12,11,9,7,13,10,13,15,16,13,11,6,14,15,14,12,10,7,12,6,12,1,2,2,3,3,1,1,2,1,1,3,6,6,12,20,11,12,7,16,1,15,1,20,10,15,1,5,1,10,1,1,1,1,74,10,20,11532369,5750,5750,3200,Northern_European,123,3,0,8119.0,Unknown,71099085,9111392.0,2.0,103,422,101,1,1,7,72,11,0.5111140513363324,0.3368983957219251,0.5441176470588236,0.0078311560273346,0.0197368421052631,0.0,0.0297574393598399,0.0297574393598399,0.0505924720131114,0.1428571428571428,0.3953488372093026,0.2916666666666665,142,6,20,29,0,5592,3,13,59,7000000,496428.5714285714,7000000.0,75000.0,,725000.0,2,200000,0.16666666666666666,0.75
467434,Rocco,Reitz,2024,18,Germany,Duisburg,Germany,29-05-02,Central Midfield,Midfield,Right,176.0,30-06-28,Sports360 GmbH,https://img.a.transfermarkt.technology/portrait/header/467434-1662966138.jpg?lm=1,L1,Borussia Verein fÃ¼r LeibesÃ¼bungen 1900 MÃ¶nchengladbach,10000000.0,10000000.0,22,108,139,12,11,11,9,13,12,6,11,3,11,13,8,12,14,13,11,12,12,10,13,11,12,12,6,12,11,12,12,12,11,12,7,13,12,13,8,11,9,11,7,10,1,3,2,3,4,3,3,1,1,2,3,10,12,4,14,9,12,10,9,1,1,1,1,1,1,15,12,20,12,10,15,10,8,72,11,20,3775000,5400,5400,3900,Northern_European,108,0,0,7671.0,Unknown,91206105,9111392.0,2.0,38,436,40,3,1,7,42,1,0.4648055041016142,0.4117647058823529,0.4338235294117646,0.0073985594921625,0.0,0.0,0.0497624406101525,0.0497624406101525,0.0505924720131114,0.1428571428571428,0.3023255813953489,0.1666666666666666,140,13,15,5,1,4918,5,34,98,15000000,1245833.3333333333,15000000.0,0.0,500000.0,650000.0,4,3350000,0.5,0.5
467437,Malik,Tillman,2024,383,Germany,NÃ¼rnberg,United States,28-05-02,Attacking Midfield,Midfield,Right,187.0,30-06-28,ROOF,https://img.a.transfermarkt.technology/portrait/header/467437-1726846425.jpg?lm=1,NL1,Eindhovense Voetbalvereniging Philips Sport Vereniging,20000000.0,20000000.0,22,127,142,4,9,13,13,14,7,14,12,2,9,13,12,10,15,11,13,11,13,10,13,11,12,13,4,13,7,8,7,13,12,12,15,12,13,12,10,13,4,7,9,16,2,2,1,2,1,3,1,2,1,1,1,13,14,2,14,12,13,12,16,1,1,1,1,1,1,10,12,17,12,15,20,15,18,71,11,20,4840000,6350,6350,4100,African_Caribbean,114,2,0,16300.0,Rangers,91187679,12000000.0,1.0,38,1067,102,3,1,1,62,0,0.590500132310135,0.4331550802139037,0.4779411764705882,0.015730870880556,0.0131578947368421,0.0,0.0997749437359339,0.0997749437359339,0.0666407400205561,0.0,0.5581395348837206,0.1666666666666666,219,74,49,27,0,5069,15,101,169,30000000,1966666.6666666667,30000000.0,0.0,500000.0,4500000.0,2,4300000,0.5,1.5
467563,Armel,Bella-Kotchap,2024,180,France,Paris,Germany,11-12-01,Centre-Back,Defender,Right,190.0,30-06-26,Unknown,https://img.a.transfermarkt.technology/portrait/header/467563-1663251475.jpg?lm=1,GB1,Southampton Football Club,12000000.0,20000000.0,23,128,-85,4,7,10,6,12,5,13,7,9,13,13,7,13,12,10,13,13,10,11,10,11,12,9,9,6,14,12,12,14,11,14,16,13,15,11,15,11,7,15,5,8,3,3,1,3,2,2,1,2,3,3,2,11,14,12,7,15,10,14,10,1,1,20,8,1,1,8,1,1,1,1,1,1,1,87,14,20,79222355,6395,6395,4995,African_Caribbean,127,0,0,46397.0,Unknown,92102718,12000000.0,1.0,34,1122,40,1,1,1,186,2,0.5964540883831702,0.5288770053475935,0.5735294117647058,0.0447930537356352,0.0,0.0,0.0597649412353088,0.0997749437359339,0.0666407400205561,0.0,0.6279069767441858,0.2083333333333332,160,3,2,22,2,2940,7,43,112,12000000,743750.0,20000000.0,6000000.0,2300000.0,18000000.0,3,8000000,0.0,-0.3333333333333333
467632,Cristian,Cásseres Jr.,2024,415,Venezuela,Caracas,Venezuela,20-01-00,Central Midfield,Midfield,Right,176.0,30-06-27,T&C,https://img.a.transfermarkt.technology/portrait/header/467632-1646141354.JPG?lm=1,FR1,Toulouse Football Club,4000000.0,4000000.0,24,118,137,11,9,12,8,12,10,7,9,9,11,13,4,12,12,14,10,11,11,10,13,12,13,12,9,9,10,13,14,14,13,13,7,11,13,13,12,13,14,14,11,14,1,2,2,2,3,3,2,1,1,3,4,11,12,7,10,9,11,12,10,1,1,1,1,1,1,17,1,20,1,1,17,1,1,69,12,20,2821536,6008,5808,3751,African_Caribbean,114,17,0,5312.0,Unknown,86055764,1000000.0,1.0,108,315,105,3,1,1,203,1,0.5187880391638,0.3958288770053475,0.4779411764705882,0.0051206683616468,0.1118421052631578,0.0,0.0197549387346836,0.0197549387346836,0.0055279313314258,0.0,0.3023255813953489,0.25,234,21,20,50,1,3494,2,8,27,5000000,226136.36363636365,5000000.0,75000.0,250000.0,2000000.0,4,50000,0.25,0.42857142857142855
467720,Youssoufa,Moukoko,2024,417,Cameroon,YaoundÃ©,Germany,20-11-04,Centre-Forward,Attack,Left,179.0,30-06-25,Wasserman,https://img.a.transfermarkt.technology/portrait/header/467720-1709561463.jpg?lm=1,FR1,Olympique Gymnaste Club Nice CÃ´te d'Azur,20000000.0,30000000.0,20,121,-95,11,12,16,16,14,11,6,11,7,5,11,13,5,16,13,11,11,14,11,9,7,13,15,5,9,6,10,13,16,16,13,7,15,15,11,11,8,5,17,12,14,1,3,2,2,1,2,3,2,1,2,2,10,18,2,15,16,16,15,16,1,1,1,1,1,1,1,1,1,1,10,10,10,20,72,20,10,68024000,6500,6500,5750,African_Caribbean,118,0,0,5999.0,Unknown,2000074825,9111392.0,2.0,15,1682,40,0,0,1,142,3,0.6103466525535857,0.6096256684491979,0.5073529411764706,0.0057840474233951,0.0,0.0,0.0997749437359339,0.1497874468617154,0.0505924720131114,0.1428571428571428,0.3720930232558141,0.0833333333333332,211,162,37,13,0,4571,12,61,71,18000000,666666.6666666666,30000000.0,5000000.0,30000000.0,18000000.0,1,2000000,-0.18181818181818182,-0.4
467940,Unknown,Vitinho,2024,8024,Brazil,Guaraulhos,Brazil,04-01-00,Central Midfield,Midfield,Right,175.0,30-06-25,Unknown,https://img.a.transfermarkt.technology/portrait/header/467940-1623883783.jpg?lm=1,PO1,Futebol Clube de Arouca,300000.0,1000000.0,24,130,138,16,15,15,12,14,12,5,13,5,5,13,12,6,15,10,10,5,11,8,15,8,10,15,10,12,7,11,11,14,15,13,10,14,14,12,13,10,2,10,3,11,1,1,2,3,2,2,3,3,2,2,3,12,7,5,15,10,12,11,14,1,1,1,1,1,1,1,12,1,10,18,20,18,12,78,15,20,8363354,6500,6500,5000,African_Caribbean,127,0,0,21337.0,Unknown,19162450,9111392.0,2.0,10,574,11,3,1,1,98,1,0.6103466525535857,0.5294117647058822,0.5735294117647058,0.0205946850494444,0.0,0.0,0.0012503125781445,0.0047511877969492,0.0505924720131114,0.1428571428571428,0.2790697674418605,0.25,51,2,4,2,0,1457,3,59,336,0,-10000.0,1000000.0,300000.0,,,2,500000,-1.0,-1.0
467992,Samuele,Ricci,2024,416,Italy,Pontedera,Italy,21-08-01,Defensive Midfield,Midfield,Right,181.0,30-06-26,CAA Base Ltd,https://img.a.transfermarkt.technology/portrait/header/467992-1646648743.jpg?lm=1,IT1,Torino Calcio,22000000.0,22000000.0,23,133,162,10,11,13,9,13,10,6,12,4,10,16,8,12,14,12,15,13,13,14,14,14,16,13,11,12,11,13,14,12,13,14,11,15,13,15,12,12,5,13,4,11,2,4,1,2,2,2,3,3,2,3,1,13,14,6,13,13,15,15,12,1,1,1,1,1,1,18,1,20,10,1,10,10,1,70,10,20,48300003,6650,6900,5150,Mediterranean_Hispanic,133,0,0,35577.0,Unknown,43390774,8500000.0,1.0,52,1165,54,3,1,3,201,4,0.6632707065361206,0.5454545454545454,0.6176470588235294,0.0343450749174155,0.0,0.0,0.1097774443610902,0.1097774443610902,0.047195755437651,0.0,0.418604651162791,0.2083333333333332,249,9,15,36,1,2105,10,28,37,28000000,1856666.6666666667,28000000.0,50000.0,450000.0,12000000.0,1,0,0.2727272727272727,0.4
467994,Luca,Belardinelli,2024,749,Italy,Ravenna,Italy,14-03-01,Central Midfield,Midfield,Right,190.0,30-06-25,Unknown,https://img.a.transfermarkt.technology/portrait/header/467994-1686206983.jpg?lm=1,IT1,Empoli Football Club S.r.l.,1000000.0,2600000.0,23,103,139,11,8,8,9,12,11,12,11,6,11,12,8,12,12,10,11,12,11,8,12,12,13,11,12,12,11,11,14,10,10,12,12,13,10,13,13,9,10,13,12,8,1,1,3,1,3,3,3,2,4,1,4,11,13,8,14,12,13,13,12,1,1,12,1,1,1,20,1,20,1,1,11,1,1,75,10,20,1831999,5150,5150,1002,Mediterranean_Hispanic,102,0,0,2728.0,SÃ¼dtirol - Alto Adige,43390125,9111392.0,2.0,52,1206,54,3,1,3,64,1,0.4317279703625297,0.1018181818181818,0.3897058823529412,0.002625513346279,0.0,0.0,0.0047511877969492,0.0127531882970742,0.0505924720131114,0.1428571428571428,0.6279069767441858,0.2083333333333332,161,19,12,29,0,1464,7,37,117,800000,63636.36363636364,2600000.0,700000.0,,125000.0,3,775000,-0.2,-0.6363636363636364
468002,Ben,Johnson,2024,677,England,London,England,24-01-00,Right-Back,Defender,Right,184.0,30-06-28,CAA Base Ltd,https://img.a.transfermarkt.technology/portrait/header/468002-1694618190.jpg?lm=1,GB1,Ipswich Town Football Club,8000000.0,12000000.0,24,135,150,6,13,12,10,12,5,11,9,11,14,10,3,14,12,12,14,14,13,14,10,13,14,8,11,13,15,15,14,13,14,13,12,11,13,14,12,11,5,12,13,15,2,2,1,1,1,1,2,2,2,3,2,14,12,5,12,10,15,13,15,1,15,1,20,12,11,1,1,1,1,1,1,1,1,67,13,20,36309034,6733,6733,5233,African_Caribbean,134,0,0,34798.0,Unknown,28111063,9111392.0,2.0,32,858,33,1,1,1,115,11,0.6411749139984123,0.554331550802139,0.625,0.0335928590671944,0.0,0.0,0.0397599399849962,0.0597649412353088,0.0505924720131114,0.1428571428571428,0.4883720930232553,0.25,206,3,9,19,1,8598,1,1,8,9000000,666666.6666666666,12000000.0,2000000.0,,2000000.0,1,1000000,0.125,0.125
468066,Jens,Cajuste,2024,677,Sweden,GÃ¶teborg,Sweden,10-08-99,Defensive Midfield,Midfield,Right,188.0,30-06-25,World in Motion,https://img.a.transfermarkt.technology/portrait/header/468066-1691568301.jpg?lm=1,GB1,Ipswich Town Football Club,10000000.0,10000000.0,25,128,151,10,7,11,8,11,11,12,8,8,11,13,8,13,13,16,12,11,14,11,12,12,14,13,10,13,11,15,17,12,12,15,13,12,13,14,15,11,5,14,13,11,2,3,4,1,1,1,3,2,1,3,2,15,10,6,13,9,14,14,16,1,1,4,15,1,15,18,8,20,15,8,10,10,9,77,12,20,10556708,7000,6500,3400,African_Caribbean,124,13,0,29630.0,Unknown,93069729,7390000.0,3.0,91,582,91,3,1,1,115,4,0.6103466525535857,0.3582887700534758,0.5514705882352942,0.0286025490364588,0.0855263157894736,0.0,0.0497624406101525,0.0497624406101525,0.0410289174699297,0.2857142857142857,0.581395348837209,0.2916666666666665,208,11,8,39,0,6724,10,34,63,12000000,597500.0,12000000.0,2000000.0,50000.0,1000000.0,4,6050000,0.2,0.2
468198,Joe,Aribo,2024,180,England,London,Nigeria,21-07-96,Central Midfield,Midfield,Left,183.0,30-06-26,Unknown,https://img.a.transfermarkt.technology/portrait/header/468198-1656428996.png?lm=1,GB1,Southampton Football Club,5000000.0,15000000.0,28,133,144,10,11,16,14,19,8,8,12,6,6,13,9,10,16,7,16,6,15,10,14,12,11,15,5,14,9,11,15,11,14,15,13,14,13,14,15,8,4,10,4,12,1,1,1,3,1,2,2,3,1,3,1,14,11,3,8,8,13,10,10,1,1,1,1,1,1,14,1,15,1,17,20,19,1,74,20,7,29229866,6650,6750,5000,African_Caribbean,133,20,2,69595.0,Unknown,89046527,9111392.0,2.0,32,858,70,3,0,1,186,1,0.6434241862926701,0.5294117647058822,0.6176470588235294,0.0671934430725168,0.131578947368421,0.0263157894736842,0.0247561890472618,0.0747686921730432,0.0505924720131114,0.1428571428571428,0.4651162790697669,0.4166666666666665,343,51,41,31,0,5990,4,25,62,6000000,362500.0,15000000.0,4000000.0,,200000.0,2,5300000,0.2,0.0
468309,Lucas,Rosa,2024,366,Brazil,RibeirÃ£o Preto,Brazil,03-04-00,Right-Back,Defender,Left,177.0,30-06-26,Talents Sports,https://img.a.transfermarkt.technology/portrait/header/468309-1552229769.jpg?lm=1,ES1,Real Valladolid Club de FÃºtbol S.A.D.,1200000.0,1200000.0,24,113,-75,7,10,11,11,12,7,9,11,8,11,13,8,11,13,9,12,9,12,11,13,12,11,11,10,12,11,10,11,12,12,10,14,12,11,13,13,12,8,10,7,12,1,1,2,3,1,4,3,3,3,2,3,15,11,4,10,10,13,10,19,1,1,1,1,1,1,10,1,12,12,12,10,20,1,80,20,8,1158284,5636,5636,1990,African_Caribbean,105,0,0,223.0,Unknown,19409769,9111392.0,2.0,10,1227,11,1,0,1,169,11,0.4960306959513099,0.2074866310160427,0.411764705882353,0.0002066420949259,0.0,0.0,0.0057514378594648,0.0057514378594648,0.0505924720131114,0.1428571428571428,0.3255813953488373,0.25,155,2,7,30,0,4307,4,18,159,2000000,146153.84615384616,2000000.0,0.0,,150000.0,2,25000,0.6666666666666666,0.6666666666666666
468332,Unknown,Ismael,2024,979,Portugal,Estarreja,Portugal,25-03-99,Defensive Midfield,Midfield,Right,184.0,30-06-25,Unknown,https://img.a.transfermarkt.technology/portrait/header/468332-1705663732.png?lm=1,PO1,Moreirense Futebol Clube,700000.0,700000.0,25,122,125,15,12,12,10,14,14,6,13,6,9,13,12,11,14,14,14,12,11,12,14,13,10,13,6,10,11,11,14,13,14,13,7,15,13,14,8,13,9,10,11,12,3,3,1,3,2,1,1,3,1,1,2,14,10,6,5,9,10,10,10,1,1,1,1,1,1,18,7,20,10,7,14,1,1,68,9,20,5007121,5750,4098,3824,Mediterranean_Hispanic,122,0,0,20278.0,Unknown,93053376,9111392.0,2.0,76,476,79,3,1,3,134,4,0.2925377083884626,0.4036363636363635,0.536764705882353,0.0195720963647406,0.0,0.0,0.0032508127031757,0.0032508127031757,0.0505924720131114,0.1428571428571428,0.4883720930232553,0.2916666666666665,100,1,1,22,0,2675,0,0,0,1000000,75000.0,1000000.0,50000.0,,,3,50000,2.3333333333333335,4.0
468539,Daniel,Peretz,2024,27,Israel,Tel Aviv,Israel,10-07-00,Goalkeeper,Goalkeeper,Right,190.0,30-06-28,CAA Base Ltd,https://img.a.transfermarkt.technology/portrait/header/468539-1700659786.jpg?lm=1,L1,FC Bayern MÃ¼nchen,3000000.0,5000000.0,24,120,140,4,3,3,2,11,6,10,1,2,4,13,15,10,12,12,12,12,12,13,11,13,12,11,11,2,13,13,13,11,9,9,11,14,8,13,12,14,5,7,10,15,13,9,10,14,13,14,13,15,14,11,17,13,13,6,14,15,12,11,11,20,1,1,1,1,1,1,1,1,1,1,1,1,1,88,11,20,1505998,6242,6492,3742,Northern_European,121,0,0,5288.0,Unknown,42083355,5000000.0,1.0,51,1481,53,2,1,7,68,5,0.6092881714739349,0.3948663101604278,0.5294117647058822,0.0050974935472626,0.0,0.0,0.0147536884221055,0.0247561890472618,0.0277507708547459,0.0,0.6279069767441858,0.25,0,0,0,0,0,0,4,27,63,3000000,190000.0,5000000.0,1000000.0,,150000.0,2,1000000,0.0,-0.25
469050,Nathan,Collins,2024,1148,Ireland,Leixlip,Ireland,30-04-01,Centre-Back,Defender,Right,193.0,30-06-29,Unknown,https://img.a.transfermarkt.technology/portrait/header/469050-1688381729.jpg?lm=1,GB1,Brentford Football Club,25000000.0,25000000.0,23,133,-8,4,6,9,3,11,5,15,4,6,14,11,5,15,11,13,14,17,15,14,10,13,14,4,13,3,14,15,15,13,11,12,15,15,14,14,14,15,7,14,4,16,3,1,1,3,1,2,2,2,2,3,3,11,16,4,10,11,16,14,7,1,1,20,14,1,10,1,1,1,1,1,1,1,1,0,8,20,93518337,6650,6650,5000,Northern_European,133,6,1,34798.0,Unknown,28117372,21716666.67,3.0,49,818,52,1,1,7,43,2,0.6301931727970362,0.5294117647058822,0.6176470588235294,0.0335928590671944,0.0394736842105263,0.0131578947368421,0.1247811952988247,0.1247811952988247,0.1206237210478068,0.2857142857142857,0.6976744186046511,0.2083333333333332,208,11,3,21,4,3786,5,28,41,28000000,1833333.3333333333,28000000.0,100000.0,800000.0,8000000.0,3,15000000,0.12,0.12
469211,Liberato,Cacace,2024,749,New Zealand,Wellington,New Zealand,27-09-00,Left-Back,Defender,Left,183.0,30-06-25,Unknown,https://img.a.transfermarkt.technology/portrait/header/469211-1643724495.jpg?lm=1,IT1,Empoli Football Club S.r.l.,2000000.0,2500000.0,24,121,151,6,13,12,8,14,5,8,12,11,12,12,4,13,13,7,11,10,10,11,12,10,14,11,5,12,11,13,13,15,13,14,11,16,14,14,12,14,10,11,5,9,1,1,1,3,2,1,2,3,4,3,3,8,11,2,12,11,11,14,15,1,20,7,1,20,1,1,10,1,1,1,1,1,1,66,20,8,4982399,6050,5900,4900,Mediterranean_Hispanic,115,12,1,5577.0,Unknown,88024471,2100000.0,2.0,68,1652,69,1,0,3,64,8,0.530960571579783,0.5187165775401069,0.4852941176470588,0.0053765569371392,0.0789473684210526,0.0131578947368421,0.0097524381095273,0.0122530632658164,0.0116392122003388,0.1428571428571428,0.4651162790697669,0.25,212,6,11,33,1,3045,1,0,17,2000000,103947.36842105263,2500000.0,500000.0,750000.0,1200000.0,2,1725000,0.0,0.0
469669,Yvan,Neyou,2024,1244,Cameroon,Douala,Cameroon,03-01-97,Defensive Midfield,Midfield,Right,180.0,30-06-25,IFM,https://img.a.transfermarkt.technology/portrait/header/469669-1703762516.jpg?lm=1,ES1,Club Deportivo LeganÃ©s S.A.D.,2000000.0,5000000.0,27,124,130,11,13,13,7,12,11,8,8,6,6,11,7,10,12,12,14,10,13,13,12,12,10,11,6,14,8,14,13,14,15,12,11,12,15,14,12,10,9,16,8,13,3,1,2,1,1,3,1,2,2,1,3,15,14,4,10,12,12,10,14,1,1,1,1,1,1,10,10,20,15,12,16,15,1,63,8,20,4156702,6250,6250,3800,African_Caribbean,114,5,0,2684.0,LeganÃ©s,85134218,1000000.0,1.0,15,426,15,3,1,1,54,4,0.5772691188145012,0.4010695187165775,0.4779411764705882,0.0025830261865746,0.0328947368421052,0.0,0.0097524381095273,0.0247561890472618,0.0055279313314258,0.0,0.3953488372093026,0.375,182,6,4,44,2,5695,3,16,37,2500000,136111.11111111112,5000000.0,1000000.0,,200000.0,3,1350000,0.25,0.7857142857142857
469781,Marcos,Senesi,2024,989,Argentina,Concordia,Argentina,10-05-97,Centre-Back,Defender,Left,185.0,30-06-26,ROOF,https://img.a.transfermarkt.technology/portrait/header/469781-1576329259.jpg?lm=1,GB1,Association Football Club Bournemouth,22000000.0,22000000.0,27,135,147,6,10,10,8,13,7,14,7,3,13,13,6,14,14,10,15,13,13,12,13,13,13,11,13,10,14,15,15,14,11,14,15,14,11,15,12,13,12,13,6,3,1,3,2,1,3,2,2,1,1,3,2,14,10,1,12,13,15,14,17,1,10,20,1,1,1,1,1,1,1,1,1,1,1,80,20,10,24283271,6750,6400,5550,Mediterranean_Hispanic,133,1,0,52196.0,Unknown,14080605,11000000.0,2.0,4,380,4,1,0,3,22,2,0.5971156390579518,0.588235294117647,0.6176470588235294,0.0503926682612226,0.006578947368421,0.0,0.1097774443610902,0.1097774443610902,0.0610850301397261,0.1428571428571428,0.5116279069767438,0.375,270,16,15,57,0,7609,7,39,106,24000000,1126190.4761904762,24000000.0,6000000.0,,1800000.0,2,0,0.09090909090909091,0.2
469787,Berkan,Kutlu,2024,141,Switzerland,Monthey,TÃ¼rkiye,25-01-98,Central Midfield,Midfield,Left,186.0,30-06-26,Unknown,https://img.a.transfermarkt.technology/portrait/header/469787-1671101403.png?lm=1,TR1,Galatasaray Spor KulÃ¼bÃ¼,3800000.0,5500000.0,26,120,130,8,8,11,9,11,6,10,10,8,14,11,10,13,11,13,13,13,13,15,11,12,14,6,10,11,12,16,18,13,13,13,12,14,14,17,12,16,11,11,10,12,2,2,3,2,2,2,3,1,3,3,2,12,10,6,15,14,15,10,14,1,1,1,1,1,1,16,1,20,1,1,10,1,1,75,20,5,2498858,6250,6250,5000,Mediterranean_Hispanic,119,6,0,12408.0,Unknown,84153377,4000000.0,1.0,92,977,100,3,0,3,102,1,0.5772691188145012,0.5294117647058822,0.5147058823529411,0.0119726884812481,0.0394736842105263,0.0,0.018754688672168,0.0272568142035508,0.0221950609739159,0.0,0.5348837209302322,0.3333333333333332,316,22,9,37,1,7841,3,3,8,3800000,190000.0,5500000.0,800000.0,,,6,2725000,0.0,-0.05
469822,David,Neres,2024,6195,Brazil,SÃ£o Paulo,Brazil,03-03-97,Right Winger,Attack,Left,176.0,30-06-28,Bertolucci Sports,https://img.a.transfermarkt.technology/portrait/header/469822-1701334470.jpg?lm=1,IT1,SocietÃ  Sportiva Calcio Napoli,25000000.0,45000000.0,27,151,157,14,14,18,13,16,10,8,12,7,5,15,10,5,17,12,14,13,13,9,15,11,13,18,5,16,6,12,10,16,16,14,9,14,14,13,11,8,8,12,8,14,4,2,1,2,1,1,3,2,4,2,3,14,14,5,14,14,13,12,12,1,1,1,1,1,1,1,16,7,18,18,14,20,14,74,20,11,25621199,7544,7094,6494,Mixed_Race,146,7,1,41350.0,Unknown,19260918,18175000.0,4.0,10,1456,11,0,0,4,184,10,0.6889388727176502,0.6891978609625667,0.713235294117647,0.0399195833940867,0.0460526315789473,0.0131578947368421,0.1247811952988247,0.2248062015503876,0.1009472485346815,0.4285714285714285,0.3023255813953489,0.375,305,77,77,24,1,9326,12,81,298,28000000,913043.4782608695,45000000.0,9000000.0,,15000000.0,3,5000000,0.12,0.12
470394,Kenneth,Taylor,2024,610,Netherlands,Alkmaar,Netherlands,16-05-02,Central Midfield,Midfield,Left,182.0,30-06-27,PUM,https://img.a.transfermarkt.technology/portrait/header/470394-1682332353.jpg?lm=1,NL1,AFC Ajax Amsterdam,15000000.0,15000000.0,22,141,-85,12,7,11,11,14,15,9,12,8,11,14,12,8,14,8,14,11,12,14,14,14,17,12,11,16,12,15,13,11,12,12,11,12,11,14,9,13,6,12,4,14,3,1,3,3,3,2,1,1,2,3,2,11,14,4,14,14,14,14,14,1,1,13,1,1,1,18,13,20,13,10,17,10,1,66,20,18,108162006,7050,7050,5500,Northern_European,135,0,0,25000.0,Unknown,37073317,9111392.0,2.0,67,45,68,3,0,7,6,1,0.6831172267795713,0.5828877005347594,0.6323529411764706,0.0241317410948361,0.0,0.0,0.0747686921730432,0.0747686921730432,0.0505924720131114,0.1428571428571428,0.4418604651162785,0.1666666666666666,279,60,50,26,1,8824,7,12,363,16000000,897058.8235294118,16000000.0,2000000.0,3000000.0,14000000.0,1,0,0.06666666666666667,0.6
470606,Leighton,Clarkson,2024,370,England,Clitheroe,England,19-10-01,Defensive Midfield,Midfield,Right,183.0,31-05-27,Unique Sports Group,https://img.a.transfermarkt.technology/portrait/header/470606-1697115918.jpg?lm=1,SC1,Aberdeen Football Club,1000000.0,1000000.0,23,109,-75,12,10,10,7,14,13,5,10,4,9,15,10,10,14,11,11,10,13,11,13,11,11,11,10,10,11,12,12,12,13,13,6,11,11,14,6,10,8,10,7,8,3,2,3,1,3,4,1,1,3,4,3,12,12,4,14,12,12,10,12,1,1,1,1,1,1,17,1,20,12,1,15,1,1,62,10,20,43984066,5434,5437,2749,Northern_European,108,0,0,2900.0,Aberdeen,28121438,9111392.0,2.0,32,370,33,3,1,7,12,4,0.4697009790949986,0.288663101604278,0.4338235294117646,0.0027915995160326,0.0,0.0,0.0047511877969492,0.0047511877969492,0.0505924720131114,0.1428571428571428,0.4651162790697669,0.2083333333333332,212,25,35,22,2,5787,0,0,0,1200000,131250.0,1200000.0,0.0,,800000.0,3,650000,0.2,0.4117647058823529
470607,Brennan,Johnson,2024,148,England,Nottingham,Wales,23-05-01,Right Winger,Attack,Right,186.0,30-06-28,Unique Sports Group,https://img.a.transfermarkt.technology/portrait/header/470607-1692959021.jpg?lm=1,GB1,Tottenham Hotspur Football Club,48000000.0,48000000.0,23,136,162,8,13,14,13,12,11,8,10,5,7,14,14,6,13,6,11,12,13,10,12,13,12,13,10,13,8,12,13,16,13,12,8,14,15,13,9,13,5,13,3,9,3,3,3,3,2,1,3,3,1,2,1,11,12,3,13,14,12,10,12,1,1,1,1,1,1,1,10,9,12,14,17,20,18,0,10,20,47361745,6800,6800,5000,African_Caribbean,129,13,2,46397.0,Unknown,29189400,55000000.0,1.0,32,1055,106,0,1,1,202,10,0.6500396930404869,0.5294117647058822,0.588235294117647,0.0447930537356352,0.0855263157894736,0.0263157894736842,0.239809952488122,0.239809952488122,0.3055362648962471,0.0,0.5348837209302322,0.2083333333333332,229,64,31,29,0,3634,3,12,29,50000000,4509090.909090909,50000000.0,0.0,,15000000.0,1,10000000,0.041666666666666664,0.041666666666666664
470794,Ivan,Ili?,2024,416,Yugoslavia (Republic),NiÅ¡,Serbia,17-03-01,Central Midfield,Midfield,Left,186.0,30-06-27,RnB Sport,https://img.a.transfermarkt.technology/portrait/header/470794-1716239802.jpg?lm=1,IT1,Torino Calcio,18000000.0,19000000.0,23,135,159,13,12,15,10,14,12,9,11,7,8,14,10,12,15,10,14,11,14,12,14,13,15,13,9,11,12,16,12,12,13,13,12,15,14,14,12,13,9,12,6,11,3,1,3,2,2,1,3,2,3,1,2,16,15,6,12,12,17,11,12,1,1,1,1,1,1,18,1,20,1,1,18,1,1,75,20,11,32960000,6750,6400,5300,Northern_European,133,3,0,4999.0,Unknown,62201068,8833333.333,3.0,110,1048,85,3,0,7,201,1,0.5971156390579518,0.5614973262032085,0.6176470588235294,0.0048184301573859,0.0197368421052631,0.0,0.0897724431107777,0.0947736934233558,0.0490476587294091,0.2857142857142857,0.5348837209302322,0.2083333333333332,179,19,15,27,1,2452,12,42,43,18000000,1121875.0,19000000.0,1000000.0,600000.0,11000000.0,5,4925000,0.0,0.0
471474,Javi,Martínez,2024,331,Spain,Ã“lvega,Spain,22-12-99,Attacking Midfield,Midfield,Right,181.0,30-06-26,BahÃ­a Internacional,https://img.a.transfermarkt.technology/portrait/header/471474-1694423354.png?lm=1,ES1,Club AtlÃ©tico Osasuna,1200000.0,2500000.0,25,143,165,5,10,8,10,12,7,15,10,8,15,13,11,15,12,11,16,15,13,15,12,13,15,8,14,10,15,17,14,8,9,15,16,12,10,12,15,14,9,16,12,15,2,3,1,3,2,1,2,1,1,1,1,15,16,4,15,16,17,13,12,1,1,18,1,1,1,20,1,15,1,1,10,1,8,89,13,20,347975206,7000,7250,5100,Mediterranean_Hispanic,130,18,0,15304.0,Unknown,1512305,9111392.0,2.0,89,1718,89,3,1,3,51,0,0.7095792537708389,0.5401069518716577,0.5955882352941175,0.0147691160836108,0.1184210526315789,0.0,0.0057514378594648,0.0122530632658164,0.0505924720131114,0.1428571428571428,0.418604651162791,0.2916666666666665,177,11,9,31,1,3524,0,0,0,1000000,50000.0,2500000.0,1000000.0,200000.0,200000.0,4,2000000,-0.16666666666666666,-0.16666666666666666
471582,Zaydou,Youssouf,2024,3329,France,Bordeaux,France,11-07-99,Central Midfield,Midfield,Left,182.0,30-06-26,ESN,https://img.a.transfermarkt.technology/portrait/header/471582-1543940836.jpg?lm=1,PO1,Futebol Clube de FamalicÃ£o,7000000.0,8000000.0,25,120,140,12,13,14,10,13,11,8,11,5,8,12,11,8,14,13,11,13,12,11,13,12,12,14,12,13,11,11,14,14,14,14,10,13,13,13,11,12,6,13,7,12,3,1,1,3,1,1,1,3,3,1,3,15,13,8,12,8,13,10,11,1,1,1,1,1,1,12,1,20,1,1,15,13,1,81,20,11,1524300,6000,6000,4000,African_Caribbean,121,0,0,5350.0,Unknown,48042327,1500000.0,2.0,34,225,36,3,0,1,99,1,0.5441915850754168,0.4224598930481283,0.5294117647058822,0.0051573618177551,0.0,0.0,0.0347586896724181,0.0397599399849962,0.0083057862718408,0.1428571428571428,0.4418604651162785,0.2916666666666665,230,12,4,38,2,4585,1,9,151,7000000,360526.3157894737,8000000.0,1000000.0,150000.0,7200000.0,2,5000000,0.4,0.75
471690,Max,Aarons,2024,989,England,London,England,04-01-00,Right-Back,Defender,Right,171.0,Unknown,ROOF,https://img.a.transfermarkt.technology/portrait/header/471690-1662465106.png?lm=1,GB1,Association Football Club Bournemouth,16000000.0,22000000.0,24,132,160,4,10,14,5,13,6,9,7,6,13,12,5,14,14,8,14,12,16,12,12,12,17,11,4,13,12,14,14,15,15,15,7,15,15,15,10,15,2,14,3,14,3,1,1,3,1,1,2,2,2,1,1,16,15,4,14,14,16,13,16,1,14,1,20,13,15,1,1,10,14,1,1,1,1,63,11,20,36894651,6600,6600,5750,African_Caribbean,128,0,0,34798.0,Unknown,29173977,8100000.0,1.0,32,858,33,1,1,1,22,11,0.6235776660492194,0.6096256684491979,0.5808823529411764,0.0335928590671944,0.0,0.0,0.0797699424856214,0.1097774443610902,0.044973471485319,0.0,0.1860465116279068,0.25,299,8,15,45,0,2707,3,17,59,16000000,828947.3684210526,22000000.0,4000000.0,250000.0,20000000.0,1,2000000,0.0,-0.1111111111111111
471936,Oliver,Christensen,2024,430,Denmark,Kerteminde,Denmark,22-03-99,Goalkeeper,Goalkeeper,Right,190.0,30-06-28,Boutique Transfers,https://img.a.transfermarkt.technology/portrait/header/471936-1688647558.jpg?lm=1,IT1,Associazione Calcio Fiorentina,3000000.0,4500000.0,25,125,142,3,1,1,1,10,6,6,2,2,2,10,4,2,10,17,15,16,16,12,11,11,17,2,13,1,11,12,10,12,13,12,15,6,11,11,12,13,15,1,5,13,15,14,11,7,12,11,11,14,16,13,11,14,15,1,13,15,15,13,5,20,1,1,1,1,1,1,1,1,1,1,1,1,1,82,8,20,2799793,5988,5988,3739,Northern_European,125,1,0,6499.0,Unknown,27137069,3400000.0,2.0,28,721,30,2,1,7,26,5,0.5426038634559407,0.3945454545454545,0.5588235294117647,0.0062668560563997,0.006578947368421,0.0,0.0147536884221055,0.0222555638909727,0.0188616350454179,0.1428571428571428,0.6279069767441858,0.2916666666666665,0,0,0,0,0,0,5,26,64,1500000,72500.0,4500000.0,1200000.0,50000.0,1000000.0,3,200000,-0.5,-0.6052631578947368
472423,Reece,James,2024,631,England,London,England,08-12-99,Right-Back,Defender,Right,180.0,30-06-28,Unique Sports Group,https://img.a.transfermarkt.technology/portrait/header/472423-1683900849.jpg?lm=1,GB1,Chelsea Football Club,35000000.0,70000000.0,25,164,170,13,16,11,12,14,14,14,11,9,13,13,7,14,15,16,14,18,16,14,11,16,17,12,13,12,13,15,16,15,12,19,10,15,14,15,18,16,10,15,5,13,1,3,1,1,2,2,2,1,3,4,2,8,17,4,12,16,19,15,12,1,10,16,20,10,19,15,1,13,12,1,1,1,1,90,10,20,287615409,8400,8200,7000,African_Caribbean,160,13,0,289979.0,Unknown,28108035,9111392.0,2.0,32,858,33,1,1,1,50,11,0.8352738819793597,0.7433155080213903,0.8161764705882353,0.2800000386246906,0.0855263157894736,0.0,0.1747936984246061,0.3498374593648412,0.0505924720131114,0.1428571428571428,0.3953488372093026,0.2916666666666665,293,21,40,35,2,7942,21,131,152,30000000,1487500.0,70000000.0,10000000.0,250000.0,30000000.0,2,14000000,-0.25,-0.4
473050,Kevin,Schade,2024,1148,Germany,Potsdam,Germany,27-11-01,Left Winger,Attack,Right,185.0,30-06-28,Unknown,https://img.a.transfermarkt.technology/portrait/header/473050-1700560328.jpg?lm=1,GB1,Brentford Football Club,22000000.0,25000000.0,23,133,-8,9,11,14,12,14,6,14,8,3,3,11,11,4,14,13,12,11,10,10,10,11,13,14,4,14,4,10,11,16,13,10,12,12,16,11,9,12,5,11,8,11,1,2,4,3,1,1,3,2,3,2,2,12,15,4,10,13,12,9,17,1,1,1,1,1,1,1,10,1,10,18,16,20,18,73,14,20,74423995,6350,6350,4005,Mixed_Race,121,0,0,4060.0,Unknown,91208050,12625000.0,2.0,38,1177,40,0,1,4,43,7,0.590500132310135,0.4229946524064171,0.5294117647058822,0.0039117155446033,0.0,0.0,0.1097774443610902,0.1247811952988247,0.0701130586960748,0.1428571428571428,0.5116279069767438,0.2083333333333332,194,45,26,29,0,4326,4,83,201,22000000,1465000.0,25000000.0,3000000.0,300000.0,12000000.0,2,9350000,0.0,-0.12
473169,Brian,Brobbey,2024,610,Netherlands,Amsterdam,Netherlands,01-02-02,Centre-Forward,Attack,Right,182.0,30-06-27,Team Raiola,https://img.a.transfermarkt.technology/portrait/header/473169-1718013901.jpg?lm=1,NL1,AFC Ajax Amsterdam,35000000.0,35000000.0,22,130,-8,5,6,11,14,13,10,13,10,4,5,11,12,4,13,6,13,14,15,12,9,14,14,14,8,11,5,11,14,14,13,17,12,13,13,12,17,13,4,9,12,6,4,2,3,2,1,1,3,2,1,2,4,9,14,3,5,13,13,9,15,1,1,1,1,1,1,1,1,1,1,13,13,13,20,78,12,20,66750001,6500,6500,5250,African_Caribbean,129,0,0,79999.0,Unknown,37065620,16350000.0,1.0,67,64,68,0,1,1,6,3,0.6103466525535857,0.5561497326203209,0.588235294117647,0.0772397251080767,0.0,0.0,0.1747936984246061,0.1747936984246061,0.0908080780021667,0.0,0.4418604651162785,0.1666666666666666,273,139,46,24,0,8232,18,71,119,30000000,1705882.3529411764,35000000.0,5000000.0,4000000.0,14000000.0,2,1500000,-0.14285714285714285,1.0
473695,Álex,Bermejo,2024,4294,Spain,Barcelona,Spain,11-12-98,Left Winger,Attack,Right,183.0,30-06-25,YOU FIRST,https://img.a.transfermarkt.technology/portrait/header/473695-1675802601.jpg?lm=1,PO1,Sporting Clube Farense,800000.0,800000.0,26,122,135,11,11,13,13,14,9,7,13,8,6,12,7,6,14,8,13,8,13,11,14,13,12,14,11,16,7,13,12,12,12,10,11,10,13,12,10,10,7,13,14,12,4,2,1,3,1,1,3,3,1,1,3,12,13,7,11,11,12,12,12,1,1,1,1,1,1,1,10,8,14,15,18,20,12,70,12,20,1352697,6050,6050,3250,Mediterranean_Hispanic,119,0,0,4223.0,Unknown,67246438,9111392.0,2.0,89,141,89,0,1,3,191,7,0.5508070918232336,0.3422459893048128,0.5147058823529411,0.0040691111589628,0.0,0.0,0.0037509377344336,0.0037509377344336,0.0505924720131114,0.1428571428571428,0.4651162790697669,0.3333333333333332,236,33,5,28,2,1225,2,19,101,500000,22222.222222222223,800000.0,300000.0,150000.0,100000.0,3,900000,-0.375,-0.2857142857142857
474589,Carlos,Cuesta,2024,1184,Colombia,MedellÃ­n,Colombia,09-03-99,Centre-Back,Defender,Right,179.0,30-06-26,Goal Management SAS,https://img.a.transfermarkt.technology/portrait/header/474589-1714037359.png?lm=1,BE1,Koninklijke Racing Club Genk,6000000.0,8000000.0,25,122,138,6,7,10,4,10,10,9,8,8,12,12,10,12,12,7,13,12,12,13,12,13,13,7,13,11,13,11,12,12,12,12,13,9,13,12,13,13,10,8,7,13,3,3,1,2,2,2,2,3,4,2,3,11,12,3,14,11,12,10,9,1,1,20,13,1,12,18,1,1,1,1,1,1,1,82,9,20,5600660,6230,5491,3499,African_Caribbean,115,8,0,7499.0,Unknown,76047487,3800000.0,1.0,20,937,20,1,1,1,122,2,0.4768457263826409,0.3688770053475935,0.4852941176470588,0.0072324733224089,0.0526315789473684,0.0,0.0297574393598399,0.0397599399849962,0.0210839189977499,0.0,0.3720930232558141,0.2916666666666665,258,4,1,37,2,9555,3,10,33,5000000,213636.36363636365,8000000.0,1000000.0,750000.0,4000000.0,1,2500000,-0.16666666666666666,-0.2857142857142857
474662,Hugo,Magnetti,2024,3911,France,Marseille,France,30-05-98,Central Midfield,Midfield,Right,180.0,30-06-27,CAA Base Ltd,https://img.a.transfermarkt.technology/portrait/header/474662-1582538510.jpg?lm=1,FR1,Stade brestois 29,7000000.0,7000000.0,26,122,130,11,11,13,10,14,10,8,10,8,11,14,11,13,13,13,12,13,12,12,12,12,10,11,7,9,12,13,13,12,14,13,8,11,12,13,14,11,13,11,6,8,1,2,2,2,2,3,2,2,2,1,3,8,12,2,12,12,13,10,10,1,1,1,1,1,1,18,1,20,1,1,12,1,1,74,10,20,2080628,6094,6094,3244,Northern_European,121,0,0,8064.0,Unknown,48044237,9111392.0,2.0,34,919,36,3,1,7,196,1,0.5566287377613125,0.3416042780748662,0.5294117647058822,0.0077780470777041,0.0,0.0,0.0347586896724181,0.0347586896724181,0.0505924720131114,0.1428571428571428,0.3953488372093026,0.3333333333333332,168,7,4,24,0,3067,0,0,0,7000000,402941.17647058825,7000000.0,200000.0,,150000.0,0,0,0.0,1.3333333333333333
474701,Crysencio,Summerville,2024,379,Netherlands,Rotterdam,Netherlands,30-10-01,Left Winger,Attack,Right,174.0,30-06-29,Wasserman,https://img.a.transfermarkt.technology/portrait/header/474701-1701683744.jpg?lm=1,GB1,West Ham United Football Club,22000000.0,22000000.0,23,118,139,5,11,15,8,12,4,3,6,2,4,8,8,4,12,7,11,8,9,6,9,7,11,14,4,11,4,11,12,18,16,13,4,9,17,12,4,12,6,8,4,12,1,1,1,1,2,1,4,1,1,1,2,15,10,11,12,9,9,10,11,1,1,1,1,1,1,1,14,1,15,19,1,20,8,0,12,20,7711131,5900,5900,3752,African_Caribbean,108,0,0,8699.0,Unknown,37065567,9111392.0,2.0,67,1253,68,0,1,1,220,7,0.530960571579783,0.3959358288770053,0.4338235294117646,0.00839121404162,0.0,0.0,0.1097774443610902,0.1097774443610902,0.0505924720131114,0.1428571428571428,0.2558139534883721,0.2083333333333332,218,52,36,28,0,6914,5,30,82,22000000,1373437.5,22000000.0,100000.0,1500000.0,3000000.0,5,3775000,0.1,0.2222222222222222
474800,Facundo,Medina,2024,826,Argentina,Villa Fiorito,Argentina,28-05-99,Centre-Back,Defender,Left,184.0,30-06-28,Unknown,https://img.a.transfermarkt.technology/portrait/header/474800-1653402999.jpg?lm=1,FR1,Racing Club de Lens,25000000.0,25000000.0,25,126,142,6,10,12,9,13,8,12,8,14,14,13,8,13,12,14,13,14,11,12,13,12,15,9,12,13,13,13,12,13,12,14,12,13,13,14,14,13,12,11,8,11,2,3,3,3,1,3,1,2,3,1,2,9,12,1,11,12,12,10,10,1,12,20,1,12,1,1,1,1,1,1,1,1,1,78,20,8,4905482,6300,6300,3900,Mediterranean_Hispanic,126,2,0,11769.0,Unknown,14185869,2150000.0,2.0,4,1596,4,1,0,3,158,2,0.5838846255623181,0.4117647058823529,0.5661764705882353,0.0113556590482683,0.0131578947368421,0.0,0.1247811952988247,0.1247811952988247,0.0119169976943803,0.1428571428571428,0.4883720930232553,0.2916666666666665,192,9,11,64,1,1657,4,10,26,25000000,1313157.894736842,25000000.0,500000.0,50000.0,4500000.0,1,3500000,0.0,0.13636363636363635
475188,Kiernan,Dewsbury-Hall,2024,631,England,Shepshed,England,06-09-98,Central Midfield,Midfield,Left,178.0,30-06-29,Wasserman,https://img.a.transfermarkt.technology/portrait/header/475188-1638810238.jpg?lm=1,GB1,Chelsea Football Club,30000000.0,30000000.0,26,144,165,13,12,14,12,14,13,8,13,5,9,14,10,13,13,13,13,12,14,12,16,12,14,13,12,13,12,15,17,12,16,11,7,18,12,18,12,14,8,14,4,12,2,3,3,2,2,3,3,1,3,3,1,7,13,6,16,13,14,12,14,1,1,1,1,10,1,16,10,20,1,1,17,1,1,0,20,10,53785948,7000,7000,5500,Northern_European,141,0,0,86994.0,Unknown,28106342,35400000.0,1.0,32,1367,33,3,0,7,50,1,0.6765017200317545,0.5828877005347594,0.6764705882352942,0.0839942178838111,0.0,0.0,0.1497874468617154,0.1497874468617154,0.1966443512319786,0.0,0.3488372093023257,0.3333333333333332,286,32,39,35,0,6355,2,6,23,28000000,2015384.6153846155,30000000.0,2000000.0,,,2,2000000,-0.06666666666666667,-0.06666666666666667
475208,Bryan,Reynolds,2024,968,United States,"Fort Worth, Texas",United States,28-06-01,Right-Back,Defender,Right,185.0,30-06-27,Mega Sports,https://img.a.transfermarkt.technology/portrait/header/475208-1706611075.jpg?lm=1,BE1,Koninklijke Voetbal Club Westerlo,3000000.0,6000000.0,23,112,137,8,10,12,11,11,7,11,10,8,9,10,12,10,11,7,11,11,10,11,10,11,12,12,5,12,12,10,12,13,12,12,11,13,15,13,11,13,4,5,11,14,1,2,3,3,1,3,2,1,3,3,1,12,12,5,12,8,8,11,10,1,14,1,20,14,19,1,10,1,14,9,1,12,8,78,11,20,2617500,5652,5777,3782,African_Caribbean,105,2,0,7070.0,KVC Westerlo,72048187,5175000.0,2.0,104,501,102,1,1,1,123,11,0.5146864249801535,0.3991443850267379,0.411764705882353,0.006818223515291,0.0131578947368421,0.0,0.0147536884221055,0.0297574393598399,0.0287230200838912,0.1428571428571428,0.5116279069767438,0.2083333333333332,152,5,21,20,0,3856,4,11,29,3500000,202941.17647058822,6000000.0,1000000.0,250000.0,3500000.0,5,1550000,0.16666666666666666,0.0
475411,Wesley,Fofana,2024,631,France,Marseille,France,17-12-00,Centre-Back,Defender,Right,186.0,30-06-29,TTMA,https://img.a.transfermarkt.technology/portrait/header/475411-1683899212.jpg?lm=1,GB1,Chelsea Football Club,25000000.0,65000000.0,24,151,180,11,6,12,7,12,10,16,5,12,15,12,5,15,14,12,14,13,14,13,12,12,16,10,10,12,15,13,13,15,13,10,16,16,16,15,15,15,10,15,8,8,3,1,1,4,3,4,2,3,1,2,3,14,16,13,8,12,11,12,12,1,1,20,12,1,1,1,1,1,1,1,1,1,1,76,10,20,145047192,7650,7250,5750,African_Caribbean,149,0,0,266781.0,Unknown,49037900,57700000.0,2.0,34,919,36,1,1,1,50,2,0.7095792537708389,0.6096256684491979,0.7352941176470587,0.257599649287809,0.0,0.0,0.1247811952988247,0.3248312078019504,0.3205366815744881,0.1428571428571428,0.5348837209302322,0.25,129,5,0,36,2,4950,10,200,350,30000000,1529411.7647058824,65000000.0,15000000.0,,40000000.0,2,37500000,0.2,-0.0625
475413,Sacha,Boey,2024,27,France,Montreuil,France,13-09-00,Right-Back,Defender,Right,178.0,30-06-28,CAA Stellar,https://img.a.transfermarkt.technology/portrait/header/475413-1706907003.jpg?lm=1,L1,FC Bayern MÃ¼nchen,18000000.0,22000000.0,24,120,140,5,11,10,8,11,5,6,7,10,14,11,7,13,11,14,11,12,12,13,10,12,13,8,15,11,13,14,14,14,14,13,11,13,14,15,12,14,8,4,6,14,2,1,2,1,2,3,3,1,3,1,2,12,12,6,7,14,13,13,14,1,10,1,20,1,14,1,1,1,10,1,1,1,1,70,8,20,6666521,6095,5445,4245,African_Caribbean,121,0,0,15384.0,Unknown,49038965,17825000.0,2.0,34,979,36,1,1,1,68,11,0.4707594601746494,0.448663101604278,0.5294117647058822,0.0148463654648916,0.0,0.0,0.0897724431107777,0.1097774443610902,0.099002750076391,0.1428571428571428,0.3488372093023257,0.25,164,7,8,27,2,4441,12,58,93,18000000,934210.5263157894,22000000.0,4000000.0,250000.0,2500000.0,4,6450000,0.0,-0.18181818181818182
475416,Sorba,Thomas,2024,995,England,London,Wales,25-01-99,Right Winger,Attack,Right,185.0,30-06-25,Wasserman,https://img.a.transfermarkt.technology/portrait/header/475416-1668520548.jpg?lm=1,FR1,Football Club de Nantes,4000000.0,6000000.0,25,121,140,15,13,13,7,11,12,5,7,8,6,12,14,6,12,13,8,4,13,9,13,10,12,10,5,12,9,11,12,14,12,13,9,12,13,13,11,11,13,5,5,14,1,2,3,2,2,2,1,3,3,2,2,12,11,9,12,14,8,5,4,1,1,1,1,15,15,1,18,1,20,17,15,20,8,0,10,20,5808357,6050,6050,3768,African_Caribbean,104,5,0,8699.0,Unknown,95040497,9111392.0,2.0,32,858,106,0,1,1,93,10,0.5508070918232336,0.3976470588235293,0.4044117647058823,0.00839121404162,0.0328947368421052,0.0,0.0197549387346836,0.0297574393598399,0.0505924720131114,0.1428571428571428,0.5116279069767438,0.2916666666666665,246,16,40,44,0,4292,0,0,0,4000000,354545.45454545453,6000000.0,1200000.0,,,1,200000,-0.047619047619047616,-0.16666666666666666
475949,Benjamin,Nygren,2024,2778,Sweden,GÃ¶teborg,Sweden,08-07-01,Second Striker,Attack,Left,188.0,31-12-25,Unknown,https://img.a.transfermarkt.technology/portrait/header/475949-1629186621.jpg?lm=1,DK1,Fodbold Club NordsjÃ¦lland,2000000.0,3700000.0,23,110,135,9,11,11,12,12,10,10,10,5,6,12,10,6,12,9,11,10,11,11,12,12,12,13,5,13,8,8,10,13,13,11,11,11,13,12,8,11,10,12,8,10,3,3,3,1,2,3,3,1,3,1,1,12,14,7,15,12,13,11,11,1,1,1,1,1,1,1,1,15,1,15,20,17,17,69,20,10,1646861,5499,5749,4999,Northern_European,103,0,0,4705.0,Unknown,93104332,2150000.0,2.0,91,582,91,0,0,7,87,12,0.5109817412013761,0.5293048128342246,0.3970588235294117,0.0045345386811792,0.0,0.0,0.0097524381095273,0.0182545636409102,0.0119169976943803,0.1428571428571428,0.581395348837209,0.2083333333333332,181,53,18,17,0,6194,1,12,90,3000000,163888.88888888888,3700000.0,600000.0,2700000.0,1000000.0,3,400000,0.5,1.0
475959,Josko,Gvardiol,2024,281,Croatia,Zagreb,Croatia,23-01-02,Left-Back,Defender,Left,185.0,30-06-28,Marjan Sisic,https://img.a.transfermarkt.technology/portrait/header/475959-1713391602.jpg?lm=1,GB1,Manchester City Football Club,75000000.0,80000000.0,22,139,-9,2,10,12,7,13,8,13,10,14,13,14,10,15,13,16,14,17,15,12,12,12,17,13,10,11,11,14,15,14,11,14,14,16,17,14,16,14,9,13,6,11,3,2,2,2,3,3,3,3,3,1,3,7,18,4,15,18,16,10,13,1,20,20,1,1,1,1,1,1,1,1,1,1,1,80,20,10,100224005,6743,7243,5743,Northern_European,138,10,1,68499.0,Unknown,24060473,63400000.0,2.0,24,1697,25,1,0,7,131,8,0.7086530828261445,0.6088770053475935,0.6544117647058822,0.0661351265489708,0.0657894736842105,0.0131578947368421,0.3748437109277319,0.3998499624906226,0.3522042278952192,0.1428571428571428,0.5116279069767438,0.1666666666666666,233,19,11,20,1,7571,6,26,36,75000000,4150000.0,80000000.0,5000000.0,16000000.0,75000000.0,2,11000000,0.0,-0.0625
476344,Unknown,Emerson Royal,2024,5,Brazil,SÃ£o Paulo,Brazil,14-01-99,Right-Back,Defender,Right,183.0,30-06-28,AIS Football,https://img.a.transfermarkt.technology/portrait/header/476344-1665609182.jpg?lm=1,IT1,Associazione Calcio Milan,18000000.0,30000000.0,25,141,153,12,11,11,12,13,8,11,11,14,13,12,11,14,14,8,12,13,11,12,12,12,13,12,11,13,12,13,16,15,14,13,11,13,15,16,13,13,8,9,7,8,2,3,3,1,1,2,3,1,3,1,4,12,13,7,12,11,15,14,14,1,1,1,20,1,18,1,1,1,11,1,1,11,1,79,9,20,33359049,7049,6999,6049,African_Caribbean,137,7,0,69595.0,Unknown,19325045,12196666.67,6.0,10,1456,11,1,1,1,27,11,0.6763694098967981,0.6416042780748663,0.6470588235294117,0.0671934430725168,0.0460526315789473,0.0,0.0897724431107777,0.1497874468617154,0.067733362982305,0.7142857142857142,0.4651162790697669,0.2916666666666665,257,11,14,52,2,3597,6,28,62,14000000,634090.9090909091,30000000.0,5000000.0,50000.0,15000000.0,4,9950000,-0.2222222222222222,-0.2222222222222222
476701,Manuel,Ugarte,2024,985,Uruguay,Montevideo,Uruguay,11-04-01,Defensive Midfield,Midfield,Right,182.0,30-06-29,Gestifute,https://img.a.transfermarkt.technology/portrait/header/476701-1715107512.jpg?lm=1,GB1,Manchester United Football Club,50000000.0,60000000.0,23,143,152,11,10,11,8,12,10,8,10,10,14,13,6,15,12,16,16,17,12,17,13,12,16,12,13,12,14,15,15,12,12,16,11,18,13,17,13,16,14,14,4,13,3,1,2,1,1,3,1,3,1,2,3,16,13,7,11,14,15,13,13,1,1,1,1,1,1,20,1,17,13,1,7,1,1,77,13,20,34684000,7150,6365,5681,Mediterranean_Hispanic,141,5,0,19511.0,Unknown,78084541,35900000.0,4.0,106,975,103,3,1,3,132,4,0.59248478433448,0.6022459893048128,0.6764705882352942,0.0188314679217116,0.0328947368421052,0.0,0.2498124531132783,0.2998249562390597,0.1994222061723936,0.4285714285714285,0.4418604651162785,0.2083333333333332,229,4,10,57,1,5585,5,8,12,50000000,2628947.3684210526,60000000.0,15000000.0,900000.0,12000000.0,4,13000000,0.1111111111111111,-0.16666666666666666
476836,Aron,Dønnum,2024,415,Norway,Eidsvoll,Norway,20-04-98,Right Winger,Attack,Left,178.0,30-06-28,Nordic Sky,https://img.a.transfermarkt.technology/portrait/header/476836-1678012976.jpg?lm=1,FR1,Toulouse Football Club,3500000.0,4000000.0,26,123,134,13,12,15,11,13,12,5,12,6,5,12,12,7,14,8,11,8,14,11,13,12,14,17,8,12,8,11,12,14,13,12,8,11,13,13,12,13,13,12,8,8,1,3,4,1,3,2,4,3,3,1,1,9,14,12,16,11,14,8,3,1,1,1,1,1,1,1,13,1,13,15,1,20,1,73,20,10,2233799,5994,6194,3994,Northern_European,122,2,0,10000.0,Unknown,53131647,3000000.0,2.0,71,449,73,0,0,7,203,10,0.5698597512569463,0.4218181818181817,0.536764705882353,0.009647482104698,0.0131578947368421,0.0,0.0172543135783946,0.0197549387346836,0.0166393510930859,0.1428571428571428,0.3488372093023257,0.3333333333333332,273,42,35,61,0,6631,2,3,8,4000000,219444.44444444444,4000000.0,800000.0,50000.0,100000.0,4,3100000,0.14285714285714285,0.14285714285714285
477477,Emmanuel,Boateng,2024,2293,Ghana,Akwatia,Ghana,17-06-97,Central Midfield,Midfield,Right,175.0,30-06-26,Berlin Sports - BFT,https://img.a.transfermarkt.technology/portrait/header/477477-1727457557.png?lm=1,TR1,Konyaspor,800000.0,1200000.0,27,123,142,9,10,13,13,12,8,12,11,6,6,11,12,7,12,14,13,15,10,11,10,10,13,14,9,15,6,12,14,16,15,9,11,13,15,13,10,9,8,15,8,13,4,2,1,2,3,2,2,3,3,3,3,12,13,5,14,14,14,15,6,1,1,1,1,1,1,1,6,1,8,13,11,13,20,70,9,20,1385998,6150,6150,4650,African_Caribbean,120,7,1,2749.0,Unknown,55082360,122500.0,2.0,39,34,41,3,1,1,125,1,0.5640381053188674,0.4919786096256684,0.5220588235294117,0.0026457913088652,0.0460526315789473,0.0131578947368421,0.0037509377344336,0.0057514378594648,0.0006527959109975,0.1428571428571428,0.2790697674418605,0.375,164,4,6,26,2,5051,7,16,42,600000,28947.36842105263,1200000.0,250000.0,,,3,150000,-0.29411764705882354,-0.5
477758,Aaron,Wan-Bissaka,2024,379,England,London,England,26-11-97,Right-Back,Defender,Right,183.0,30-06-31,Unique Sports Group,https://img.a.transfermarkt.technology/portrait/header/477758-1617030255.jpg?lm=1,GB1,West Ham United Football Club,20000000.0,40000000.0,27,138,150,5,11,12,5,12,4,8,3,10,13,10,5,20,11,15,12,18,11,10,5,12,11,12,6,11,9,14,13,17,18,15,10,15,15,16,13,13,8,12,5,10,2,1,2,2,2,2,1,1,1,1,2,9,14,8,13,15,14,14,15,1,1,1,20,1,13,1,1,1,1,1,1,1,1,72,8,20,33915983,7100,7200,6500,African_Caribbean,131,0,0,115992.0,Unknown,28100123,36300000.0,2.0,32,858,33,1,1,1,220,11,0.702963747023022,0.6898395721925134,0.6029411764705883,0.1119951873635462,0.0,0.0,0.0997749437359339,0.1997999499874969,0.2016444901247256,0.1428571428571428,0.4651162790697669,0.375,0,0,0,0,0,0,10,43,73,22000000,954545.4545454546,40000000.0,8000000.0,,5000000.0,2,7000000,0.1,0.1
477930,R?Dvan,Y?Lmaz,2024,124,TÃ¼rkiye,Istanbul,TÃ¼rkiye,21-05-01,Left-Back,Defender,Left,174.0,31-05-27,Unknown,https://img.a.transfermarkt.technology/portrait/header/477930-1727381049.jpg?lm=1,SC1,Rangers Football Club,5000000.0,6500000.0,23,130,140,6,13,14,9,14,7,10,9,11,11,14,12,12,15,12,12,14,13,14,13,12,13,14,7,14,12,14,15,15,14,13,10,15,15,13,8,15,10,12,8,8,2,3,2,3,2,3,2,1,2,2,2,13,12,8,14,10,14,12,13,1,20,1,1,18,1,1,17,1,1,1,1,1,1,65,20,6,15505775,6150,6150,5000,Mediterranean_Hispanic,126,6,0,16239.0,Unknown,70121604,4000000.0,1.0,100,667,100,1,0,3,161,8,0.5640381053188674,0.5294117647058822,0.5661764705882353,0.0156719682273294,0.0394736842105263,0.0,0.0247561890472618,0.032258064516129,0.0221950609739159,0.0,0.2558139534883721,0.2083333333333332,153,9,12,16,0,4502,10,69,132,4500000,261764.70588235295,6500000.0,1000000.0,50000.0,5500000.0,2,500000,-0.1,0.0
478365,Francisco,Moura,2024,720,Portugal,Braga,Portugal,16-08-99,Left-Back,Defender,Left,181.0,30-06-29,Proeleven S.A.,https://img.a.transfermarkt.technology/portrait/header/478365-1537881888.jpg?lm=1,PO1,Futebol Clube do Porto,7000000.0,7000000.0,25,125,138,11,11,14,10,13,10,8,8,10,8,12,9,12,15,9,12,11,12,11,11,11,13,13,8,12,9,9,13,15,13,11,10,13,14,13,12,12,8,10,9,12,1,1,2,2,1,2,3,1,4,1,3,14,14,8,12,13,15,11,14,1,17,1,1,19,1,1,16,1,1,20,1,12,1,75,20,7,2499999,6250,6250,4252,Mediterranean_Hispanic,120,0,0,3850.0,Futebol Clube de FamalicÃ£o,83206395,3000000.0,2.0,76,237,79,1,0,3,100,8,0.5772691188145012,0.4494117647058823,0.5220588235294117,0.0037089359187413,0.0,0.0,0.0347586896724181,0.0347586896724181,0.0166393510930859,0.1428571428571428,0.418604651162791,0.2916666666666665,174,12,19,27,0,4678,4,60,279,8000000,532142.8571428572,8000000.0,1000000.0,,200000.0,4,2700000,0.3333333333333333,1.0
478573,Ryan,Gravenberch,2024,31,Netherlands,Amsterdam,Netherlands,16-05-02,Central Midfield,Midfield,Right,190.0,30-06-28,Team Raiola,https://img.a.transfermarkt.technology/portrait/header/478573-1718097194.jpg?lm=1,GB1,Liverpool Football Club,40000000.0,40000000.0,22,138,-9,14,12,14,10,15,13,12,13,4,10,15,10,11,15,11,12,13,14,11,12,13,15,15,8,12,11,12,12,13,14,15,14,12,13,14,13,12,4,12,8,9,3,2,2,3,1,2,3,1,3,1,2,11,16,2,13,15,11,13,12,1,1,1,1,1,1,17,10,20,10,12,17,10,1,77,11,20,80320000,6997,6997,5497,African_Caribbean,135,10,1,176437.0,Unknown,37071197,29250000.0,2.0,67,64,68,3,1,1,129,1,0.6761047896268855,0.582566844919786,0.6323529411764706,0.1703619230074729,0.0657894736842105,0.0131578947368421,0.1997999499874969,0.1997999499874969,0.162476735464874,0.1428571428571428,0.6279069767441858,0.1666666666666666,294,40,37,26,0,7577,5,21,58,55000000,2500000.0,55000000.0,5000000.0,28000000.0,30000000.0,3,10000000,0.5714285714285714,0.5714285714285714
479638,Tiago,Gouveia,2024,294,Portugal,Cascais,Portugal,18-06-01,Right Winger,Attack,Right,176.0,30-06-28,CAA Stellar,https://img.a.transfermarkt.technology/portrait/header/479638-1655898881.jpg?lm=1,PO1,Sport Lisboa e Benfica,5000000.0,5000000.0,23,129,148,10,12,15,13,14,6,9,12,8,4,12,8,10,15,14,13,12,12,11,14,12,15,17,6,15,8,8,13,14,14,12,8,14,14,13,12,12,13,14,6,6,2,3,2,1,3,2,3,4,3,3,1,13,13,8,5,16,15,15,14,1,1,1,1,1,1,1,13,1,13,20,1,20,1,73,10,20,11320000,6444,6444,4994,Mediterranean_Hispanic,129,0,0,3568.0,Grupo Desportivo Estoril Praia - SAD,83228377,9111392.0,2.0,76,324,79,0,1,3,188,10,0.6029372849960307,0.5287700534759358,0.588235294117647,0.0034366318497267,0.0,0.0,0.0247561890472618,0.0247561890472618,0.0505924720131114,0.1428571428571428,0.3023255813953489,0.2083333333333332,140,30,15,17,0,2640,3,37,130,5000000,544444.4444444445,5000000.0,0.0,,1500000.0,3,1225000,0.0,0.42857142857142855
479643,Alexandre,Penetra,2024,1090,Portugal,SÃ¡tÃ£o,Portugal,09-09-01,Centre-Back,Defender,Right,186.0,30-06-28,Sportsbloom,https://img.a.transfermarkt.technology/portrait/header/479643-1721657319.jpg?lm=1,NL1,Alkmaar Zaanstreek,4500000.0,5500000.0,23,117,136,4,7,8,9,12,5,15,6,10,13,13,4,13,11,14,15,11,9,14,11,12,13,2,15,8,12,12,12,12,12,11,12,14,12,13,12,14,12,11,8,14,2,3,2,2,2,2,1,2,4,3,2,18,14,1,15,10,12,13,15,1,1,20,14,1,10,1,1,1,1,1,1,1,1,73,8,20,2679999,6245,6245,3846,Mediterranean_Hispanic,116,0,0,2500.0,Unknown,83228369,4200000.0,1.0,76,1448,79,1,1,3,16,2,0.5766075681397195,0.4059893048128342,0.4926470588235294,0.0024053526096289,0.0,0.0,0.0222555638909727,0.0272568142035508,0.0233062029500819,0.0,0.5348837209302322,0.2083333333333332,159,7,4,21,1,4561,0,0,0,5000000,470000.0,5500000.0,500000.0,,3000000.0,1,1500000,0.1111111111111111,-0.09090909090909091
479649,Gonçalo,Borges,2024,720,Portugal,Lisboa,Portugal,29-03-01,Right Winger,Attack,Right,184.0,30-06-27,Epic Borges,https://img.a.transfermarkt.technology/portrait/header/479649-1693589900.png?lm=1,PO1,Futebol Clube do Porto,4000000.0,5000000.0,23,119,142,10,12,16,10,12,6,6,8,7,5,11,12,5,14,11,9,9,10,9,12,9,13,16,9,14,5,9,13,15,15,12,8,12,16,12,9,11,8,10,5,14,1,3,3,1,1,1,1,1,3,3,3,10,13,7,12,10,13,8,10,1,1,1,1,1,1,1,13,1,13,19,11,20,7,77,7,20,2212499,5950,5950,3550,African_Caribbean,114,0,0,4850.0,Unknown,83228804,9111392.0,2.0,76,843,79,0,1,1,100,10,0.5375760783275999,0.374331550802139,0.4779411764705882,0.0046745531847505,0.0,0.0,0.0197549387346836,0.0247561890472618,0.0505924720131114,0.1428571428571428,0.4883720930232553,0.2083333333333332,166,15,14,19,1,1949,0,0,0,4000000,316666.6666666667,5000000.0,1000000.0,,700000.0,1,3000000,0.3333333333333333,0.0
479999,Eberechi,Eze,2024,873,England,London,England,29-06-98,Attacking Midfield,Midfield,Right,178.0,30-06-27,CAA Base Ltd,https://img.a.transfermarkt.technology/portrait/header/479999-1678466922.jpg?lm=1,GB1,Crystal Palace Football Club,60000000.0,60000000.0,26,141,155,14,13,17,13,14,13,5,13,5,6,14,13,6,15,8,13,8,16,12,15,14,15,17,9,12,8,14,12,13,15,16,9,13,13,12,14,13,1,12,10,13,3,3,3,4,3,2,1,4,3,1,3,14,16,3,12,15,15,12,15,1,1,1,1,1,1,1,14,18,12,17,20,13,1,69,13,20,31622131,7049,7049,5499,African_Caribbean,141,0,0,52196.0,Unknown,29156522,17800000.0,1.0,32,858,33,3,1,1,58,0,0.682984916644615,0.5827807486631016,0.6764705882352942,0.0503926682612226,0.0,0.0,0.2998249562390597,0.2998249562390597,0.0988638573293702,0.0,0.3488372093023257,0.3333333333333332,286,57,35,17,0,3191,5,32,163,55000000,2745000.0,60000000.0,5000000.0,,3500000.0,1,9000000,0.0,0.14583333333333334
480116,Lloyd,Kelly,2024,762,England,Bristol,England,06-10-98,Centre-Back,Defender,Left,190.0,30-06-29,CSM,https://img.a.transfermarkt.technology/portrait/header/480116-1684771304.jpg?lm=1,GB1,Newcastle United Football Club,18000000.0,18000000.0,26,132,153,7,12,10,6,11,5,13,6,12,14,13,7,14,12,10,13,12,14,11,9,14,13,6,13,9,13,13,13,13,13,14,14,11,14,14,13,12,10,12,7,11,2,2,1,1,3,3,2,3,2,3,1,10,9,4,14,12,12,15,13,1,19,20,1,10,1,1,1,1,1,1,1,1,1,0,20,9,22428781,6593,6593,4993,African_Caribbean,132,0,0,40597.0,Unknown,29158244,14800000.0,1.0,32,259,33,1,0,1,137,2,0.622651495104525,0.528663101604278,0.6102941176470589,0.0391924735927818,0.0,0.0,0.0897724431107777,0.0897724431107777,0.0821967276868801,0.0,0.6279069767441858,0.3333333333333332,205,5,11,25,0,3045,13,81,139,18000000,994444.4444444445,18000000.0,2000000.0,100000.0,9000000.0,2,0,0.0,0.125
480267,Ronald,Araujo,2024,131,Uruguay,Rivera,Uruguay,07-03-99,Centre-Back,Defender,Right,192.0,30-06-26,Excellence Sport,https://img.a.transfermarkt.technology/portrait/header/480267-1701118351.jpg?lm=1,ES1,Futbol Club Barcelona,70000000.0,70000000.0,25,160,174,5,7,11,10,13,8,17,11,7,17,12,13,17,12,15,15,18,15,15,11,14,17,7,16,7,15,15,16,12,11,12,16,13,16,15,16,15,12,13,12,12,3,3,2,4,1,1,2,3,2,2,3,15,16,9,13,12,15,12,13,1,1,20,10,1,1,12,1,8,1,1,1,1,1,91,8,20,111375005,7900,7500,7000,Mixed_Race,161,11,0,144230.0,Unknown,78085068,2547500.0,2.0,106,1239,103,1,1,4,96,2,0.7426567875099233,0.7433155080213903,0.8235294117647058,0.1392622877211143,0.0723684210526315,0.0,0.3498374593648412,0.3498374593648412,0.0141253923720103,0.1428571428571428,0.6744186046511627,0.2916666666666665,250,22,11,50,4,5901,17,95,147,55000000,2386956.5217391304,70000000.0,15000000.0,175000.0,5000000.0,3,6400000,-0.21428571428571427,-0.21428571428571427
480453,Jay,Gorter,2024,610,Netherlands,Amsterdam,Netherlands,30-05-00,Goalkeeper,Goalkeeper,Right,190.0,30-06-26,Muy Manero,https://img.a.transfermarkt.technology/portrait/header/480453-1599331700.jpg?lm=1,NL1,AFC Ajax Amsterdam,1500000.0,2000000.0,24,124,146,3,1,3,1,10,7,3,1,1,2,12,2,2,10,6,14,13,11,11,11,13,13,2,12,1,16,12,10,13,13,8,15,15,13,6,7,12,13,15,6,14,14,11,10,17,12,12,12,15,14,17,12,10,18,2,12,10,13,8,10,20,1,1,1,1,1,1,1,1,1,1,1,1,1,0,7,20,7359999,6250,6250,3768,Northern_European,121,0,0,5999.0,Unknown,37067287,1000000.0,1.0,67,64,68,2,1,7,6,5,0.5772691188145012,0.3976470588235293,0.5294117647058822,0.0057840474233951,0.0,0.0,0.0072518129532383,0.0097524381095273,0.0055279313314258,0.0,0.6279069767441858,0.25,0,0,0,0,0,0,9,37,69,1200000,73437.5,2000000.0,500000.0,,700000.0,3,1500000,-0.2,-0.4
480692,Luis,Díaz,2024,31,Colombia,Barrancas,Colombia,13-01-97,Left Winger,Attack,Right,180.0,30-06-27,Nomi Sports,https://img.a.transfermarkt.technology/portrait/header/480692-1697903145.jpg?lm=1,GB1,Liverpool Football Club,80000000.0,80000000.0,27,166,172,9,12,18,15,18,10,13,13,4,7,14,5,8,18,13,13,13,14,13,14,13,15,19,4,15,9,13,14,17,17,14,10,15,16,13,10,15,11,17,7,10,1,2,1,1,3,3,4,1,1,3,3,15,14,8,13,16,12,10,13,1,1,1,1,1,1,1,11,1,8,20,13,14,12,70,12,20,251912317,8250,8050,7250,Mixed_Race,160,37,8,104393.0,Unknown,76049803,29610000.0,2.0,20,149,20,0,1,4,129,7,0.8154273617359089,0.7700534759358288,0.8161764705882353,0.1007949926951053,0.2434210526315789,0.1052631578947368,0.3998499624906226,0.3998499624906226,0.1644767910219728,0.1428571428571428,0.3953488372093026,0.375,406,101,45,30,3,16149,4,39,189,85000000,3538541.6666666665,85000000.0,2000000.0,,100000.0,3,10025000,0.13333333333333333,0.13333333333333333
480762,Lisandro,Martínez,2024,985,Argentina,Gualeguay,Argentina,18-01-98,Centre-Back,Defender,Left,175.0,30-06-27,Score Futbol,https://img.a.transfermarkt.technology/portrait/header/480762-1680681507.jpg?lm=1,GB1,Manchester United Football Club,50000000.0,50000000.0,26,143,155,6,9,12,7,13,9,14,7,12,15,15,9,13,15,16,14,14,14,14,14,14,12,12,13,12,14,13,15,13,12,14,13,15,13,15,13,15,14,11,7,13,3,3,1,3,3,3,2,1,2,2,1,14,13,6,12,14,14,12,11,1,15,20,1,1,1,15,1,12,1,1,1,1,1,77,20,10,108516059,7500,7000,6000,Mediterranean_Hispanic,142,7,0,139190.0,Unknown,14167329,21698333.33,3.0,4,573,4,1,0,3,132,2,0.6765017200317545,0.6363636363636364,0.6838235294117647,0.1343955767004278,0.0460526315789473,0.0,0.2498124531132783,0.2498124531132783,0.1205218663296202,0.2857142857142857,0.2790697674418605,0.3333333333333332,270,12,15,53,0,8027,9,85,333,50000000,2371428.5714285714,50000000.0,5000000.0,,6000000.0,2,23000000,0.0,0.0
480763,Juan,Foyth,2024,1050,Argentina,La Plata,Argentina,12-01-98,Right-Back,Defender,Right,187.0,30-06-26,Primotempo,https://img.a.transfermarkt.technology/portrait/header/480763-1662668281.jpg?lm=1,ES1,Villarreal Club de FÃºtbol S.A.D.,15000000.0,25000000.0,26,145,157,7,11,13,8,15,11,15,7,8,14,14,8,16,15,14,13,16,16,12,13,11,12,12,10,13,14,15,16,13,14,14,13,13,14,15,13,11,13,13,6,12,1,3,1,2,1,1,1,3,1,1,2,15,11,7,10,12,13,10,14,1,1,19,20,1,10,16,1,1,1,1,1,1,1,69,11,20,23749899,7250,7250,5250,Northern_European,144,15,0,33574.0,Unknown,14186894,12750000.0,2.0,4,784,4,1,1,7,216,11,0.7095792537708389,0.5561497326203209,0.6985294117647058,0.0324109435335991,0.0986842105263157,0.0,0.0747686921730432,0.1247811952988247,0.0708075224311786,0.1428571428571428,0.5581395348837206,0.3333333333333332,164,5,6,30,1,6469,11,114,175,7500000,119047.61904761905,25000000.0,7000000.0,,8000000.0,1,500000,-0.5,-0.7
480883,Miguel,De La Fuente,2024,1244,Spain,Tudela de Duero (Valladolid),Spain,03-09-99,Centre-Forward,Attack,Right,182.0,30-06-28,BahÃ­a Internacional,https://img.a.transfermarkt.technology/portrait/header/480883-1647530867.jpg?lm=1,ES1,Club Deportivo LeganÃ©s S.A.D.,2500000.0,2500000.0,25,123,138,11,10,12,14,11,11,11,11,7,11,10,12,7,10,12,11,12,13,12,14,12,13,7,13,13,12,12,15,12,12,12,13,15,14,12,11,14,7,15,8,7,2,2,1,4,3,2,4,2,2,3,3,11,15,10,10,13,13,15,8,1,1,1,1,1,1,1,1,1,1,1,1,1,20,77,12,20,3863998,6150,6150,3650,Mediterranean_Hispanic,120,0,0,3068.0,Unknown,67252958,2000000.0,1.0,89,1532,89,0,1,3,54,3,0.5640381053188674,0.3850267379679144,0.5220588235294117,0.0029538232167221,0.0,0.0,0.0122530632658164,0.0122530632658164,0.0110836412122558,0.0,0.4418604651162785,0.2916666666666665,250,51,17,51,0,3369,1,0,6,2000000,105555.55555555556,2500000.0,500000.0,150000.0,350000.0,3,700000,-0.2,-0.16666666666666666
480975,Allahyar,Sayyadmanesh,2024,968,Iran,"Amol, Mazandaran",Iran,29-06-01,Left Winger,Attack,Right,180.0,30-06-26,FutureBall,https://img.a.transfermarkt.technology/portrait/header/480975-1713450420.png?lm=1,BE1,Koninklijke Voetbal Club Westerlo,2500000.0,4000000.0,23,122,147,7,10,13,12,13,5,13,11,5,8,10,12,6,14,12,9,13,9,10,10,12,12,12,6,13,8,12,13,14,15,10,11,13,14,12,11,11,8,9,9,12,1,3,2,1,3,2,2,2,3,2,1,12,15,6,10,8,11,9,13,1,1,1,1,10,10,1,11,1,11,19,11,18,20,78,10,20,12840285,6100,6100,4500,North_African__Middle_Eastern,113,7,1,19371.0,Unknown,29223444,2531000.0,3.0,48,63,50,0,1,6,123,7,0.5574225985710506,0.4759358288770053,0.4705882352941176,0.0186962815044703,0.0460526315789473,0.0131578947368421,0.0122530632658164,0.0197549387346836,0.0140337231589766,0.2857142857142857,0.3953488372093026,0.2083333333333332,165,27,18,21,0,4128,5,62,129,4000000,196250.0,4000000.0,800000.0,350000.0,2500000.0,6,1600000,1.2222222222222223,0.6
481084,Unknown,Marcos André,2024,366,Brazil,CoroatÃ¡,Brazil,20-10-96,Centre-Forward,Attack,Right,185.0,30-06-29,ADM PRO,https://img.a.transfermarkt.technology/portrait/header/481084-1601535152.jpg?lm=1,ES1,Real Valladolid Club de FÃºtbol S.A.D.,2000000.0,8500000.0,28,130,148,8,9,13,13,13,10,14,12,9,8,13,12,9,14,12,13,14,13,14,12,13,14,10,10,13,11,14,14,13,13,10,11,12,14,13,14,12,11,12,7,11,2,3,2,2,1,1,1,3,2,3,3,7,12,3,10,11,11,13,20,1,1,1,1,1,1,1,1,1,1,1,1,1,20,78,9,20,4719684,6500,5170,4653,North_African__Middle_Eastern,130,0,0,14999.0,Unknown,19270874,3600000.0,3.0,10,385,11,0,1,6,169,3,0.4343741730616565,0.4922994652406416,0.5955882352941175,0.014474602817478,0.0,0.0,0.0097524381095273,0.0422605651412853,0.0199727770215839,0.2857142857142857,0.5116279069767438,0.4166666666666665,252,53,17,37,2,5419,3,35,105,1500000,60869.565217391304,8500000.0,2000000.0,,100000.0,6,6250000,-0.25,-0.3181818181818182
481128,Martin,Minchev,2024,126,Bulgaria,Varna,Bulgaria,22-04-01,Centre-Forward,Attack,Right,185.0,30-06-26,Soccertalk GmbH,https://img.a.transfermarkt.technology/portrait/header/481128-1694706381.png?lm=1,TR1,Ã‡aykur Rizespor KulÃ¼bÃ¼,1800000.0,1800000.0,23,113,-75,8,10,13,12,11,10,6,11,2,3,11,13,5,13,11,9,12,12,10,12,11,14,15,7,12,4,10,11,14,13,10,9,11,14,10,9,12,8,13,8,13,3,1,3,3,2,2,1,3,3,1,1,19,15,7,12,13,15,13,11,1,1,1,1,1,1,1,12,1,15,18,10,20,17,72,12,20,11796359,5650,5650,3100,Northern_European,105,10,0,944.0,Unknown,22071728,1000000.0,1.0,11,1565,12,0,1,7,225,3,0.4978830378406986,0.3262032085561497,0.411764705882353,0.0009028521437186,0.0657894736842105,0.0,0.0087521880470117,0.0087521880470117,0.0055279313314258,0.0,0.5116279069767438,0.2083333333333332,231,35,26,24,1,6295,3,6,9,1600000,81578.94736842105,1800000.0,250000.0,675000.0,750000.0,2,125000,-0.1111111111111111,0.3333333333333333
481173,Mady,Camara,2024,1091,Guinea,Matam,Guinea,28-02-97,Central Midfield,Midfield,Right,182.0,30-06-27,Unknown,https://img.a.transfermarkt.technology/portrait/header/481173-1727967358.png?lm=1,GR1,Panthessalonikios Athlitikos Omilos Konstantinoupoliton,6000000.0,15000000.0,27,132,140,7,10,12,10,13,8,9,10,8,12,13,8,14,13,16,12,16,12,10,12,11,14,10,8,13,11,13,16,15,14,13,11,16,14,16,14,12,12,12,7,12,1,1,3,1,2,3,3,1,1,1,2,15,15,8,12,12,13,9,13,1,1,1,1,1,1,20,1,20,7,1,14,1,1,81,11,20,8207997,6600,6000,4750,African_Caribbean,130,21,1,14194.0,Associazione Sportiva Roma,89058721,9111392.0,2.0,43,926,44,3,1,1,153,1,0.5441915850754168,0.5026737967914437,0.5955882352941175,0.0136972809183406,0.1381578947368421,0.0131578947368421,0.0297574393598399,0.0747686921730432,0.0505924720131114,0.1428571428571428,0.4418604651162785,0.375,321,30,18,68,1,9888,10,12,14,6000000,307894.7368421053,15000000.0,2000000.0,,300000.0,4,5700000,0.0,-0.25
481688,Sotiris,Alexandropoulos,2024,3057,Greece,Marousi,Greece,26-11-01,Central Midfield,Midfield,Right,186.0,30-06-25,Unknown,https://img.a.transfermarkt.technology/portrait/header/481688-1660812221.jpg?lm=1,BE1,Royal Standard Club de LiÃ¨ge,2500000.0,4000000.0,23,118,145,7,8,12,7,11,8,10,11,7,11,12,10,13,12,14,12,15,12,10,10,9,15,12,10,11,11,12,16,16,15,14,12,12,16,14,10,12,10,12,7,10,4,2,2,2,1,2,3,1,2,3,1,15,15,3,16,15,14,15,16,1,1,1,1,1,1,16,1,20,1,1,1,1,1,71,9,20,4608750,5900,6250,3500,Mediterranean_Hispanic,116,5,0,15500.0,Unknown,36141840,4000000.0,1.0,40,918,42,3,1,3,176,1,0.5772691188145012,0.3689839572192513,0.4926470588235294,0.0149583770677486,0.0328947368421052,0.0,0.0122530632658164,0.0197549387346836,0.0221950609739159,0.0,0.5348837209302322,0.2083333333333332,167,5,4,37,0,5540,1,6,36,2500000,153125.0,4000000.0,1000000.0,150000.0,4000000.0,3,1500000,-0.16666666666666666,-0.16666666666666666
481834,Andrea,Carboni,2024,2919,Italy,Sorgono,Italy,04-02-01,Centre-Back,Defender,Left,187.0,30-06-27,YOU FIRST,https://img.a.transfermarkt.technology/portrait/header/481834-1632215920.jpg?lm=1,IT1,Associazione Calcio Monza,4000000.0,5000000.0,23,123,156,5,8,8,5,9,5,15,5,8,13,10,5,14,9,11,12,13,12,13,12,13,14,9,13,7,13,14,13,13,12,12,15,11,12,13,14,13,14,11,7,10,2,1,3,2,4,1,2,3,2,1,1,7,15,5,12,13,13,8,18,1,16,20,1,12,1,1,1,1,1,1,1,1,1,70,20,8,4246399,6150,6350,4400,Mediterranean_Hispanic,123,0,0,14621.0,Unknown,43391662,9111392.0,2.0,52,1397,54,1,0,3,28,2,0.590500132310135,0.4652406417112299,0.5441176470588236,0.0141095994909265,0.0,0.0,0.0197549387346836,0.0247561890472618,0.0505924720131114,0.1428571428571428,0.5581395348837206,0.2083333333333332,204,11,4,28,1,2331,10,30,36,4000000,336363.63636363635,5000000.0,1000000.0,,5000000.0,3,1000000,0.0,0.0
482769,Alexis,Trouillet,2024,265,France,Saint-Priest-en-Jarez,France,23-12-00,Central Midfield,Midfield,Right,175.0,30-06-25,HEWGO SPORT ,https://img.a.transfermarkt.technology/portrait/header/482769-1598255415.jpg?lm=1,GR1,Panathinaikos Athlitikos Omilos,800000.0,2000000.0,24,110,135,8,8,14,10,13,10,4,13,9,10,12,3,11,14,9,12,9,10,12,13,12,13,14,15,12,9,11,13,15,12,12,8,13,12,13,8,11,14,10,7,12,3,1,3,3,1,1,1,2,3,3,3,14,12,2,14,13,13,10,11,1,1,1,1,1,1,14,9,20,7,10,10,6,1,65,8,20,2530999,5250,5550,2500,Northern_European,110,0,0,1976.0,Unknown,49039032,9111392.0,2.0,34,1278,36,3,1,7,150,1,0.4846520243450648,0.2620320855614972,0.4485294117647059,0.0018993691622401,0.0,0.0,0.0037509377344336,0.0097524381095273,0.0505924720131114,0.1428571428571428,0.2790697674418605,0.25,93,3,8,4,0,2816,2,28,184,700000,32142.85714285714,2000000.0,500000.0,,1500000.0,4,900000,-0.2222222222222222,-0.4166666666666667
482802,Josh,Campbell,2024,903,Scotland,Edinburgh,Scotland,06-05-00,Attacking Midfield,Midfield,Left,182.0,31-05-25,PLG Scotland,https://img.a.transfermarkt.technology/portrait/header/482802-1642066394.jpg?lm=1,SC1,Hibernian Football Club,900000.0,900000.0,24,129,150,10,12,16,12,14,10,7,13,4,6,13,14,7,14,10,13,13,13,9,13,12,13,14,6,14,7,13,14,14,14,12,9,12,13,12,11,15,9,12,6,10,3,3,3,2,1,3,2,2,1,3,1,14,13,6,14,13,12,15,15,1,1,1,1,1,1,1,15,1,16,20,12,19,16,70,20,8,3073452,6588,6741,5492,African_Caribbean,125,117,25,28461.0,Unknown,80010074,9111392.0,2.0,82,446,83,3,0,1,114,0,0.642233395078063,0.5820320855614973,0.5588235294117647,0.027473742452494,0.7697368421052632,0.3289473684210526,0.0042510627656914,0.0042510627656914,0.0505924720131114,0.1428571428571428,0.4418604651162785,0.25,191,27,22,34,0,5202,1,14,82,800000,83333.33333333333,900000.0,100000.0,,,1,200000,-0.1111111111111111,-0.1111111111111111
483046,Josip,Stanisic,2024,27,Germany,MÃ¼nchen,Croatia,02-04-00,Right-Back,Defender,Right,187.0,30-06-29,BALLWERK Sports GmbH,https://img.a.transfermarkt.technology/portrait/header/483046-1716966862.jpg?lm=1,L1,FC Bayern MÃ¼nchen,28000000.0,28000000.0,24,131,149,4,12,12,7,11,3,13,6,12,13,13,6,15,11,14,12,15,12,12,12,12,16,11,6,12,13,16,15,12,10,12,13,13,15,14,13,15,8,14,9,18,3,1,3,1,1,1,1,3,2,2,3,13,14,6,13,10,16,10,12,1,18,20,18,14,15,12,1,12,1,1,1,1,1,77,12,20,8279999,6600,6400,5500,Northern_European,124,5,0,19177.0,Unknown,91190673,9111392.0,2.0,38,1006,25,1,1,7,68,11,0.5971156390579518,0.5828877005347594,0.5514705882352942,0.0185089517548645,0.0328947368421052,0.0,0.1397849462365591,0.1397849462365591,0.0505924720131114,0.1428571428571428,0.5581395348837206,0.25,181,8,11,24,0,5227,15,93,141,28000000,1638235.294117647,28000000.0,2000000.0,,300000.0,2,2000000,0.0,1.8
483063,Berat,ÃÂZdemir,2024,6890,TÃ¼rkiye,Kayseri,TÃ¼rkiye,23-05-98,Defensive Midfield,Midfield,Right,187.0,30-06-25,MEK Football,https://img.a.transfermarkt.technology/portrait/header/483063-1695671006.png?lm=1,TR1,?stanbul Ba?ak?ehir Futbol KulÃ¼bÃ¼,5500000.0,7000000.0,26,125,130,7,8,12,8,14,9,13,12,2,13,13,12,14,12,13,13,14,13,14,12,11,15,10,8,8,13,15,12,12,12,13,13,14,12,14,13,13,3,14,5,12,2,3,3,1,3,2,3,1,3,3,1,14,16,7,13,13,15,13,13,1,1,1,1,1,1,20,1,15,1,1,1,1,1,83,12,20,7829317,6650,6500,5000,Mediterranean_Hispanic,124,3,0,22222.0,Unknown,70107299,2470000.0,2.0,100,717,100,3,1,3,4,4,0.6103466525535857,0.5294117647058822,0.5514705882352942,0.0214492563298625,0.0197368421052631,0.0,0.0272568142035508,0.0347586896724181,0.013694824856246,0.1428571428571428,0.5581395348837206,0.3333333333333332,258,10,3,36,1,4157,5,11,21,4800000,197916.66666666666,7000000.0,1500000.0,50000.0,100000.0,6,2450000,-0.2,-0.04
483348,Djed,Spence,2024,148,England,London,England,09-08-00,Right-Back,Defender,Right,184.0,30-06-27,CAA Base Ltd,https://img.a.transfermarkt.technology/portrait/header/483348-1596807960.jpg?lm=1,GB1,Tottenham Hotspur Football Club,8000000.0,13000000.0,24,130,152,6,12,13,11,10,6,7,7,10,10,10,6,11,10,11,11,11,10,10,11,9,10,13,7,13,9,9,12,17,14,12,12,13,15,14,10,10,13,12,5,12,3,1,4,1,2,2,2,1,1,3,1,12,15,11,9,13,7,8,13,1,12,10,19,13,20,1,12,1,18,12,1,18,1,68,9,20,30795806,6498,6498,4648,African_Caribbean,110,0,0,40597.0,Unknown,29178504,14700000.0,1.0,32,858,33,1,1,1,202,11,0.610082032283673,0.4917647058823529,0.4485294117647059,0.0391924735927818,0.0,0.0,0.0397599399849962,0.0647661915478869,0.0816411566987971,0.0,0.4883720930232553,0.25,226,7,11,17,1,7272,4,23,62,8000000,428571.4285714286,13000000.0,3000000.0,,2000000.0,6,10500000,0.0,0.0
484547,Jeremie,Frimpong,2024,15,Netherlands,Amsterdam,Netherlands,10-12-00,Right Midfield,Midfield,Right,172.0,30-06-28,Dirk Hebel,https://img.a.transfermarkt.technology/portrait/header/484547-1689710682.jpg?lm=1,L1,Bayer 04 Leverkusen FuÃŸball,50000000.0,50000000.0,24,142,162,11,11,15,10,11,10,6,9,6,11,11,8,12,14,13,12,14,11,11,12,11,14,13,8,14,10,13,14,18,15,11,6,14,18,14,11,12,6,12,5,12,1,1,1,3,1,3,1,3,2,3,3,13,12,6,11,12,12,13,13,1,16,1,20,16,20,1,1,1,17,1,1,12,1,64,6,20,69660001,7100,6343,5696,African_Caribbean,122,0,0,28766.0,Unknown,28113828,5690000.0,2.0,67,64,68,3,1,1,36,9,0.5895739613654406,0.6038502673796791,0.536764705882353,0.0277682557186268,0.0,0.0,0.2498124531132783,0.2498124531132783,0.0315842106725186,0.1428571428571428,0.2093023255813952,0.25,295,34,58,36,2,7538,3,14,53,50000000,2772222.222222222,50000000.0,200000.0,100000.0,15000000.0,1,6000000,0.0,0.0
484743,Gabriel,Barès,2024,969,Switzerland,Lausanne,Switzerland,29-08-00,Defensive Midfield,Midfield,Left,187.0,30-06-26,BSG GROUP,https://img.a.transfermarkt.technology/portrait/header/484743-1697213472.jpg?lm=1,FR1,Montpellier HÃ©rault Sport Club,400000.0,800000.0,24,142,152,12,13,15,15,15,8,12,13,7,6,14,20,6,16,11,15,15,15,13,15,13,16,14,13,18,7,13,13,15,15,14,10,13,15,15,14,13,9,16,8,14,1,3,3,2,2,1,2,4,3,1,1,2,16,18,12,11,11,10,8,1,1,1,1,1,1,1,1,1,1,11,1,15,20,74,20,3,28176634,7442,7442,5588,Mediterranean_Hispanic,147,18,5,67091.0,Unknown,30035404,9111392.0,2.0,92,805,92,3,0,3,133,4,0.7349827996824557,0.5922994652406417,0.7205882352941175,0.0647755374384298,0.1184210526315789,0.0657894736842105,0.0017504376094023,0.0037509377344336,0.0505924720131114,0.1428571428571428,0.5581395348837206,0.25,221,9,8,33,0,5020,2,8,40,400000,36363.63636363636,800000.0,200000.0,0.0,600000.0,5,400000,0.0,0.0
484992,Aïmen,Moueffek,2024,618,France,Vienne,Morocco,09-04-01,Central Midfield,Midfield,Right,179.0,30-06-28,CANTERASPORT,https://img.a.transfermarkt.technology/portrait/header/484992-1727722286.jpg?lm=1,FR1,Association sportive de Saint-Ã‰tienne Loire,3000000.0,3000000.0,23,113,145,10,9,4,7,15,10,9,12,8,12,12,1,13,13,6,14,11,10,12,14,15,6,5,14,11,8,11,13,11,12,12,10,14,14,13,9,12,11,5,10,11,3,1,1,2,2,3,3,2,2,3,2,15,10,5,8,13,12,9,13,1,12,10,1,1,1,20,1,15,1,1,1,1,1,73,7,20,5522999,5650,5650,2500,North_African__Middle_Eastern,111,0,0,1036.0,Unknown,49039002,9111392.0,2.0,34,1585,67,3,1,6,25,1,0.4978830378406986,0.2620320855614972,0.4558823529411764,0.0009916889321914,0.0,0.0,0.0147536884221055,0.0147536884221055,0.0505924720131114,0.1428571428571428,0.3720930232558141,0.2083333333333332,124,5,3,11,0,3030,10,34,43,2500000,108333.33333333333,3000000.0,600000.0,,2000000.0,0,0,0.25,2.125
485424,Moussa,Djenepo,2024,589,Mali,Bamako,Mali,15-06-98,Left Winger,Attack,Right,177.0,30-06-25,Unknown,https://img.a.transfermarkt.technology/portrait/header/485424-1726736621.jpg?lm=1,TR1,Antalyaspor,3000000.0,13000000.0,26,128,141,10,11,15,7,12,8,8,8,7,8,12,7,5,13,10,8,14,10,11,8,10,14,12,7,12,5,12,13,16,14,15,9,9,16,14,12,12,6,10,5,10,2,3,3,1,3,3,4,2,3,3,1,7,12,7,10,8,12,10,10,1,14,1,14,14,14,1,15,1,15,20,1,19,1,66,9,20,10564765,6400,6750,5000,African_Caribbean,120,29,3,57996.0,Unknown,6601602,6416666.667,3.0,61,133,61,0,1,1,19,7,0.6434241862926701,0.5294117647058822,0.5220588235294117,0.055993248404076,0.1907894736842105,0.0394736842105263,0.0147536884221055,0.0647661915478869,0.0356213598544404,0.2857142857142857,0.3255813953488373,0.3333333333333332,203,20,13,38,1,5655,11,35,48,2800000,110000.0,13000000.0,3000000.0,50000.0,12000000.0,3,1500000,-0.06666666666666667,-0.44
485583,Ki-Jana,Hoever,2024,290,Netherlands,Amsterdam,Netherlands,18-01-02,Right-Back,Defender,Right,183.0,30-06-25,Wasserman,https://img.a.transfermarkt.technology/portrait/header/485583-1724259461.jpg?lm=1,FR1,Association de la Jeunesse auxerroise,4500000.0,7000000.0,22,109,-8,6,10,13,9,13,11,11,9,7,11,12,8,11,11,11,10,10,13,11,11,12,15,10,8,10,11,10,10,13,11,11,12,12,13,12,11,10,8,12,7,13,4,2,2,3,2,3,1,1,1,2,2,12,15,9,10,14,12,10,14,1,14,17,19,14,20,10,1,1,10,1,1,10,1,73,10,20,44912000,5450,4900,4251,Northern_European,104,0,0,13919.0,PSV Eindhoven,37073593,4950000.0,2.0,67,64,68,1,1,7,23,11,0.3986504366234453,0.4493048128342246,0.4044117647058823,0.0134317361701881,0.0,0.0,0.0222555638909727,0.0347586896724181,0.0274729853607044,0.1428571428571428,0.4651162790697669,0.1666666666666666,0,0,0,0,0,0,0,0,0,4500000,38461.53846153846,7000000.0,2000000.0,7000000.0,4000000.0,5,5900000,0.0,0.2857142857142857
485585,Ian,Maatsen,2024,405,Netherlands,Vlaardingen,Netherlands,10-03-02,Left-Back,Defender,Left,178.0,30-06-30,Epic Maatsen,https://img.a.transfermarkt.technology/portrait/header/485585-1704795222.jpg?lm=1,GB1,Aston Villa Football Club,40000000.0,40000000.0,22,117,-8,11,12,11,10,11,11,8,10,6,10,11,11,10,13,7,9,8,10,11,8,8,13,12,6,8,11,11,14,15,12,12,6,8,15,15,7,10,9,10,7,11,2,3,3,1,1,3,3,1,1,1,3,7,12,1,10,11,12,10,17,1,20,14,1,19,1,12,14,16,13,13,1,13,1,65,20,10,42568967,5846,5846,3260,African_Caribbean,98,0,0,11599.0,Burnley,28121372,14878666.67,3.0,67,1620,68,1,0,1,30,8,0.5238158242921408,0.3433155080213903,0.3602941176470588,0.0111915041130467,0.0,0.0,0.1997999499874969,0.1997999499874969,0.0826337768826911,0.2857142857142857,0.3488372093023257,0.1666666666666666,266,14,22,46,2,6940,3,8,31,32000000,3100000.0,40000000.0,8000000.0,,9000000.0,5,31000000,-0.2,0.6
485586,Syb,Van Ottele,2024,385,Netherlands,Nijmegen,Netherlands,02-02-02,Centre-Back,Defender,Left,185.0,30-06-27,World Soccer Consult,https://img.a.transfermarkt.technology/portrait/header/485586-1629185924.jpg?lm=1,NL1,Fortuna Sittardia Combinatie,700000.0,850000.0,22,106,140,8,10,10,9,11,10,12,7,9,12,13,7,12,8,12,13,6,9,12,12,12,13,7,2,12,11,10,12,9,10,12,13,14,12,11,12,11,15,7,5,17,2,1,2,3,3,3,1,1,3,2,1,16,13,3,9,12,11,10,16,1,1,20,1,1,1,18,1,12,1,1,1,1,1,0,20,10,3849599,4999,4999,2499,Northern_European,99,0,0,953.0,Unknown,37072832,9111392.0,2.0,67,1047,68,1,0,7,94,2,0.4117491399841227,0.2619251336898395,0.3676470588235294,0.0009115426991126,0.0,0.0,0.0032508127031757,0.0040010002500625,0.0505924720131114,0.1428571428571428,0.5116279069767438,0.1666666666666666,150,7,6,14,1,5217,2,3,14,600000,50000.0,850000.0,150000.0,250000.0,350000.0,2,100000,-0.14285714285714285,-0.29411764705882354
485706,Amadou,Onana,2024,405,Senegal,Dakar,Belgium,16-08-01,Defensive Midfield,Midfield,Right,195.0,30-06-29,BTFM,https://img.a.transfermarkt.technology/portrait/header/485706-1718697649.jpg?lm=1,GB1,Aston Villa Football Club,55000000.0,55000000.0,23,133,-85,7,9,14,8,13,9,12,9,8,12,13,9,14,14,13,11,12,14,12,14,12,14,14,9,11,11,10,14,12,13,15,15,13,17,14,13,10,10,15,10,11,2,3,3,2,3,1,3,4,1,1,1,13,17,15,6,13,9,12,10,1,1,16,1,1,1,19,1,20,1,1,12,1,1,76,12,20,123699386,6800,5773,5270,African_Caribbean,130,1,0,40597.0,Unknown,91207274,37596666.67,3.0,83,402,8,3,1,1,30,4,0.5141571844403281,0.5582887700534759,0.5955882352941175,0.0391924735927818,0.006578947368421,0.0,0.274818704676169,0.274818704676169,0.2088483939553876,0.2857142857142857,0.7441860465116279,0.2083333333333332,225,17,6,46,1,2296,7,23,28,55000000,3211764.705882353,55000000.0,0.0,400000.0,10000000.0,3,28000000,0.1,0.1
485960,Lilian,Brassier,2024,244,France,Argenteuil,France,02-11-99,Centre-Back,Defender,Left,186.0,30-06-25,HD,https://img.a.transfermarkt.technology/portrait/header/485960-1623749516.jpg?lm=1,FR1,Olympique de Marseille,12000000.0,12000000.0,25,120,145,10,12,12,7,12,6,13,12,6,12,13,7,14,12,11,12,13,11,11,13,13,9,10,7,10,12,13,12,13,13,12,12,13,14,13,14,12,12,13,6,8,1,2,4,2,3,1,2,1,1,2,1,9,12,3,14,9,12,9,13,1,15,20,1,1,1,1,1,1,1,1,1,1,1,78,20,8,5539998,5984,5984,3801,African_Caribbean,121,0,0,6445.0,Unknown,48044279,1750000.0,1.0,34,84,36,1,0,1,144,2,0.5420746229161154,0.4011764705882352,0.5294117647058822,0.0062147127240352,0.0,0.0,0.0597649412353088,0.0597649412353088,0.0096947137420483,0.0,0.5348837209302322,0.2916666666666665,202,7,4,35,1,3137,1,1,8,10000000,527777.7777777778,12000000.0,2000000.0,,1500000.0,3,2875000,-0.16666666666666666,0.25
485963,Pape,Gueye,2024,1050,France,Montreuil,Senegal,24-01-99,Defensive Midfield,Midfield,Left,189.0,30-06-28,ROOF,https://img.a.transfermarkt.technology/portrait/header/485963-1604255792.jpg?lm=1,ES1,Villarreal Club de FÃºtbol S.A.D.,6000000.0,12000000.0,25,125,145,11,8,11,6,13,10,10,14,3,12,14,9,14,13,12,13,11,7,8,12,12,13,13,12,13,14,15,14,14,11,14,10,14,14,14,14,11,11,10,12,9,2,1,3,3,2,1,2,2,1,1,2,13,15,13,7,8,7,11,10,1,1,1,1,1,1,20,1,18,1,1,1,1,1,65,20,10,4159691,6250,6000,4500,African_Caribbean,125,11,0,27615.0,Unknown,48043484,9111392.0,2.0,34,979,84,3,0,1,216,4,0.5441915850754168,0.4759358288770053,0.5588235294117647,0.0266568302454502,0.0723684210526315,0.0,0.0297574393598399,0.0597649412353088,0.0505924720131114,0.1428571428571428,0.6046511627906974,0.2916666666666665,236,11,10,49,2,5096,0,0,0,8000000,410526.3157894737,12000000.0,2000000.0,,1750000.0,5,5500000,0.3333333333333333,0.0
485965,Nicolas,Cozza,2024,995,France,Ganges,France,08-01-99,Left-Back,Defender,Left,178.0,30-06-25,One Team Football ,https://img.a.transfermarkt.technology/portrait/header/485965-1689865641.jpg?lm=1,FR1,Football Club de Nantes,3500000.0,5000000.0,25,125,139,9,11,11,8,13,7,12,9,10,14,13,8,13,12,10,14,12,13,13,11,12,11,10,10,12,14,14,13,12,12,14,12,13,12,14,13,13,9,14,11,12,2,2,3,3,3,2,3,1,1,2,1,8,13,11,10,12,14,12,15,1,20,20,1,14,1,1,1,1,1,1,1,1,1,72,20,8,2298572,6250,6250,3814,Northern_European,125,0,0,8049.0,Unknown,49037761,500000.0,1.0,34,521,36,1,0,7,93,8,0.5772691188145012,0.402566844919786,0.5588235294117647,0.007763562818714,0.0,0.0,0.0172543135783946,0.0247561890472618,0.0027500763910108,0.0,0.3488372093023257,0.2916666666666665,174,6,8,18,3,5946,3,24,198,3500000,176315.7894736842,5000000.0,1500000.0,150000.0,4000000.0,2,1500000,0.0,0.0
486039,Anouar,Ait El Hadj,2024,3948,Belgium,Molenbeek,Belgium,20-04-02,Attacking Midfield,Midfield,Right,167.0,30-06-28,YOU FIRST,https://img.a.transfermarkt.technology/portrait/header/486039-1714038174.png?lm=1,BE1,Royale Union Saint-Gilloise,2500000.0,6000000.0,22,115,-75,11,12,13,9,15,9,9,12,5,9,14,5,5,14,8,13,14,14,11,13,10,10,15,5,12,10,12,11,12,12,11,5,9,14,15,10,8,8,13,5,16,3,2,2,1,2,3,1,1,2,1,3,11,14,7,14,7,12,12,10,1,1,1,1,1,1,1,1,15,1,17,20,12,1,70,10,20,24620000,5245,5495,3995,North_African__Middle_Eastern,116,0,0,3499.0,Unknown,18113291,1750000.0,2.0,7,965,8,3,1,6,177,0,0.4773749669224663,0.4219251336898395,0.4926470588235294,0.0033700042583721,0.0,0.0,0.0122530632658164,0.0297574393598399,0.0096947137420483,0.1428571428571428,0.0930232558139532,0.1666666666666666,0,0,0,0,0,0,0,0,0,1800000,100000.0,6000000.0,1500000.0,2800000.0,2000000.0,2,1000000,-0.28,0.2
486046,Maarten,Vandevoordt,2024,23826,Belgium,Sint-Truiden,Belgium,26-02-02,Goalkeeper,Goalkeeper,Right,192.0,30-06-29,SportPlus,https://img.a.transfermarkt.technology/portrait/header/486046-1724337345.jpg?lm=1,L1,RasenBallsport Leipzig,8000000.0,11000000.0,22,121,-8,4,1,3,2,9,6,1,2,3,1,15,4,1,14,6,10,12,10,14,8,11,14,14,10,2,11,10,14,13,14,12,14,7,14,10,10,10,9,12,13,14,12,12,12,13,12,14,16,14,12,6,11,19,12,12,8,11,11,10,19,20,1,1,1,1,1,1,1,1,1,1,1,1,1,76,7,20,5000000,6400,6000,4500,Northern_European,122,0,0,8500.0,Unknown,18107187,10000000.0,1.0,7,1376,8,2,1,7,162,5,0.5441915850754168,0.4759358288770053,0.536764705882353,0.0081990562056842,0.0,0.0,0.0397599399849962,0.0547636909227306,0.055529320258896,0.0,0.6744186046511627,0.1666666666666666,0,0,0,0,0,0,3,17,138,8000000,490625.0,11000000.0,3000000.0,1500000.0,9000000.0,2,4200000,-0.2727272727272727,-0.2727272727272727
486049,Jérémy,Doku,2024,281,Belgium,Borgerhout,Belgium,27-05-02,Left Winger,Attack,Right,173.0,30-06-28,Elevate,https://img.a.transfermarkt.technology/portrait/header/486049-1666699113.jpg?lm=1,GB1,Manchester City Football Club,65000000.0,65000000.0,22,129,-9,11,11,15,10,14,8,5,8,5,5,12,14,7,16,14,12,18,11,9,6,8,12,16,6,11,7,11,14,16,15,5,5,16,17,12,10,10,5,12,9,11,1,4,2,3,1,1,1,2,2,1,1,12,15,4,12,10,11,12,13,1,1,1,1,1,1,1,1,1,1,20,1,15,19,67,10,20,100263256,6450,6450,4500,African_Caribbean,121,10,2,14999.0,Unknown,18106083,43000000.0,2.0,7,227,8,0,1,1,131,7,0.6037311458057687,0.4759358288770053,0.5294117647058822,0.014474602817478,0.0657894736842105,0.0263157894736842,0.3248312078019504,0.3248312078019504,0.2388677463262868,0.1428571428571428,0.2325581395348837,0.1666666666666666,199,30,33,11,1,4705,12,70,45,60000000,3105263.1578947366,65000000.0,5000000.0,22000000.0,18000000.0,3,46000000,-0.07692307692307693,-0.07692307692307693
486051,Marco,Kana,2024,58,DR Congo,Kinshasa,Belgium,08-08-02,Defensive Midfield,Midfield,Right,182.0,30-06-26,Stirr Associates,https://img.a.transfermarkt.technology/portrait/header/486051-1660720218.jpg?lm=1,BE1,Royal Sporting Club Anderlecht,1500000.0,4500000.0,22,112,-75,10,10,13,8,11,8,12,7,7,12,14,7,14,14,14,12,12,12,12,12,12,14,14,14,11,11,14,13,13,12,10,10,10,13,10,13,8,12,10,14,14,3,2,3,2,2,1,3,1,1,1,3,20,15,2,12,12,14,10,16,1,1,17,1,1,1,20,1,15,1,1,1,1,1,65,7,20,24620000,4990,5240,3990,African_Caribbean,112,0,0,6499.0,Unknown,18107452,9111392.0,2.0,27,729,8,3,1,1,175,4,0.4436358825086002,0.4213903743315507,0.463235294117647,0.0062668560563997,0.0,0.0,0.0072518129532383,0.0222555638909727,0.0505924720131114,0.1428571428571428,0.4418604651162785,0.1666666666666666,87,1,1,12,0,2476,8,61,107,1000000,0.0,4500000.0,1000000.0,2800000.0,2000000.0,2,500000,-0.3333333333333333,-0.5
486083,Danila,Prokhin,2024,14589,Russia,"Kirishi, Leningrad Oblast",Russia,24-05-01,Centre-Back,Defender,Right,186.0,30-06-25,InFootball,https://img.a.transfermarkt.technology/portrait/header/486083-1722312973.png?lm=1,RU1,FC Orenburg,1800000.0,3200000.0,23,111,143,7,9,6,10,10,8,14,14,6,11,10,9,12,10,8,13,13,13,14,6,11,5,5,12,11,13,15,15,10,10,11,14,15,13,13,10,16,8,7,12,7,3,3,1,2,2,3,2,2,2,3,2,9,12,3,10,11,12,13,15,1,1,20,1,1,1,1,1,1,1,1,1,1,1,74,7,20,6995018,5518,5518,3119,Northern_European,108,0,0,18160.0,Unknown,58147376,1700000.0,1.0,78,731,81,1,1,7,70,2,0.480418100026462,0.328235294117647,0.4338235294117646,0.0175269189953331,0.0,0.0,0.0087521880470117,0.0157539384846211,0.0094169282480068,0.0,0.5348837209302322,0.2083333333333332,146,4,3,36,2,5052,0,0,0,1500000,66666.66666666667,3200000.0,1000000.0,350000.0,3000000.0,5,1525000,0.0,-0.25
486144,Jakub,Stolarczyk,2024,1003,Poland,Kielce,Poland,19-12-00,Goalkeeper,Goalkeeper,Right,194.0,30-06-26,Two Touch Agency,https://img.a.transfermarkt.technology/portrait/header/486144-1692967745.jpg?lm=1,GB1,Leicester City Football Club,400000.0,400000.0,24,108,-8,5,1,1,2,5,6,1,1,1,3,9,3,2,8,14,13,15,9,8,8,14,8,1,10,2,12,9,8,12,10,9,13,14,10,6,7,20,7,5,6,15,12,13,12,5,11,11,13,13,12,8,14,19,11,3,11,11,12,9,15,20,1,1,1,1,1,1,1,1,1,1,1,1,1,82,12,20,63841850,5390,5390,2990,Northern_European,106,0,0,11599.0,Fleetwood Town,28117362,9111392.0,2.0,75,725,78,2,1,7,127,5,0.4634824027520507,0.3144385026737967,0.4191176470588235,0.0111915041130467,0.0,0.0,0.0017504376094023,0.0017504376094023,0.0505924720131114,0.1428571428571428,0.7209302325581395,0.25,0,0,0,0,0,0,1,18,140,400000,33333.333333333336,400000.0,0.0,,200000.0,2,100000,0.0,0.3333333333333333
486814,Filip,Krastev,2024,1269,Bulgaria,Sofia,Bulgaria,15-10-01,Central Midfield,Midfield,Right,178.0,30-06-25,Unknown,https://img.a.transfermarkt.technology/portrait/header/486814-1724750480.jpg?lm=1,NL1,Prins Hendrik Ende Desespereert Nimmer Combinatie Zwolle,3000000.0,4000000.0,23,118,148,14,12,14,11,13,14,6,11,5,7,14,13,9,14,8,11,9,12,8,14,10,13,16,10,12,10,13,13,13,14,13,8,13,12,13,7,11,7,15,8,13,1,3,2,3,3,3,3,2,1,2,1,9,16,1,13,17,17,17,17,1,1,1,1,1,1,14,1,20,5,1,20,5,1,68,12,20,1875001,5909,5759,5056,Northern_European,115,4,0,2000.0,Levski Sofia,22073681,9111392.0,2.0,11,1389,12,3,1,7,156,1,0.5123048425509394,0.5354010695187166,0.4852941176470588,0.0019225439766243,0.0263157894736842,0.0,0.0147536884221055,0.0197549387346836,0.0505924720131114,0.1428571428571428,0.3488372093023257,0.2083333333333332,159,26,17,21,0,5381,1,1,6,3000000,155263.15789473685,4000000.0,1000000.0,150000.0,1200000.0,5,1500000,0.0,-0.25
487421,Juan Manuel,Boselli,2024,49702,Uruguay,Montevideo,Uruguay,09-11-99,Right Winger,Attack,Left,175.0,30-06-26,Unknown,https://img.a.transfermarkt.technology/portrait/header/487421-1722314954.png?lm=1,RU1,FK Nizhny Novgorod,700000.0,700000.0,25,120,136,15,15,14,12,14,13,6,15,11,4,13,9,8,15,13,9,11,13,8,13,9,10,14,7,12,9,10,10,13,14,14,7,12,13,12,11,8,13,10,6,13,3,2,3,1,2,2,3,1,1,3,3,11,9,2,14,13,11,12,14,1,1,1,1,1,1,1,1,11,1,18,18,20,14,72,20,9,1149999,6000,5323,4035,Mediterranean_Hispanic,119,0,0,1649.0,Unknown,78084181,125000.0,2.0,106,975,103,0,0,3,79,10,0.4546176237099761,0.4262032085561497,0.5147058823529411,0.0015836123162551,0.0,0.0,0.0032508127031757,0.0032508127031757,0.0006666851856996,0.1428571428571428,0.2790697674418605,0.2916666666666665,181,25,9,29,1,3786,3,5,41,900000,50000.0,900000.0,200000.0,300000.0,100000.0,6,550000,0.2857142857142857,0.2857142857142857
487465,Pedro,Neto,2024,631,Portugal,Viana do Castelo,Portugal,09-03-00,Right Winger,Attack,Left,173.0,30-06-31,Gestifute,https://img.a.transfermarkt.technology/portrait/header/487465-1709158892.jpg?lm=1,GB1,Chelsea Football Club,55000000.0,55000000.0,24,138,167,13,13,17,13,13,11,7,12,3,5,13,8,3,14,9,9,9,11,10,11,11,15,16,7,13,6,11,10,17,13,11,7,14,16,12,7,14,11,12,5,17,1,2,1,2,3,1,2,1,2,1,1,13,15,8,13,14,15,16,15,1,1,1,1,1,1,1,14,1,14,20,15,20,16,62,20,10,48667812,6900,6400,6000,Mediterranean_Hispanic,124,3,1,46397.0,Unknown,29179717,29633333.33,3.0,76,1580,79,0,0,3,50,10,0.5971156390579518,0.6363636363636364,0.5514705882352942,0.0447930537356352,0.0197368421052631,0.0131578947368421,0.274818704676169,0.274818704676169,0.1646064242340064,0.2857142857142857,0.2325581395348837,0.25,185,21,30,28,0,5067,10,128,298,55000000,2190000.0,55000000.0,6000000.0,2500000.0,27000000.0,3,7250000,0.0,0.30952380952380953
487466,Pedro,Ganchas,2024,1177,Portugal,Lisboa,Portugal,31-05-00,Centre-Back,Defender,Left,190.0,31-12-28,Signature - ISCM AG,https://img.a.transfermarkt.technology/portrait/header/487466-1725559352.JPG?lm=1,DK1,Silkeborg IdrÃ¦tsforening,700000.0,700000.0,24,106,140,9,10,9,8,12,5,13,10,5,13,11,4,12,12,12,11,10,13,12,11,12,14,4,12,8,11,13,11,11,11,12,15,13,12,12,12,13,8,10,9,8,1,2,2,3,2,4,1,3,2,1,2,10,13,3,14,14,15,18,16,1,17,20,1,16,1,1,1,1,1,1,1,1,1,84,20,5,751999,5300,5300,2070,Northern_European,106,0,0,1849.0,Unknown,83191310,400000.0,1.0,76,843,79,1,0,7,182,2,0.4515744906059804,0.2160427807486631,0.4191176470588235,0.0017767357694569,0.0,0.0,0.0032508127031757,0.0032508127031757,0.0021945054029278,0.0,0.6279069767441858,0.25,124,11,1,20,0,2539,0,0,0,1200000,90000.0,1200000.0,100000.0,,300000.0,2,500000,0.7142857142857143,2.4285714285714284
487469,Unknown,Vitinha,2024,583,Portugal,Vila das Aves,Portugal,13-02-00,Central Midfield,Midfield,Right,172.0,30-06-27,Gestifute,https://img.a.transfermarkt.technology/portrait/header/487469-1672303629.jpg?lm=1,FR1,Paris Saint-Germain Football Club,55000000.0,55000000.0,24,150,173,12,11,15,9,15,10,6,13,9,12,16,10,12,16,12,15,15,15,13,16,15,14,13,12,14,13,16,15,13,16,14,6,14,13,14,9,15,5,13,5,10,2,2,1,3,1,1,1,1,1,2,1,15,14,5,16,16,16,14,14,1,1,1,1,1,1,19,1,20,1,1,13,1,1,66,10,20,82354132,7600,7300,5550,Mediterranean_Hispanic,150,3,0,91246.0,Unknown,83174762,41500000.0,1.0,76,1591,79,3,1,3,154,1,0.7161947605186557,0.588235294117647,0.7426470588235294,0.0881000224988823,0.0197368421052631,0.0,0.274818704676169,0.274818704676169,0.2305341815050418,0.0,0.2093023255813952,0.25,234,30,22,16,0,5718,2,6,25,55000000,2972222.222222222,55000000.0,3000000.0,,5000000.0,4,15200000,0.0,0.2222222222222222
487474,Francisco,Conceição,2024,506,Portugal,Coimbra,Portugal,14-12-02,Right Winger,Attack,Left,170.0,30-06-25,Gestifute,https://img.a.transfermarkt.technology/portrait/header/487474-1713948689.png?lm=1,IT1,Juventus Football Club,22000000.0,22000000.0,22,124,-85,12,12,16,11,14,11,6,11,3,4,13,11,5,15,13,11,15,12,11,12,11,14,19,8,14,5,8,13,15,16,11,6,13,14,11,8,11,14,13,3,6,4,1,2,2,2,3,2,2,2,2,3,12,13,16,6,14,14,5,7,1,1,1,1,1,1,1,5,1,13,14,12,20,1,64,20,8,64200000,6200,6200,4250,Mediterranean_Hispanic,121,0,0,26000.0,Unknown,83261140,7750000.0,2.0,76,374,79,0,0,3,116,10,0.5706536120666843,0.4491978609625668,0.5294117647058822,0.0250973583608453,0.0,0.0,0.1097774443610902,0.1097774443610902,0.0430289730270285,0.1428571428571428,0.1627906976744184,0.1666666666666666,177,26,25,31,0,4745,7,30,39,36000000,2950000.0,36000000.0,0.0,8000000.0,8000000.0,4,18500000,0.6363636363636364,2.6
487834,Lorenzo,Pirola,2024,683,Italy,Carate Brianza,Italy,20-02-02,Centre-Back,Defender,Left,185.0,30-06-27,GR Sports,https://img.a.transfermarkt.technology/portrait/header/487834-1728417291.png?lm=1,GR1,Olympiakos Syndesmos Filathlon Peiraios,5500000.0,8000000.0,22,113,-75,3,8,7,8,11,3,13,4,5,13,12,4,13,12,10,13,12,11,11,12,11,15,8,10,8,12,12,13,13,12,13,13,16,13,12,14,13,8,11,3,10,2,2,2,1,3,3,3,2,4,3,3,12,14,3,12,13,14,11,7,1,12,20,1,1,1,1,1,1,1,1,1,1,1,78,20,9,50240000,5645,5645,3009,Mediterranean_Hispanic,112,0,0,7871.0,U.S. Salernitana 1919,43425720,4000000.0,2.0,52,317,54,1,0,3,141,2,0.4972214871659169,0.316470588235294,0.463235294117647,0.0075916829453644,0.0,0.0,0.0272568142035508,0.0397599399849962,0.0221950609739159,0.1428571428571428,0.5116279069767438,0.1666666666666666,163,6,3,19,0,3822,11,32,56,5500000,364285.71428571426,8000000.0,1500000.0,1500000.0,2500000.0,3,600000,0.0,-0.21428571428571427
487843,Lorenzo,Colombo,2024,749,Italy,Vimercate,Italy,08-03-02,Centre-Forward,Attack,Left,183.0,30-06-25,GR Sports,https://img.a.transfermarkt.technology/portrait/header/487843-1663745283.jpg?lm=1,IT1,Empoli Football Club S.r.l.,6000000.0,7000000.0,22,118,-8,3,7,11,14,13,9,14,13,3,4,11,12,5,13,12,12,11,12,10,11,12,17,8,6,13,7,11,11,13,13,12,12,14,13,12,12,12,11,7,9,8,1,3,1,1,2,3,3,2,4,1,2,14,16,5,13,15,14,14,13,1,1,1,1,1,1,1,1,1,1,11,1,13,20,76,20,12,55700000,5900,6100,4750,Mediterranean_Hispanic,118,0,0,10672.0,Salento,43424893,9111392.0,2.0,52,1612,54,0,0,3,64,3,0.5574225985710506,0.5026737967914437,0.5073529411764706,0.0102963769074562,0.0,0.0,0.0297574393598399,0.0347586896724181,0.0505924720131114,0.1428571428571428,0.4651162790697669,0.1666666666666666,186,47,7,19,0,1655,4,24,96,6000000,416666.6666666667,7000000.0,1000000.0,1000000.0,3500000.0,5,4000000,0.0,-0.14285714285714285
487969,Randal,Kolo Muani,2024,583,France,Bondy,France,05-12-98,Centre-Forward,Attack,Right,187.0,30-06-28,Unknown,https://img.a.transfermarkt.technology/portrait/header/487969-1718697120.jpg?lm=1,FR1,Paris Saint-Germain Football Club,40000000.0,80000000.0,26,140,149,8,11,15,14,14,8,13,10,4,7,14,10,7,15,7,13,12,13,13,12,13,13,15,8,12,7,12,11,15,14,12,13,14,16,14,14,12,8,10,4,12,2,3,3,2,3,2,2,3,1,3,2,12,12,5,14,12,13,14,15,1,1,1,1,1,1,1,1,1,14,13,1,17,20,73,10,20,16252107,7000,6700,5400,North_African__Middle_Eastern,138,0,0,28766.0,Unknown,48043873,95000000.0,1.0,34,223,36,0,1,6,154,3,0.6368086795448531,0.5721925133689839,0.6544117647058822,0.0277682557186268,0.0,0.0,0.1997999499874969,0.3998499624906226,0.527764660129448,0.0,0.5581395348837206,0.3333333333333332,252,81,50,25,2,3927,2,2,5,30000000,1243750.0,80000000.0,15000000.0,150000.0,300000.0,2,14000000,-0.3333333333333333,-0.5714285714285714
488052,Matthias,Braunöder,2024,1047,Austria,Eisenstadt,Austria,27-03-02,Central Midfield,Midfield,Right,174.0,30-06-27,CN Sports,https://img.a.transfermarkt.technology/portrait/header/488052-1692968166.png?lm=1,IT1,Calcio Como,2000000.0,3500000.0,22,121,128,4,15,12,7,11,5,7,8,15,12,12,6,13,12,14,12,13,12,11,12,12,15,12,6,13,12,12,13,14,12,11,8,14,15,15,9,14,8,13,9,14,2,3,2,3,2,1,1,4,3,3,1,10,13,6,13,12,16,12,12,1,12,1,20,12,18,1,8,1,12,1,1,10,1,73,9,20,1686048,6079,6079,4072,Northern_European,114,0,0,12466.0,Unknown,91149532,1500000.0,1.0,6,451,7,3,1,7,47,1,0.5546440857369674,0.4301604278074866,0.4779411764705882,0.0120286942826767,0.0,0.0,0.0097524381095273,0.0172543135783946,0.0083057862718408,0.0,0.2558139534883721,0.1666666666666666,193,12,17,29,1,5423,1,1,11,2000000,137500.0,3500000.0,1000000.0,300000.0,3500000.0,2,750000,0.0,0.5384615384615384
488362,Conor,Gallagher,2024,13,England,Epsom,England,06-02-00,Central Midfield,Midfield,Right,182.0,30-06-29,Unknown,https://img.a.transfermarkt.technology/portrait/header/488362-1668500476.jpg?lm=1,ES1,Club AtlÃ©tico de Madrid S.A.D.,50000000.0,50000000.0,24,144,164,12,12,13,14,13,13,8,12,6,9,13,7,13,13,17,11,15,13,14,13,14,17,12,11,14,13,15,17,15,14,11,10,16,13,18,11,13,8,11,4,8,3,1,2,3,3,4,1,3,2,1,2,8,13,7,13,14,13,9,14,1,1,1,1,1,1,14,12,20,12,1,16,1,1,74,12,20,44656818,7200,7150,6250,Northern_European,142,4,0,17399.0,Unknown,28108036,42000000.0,1.0,32,466,33,3,1,7,52,1,0.696348240275205,0.6631016042780749,0.6838235294117647,0.0167920842559001,0.0263157894736842,0.0,0.2498124531132783,0.2498124531132783,0.2333120364454568,0.0,0.4418604651162785,0.25,335,45,44,77,0,6247,1,0,5,40000000,2111111.111111111,50000000.0,10000000.0,,10000000.0,7,29000000,-0.2,-0.047619047619047616
488755,Jakov,Medic,2024,80,Croatia,Zagreb,Croatia,07-09-98,Centre-Back,Defender,Right,193.0,30-06-25,Unknown,https://img.a.transfermarkt.technology/portrait/header/488755-1689779607.jpg?lm=1,L1,Verein fÃ¼r LeibesÃ¼bungen Bochum 1848 FuÃŸballgemeinschaft,2000000.0,2500000.0,26,120,132,6,7,8,8,11,8,13,7,6,13,12,6,13,10,15,12,15,12,12,11,12,17,9,10,8,13,13,13,12,9,15,16,15,13,13,13,15,12,12,5,13,2,3,3,1,2,2,1,1,2,3,1,17,15,8,7,14,12,11,10,1,1,20,1,1,1,17,1,14,1,1,1,1,10,91,10,20,1685824,6000,5195,4416,Northern_European,119,0,0,1500.0,Unknown,24055490,1700000.0,2.0,24,1697,25,1,1,7,212,2,0.437681926435565,0.466951871657754,0.5147058823529411,0.0014397353436197,0.0,0.0,0.0097524381095273,0.0122530632658164,0.0094169282480068,0.1428571428571428,0.6976744186046511,0.3333333333333332,174,16,8,23,0,2372,7,12,78,2000000,108333.33333333333,2500000.0,500000.0,50000.0,200000.0,6,1300000,0.0,-0.2
488935,Hákon Rafn,Valdimarsson,2024,1148,Iceland,Reykjavik,Iceland,13-10-01,Goalkeeper,Goalkeeper,Right,195.0,30-06-28,CAA Stellar,https://img.a.transfermarkt.technology/portrait/header/488935-1689319830.jpg?lm=1,GB1,Brentford Football Club,2500000.0,2500000.0,23,108,144,6,7,1,3,7,7,3,3,1,3,8,1,1,7,8,11,14,11,12,7,11,14,3,6,1,11,11,10,10,12,12,15,12,10,10,12,13,6,12,5,10,12,14,9,5,13,12,13,13,8,7,11,14,12,5,10,14,12,15,15,20,1,1,1,1,1,1,1,1,1,1,1,1,1,0,8,20,1118275,5400,4446,1350,Northern_European,106,2,0,1165.0,Unknown,39053746,3000000.0,1.0,46,1221,48,2,1,7,43,5,0.3385816353532681,0.1390374331550802,0.4191176470588235,0.0011162535595066,0.0131578947368421,0.0,0.0122530632658164,0.0122530632658164,0.0166393510930859,0.0,0.7441860465116279,0.2083333333333332,0,0,0,0,0,0,0,0,0,2500000,178571.42857142858,2500000.0,0.0,50000.0,350000.0,3,925000,0.0,0.3888888888888889
488996,Thórir Jóhann,Helgason,2024,1005,Iceland,HafnarfjÃ¶rÃ°ur,Iceland,28-09-00,Central Midfield,Midfield,Right,187.0,30-06-25,Dirk Hebel,https://img.a.transfermarkt.technology/portrait/header/488996-1725530709.jpg?lm=1,IT1,Unione Sportiva Lecce,1000000.0,1000000.0,24,111,148,11,12,13,12,13,10,8,12,2,11,13,10,11,13,6,13,12,9,12,12,12,12,12,13,13,11,13,11,12,12,12,13,14,12,12,12,12,4,10,3,12,2,1,1,1,1,3,3,1,3,2,1,14,12,4,12,13,13,14,16,1,1,1,1,1,1,15,1,20,1,1,12,1,1,74,8,20,4303999,5548,4892,2048,Northern_European,112,12,2,5014.0,Unknown,39053303,9111392.0,2.0,46,587,48,3,1,7,206,1,0.3975919555437947,0.2136898395721925,0.463235294117647,0.004832914416376,0.0789473684210526,0.0263157894736842,0.0047511877969492,0.0047511877969492,0.0505924720131114,0.1428571428571428,0.5581395348837206,0.25,0,0,0,0,0,0,1,1,10,800000,72727.27272727272,1000000.0,200000.0,,125000.0,4,525000,-0.2,0.0
489463,Kyogo,Furuhashi,2024,371,Japan,"Ikoma, Nara",Japan,20-01-95,Centre-Forward,Attack,Right,170.0,31-05-27,CAA Base Ltd,https://img.a.transfermarkt.technology/portrait/header/489463-1671709799.jpg?lm=1,SC1,The Celtic Football Club,14000000.0,15000000.0,29,139,148,7,9,12,13,13,7,7,12,4,5,11,12,10,14,15,16,10,12,14,13,11,18,13,8,18,8,14,17,15,15,12,6,14,15,16,4,13,4,13,4,10,3,3,1,1,4,3,2,2,3,1,4,17,15,1,13,18,16,14,16,1,1,1,1,1,1,1,1,1,1,18,1,15,20,63,15,20,22323305,6950,7000,6000,10,127,15,3,22038.0,Unknown,45105555,2775000.0,2.0,54,652,56,0,1,0,200,3,0.6765017200317545,0.6363636363636364,0.5735294117647058,0.0212715827529168,0.0986842105263157,0.0394736842105263,0.0697674418604651,0.0747686921730432,0.0153893163698991,0.1428571428571428,0.1627906976744184,0.4583333333333332,0,0,0,0,0,0,3,38,117,14000000,822058.8235294118,15000000.0,1000000.0,,,2,4000000,0.0,-0.06666666666666667
489929,Magnus,Mattsson,2024,190,Denmark,Marstal,Denmark,25-02-99,Central Midfield,Midfield,Right,174.0,30-06-28,Boutique Transfers,https://img.a.transfermarkt.technology/portrait/header/489929-1704798357.jpg?lm=1,DK1,Football Club KÃ¸benhavn,3500000.0,3500000.0,25,122,135,13,13,14,12,14,14,7,13,6,5,12,14,3,14,8,13,9,12,12,12,12,15,14,7,13,4,14,14,14,13,10,7,12,12,11,7,13,5,11,11,10,2,2,2,2,2,3,1,1,3,3,3,7,14,4,14,12,13,14,15,1,1,1,1,1,1,1,14,14,10,20,18,10,1,63,15,20,3722397,6100,6000,4000,Northern_European,122,0,0,3045.0,Unknown,27119215,2750000.0,2.0,28,920,30,3,1,7,90,1,0.5441915850754168,0.4224598930481283,0.536764705882353,0.0029316140196039,0.0,0.0,0.0172543135783946,0.0172543135783946,0.0152504236228784,0.1428571428571428,0.2558139534883721,0.2916666666666665,241,70,33,12,0,7192,9,67,287,3500000,202941.17647058822,3500000.0,50000.0,50000.0,300000.0,3,700000,0.0,0.16666666666666666
490309,Edward,Chilufya,2024,865,Zambia,Kasama,Zambia,17-09-99,Right Winger,Attack,Right,171.0,31-12-26,Prosport,https://img.a.transfermarkt.technology/portrait/header/490309-1695368588.jpg?lm=1,DK1,Fodbold Club Midtjylland,1500000.0,2500000.0,25,118,140,6,11,14,12,12,5,10,11,7,5,11,9,4,14,11,9,11,9,9,8,10,15,15,6,11,6,12,13,17,14,12,8,12,16,10,9,9,8,10,12,9,3,3,1,2,1,1,2,2,3,1,3,12,12,6,15,12,15,14,14,1,1,1,1,1,1,1,12,1,12,18,1,20,15,65,6,20,3790693,5848,4996,3659,African_Caribbean,109,6,0,4772.0,Unknown,13191598,2400000.0,1.0,112,711,107,0,1,1,86,10,0.4113522095792538,0.3859893048128341,0.4411764705882353,0.0045992350380018,0.0394736842105263,0.0,0.0072518129532383,0.0122530632658164,0.0133059251645879,0.0,0.1860465116279068,0.2916666666666665,193,38,20,9,0,7573,0,0,0,1500000,92187.5,2500000.0,500000.0,75000.0,200000.0,4,550000,0.0,-0.25
490384,Koni,De Winter,2024,252,Belgium,Antwerpen,Belgium,12-06-02,Centre-Back,Defender,Right,191.0,30-06-28,NGA Sport,https://img.a.transfermarkt.technology/portrait/header/490384-1661524152.jpg?lm=1,IT1,Genoa Cricket and Football Club,12000000.0,12000000.0,22,118,-75,7,10,12,7,12,8,13,7,6,13,12,7,13,11,9,13,11,11,10,11,12,15,11,9,8,13,13,10,12,12,14,13,16,14,13,13,13,7,12,5,19,1,3,4,1,2,1,2,3,2,4,3,14,14,7,12,11,14,11,11,1,1,20,14,1,1,11,1,7,1,1,1,1,1,78,10,20,46000000,5900,4653,3160,Mixed_Race,118,0,0,6811.0,Empoli Football Club,18108550,8000000.0,1.0,7,74,8,1,1,4,104,2,0.3659698332892299,0.3326203208556149,0.5073529411764706,0.0065681286433946,0.0,0.0,0.0597649412353088,0.0597649412353088,0.044417900497236,0.0,0.6511627906976742,0.1666666666666666,156,6,3,24,1,1987,11,43,73,12000000,1288888.888888889,12000000.0,0.0,,4000000.0,3,6400000,0.0,0.7142857142857143
490417,Ibrahima,Niane,2024,1420,Senegal,M'bour,Senegal,11-03-99,Centre-Forward,Attack,Right,187.0,30-06-25,World Elites,https://img.a.transfermarkt.technology/portrait/header/490417-1511780508.jpg?lm=1,FR1,Angers Sporting Club de l'Ouest,1000000.0,9000000.0,25,120,129,7,8,11,13,10,11,13,13,8,8,8,12,7,11,10,12,14,13,12,14,11,12,8,11,14,7,12,13,13,12,15,15,12,14,12,14,11,10,11,10,8,1,1,2,3,2,1,3,3,4,2,2,12,9,5,13,11,12,10,12,1,1,1,1,1,1,1,1,1,1,12,8,12,20,73,9,20,2144803,6000,6000,3655,African_Caribbean,120,0,0,7536.0,Unknown,13181735,500000.0,1.0,83,887,84,0,1,1,18,3,0.5441915850754168,0.3855614973262031,0.5220588235294117,0.0072682011612513,0.0,0.0,0.0047511877969492,0.0447611902975743,0.0027500763910108,0.0,0.5581395348837206,0.2916666666666665,221,41,7,13,2,6871,1,29,183,1500000,63157.89473684211,9000000.0,1500000.0,1500000.0,3500000.0,1,500000,0.5,0.0
490423,Ignace,Van Der Brempt,2024,1047,Belgium,Antwerpen,Belgium,01-04-02,Right-Back,Defender,Right,187.0,30-06-25,YOU FIRST,https://img.a.transfermarkt.technology/portrait/header/490423-1692996873.png?lm=1,IT1,Calcio Como,3000000.0,3500000.0,22,121,-8,9,12,11,7,11,7,11,7,9,11,11,4,11,11,14,11,13,10,11,10,10,15,5,8,13,10,15,14,14,11,12,14,13,15,14,12,10,9,8,5,12,1,2,3,2,1,2,4,3,2,1,2,15,16,8,11,10,10,11,20,1,1,14,20,1,18,1,1,1,15,1,1,13,1,0,12,20,14765000,6090,6060,2249,Northern_European,112,0,0,4800.0,Unknown,18110809,9111392.0,2.0,7,74,8,1,1,7,47,11,0.5521301931727971,0.235187165775401,0.463235294117647,0.0046262723214501,0.0,0.0,0.0147536884221055,0.0172543135783946,0.0505924720131114,0.1428571428571428,0.5581395348837206,0.1666666666666666,125,4,10,19,0,4565,9,30,43,3000000,181250.0,3500000.0,500000.0,1200000.0,3000000.0,3,2300000,0.0,-0.14285714285714285
490426,Krépin,Diatta,2024,162,Senegal,Dakar,Senegal,25-02-99,Right Winger,Attack,Right,175.0,30-06-25,Wasserman,https://img.a.transfermarkt.technology/portrait/header/490426-1668163198.jpg?lm=1,FR1,Association sportive de Monaco Football Club,12000000.0,21000000.0,25,129,140,5,10,13,10,13,8,8,11,3,10,13,9,10,14,9,12,15,13,13,12,11,12,13,9,10,8,11,13,14,14,10,8,12,14,10,10,12,9,11,6,15,2,1,1,1,1,1,2,2,1,1,3,12,16,4,13,12,11,11,15,1,1,1,11,14,17,1,14,12,17,20,19,18,12,68,10,20,3316642,6450,6450,5000,African_Caribbean,115,24,2,41424.0,Unknown,13191636,9111392.0,2.0,83,402,84,0,1,1,24,10,0.6037311458057687,0.5294117647058822,0.4852941176470588,0.0399910390717714,0.1578947368421052,0.0263157894736842,0.0597649412353088,0.1047761940485121,0.0505924720131114,0.1428571428571428,0.2790697674418605,0.2916666666666665,233,36,27,21,0,5528,10,87,225,10000000,375000.0,21000000.0,3000000.0,1500000.0,17000000.0,2,500000,-0.16666666666666666,-0.16666666666666666
490606,Lucas,Bergström,2024,631,Finland,Pargas,Finland,05-09-02,Goalkeeper,Goalkeeper,Right,205.0,30-06-25,CAA Stellar,https://img.a.transfermarkt.technology/portrait/header/490606-1639405918.jpg?lm=1,GB1,Chelsea Football Club,700000.0,800000.0,22,112,-75,6,1,3,3,8,9,10,2,1,3,6,3,2,8,9,8,12,11,12,11,11,13,1,9,2,8,9,10,10,13,12,20,15,10,5,10,12,9,10,5,13,19,11,10,3,11,14,12,14,9,7,14,12,12,5,10,12,13,13,10,20,1,1,1,1,1,1,1,1,1,1,1,1,1,84,8,20,33823190,5600,5600,1750,Northern_European,108,0,0,2900.0,Peterborough United,28124568,9111392.0,2.0,33,1121,35,2,1,7,50,5,0.4912675310928817,0.1818181818181818,0.4338235294117646,0.0027915995160326,0.0,0.0,0.0032508127031757,0.0037509377344336,0.0505924720131114,0.1428571428571428,0.9767441860465113,0.1666666666666666,0,0,0,0,0,0,0,0,0,700000,90000.0,800000.0,100000.0,,,3,350000,0.0,-0.125
491039,Marko,Bulat,2024,3057,Croatia,Å ibenik,Croatia,26-09-01,Attacking Midfield,Midfield,Right,178.0,30-06-25,GreenField,https://img.a.transfermarkt.technology/portrait/header/491039-1662491864.jpg?lm=1,BE1,Royal Standard Club de LiÃ¨ge,3500000.0,3500000.0,23,115,147,13,12,11,10,13,13,11,15,6,9,14,11,10,14,14,12,13,11,11,12,12,13,8,12,13,11,13,15,11,13,10,12,13,11,13,9,12,13,13,6,10,2,1,2,1,2,2,3,3,3,2,2,13,13,8,11,12,12,8,13,1,1,1,1,1,1,20,1,17,1,1,14,1,1,68,10,20,3960000,5798,5548,3799,Northern_European,113,0,0,2877.0,Unknown,24057489,2200000.0,1.0,24,1726,25,3,1,7,176,0,0.4843874040751521,0.4009625668449197,0.4705882352941176,0.0027693903189144,0.0,0.0,0.0172543135783946,0.0172543135783946,0.0121947831884219,0.0,0.3488372093023257,0.2083333333333332,210,18,15,21,0,3647,2,36,158,3000000,166666.66666666666,3500000.0,500000.0,,2700000.0,2,500000,-0.14285714285714285,-0.14285714285714285
491296,Anass,Zaroury,2024,826,Belgium,Mechelen,Morocco,07-11-00,Attacking Midfield,Midfield,Right,176.0,30-06-28,SBB Global,https://img.a.transfermarkt.technology/portrait/header/491296-1626771045.jpg?lm=1,FR1,Racing Club de Lens,9000000.0,12000000.0,24,120,138,9,11,14,7,14,8,5,8,6,7,12,3,5,14,10,12,14,10,12,10,12,4,16,7,12,8,11,11,15,14,9,9,12,14,11,9,12,6,18,6,14,2,3,3,1,2,1,2,3,1,3,2,12,14,5,8,11,8,11,7,1,1,1,1,1,1,1,13,1,13,20,1,19,8,0,14,20,11617732,6000,6000,3000,North_African__Middle_Eastern,116,0,0,13919.0,Unknown,18106037,3116666.667,3.0,7,936,67,3,1,6,158,0,0.5441915850754168,0.3155080213903743,0.4926470588235294,0.0134317361701881,0.0,0.0,0.0447611902975743,0.0597649412353088,0.0172875172477013,0.2857142857142857,0.3023255813953489,0.25,155,27,15,1,1,3036,0,0,0,8000000,530000.0,12000000.0,3000000.0,50000.0,1300000.0,4,3350000,-0.1111111111111111,-0.1111111111111111
491298,Ewoud,Pletinckx,2024,2727,Unknown,Unknown,Belgium,10-10-00,Centre-Back,Defender,Right,190.0,30-06-26,SportPlus,https://img.a.transfermarkt.technology/portrait/header/491298-1713278867.png?lm=1,BE1,Oud-Heverlee Leuven,2000000.0,2000000.0,24,110,141,7,7,7,7,10,8,11,8,11,14,11,6,11,10,14,11,12,12,11,7,12,14,7,14,9,9,14,14,11,11,12,16,6,12,14,11,14,12,12,9,12,1,3,1,2,2,3,2,2,1,1,1,11,9,1,11,12,11,13,10,1,1,20,1,1,1,1,1,1,1,1,1,1,1,87,8,20,5059999,6125,5775,3265,Northern_European,106,0,0,1799.0,Unknown,18106040,750000.0,1.0,105,1549,8,1,1,7,146,2,0.5144218047102408,0.3438502673796791,0.4191176470588235,0.0017284549061564,0.0,0.0,0.0097524381095273,0.0097524381095273,0.0041390038612183,0.0,0.6279069767441858,0.25,173,7,3,13,1,3249,6,41,130,2000000,126666.66666666667,2000000.0,200000.0,1500000.0,1600000.0,1,300000,0.0,0.1111111111111111
491587,Alexis,Duarte,2024,232,Paraguay,ItauguÃ¡,Paraguay,12-03-00,Centre-Back,Defender,Right,185.0,30-06-27,La Squadra Sports,https://img.a.transfermarkt.technology/portrait/header/491587-1721915183.png?lm=1,RU1,FK Spartak Moskva,3000000.0,4000000.0,24,118,-75,7,5,8,8,9,7,13,9,6,11,9,9,13,8,12,13,13,12,12,8,12,12,5,9,8,12,14,13,14,12,11,13,11,12,12,12,12,12,11,11,13,2,3,1,1,2,1,3,2,1,2,3,12,10,3,12,12,9,12,12,1,1,20,1,1,1,1,1,1,1,1,1,1,1,76,12,20,3160919,4575,5106,1668,Mediterranean_Hispanic,112,0,0,1869.0,Unknown,79031724,4000000.0,1.0,73,674,75,1,1,3,82,2,0.425906324424451,0.1730481283422459,0.463235294117647,0.0017960481147771,0.0,0.0,0.0147536884221055,0.0197549387346836,0.0221950609739159,0.0,0.5116279069767438,0.25,158,1,3,27,2,3992,2,2,8,3000000,241666.66666666666,4000000.0,1000000.0,,3000000.0,1,1000000,-0.14285714285714285,-0.14285714285714285
491589,Roberto,Fernández,2024,121,Paraguay,ConcepciÃ³n,Paraguay,07-06-00,Centre-Back,Defender,Left,188.0,30-06-27,EagleEye,https://img.a.transfermarkt.technology/portrait/header/491589-1721727605.png?lm=1,RU1,FK Dinamo Moskva,3500000.0,3500000.0,24,117,140,8,8,8,4,11,9,14,7,1,13,12,11,12,8,13,12,14,13,12,13,16,13,5,8,8,9,15,13,13,10,13,14,12,12,12,14,11,12,11,11,9,3,1,2,1,2,2,3,3,2,2,1,16,9,7,14,12,13,7,9,1,7,20,1,1,1,1,1,1,1,1,1,1,1,84,20,11,6695232,5250,4853,2809,Mediterranean_Hispanic,120,0,0,14817.0,Unknown,79031726,3000000.0,1.0,73,379,75,1,0,3,74,2,0.3924318602804975,0.2950802139037433,0.5220588235294117,0.0142988604750643,0.0,0.0,0.0172543135783946,0.0172543135783946,0.0166393510930859,0.0,0.581395348837209,0.25,152,8,5,38,0,4034,3,14,33,3500000,242307.6923076923,3500000.0,25000.0,,1000000.0,1,1700000,0.0,0.16666666666666666
491616,Jackson,Porozo,2024,1244,Ecuador,San Lorenzo,Ecuador,04-08-00,Centre-Back,Defender,Left,192.0,30-06-25,Team of Future,https://img.a.transfermarkt.technology/portrait/header/491616-1706871948.jpg?lm=1,ES1,Club Deportivo LeganÃ©s S.A.D.,3300000.0,3500000.0,24,127,138,5,6,10,8,11,5,16,6,10,14,9,8,14,11,18,16,15,8,7,9,9,15,6,11,9,12,13,13,14,13,13,16,16,16,15,14,11,15,9,3,10,3,2,3,3,1,2,2,2,3,2,2,14,14,8,13,12,12,13,10,1,1,20,1,1,1,1,1,1,1,1,1,1,1,85,20,11,5539998,6332,5982,3982,African_Caribbean,127,5,0,11947.0,Unknown,19354849,1450000.0,3.0,30,1302,31,1,0,1,54,2,0.5418100026462027,0.4205347593582887,0.5735294117647058,0.0115275389216179,0.0328947368421052,0.0,0.0162540635158789,0.0172543135783946,0.0080280007777993,0.2857142857142857,0.6744186046511627,0.25,97,6,1,27,2,2570,2,15,49,1800000,100000.0,3500000.0,800000.0,300000.0,500000.0,5,1300000,-0.45454545454545453,-0.4
491693,Nehuén,Pérez,2024,720,Argentina,Hurlingham,Argentina,24-06-00,Centre-Back,Defender,Right,186.0,30-06-25,11WINS,https://img.a.transfermarkt.technology/portrait/header/491693-1695029359.jpg?lm=1,PO1,Futebol Clube do Porto,13000000.0,13000000.0,24,130,155,4,6,6,6,10,5,14,8,13,14,12,5,15,10,17,15,15,15,15,12,10,17,5,10,7,14,14,13,14,14,14,13,14,14,14,12,13,14,14,3,5,3,2,2,1,3,3,3,3,2,2,3,15,18,12,10,18,18,9,10,1,1,20,1,1,1,1,1,1,1,1,1,1,1,76,10,20,8872000,6500,6600,5200,Mediterranean_Hispanic,131,0,0,24439.0,Unknown,14181374,5000000.0,2.0,4,643,4,1,1,3,100,2,0.6235776660492194,0.5508021390374331,0.6029411764705883,0.023590029808605,0.0,0.0,0.0647661915478869,0.0647661915478869,0.0277507708547459,0.1428571428571428,0.5348837209302322,0.25,182,6,3,48,2,3753,3,10,21,13000000,657894.7368421053,13000000.0,3000000.0,2500000.0,4000000.0,6,3800000,0.0,0.3
491707,Julián,Carranza,2024,234,Argentina,Oncativo,Argentina,22-05-00,Centre-Forward,Attack,Right,182.0,30-06-28,Hernan Berman,https://img.a.transfermarkt.technology/portrait/header/491707-1711203825.jpg?lm=1,NL1,Feyenoord Rotterdam,6000000.0,6000000.0,24,117,135,7,8,12,13,12,8,12,11,7,5,10,13,8,12,13,11,13,12,9,9,11,12,12,8,13,10,12,13,13,13,13,12,10,13,12,13,12,7,10,5,5,1,2,2,4,2,3,3,2,2,1,3,8,13,5,12,11,10,7,19,1,1,1,1,1,1,1,1,1,1,13,1,1,20,75,11,20,6890880,5920,5820,4195,Mediterranean_Hispanic,115,0,0,17451.0,Unknown,14184530,2952500.0,2.0,4,1085,4,0,1,3,85,3,0.520375760783276,0.4433155080213903,0.4852941176470588,0.0168422963537326,0.0,0.0,0.0297574393598399,0.0297574393598399,0.0163754548737464,0.1428571428571428,0.4418604651162785,0.25,203,60,23,43,1,6625,7,26,153,6000000,371875.0,6000000.0,1000000.0,2500000.0,5000000.0,4,3550000,0.0,0.0
491960,Unknown,Benito,2024,10690,Cote d'Ivoire,Abidjan,Nigeria,07-09-98,Right Winger,Attack,Right,180.0,30-06-25,Wonder Sports,https://img.a.transfermarkt.technology/portrait/header/491960-1685896142.png?lm=1,UKR1,FK Zarya Lugansk,600000.0,600000.0,26,132,148,5,1,1,2,12,9,7,3,1,2,10,1,2,12,12,12,12,13,15,10,12,16,2,11,2,15,11,12,13,13,13,16,13,13,12,13,12,6,8,15,13,13,13,13,10,15,12,14,13,14,11,11,16,11,7,11,14,11,11,18,20,1,1,1,1,1,1,1,1,1,1,1,1,1,91,5,20,8096172,6557,6557,3434,Northern_European,133,0,0,14293.0,Unknown,19337914,9111392.0,2.0,23,14,70,0,1,7,83,10,0.6178883302460969,0.3619251336898395,0.6176470588235294,0.0137928770276755,0.0,0.0,0.0027506876719179,0.0027506876719179,0.0505924720131114,0.1428571428571428,0.3953488372093026,0.3333333333333332,122,11,13,21,0,3973,1,2,20,500000,23529.41176470588,600000.0,150000.0,100000.0,200000.0,7,400000,-0.16666666666666666,0.0
493003,Daniel,Muñoz,2024,873,Colombia,Amalfi,Colombia,26-05-96,Right-Back,Defender,Right,181.0,30-06-27,Goal Management SAS,https://img.a.transfermarkt.technology/portrait/header/493003-1718642628.jpg?lm=1,GB1,Crystal Palace Football Club,23000000.0,23000000.0,28,128,140,10,13,11,9,9,8,13,15,15,13,10,8,14,10,10,15,13,12,13,11,12,15,9,15,11,13,14,15,13,10,13,13,13,13,14,13,12,10,13,6,10,2,4,3,4,2,2,3,1,4,1,4,12,13,8,15,10,13,12,10,1,1,17,20,1,18,1,1,1,14,1,1,1,1,73,7,20,7493556,6290,5688,4085,Mediterranean_Hispanic,123,14,0,12499.0,Unknown,76050675,6250000.0,2.0,20,60,20,1,1,3,58,11,0.5029108229690394,0.4315508021390374,0.5441176470588236,0.012060559652455,0.0921052631578947,0.0,0.1147786946736684,0.1147786946736684,0.0346954082057834,0.1428571428571428,0.418604651162791,0.4166666666666665,320,33,39,82,2,8843,2,5,24,25000000,1035416.6666666666,25000000.0,1500000.0,,,3,8050000,0.08695652173913043,1.5
493702,Mattia,Viti,2024,749,Italy,Borgo San Lorenzo,Italy,24-01-02,Centre-Back,Defender,Left,190.0,30-06-25,CAA Base Ltd,https://img.a.transfermarkt.technology/portrait/header/493702-1692882028.jpg?lm=1,IT1,Empoli Football Club S.r.l.,5000000.0,10000000.0,22,125,-85,6,7,10,6,11,6,14,6,8,13,13,6,14,11,11,14,13,10,13,11,13,14,9,10,7,13,14,14,12,12,13,14,15,13,14,13,14,8,10,9,8,3,2,1,2,3,1,1,3,3,1,2,15,13,5,13,15,15,8,19,1,1,20,1,1,1,1,1,1,1,1,1,1,1,74,20,9,64537802,6250,6250,4550,Mediterranean_Hispanic,125,0,0,11750.0,Unknown,43426109,9111392.0,2.0,52,228,54,1,0,3,64,2,0.5772691188145012,0.481283422459893,0.5588235294117647,0.0113373123202141,0.0,0.0,0.0247561890472618,0.0497624406101525,0.0505924720131114,0.1428571428571428,0.6279069767441858,0.1666666666666666,128,4,0,13,0,2956,10,21,41,6500000,520833.3333333333,10000000.0,3000000.0,250000.0,10000000.0,3,5500000,0.3,0.08333333333333333
494236,Andy,Pelmard,2024,1005,France,Nice,France,12-03-00,Centre-Back,Defender,Right,180.0,30-06-25,ELIFA,https://img.a.transfermarkt.technology/portrait/header/494236-1688916547.jpg?lm=1,IT1,Unione Sportiva Lecce,3500000.0,5000000.0,24,124,144,6,9,12,6,13,6,12,6,8,13,12,9,14,13,10,15,12,13,10,10,11,14,13,8,8,13,13,14,14,14,13,11,15,14,14,10,12,10,10,13,14,3,3,3,3,2,3,3,3,1,1,2,10,13,6,14,12,15,12,20,1,17,20,10,1,1,11,1,1,1,1,1,1,1,68,15,20,4666895,6155,6172,3823,African_Caribbean,123,0,0,7288.0,Unknown,49039039,1950000.0,2.0,34,1041,36,1,1,1,206,2,0.5669489282879069,0.4035294117647058,0.5441176470588236,0.007028728079281,0.0,0.0,0.0172543135783946,0.0247561890472618,0.0108058557182143,0.1428571428571428,0.3953488372093026,0.25,225,0,2,23,1,4430,2,3,5,2500000,62500.0,5000000.0,1000000.0,,5000000.0,3,800000,-0.2857142857142857,-0.375
494880,Jorge,Cuenca,2024,931,Spain,Madrid,Spain,17-11-99,Centre-Back,Defender,Left,190.0,30-06-28,InterStarDeporte,https://img.a.transfermarkt.technology/portrait/header/494880-1539767956.jpg?lm=1,GB1,Fulham Football Club,6000000.0,8000000.0,25,136,161,6,6,7,6,14,6,14,8,9,14,12,6,15,12,12,14,13,13,13,11,14,14,7,9,7,15,13,13,14,11,12,14,14,14,12,15,12,9,12,8,5,1,1,1,3,1,3,1,1,2,3,2,13,14,5,10,14,15,13,15,1,10,20,5,1,1,10,1,1,1,1,1,1,1,76,20,9,27299998,6800,6800,4650,Mediterranean_Hispanic,136,0,0,18738.0,Unknown,67248170,3646666.667,3.0,89,892,89,1,0,3,95,2,0.6500396930404869,0.4919786096256684,0.6397058823529411,0.0180850457750864,0.0,0.0,0.0297574393598399,0.0397599399849962,0.0202320434845412,0.2857142857142857,0.6279069767441858,0.2916666666666665,213,10,3,39,2,4679,6,17,89,6000000,261904.7619047619,8000000.0,2000000.0,1000000.0,3000000.0,4,2700000,0.0,0.2
495601,Víctor,Gómez,2024,1075,Spain,Olesa de Montserrat,Spain,01-04-00,Right-Back,Defender,Right,169.0,30-06-28,SEG,https://img.a.transfermarkt.technology/portrait/header/495601-1583506246.jpg?lm=1,PO1,Sporting Clube de Braga,8000000.0,8000000.0,24,122,145,12,13,12,6,10,7,9,9,12,10,13,8,10,13,11,12,11,13,8,12,13,13,11,9,14,10,13,14,15,13,14,7,12,14,13,11,13,7,5,7,11,3,3,1,2,1,3,2,2,1,1,3,18,10,4,12,12,10,12,20,1,1,1,20,1,18,1,1,1,14,1,1,14,1,68,9,20,5839999,6100,5950,4100,Mediterranean_Hispanic,113,0,0,9000.0,Sporting Clube de Braga,67257950,2000000.0,1.0,89,1078,89,1,1,3,192,11,0.5375760783275999,0.4331550802139037,0.4705882352941176,0.0086818648386888,0.0,0.0,0.0397599399849962,0.0397599399849962,0.0110836412122558,0.0,0.13953488372093,0.25,257,3,23,34,1,5162,3,15,43,6000000,316666.6666666667,8000000.0,2000000.0,300000.0,2300000.0,4,2200000,-0.25,-0.25
495621,Antonio,Blanco,2024,1108,Spain,MontalbÃ¡n,Spain,23-07-00,Defensive Midfield,Midfield,Right,176.0,30-06-27,Unknown,https://img.a.transfermarkt.technology/portrait/header/495621-1705337231.jpg?lm=1,ES1,Deportivo AlavÃ©s S.A.D.,7500000.0,7500000.0,24,124,160,9,10,8,7,12,11,13,10,11,13,13,7,13,13,10,14,12,12,13,12,13,17,9,15,14,14,15,14,13,12,11,9,15,12,14,13,15,7,16,5,12,4,3,1,1,3,1,2,2,2,3,3,12,14,5,11,12,12,15,14,1,1,1,1,1,1,16,1,20,1,1,1,1,1,63,10,20,11309999,6200,6200,3002,Mediterranean_Hispanic,125,1,0,7530.0,CÃ¡diz,67256515,4000000.0,1.0,89,971,89,3,1,3,59,4,0.5706536120666843,0.3157219251336898,0.5588235294117647,0.0072624074576552,0.006578947368421,0.0,0.0372593148287071,0.0372593148287071,0.0221950609739159,0.0,0.3023255813953489,0.25,171,2,6,55,2,2374,1,1,7,7500000,521428.5714285714,7500000.0,1500000.0,,5000000.0,4,5000000,0.0,0.5
495629,Hugo,Guillamón,2024,1049,Spain,Donostia-San SebastiÃ¡n,Spain,31-01-00,Defensive Midfield,Midfield,Right,178.0,30-06-26,InterStarDeporte,https://img.a.transfermarkt.technology/portrait/header/495629-1694617306.jpg?lm=1,ES1,Valencia Club de FÃºtbol S. A. D.,8000000.0,25000000.0,24,140,156,9,9,11,8,13,9,11,10,11,12,14,11,12,13,12,14,13,14,15,14,15,15,13,9,12,15,15,15,13,13,13,12,14,12,14,12,14,12,11,6,12,2,3,3,2,2,1,3,3,2,1,3,12,14,4,17,15,16,11,12,1,1,18,1,1,1,20,1,18,1,1,1,1,1,76,12,20,33389998,7000,7000,5500,Mediterranean_Hispanic,138,2,1,8351.0,Unknown,67258817,9111392.0,2.0,89,423,89,3,1,3,208,4,0.6765017200317545,0.5828877005347594,0.6544117647058822,0.0080551792330488,0.0131578947368421,0.0131578947368421,0.0397599399849962,0.1247811952988247,0.0505924720131114,0.1428571428571428,0.3488372093023257,0.25,211,7,4,62,2,3472,0,0,0,6000000,270454.54545454547,25000000.0,8000000.0,50000.0,7500000.0,2,4900000,-0.25,0.0
495666,William,Saliba,2024,11,France,Bondy,France,24-03-01,Centre-Back,Defender,Right,192.0,30-06-27,ND SPORTS MANAGEMENT,https://img.a.transfermarkt.technology/portrait/header/495666-1718697201.jpg?lm=1,GB1,Arsenal Football Club,80000000.0,80000000.0,23,145,175,6,10,10,9,12,6,16,11,6,14,13,10,15,12,15,13,14,13,13,10,13,14,11,10,8,13,16,14,14,13,15,16,14,14,14,16,14,14,14,8,7,1,1,1,2,1,1,1,2,2,1,1,15,15,6,11,14,14,13,13,1,1,20,14,1,1,1,1,1,1,1,1,1,1,83,10,20,102536694,7394,7394,5994,African_Caribbean,144,5,0,46397.0,Unknown,49039004,30000000.0,1.0,34,223,36,1,1,1,21,2,0.7286319132045515,0.6357219251336897,0.6985294117647058,0.0447930537356352,0.0328947368421052,0.0,0.3998499624906226,0.3998499624906226,0.1666435178754965,0.0,0.6744186046511627,0.2083333333333332,239,8,2,28,1,6862,5,61,129,80000000,3850000.0,80000000.0,5500000.0,25000000.0,24000000.0,4,17000000,0.0,0.06666666666666667
495667,Lucas,Da Cunha,2024,1047,France,Roanne,France,09-06-01,Left Winger,Attack,Right,174.0,30-06-26,Unknown,https://img.a.transfermarkt.technology/portrait/header/495667-1714818116.jpg?lm=1,IT1,Calcio Como,6500000.0,6500000.0,23,122,130,6,7,8,8,11,7,12,7,8,15,12,10,11,11,15,13,14,11,10,11,10,12,8,12,7,15,14,13,12,13,12,14,13,12,13,13,13,12,12,10,8,3,3,3,2,3,2,2,2,2,3,2,15,12,6,14,13,12,12,10,1,1,20,5,1,1,1,1,1,1,1,1,1,1,80,12,20,1336497,6100,6100,4102,Mediterranean_Hispanic,121,0,0,2149.0,Unknown,55083804,700000.0,2.0,34,1241,36,0,1,3,47,7,0.5574225985710506,0.4333689839572192,0.5294117647058822,0.0020664209492597,0.0,0.0,0.032258064516129,0.032258064516129,0.0038612183671768,0.1428571428571428,0.2558139534883721,0.2083333333333332,157,26,11,12,0,3780,2,2,6,6000000,333333.3333333333,6500000.0,1000000.0,1800000.0,4000000.0,5,2800000,-0.07692307692307693,2.0
495920,Oleksandr,Nazarenko,2024,53646,Ukraine,Dnipropetrovsk,Ukraine,01-02-00,Left Winger,Attack,Left,177.0,30-06-28,Unknown,https://img.a.transfermarkt.technology/portrait/header/495920-1641379228.png?lm=1,UKR1,FK Polissya Zhytomyr,1200000.0,1200000.0,24,112,135,6,8,11,11,12,11,11,12,8,5,10,5,4,11,5,11,15,13,10,12,12,5,13,3,10,11,10,15,14,12,8,8,13,14,10,10,11,5,10,5,13,1,2,2,1,3,2,3,3,2,3,3,11,9,2,15,12,15,15,14,1,1,1,1,1,1,1,20,1,15,18,1,15,1,60,20,10,2830537,4500,4608,2560,Northern_European,98,0,0,690.0,Unknown,71099055,200000.0,1.0,103,417,101,0,0,7,80,7,0.3600158772161947,0.2684491978609625,0.3602941176470588,0.0006575853581522,0.0,0.0,0.0057514378594648,0.0057514378594648,0.0010833634267618,0.0,0.3255813953488373,0.25,168,29,23,25,1,3631,5,34,132,2000000,120312.5,2000000.0,200000.0,250000.0,800000.0,1,200000,1.8571428571428572,2.3333333333333335
496094,Karim,Adeyemi,2024,16,Germany,MÃ¼nchen,Germany,18-01-02,Left Winger,Attack,Left,180.0,30-06-27,Unknown,https://img.a.transfermarkt.technology/portrait/header/496094-1712859708.jpg?lm=1,L1,Borussia Dortmund,35000000.0,40000000.0,22,138,160,8,9,14,13,12,7,8,9,3,5,9,13,6,13,13,12,12,10,13,12,10,19,12,7,15,5,12,14,18,14,7,11,12,18,13,10,11,8,14,13,5,2,4,1,2,1,2,3,3,2,4,3,16,19,7,10,13,15,10,10,1,1,1,1,1,1,1,1,1,1,13,1,17,20,74,20,13,82679995,7000,7000,5750,African_Caribbean,125,4,1,115067.0,Unknown,16279486,20050000.0,2.0,38,1006,40,0,0,1,41,7,0.6765017200317545,0.6096256684491979,0.5588235294117647,0.1111019913924876,0.0263157894736842,0.0131578947368421,0.1747936984246061,0.1997999499874969,0.1113642045612378,0.1428571428571428,0.3953488372093026,0.1666666666666666,0,0,0,0,0,0,17,63,69,35000000,1861111.111111111,40000000.0,7000000.0,9000000.0,35000000.0,2,800000,0.25,0.25
496652,Dylan,Levitt,2024,903,Wales,Bodelwyddan,Wales,17-11-00,Central Midfield,Midfield,Right,180.0,31-05-26,Wasserman,https://img.a.transfermarkt.technology/portrait/header/496652-1615797379.jpg?lm=1,SC1,Hibernian Football Club,800000.0,850000.0,24,124,-75,13,8,10,13,14,12,5,15,2,7,16,10,12,15,6,13,8,14,11,14,13,14,12,5,14,8,14,13,13,13,10,5,15,12,13,9,15,9,12,4,10,1,2,3,2,3,3,3,4,3,1,1,15,15,5,14,12,14,15,16,1,1,1,1,1,1,14,1,20,1,12,14,10,1,73,11,20,16391024,6200,6200,4950,Northern_European,124,12,0,4640.0,Unknown,28115832,352500.0,2.0,109,213,106,3,1,7,114,1,0.5706536120666843,0.5240641711229946,0.5514705882352942,0.0044717735588886,0.0789473684210526,0.0,0.0037509377344336,0.0040010002500625,0.0019306091835884,0.1428571428571428,0.3953488372093026,0.25,197,29,19,22,0,5812,7,33,95,700000,-4166.666666666667,850000.0,100000.0,,650000.0,3,75000,-0.125,-0.125
496656,Reo,Hatate,2024,371,Japan,"Suzuka, Mie",Japan,21-11-97,Central Midfield,Midfield,Right,172.0,31-05-28,AKI&DESIDERIO,https://img.a.transfermarkt.technology/portrait/header/496656-1671709618.jpg?lm=1,SC1,The Celtic Football Club,10000000.0,11000000.0,27,129,140,11,12,11,11,14,11,9,12,6,7,14,10,12,12,14,13,9,11,12,14,12,7,11,10,14,12,15,17,14,13,14,6,10,13,14,12,13,10,17,10,15,1,2,3,1,4,1,1,1,2,1,1,13,13,7,15,11,9,11,10,1,1,1,1,1,1,15,1,20,1,1,15,1,1,70,10,20,12049511,6500,6500,5500,10,128,1,0,16819.0,Unknown,45111893,1530000.0,1.0,54,1439,56,3,1,0,200,1,0.6103466525535857,0.5828877005347594,0.5808823529411764,0.0162320262416148,0.006578947368421,0.0,0.0497624406101525,0.0547636909227306,0.0084724575682657,0.0,0.2093023255813952,0.375,205,35,32,9,0,6176,8,61,71,11000000,842307.6923076923,11000000.0,1000000.0,,,1,400000,0.1,0.0
496660,Jack,Vale,2024,987,Wales,Wrexham,Wales,03-03-01,Centre-Forward,Attack,Right,185.0,31-05-25,Wasserman,https://img.a.transfermarkt.technology/portrait/header/496660-1673204430.jpg?lm=1,SC1,Motherwell Football Club,500000.0,600000.0,23,107,135,7,8,11,13,12,7,10,12,7,7,12,12,7,12,11,10,11,11,10,12,11,12,9,8,13,8,11,14,13,12,12,12,12,12,13,12,10,4,12,7,12,1,1,3,3,1,3,2,2,3,2,1,10,11,4,12,11,14,10,12,1,1,1,1,1,1,1,1,1,1,14,14,14,20,70,9,20,4003107,5344,5344,2244,Northern_European,107,0,0,1160.0,Unknown,29191224,9111392.0,2.0,109,1676,106,0,1,7,135,3,0.4573961365440593,0.2346524064171123,0.4264705882352941,0.0011114254731766,0.0,0.0,0.0022505626406601,0.0027506876719179,0.0505924720131114,0.1428571428571428,0.5116279069767438,0.2083333333333332,160,44,22,19,2,5838,0,0,0,500000,16666.666666666668,600000.0,150000.0,,,2,200000,0.0,0.1111111111111111
496745,Emil,Holm,2024,1025,Sweden,GÃ¶teborg,Sweden,13-05-00,Right-Back,Defender,Right,191.0,30-06-28,Unknown,https://img.a.transfermarkt.technology/portrait/header/496745-1688450376.jpg?lm=1,IT1,Bologna Football Club 1909,12000000.0,12000000.0,24,124,147,7,11,12,7,11,9,12,8,8,10,10,5,11,11,11,11,14,11,13,10,12,14,8,7,13,11,14,14,14,11,12,15,10,16,15,14,12,6,11,8,11,2,2,2,1,1,1,3,2,4,1,1,11,14,6,13,11,14,12,8,1,10,14,20,1,20,1,1,1,15,1,1,12,1,83,7,20,5127999,6200,5505,861,Northern_European,117,0,0,3999.0,Unknown,93085044,3327333.333,3.0,91,582,91,1,1,7,40,11,0.4786980682720296,0.0867379679144385,0.4999999999999999,0.0038528128913767,0.0,0.0,0.0597649412353088,0.0597649412353088,0.018457920125559,0.2857142857142857,0.6511627906976742,0.25,171,13,16,40,0,6380,8,29,72,7000000,383333.3333333333,12000000.0,3500000.0,,300000.0,5,6400000,-0.4166666666666667,0.0
496857,Edon,Zhegrova,2024,1082,Germany,Herford,Kosovo,31-03-99,Right Winger,Attack,Left,180.0,30-06-26,Unknown,https://img.a.transfermarkt.technology/portrait/header/496857-1642174107.jpg?lm=1,FR1,Lille Olympique Sporting Club Lille MÃ©tropole,25000000.0,25000000.0,25,130,146,12,12,17,10,16,10,4,12,4,4,12,12,6,17,7,11,13,13,9,10,9,11,18,4,12,5,8,9,15,16,14,7,12,16,12,7,10,8,12,11,8,2,1,1,1,3,1,3,2,2,3,1,8,18,14,8,17,11,5,7,1,1,1,1,1,1,1,15,1,18,17,15,20,12,72,20,7,11123229,6500,6500,4005,Northern_European,122,28,3,16420.0,Unknown,18104985,5000000.0,2.0,38,616,59,0,0,7,128,10,0.6103466525535857,0.4229946524064171,0.536764705882353,0.0158467449524771,0.1842105263157894,0.0394736842105263,0.1247811952988247,0.1247811952988247,0.0277507708547459,0.1428571428571428,0.3953488372093026,0.2916666666666665,210,42,38,20,1,6774,14,55,92,25000000,1242500.0,25000000.0,200000.0,700000.0,1500000.0,2,2000000,0.0,1.5
497291,Nicolás,Domínguez,2024,703,Argentina,Haedo,Argentina,28-06-98,Central Midfield,Midfield,Right,179.0,30-06-28,Interplayers,https://img.a.transfermarkt.technology/portrait/header/497291-1663656746.jpg?lm=1,GB1,Nottingham Forest Football Club,17000000.0,17500000.0,26,136,149,6,10,11,9,15,7,13,11,5,9,15,10,16,15,14,14,15,13,12,14,13,16,14,10,13,12,14,16,12,13,11,11,15,12,17,11,15,14,13,7,12,2,3,1,4,1,3,3,3,1,3,3,16,15,7,11,15,14,10,11,1,1,1,1,1,1,20,7,20,7,1,14,1,1,73,10,20,6654020,6800,6600,6000,Mediterranean_Hispanic,134,11,1,17307.0,Unknown,14077011,8815000.0,2.0,4,586,4,3,1,3,140,1,0.6235776660492194,0.6363636363636364,0.625,0.0167032474674273,0.0723684210526315,0.0131578947368421,0.0847711927981995,0.0872718179544886,0.0489458040501125,0.1428571428571428,0.3720930232558141,0.3333333333333332,249,17,15,58,0,3227,7,23,78,17000000,964705.8823529412,17500000.0,4000000.0,,7500000.0,2,2000000,0.0,0.0
497663,Mujaid,Sadick,2024,1184,Spain,LogroÃ±o,Spain,14-03-00,Centre-Back,Defender,Right,185.0,30-06-25,YOU FIRST,https://img.a.transfermarkt.technology/portrait/header/497663-1714036674.png?lm=1,BE1,Koninklijke Racing Club Genk,5000000.0,5000000.0,24,124,149,7,7,8,8,10,8,14,8,10,14,9,4,15,10,13,13,14,13,12,11,12,7,8,11,8,15,14,15,13,11,12,9,12,14,14,15,12,5,3,7,13,3,1,2,3,3,4,3,2,3,3,3,16,12,3,10,12,12,11,11,1,1,20,15,1,12,1,1,1,1,1,1,1,1,88,7,20,15990000,5451,6078,4228,African_Caribbean,123,0,0,8500.0,Unknown,67249928,1700000.0,1.0,89,855,89,1,1,1,122,2,0.5545117756020111,0.4468449197860962,0.5441176470588236,0.0081990562056842,0.0,0.0,0.0247561890472618,0.0247561890472618,0.0094169282480068,0.0,0.5116279069767438,0.25,178,3,0,25,2,4318,2,17,82,6000000,325000.0,6000000.0,1000000.0,150000.0,350000.0,2,550000,0.7142857142857143,0.3333333333333333
498237,David,Carmo,2024,683,Portugal,Aveiro,Angola,19-07-99,Centre-Back,Defender,Left,196.0,30-06-25,Proeleven S.A.,https://img.a.transfermarkt.technology/portrait/header/498237-1728417252.png?lm=1,GR1,Olympiakos Syndesmos Filathlon Peiraios,12000000.0,20000000.0,25,137,148,6,10,10,8,12,7,14,9,11,15,13,8,13,13,13,14,16,14,12,13,11,14,7,13,9,13,14,14,10,9,13,17,15,14,14,17,12,15,6,12,8,1,2,2,3,2,3,3,3,3,3,1,10,13,11,16,8,15,13,8,1,10,20,1,1,1,17,1,5,1,1,1,1,1,85,20,12,21059998,7250,6750,5250,African_Caribbean,136,0,0,19549.0,Unknown,83111598,10743333.33,3.0,76,110,3,1,0,1,141,2,0.6434241862926701,0.5561497326203209,0.6397058823529411,0.0188681613778199,0.0,0.0,0.0597649412353088,0.0997749437359339,0.0596590645851273,0.2857142857142857,0.7674418604651163,0.2916666666666665,168,2,0,55,2,7940,3,65,352,12000000,632352.9411764706,20000000.0,4000000.0,,900000.0,3,7250000,0.0,-0.14285714285714285
498529,Miguel,Crespo,2024,6890,France,Lyon,Portugal,11-09-96,Central Midfield,Midfield,Right,186.0,30-06-27,DL Sport Management,https://img.a.transfermarkt.technology/portrait/header/498529-1696447057.png?lm=1,TR1,?stanbul Ba?ak?ehir Futbol KulÃ¼bÃ¼,3500000.0,10000000.0,28,130,135,8,12,14,13,11,7,11,12,3,8,14,10,14,13,17,13,16,14,11,13,11,17,11,14,13,14,15,17,12,11,13,12,14,12,17,13,17,8,13,4,12,3,1,1,1,1,3,3,2,1,2,1,16,14,6,12,14,15,12,13,1,1,1,1,1,1,17,1,20,1,10,14,12,1,78,10,20,9922738,6600,6500,5350,Northern_European,129,0,0,14422.0,Unknown,84122771,1500000.0,1.0,34,884,79,3,1,7,4,1,0.6103466525535857,0.5668449197860962,0.588235294117647,0.0139174416549907,0.0,0.0,0.0172543135783946,0.0497624406101525,0.0083057862718408,0.0,0.5348837209302322,0.4166666666666665,236,20,20,62,0,5256,3,12,60,3500000,150000.0,10000000.0,2000000.0,,200000.0,4,1975000,-0.125,-0.4166666666666667
499721,Unknown,Wendel,2024,964,Brazil,Duque de Caxias,Brazil,28-08-97,Central Midfield,Midfield,Right,180.0,30-06-28,TF Tribe,https://img.a.transfermarkt.technology/portrait/header/499721-1721722954.png?lm=1,RU1,AO FK Zenit Sankt-Peterburg,20000000.0,24000000.0,27,141,155,12,13,13,8,13,11,8,14,12,11,15,10,11,15,11,14,14,14,12,14,14,12,13,12,13,12,14,13,13,14,14,9,14,13,14,10,14,6,13,8,12,4,4,1,2,2,4,2,3,2,3,4,17,12,11,9,12,7,10,9,1,1,1,1,1,1,17,15,20,1,13,15,1,1,75,12,20,17919439,7050,6550,5000,Mixed_Race,139,0,0,32000.0,Unknown,90072860,9111392.0,2.0,10,438,11,3,1,4,7,1,0.6169621593014025,0.5294117647058822,0.6617647058823528,0.0308910619569006,0.0,0.0,0.0997749437359339,0.1197799449862465,0.0505924720131114,0.1428571428571428,0.3953488372093026,0.375,0,0,0,0,0,0,10,24,57,20000000,750000.0,24000000.0,2000000.0,,6500000.0,2,4000000,0.0,-0.09090909090909091
499758,Hugo,Vetlesen,2024,2282,Belgium,Braine-lâ€™Alleud,Norway,29-02-00,Central Midfield,Midfield,Right,174.0,30-06-27,Unknown,https://img.a.transfermarkt.technology/portrait/header/499758-1674570120.jpg?lm=1,BE1,Club Brugge Koninklijke Voetbalvereniging,7000000.0,7000000.0,24,131,146,8,13,14,13,13,10,6,10,4,8,13,8,11,13,12,14,8,15,16,13,13,13,14,9,14,12,15,15,13,14,11,7,14,13,15,9,14,14,14,6,10,2,1,1,3,2,2,3,1,2,3,3,11,13,7,12,13,14,12,15,1,1,1,1,1,1,10,1,20,1,1,16,1,1,0,13,20,4296993,6183,6183,4488,Northern_European,130,0,0,1160.0,Unknown,53146811,4125000.0,2.0,7,238,73,3,1,7,53,1,0.5684043397724265,0.4746524064171122,0.5955882352941175,0.0011114254731766,0.0,0.0,0.0347586896724181,0.0347586896724181,0.0228895247090196,0.1428571428571428,0.2558139534883721,0.25,316,46,60,52,0,7959,4,8,19,6000000,438461.53846153844,7000000.0,1000000.0,400000.0,700000.0,2,1200000,-0.14285714285714285,0.0
500054,David,Jurásek,2024,533,Czech Republic,DolnÃ­ N?m?Ã­,Czech Republic,07-08-00,Left-Back,Defender,Left,183.0,30-06-25,Football Mechanic,https://img.a.transfermarkt.technology/portrait/header/500054-1701333965.jpg?lm=1,L1,TSG 1899 Hoffenheim FuÃŸball-Spielbetriebs GmbH,8000000.0,8000000.0,24,117,135,9,14,8,10,13,5,12,7,11,9,11,9,15,12,5,9,12,9,11,13,11,7,6,10,11,11,12,13,13,11,12,11,6,13,13,12,12,8,13,8,16,2,3,3,4,3,3,1,3,2,3,3,18,9,3,12,14,13,10,12,1,20,1,1,15,1,1,12,5,1,10,5,1,1,76,20,11,2638812,5848,5848,3499,Northern_European,111,0,0,1246.0,Unknown,25062133,5020000.0,3.0,26,418,28,1,0,7,199,8,0.5240804445620535,0.3688770053475935,0.4558823529411764,0.0011944685580533,0.0,0.0,0.0397599399849962,0.0397599399849962,0.0278618850523625,0.2857142857142857,0.4651162790697669,0.25,182,23,21,23,0,4940,5,20,65,7000000,498214.28571428574,8000000.0,1000000.0,,200000.0,5,3725000,-0.125,-0.125
500067,Chidera,Ejuke,2024,368,Nigeria,Zaria,Nigeria,02-01-98,Left Winger,Attack,Right,176.0,30-06-27,Aneke/PMG ,https://img.a.transfermarkt.technology/portrait/header/500067-1706264992.jpg?lm=1,ES1,Sevilla FÃºtbol Club S.A.D.,6000000.0,9000000.0,26,130,141,7,9,16,11,12,7,5,11,3,5,12,10,8,14,8,10,8,11,10,11,11,13,18,5,13,9,10,10,16,17,14,8,13,15,14,9,11,6,12,7,9,1,3,3,3,4,1,3,4,1,2,1,12,12,2,9,10,9,12,18,1,1,1,1,1,1,1,12,1,1,20,13,16,12,72,11,20,8548171,6247,6247,5247,African_Caribbean,124,8,0,28766.0,Hertha Berlin,13182752,6750000.0,2.0,69,1701,70,0,1,1,181,7,0.5768721884096322,0.5558288770053476,0.5514705882352942,0.0277682557186268,0.0526315789473684,0.0,0.0297574393598399,0.0447611902975743,0.0374732631461985,0.1428571428571428,0.3023255813953489,0.3333333333333332,254,44,30,13,0,5298,2,26,101,6000000,300000.0,9000000.0,2000000.0,,400000.0,5,5100000,0.0,0.2
500091,Ersin,Destano?Lu,2024,114,TÃ¼rkiye,Istanbul,TÃ¼rkiye,01-01-01,Goalkeeper,Goalkeeper,Right,195.0,30-06-26,F-F SPORT,https://img.a.transfermarkt.technology/portrait/header/500091-1727354578.png?lm=1,TR1,Be?ikta? Jimnastik KulÃ¼bÃ¼,2000000.0,10000000.0,23,120,135,3,2,2,1,7,4,2,2,3,2,7,2,1,10,10,14,17,12,10,6,12,10,2,8,1,12,14,14,11,10,13,14,15,11,14,14,11,9,10,5,14,13,14,10,15,12,14,13,13,17,12,9,13,10,4,14,8,13,14,14,20,1,1,1,1,1,1,1,1,1,1,1,1,1,88,9,20,4492655,6050,6050,4450,Mediterranean_Hispanic,117,0,0,23043.0,Unknown,70112946,6000.0,1.0,100,667,100,2,1,3,37,5,0.5508070918232336,0.4705882352941176,0.4999999999999999,0.0222420281052561,0.0,0.0,0.0097524381095273,0.0497624406101525,5.555709880830019e-06,0.0,0.7441860465116279,0.2083333333333332,0,0,0,0,0,0,3,7,34,2000000,84782.60869565218,10000000.0,2500000.0,50000.0,8500000.0,1,0,0.0,-0.3333333333333333
500689,Evann,Guessand,2024,417,France,Ajaccio,Cote d'Ivoire,01-07-01,Centre-Forward,Attack,Right,188.0,30-06-28,One Team Management,https://img.a.transfermarkt.technology/portrait/header/500689-1596556363.jpg?lm=1,FR1,Olympique Gymnaste Club Nice CÃ´te d'Azur,12000000.0,12000000.0,23,116,141,5,8,13,13,13,6,11,9,4,5,11,7,6,13,12,12,14,11,10,12,12,15,14,5,14,8,12,12,13,13,15,14,15,14,14,14,11,7,12,7,7,3,2,3,1,1,1,1,2,2,1,1,15,14,8,10,12,14,11,10,1,1,1,1,1,1,1,1,1,1,9,1,1,20,79,8,20,5259999,5794,5794,3308,African_Caribbean,118,0,0,5771.0,FC Nantes,49041006,9111392.0,2.0,34,29,24,0,1,1,142,3,0.5169356972744112,0.3484491978609625,0.5073529411764706,0.005563886686745,0.0,0.0,0.0597649412353088,0.0597649412353088,0.0505924720131114,0.1428571428571428,0.581395348837209,0.2083333333333332,202,39,21,13,0,2507,0,0,0,20000000,1515384.6153846155,20000000.0,500000.0,,3000000.0,3,2500000,1.5,3.0
501418,Adrià,Pedrosa,2024,368,Spain,Barcelona,Spain,13-05-98,Left-Back,Defender,Left,172.0,30-06-28,CAA Base Ltd,https://img.a.transfermarkt.technology/portrait/header/501418-1583506190.jpg?lm=1,ES1,Sevilla FÃºtbol Club S.A.D.,6000000.0,10000000.0,26,132,150,8,10,11,12,14,9,12,9,12,14,13,10,13,14,7,15,12,14,9,11,14,3,5,7,15,12,13,13,14,13,13,8,7,15,13,10,14,11,10,6,18,1,3,3,1,4,3,2,3,3,1,3,18,8,7,11,12,13,8,20,1,19,1,1,20,1,1,14,1,1,13,1,1,1,69,20,8,3336110,6500,6500,5100,Mediterranean_Hispanic,128,0,0,10294.0,Unknown,95035991,9111392.0,2.0,89,141,89,1,0,3,181,8,0.6103466525535857,0.5401069518716577,0.5808823529411764,0.0099313735809047,0.0,0.0,0.0297574393598399,0.0497624406101525,0.0505924720131114,0.1428571428571428,0.2093023255813952,0.3333333333333332,199,12,18,33,0,4427,8,58,259,7000000,340000.0,10000000.0,2000000.0,,300000.0,2,1000000,0.16666666666666666,0.16666666666666666
501769,Kirill,Shchetinin,2024,1083,Russia,Kursk,Russia,17-01-02,Attacking Midfield,Midfield,Right,178.0,30-06-28,Unknown,https://img.a.transfermarkt.technology/portrait/header/501769-1721922918.png?lm=1,RU1,FK Rostov,3000000.0,3000000.0,22,106,-75,12,12,13,12,13,10,8,14,8,9,12,8,11,12,9,10,5,12,10,12,11,14,10,10,10,10,12,12,12,13,11,8,10,13,12,6,13,8,9,12,13,3,1,2,1,1,2,1,2,2,2,3,11,13,3,12,12,15,14,18,1,1,1,1,1,1,1,15,20,13,15,13,13,1,67,8,20,12664315,5000,5000,2610,Northern_European,102,0,0,9725.0,Unknown,58152148,265000.0,2.0,78,771,81,3,1,7,81,0,0.4118814501190792,0.2737967914438502,0.3897058823529412,0.0093819373565454,0.0,0.0,0.0147536884221055,0.0147536884221055,0.0014444845690158,0.1428571428571428,0.3488372093023257,0.1666666666666666,168,18,29,21,0,5646,2,1,6,2800000,168750.0,3000000.0,200000.0,200000.0,1000000.0,2,100000,-0.06666666666666667,0.4
502239,Michel-Ange,Balikwisha,2024,1096,Belgium,Gent,Belgium,10-05-01,Left Winger,Attack,Right,178.0,30-06-26,Unknown,https://img.a.transfermarkt.technology/portrait/header/502239-1671480373.jpg?lm=1,BE1,Royal Antwerp Football Club,9000000.0,11000000.0,23,124,149,11,11,14,11,15,10,10,9,5,6,13,9,8,14,8,13,13,12,14,12,12,12,14,13,12,6,12,10,15,14,9,8,15,15,10,7,9,6,2,12,14,2,2,3,1,2,1,3,2,2,3,3,20,14,5,10,11,14,11,12,1,1,1,1,1,1,1,1,1,1,18,17,1,20,69,8,20,14099999,6250,6250,4500,African_Caribbean,111,0,0,14999.0,Unknown,18114977,5000000.0,1.0,7,532,8,0,1,1,173,7,0.5772691188145012,0.4759358288770053,0.4558823529411764,0.014474602817478,0.0,0.0,0.0447611902975743,0.0547636909227306,0.0277507708547459,0.0,0.3488372093023257,0.2083333333333332,169,34,18,13,0,4703,7,60,127,7000000,485714.28571428574,11000000.0,2000000.0,,4000000.0,1,1000000,-0.2222222222222222,-0.36363636363636365
502302,Yari,Verschaeren,2024,58,Belgium,Sint-Niklaas,Belgium,12-07-01,Attacking Midfield,Midfield,Right,170.0,30-06-26,HOME OF TALENTS,https://img.a.transfermarkt.technology/portrait/header/502302-1704982236.jpg?lm=1,BE1,Royal Sporting Club Anderlecht,7000000.0,16000000.0,23,123,148,12,13,13,10,14,12,5,12,8,6,14,14,5,15,12,13,14,11,13,15,14,12,14,10,14,8,13,14,11,14,11,5,12,13,13,6,8,11,19,7,14,3,3,1,3,1,3,1,1,1,3,1,14,12,7,12,14,14,16,18,1,1,1,1,1,1,1,1,13,13,17,20,15,1,63,10,20,13200000,6019,6019,5510,Northern_European,122,7,1,14499.0,Unknown,18105040,9111392.0,2.0,7,1374,8,3,1,7,175,0,0.5467054776395872,0.5839572192513368,0.536764705882353,0.0139917941844734,0.0460526315789473,0.0131578947368421,0.0347586896724181,0.0797699424856214,0.0505924720131114,0.1428571428571428,0.1627906976744184,0.2083333333333332,222,30,32,9,0,7422,7,55,240,5000000,210526.31578947368,16000000.0,3000000.0,13500000.0,13000000.0,1,3000000,-0.4117647058823529,-0.3333333333333333
502670,Khvicha,Kvaratskhelia,2024,6195,Georgia,Tiflis,Georgia,12-02-01,Left Winger,Attack,Right,183.0,30-06-27,Unknown,https://img.a.transfermarkt.technology/portrait/header/502670-1708553120.jpg?lm=1,IT1,SocietÃ  Sportiva Calcio Napoli,80000000.0,85000000.0,23,153,174,8,12,18,15,17,12,11,14,4,4,14,12,5,18,11,12,12,15,12,14,14,17,19,5,13,6,9,9,15,18,12,10,16,14,13,10,15,8,16,6,13,3,1,3,2,2,3,3,2,1,3,2,19,16,4,11,17,16,13,14,1,1,1,1,1,1,1,12,1,10,20,15,15,12,70,15,20,74983994,7650,6297,5631,Northern_European,150,17,8,29614.0,Unknown,59130638,5020000.0,4.0,37,1490,39,0,1,7,184,7,0.583487695157449,0.596898395721925,0.7426470588235294,0.0285870991602026,0.1118421052631578,0.1052631578947368,0.3998499624906226,0.4248562140535133,0.0278618850523625,0.4285714285714285,0.4651162790697669,0.2083333333333332,230,53,54,30,0,3541,16,27,51,85000000,3690217.3913043477,85000000.0,5000000.0,2500000.0,16000000.0,5,21975000,0.0625,0.0625
502676,Giorgi,Mamardashvili,2024,1049,Georgia,Tiflis,Georgia,29-09-00,Goalkeeper,Goalkeeper,Left,197.0,30-06-25,Free Football,https://img.a.transfermarkt.technology/portrait/header/502676-1716542116.jpg?lm=1,ES1,Valencia Club de FÃºtbol S. A. D.,45000000.0,45000000.0,24,138,156,4,1,1,3,9,6,2,2,2,3,14,4,3,9,11,12,14,11,13,12,10,14,2,3,2,12,13,12,10,12,13,15,13,11,13,14,14,5,12,5,16,15,16,16,12,13,15,12,16,13,10,12,16,14,7,12,10,12,10,10,20,1,1,1,1,1,1,1,1,1,1,1,1,1,0,20,8,23467499,6750,6750,4750,Mediterranean_Hispanic,132,3,0,3068.0,Unknown,59138294,16925000.0,2.0,37,1490,39,2,0,3,208,5,0.6434241862926701,0.5026737967914437,0.6102941176470589,0.0029538232167221,0.0197368421052631,0.0,0.2248062015503876,0.2248062015503876,0.0940026111836439,0.1428571428571428,0.7906976744186047,0.25,0,0,0,0,0,0,1,3,22,40000000,1903571.4285714286,45000000.0,5000000.0,250000.0,800000.0,3,2200000,-0.1111111111111111,0.3333333333333333
502821,Riccardo,Calafiori,2024,11,Italy,Roma,Italy,19-05-02,Left-Back,Defender,Left,188.0,30-06-29,World Soccer Agency,https://img.a.transfermarkt.technology/portrait/header/502821-1727382174.jpg?lm=1,GB1,Arsenal Football Club,45000000.0,45000000.0,22,112,138,7,15,13,9,14,7,11,13,10,12,12,7,12,14,14,12,11,14,12,12,11,14,13,6,12,13,13,14,12,10,15,12,12,13,12,13,12,11,14,14,10,3,3,1,3,4,3,3,1,1,3,1,5,13,8,12,14,13,12,12,1,20,1,1,12,1,1,14,1,1,1,1,1,1,86,20,11,3322787,5900,6050,4750,Mediterranean_Hispanic,118,0,0,6853.0,Unknown,43424738,26566666.67,3.0,52,1244,54,1,0,3,21,8,0.5508070918232336,0.5026737967914437,0.5073529411764706,0.006608684568567,0.0,0.0,0.2248062015503876,0.2248062015503876,0.1475689139698325,0.2857142857142857,0.581395348837209,0.1666666666666666,0,0,0,0,0,0,19,162,291,45000000,3164285.714285714,45000000.0,500000.0,2500000.0,3500000.0,4,1000000,0.0,2.4615384615384617
503075,Isak,Hien,2024,800,Sweden,Kista,Sweden,13-01-99,Centre-Back,Defender,Right,191.0,30-06-28,BHM Sports Agency,https://img.a.transfermarkt.technology/portrait/header/503075-1725531359.jpg?lm=1,IT1,Atalanta Bergamasca Calcio S.p.a.,20000000.0,20000000.0,25,121,142,6,8,10,5,10,5,13,7,9,13,12,5,13,11,12,12,15,10,10,10,10,15,8,7,8,11,12,13,14,12,13,17,12,15,14,17,13,9,12,6,14,3,2,1,1,1,2,3,1,3,3,3,14,13,8,11,15,14,14,15,1,10,20,12,8,10,1,6,1,6,6,1,6,8,88,7,20,3152995,6050,6050,2250,African_Caribbean,119,0,0,7795.0,Unknown,93083839,6550000.0,2.0,91,734,91,1,1,1,31,2,0.5508070918232336,0.2352941176470588,0.5147058823529411,0.0075182960331477,0.0,0.0,0.0997749437359339,0.0997749437359339,0.0363621211700324,0.1428571428571428,0.6511627906976742,0.2916666666666665,219,9,7,41,2,5473,7,23,30,30000000,2725000.0,30000000.0,0.0,,,2,13000000,0.5,2.3333333333333335
503160,Paul,Nebel,2024,39,Germany,Bad Nauheim,Germany,10-10-02,Attacking Midfield,Midfield,Right,169.0,30-06-27,PRO Profil GmbH,https://img.a.transfermarkt.technology/portrait/header/503160-1722886613.jpg?lm=1,L1,1. FuÃŸball- und Sportverein Mainz 05,3500000.0,3500000.0,22,112,-75,13,11,14,11,13,13,4,11,3,6,12,12,7,14,13,10,8,9,8,11,8,15,16,7,11,8,14,12,14,14,11,4,6,13,12,6,12,7,7,6,18,3,1,2,1,1,1,3,3,3,2,1,10,16,12,16,15,14,12,12,1,10,1,10,12,12,1,12,14,12,15,15,20,11,66,15,20,49600000,5554,5554,3354,Northern_European,111,0,0,4794.0,Karlsruher SC,91188358,9111392.0,2.0,38,121,40,3,1,7,1,0,0.4851812648848902,0.3533689839572192,0.4558823529411764,0.004620478617854,0.0,0.0,0.0172543135783946,0.0172543135783946,0.0505924720131114,0.1428571428571428,0.13953488372093,0.1666666666666666,195,42,55,37,0,1524,0,0,0,7000000,464285.71428571426,7000000.0,0.0,1300000.0,2000000.0,2,4000000,1.0,1.8
503162,Christopher,Scott,2024,1096,Germany,KÃ¶ln,Germany,07-06-02,Attacking Midfield,Midfield,Right,178.0,30-06-26,CN Sports,https://img.a.transfermarkt.technology/portrait/header/503162-1659086962.jpg?lm=1,BE1,Royal Antwerp Football Club,600000.0,1500000.0,22,114,-75,6,10,14,11,13,6,8,11,4,8,13,7,10,14,13,12,12,11,10,13,10,14,13,5,13,9,13,13,13,12,11,9,13,14,12,12,13,7,14,10,17,1,2,1,1,1,1,4,1,1,3,3,13,15,9,10,12,13,12,11,1,1,1,1,1,1,1,1,20,1,15,19,1,1,71,11,20,23100000,5700,5700,4200,African_Caribbean,110,0,0,9588.0,Unknown,92097822,1400000.0,1.0,38,777,40,3,1,1,173,0,0.5044985445885155,0.4438502673796791,0.4485294117647059,0.0092496477911022,0.0,0.0,0.0027506876719179,0.0072518129532383,0.0077502152837578,0.0,0.3488372093023257,0.1666666666666666,171,48,18,19,3,3176,7,47,83,600000,18181.81818181818,1500000.0,400000.0,700000.0,1200000.0,3,300000,0.0,-0.5
503638,Mohamed,Ihattaren,2024,235,Netherlands,Utrecht,Netherlands,12-02-02,Attacking Midfield,Midfield,Left,183.0,30-06-25,Team Raiola,https://img.a.transfermarkt.technology/portrait/header/503638-1701761654.jpg?lm=1,NL1,Rooms Katholieke Combinatie Waalwijk,100000.0,22000000.0,22,118,-8,8,9,15,11,15,12,7,11,6,5,14,11,5,16,11,13,13,14,7,14,10,4,14,5,13,5,11,9,13,14,14,9,3,14,6,9,7,11,12,15,13,3,3,2,4,2,3,3,3,2,3,1,5,13,19,7,3,5,10,12,1,1,1,1,1,1,1,16,17,19,17,19,20,8,79,20,12,65100001,5899,5899,5249,North_African__Middle_Eastern,111,0,0,11880.0,AFC Ajax,37073834,1900000.0,1.0,67,1551,68,3,0,6,172,0,0.5308282614448266,0.5560427807486631,0.4558823529411764,0.0114628425647953,0.0,0.0,0.0002500625156289,0.1097774443610902,0.0105280702241728,0.0,0.4651162790697669,0.1666666666666666,138,30,28,4,0,6055,11,19,119,300000,-60000.0,22000000.0,5000000.0,16000000.0,3000000.0,7,5650000,2.0,0.0
503680,Neco,Williams,2024,703,Wales,Wrexham,Wales,13-04-01,Right-Back,Defender,Right,183.0,30-06-26,Unique Sports Group,https://img.a.transfermarkt.technology/portrait/header/503680-1705499825.jpg?lm=1,GB1,Nottingham Forest Football Club,17000000.0,20000000.0,23,134,155,8,15,13,11,14,7,11,12,10,11,12,6,13,13,12,11,12,13,10,12,13,14,11,6,11,11,14,14,14,13,13,11,15,14,14,11,11,8,10,10,8,2,3,2,3,1,2,3,1,2,1,3,14,14,8,16,12,14,12,12,1,15,1,18,16,20,1,1,1,14,1,1,17,1,0,8,20,55351256,6695,6695,5395,Northern_European,125,21,2,46397.0,Unknown,28115792,20000000.0,1.0,109,1676,106,1,1,7,140,11,0.6361471288700714,0.5716577540106952,0.5588235294117647,0.0447930537356352,0.1381578947368421,0.0263157894736842,0.0847711927981995,0.0997749437359339,0.1110864190671963,0.0,0.4651162790697669,0.2083333333333332,0,0,0,0,0,0,11,27,35,17000000,1000000.0,20000000.0,3000000.0,,8000000.0,2,7000000,0.0,0.0
503733,Anthony,Gordon,2024,762,England,Liverpool,England,24-02-01,Left Winger,Attack,Right,183.0,30-06-26,Unique Sports Group,https://img.a.transfermarkt.technology/portrait/header/503733-1660588736.jpg?lm=1,GB1,Newcastle United Football Club,60000000.0,60000000.0,23,131,154,11,13,14,11,13,12,7,13,5,8,12,12,11,13,11,10,10,12,10,11,12,17,15,9,10,6,11,15,15,14,7,11,10,14,14,9,10,7,8,11,5,1,1,3,1,1,1,1,2,1,1,3,9,16,8,12,12,14,12,13,1,1,1,1,1,1,1,1,1,1,18,17,20,15,0,10,20,59569003,6996,6996,5496,Northern_European,125,0,0,11599.0,Unknown,28116386,45600000.0,1.0,32,845,33,0,1,7,137,7,0.6759724794919291,0.5824598930481283,0.5588235294117647,0.0111915041130467,0.0,0.0,0.2998249562390597,0.2998249562390597,0.2533125920164448,0.0,0.4651162790697669,0.2083333333333332,244,53,35,34,0,6273,5,9,23,60000000,3656250.0,60000000.0,5000000.0,1500000.0,8000000.0,4,8200000,0.0,0.2
503743,Morgan,Rogers,2024,405,England,Halesowen,England,26-07-02,Attacking Midfield,Midfield,Right,187.0,30-06-29,Footwork,https://img.a.transfermarkt.technology/portrait/header/503743-1706786450.jpg?lm=1,GB1,Aston Villa Football Club,22000000.0,22000000.0,22,115,-8,9,12,14,11,12,7,8,9,4,9,11,5,9,13,9,10,9,12,9,11,9,14,15,6,11,7,10,12,14,11,13,11,13,13,11,13,9,4,10,4,10,1,3,3,2,3,2,2,4,1,2,2,8,13,4,14,11,10,14,14,1,1,1,1,1,1,1,1,1,1,20,17,17,18,0,13,20,71822083,5744,5744,3744,Mixed_Race,109,0,0,23198.0,Unknown,28115996,5000000.0,3.0,32,590,33,3,1,4,30,0,0.5103201905265944,0.3950802139037432,0.4411764705882353,0.0223916987814875,0.0,0.0,0.1097774443610902,0.1097774443610902,0.0277507708547459,0.2857142857142857,0.5581395348837206,0.1666666666666666,0,0,0,0,0,0,1,3,27,40000000,3208333.3333333335,40000000.0,200000.0,,1800000.0,5,6100000,1.6666666666666667,13.285714285714286
503749,Jacob,Ramsey,2024,405,England,Birmingham,England,28-05-01,Attacking Midfield,Midfield,Right,180.0,30-06-27,Unique Sports Group,https://img.a.transfermarkt.technology/portrait/header/503749-1687975464.jpg?lm=1,GB1,Aston Villa Football Club,32000000.0,42000000.0,23,134,-8,8,10,15,13,13,7,9,12,7,10,13,9,10,14,9,12,14,14,11,13,12,13,13,8,12,10,14,14,14,14,12,11,13,14,14,13,13,9,12,7,11,2,4,1,1,1,1,3,3,2,3,1,10,13,5,14,10,13,11,13,1,1,1,1,1,1,1,1,20,1,10,20,1,1,61,12,20,76090578,6695,6695,5595,Mixed_Race,130,0,0,81194.0,Unknown,29193659,9111392.0,2.0,32,199,33,3,1,4,30,0,0.6361471288700714,0.593048128342246,0.5955882352941175,0.0783936377409577,0.0,0.0,0.1597899474868717,0.2098024506126531,0.0505924720131114,0.1428571428571428,0.3953488372093026,0.2083333333333332,221,43,27,27,1,6669,5,40,120,32000000,2178571.4285714286,42000000.0,7000000.0,,22000000.0,0,0,-0.08571428571428572,-0.23809523809523808
503770,Folarin,Balogun,2024,162,United States,"New York City, New York",United States,03-07-01,Centre-Forward,Attack,Right,178.0,30-06-28,Unknown,https://img.a.transfermarkt.technology/portrait/header/503770-1672838317.jpg?lm=1,FR1,Association sportive de Monaco Football Club,25000000.0,30000000.0,23,124,149,5,9,13,14,13,7,9,10,2,5,10,11,5,13,10,10,12,12,9,9,12,13,13,3,14,5,12,12,16,15,12,11,12,15,13,10,13,7,15,7,8,2,1,4,3,1,3,3,2,2,2,1,13,14,10,8,12,13,14,14,1,1,1,1,1,1,1,1,1,1,14,14,14,20,0,14,20,15658884,6250,6250,4251,African_Caribbean,121,0,0,34798.0,Stade de Reims,28116305,30000000.0,1.0,104,1035,102,0,1,1,24,3,0.5772691188145012,0.4493048128342246,0.5294117647058822,0.0335928590671944,0.0,0.0,0.1247811952988247,0.1497874468617154,0.1666435178754965,0.0,0.3488372093023257,0.2083333333333332,215,113,33,16,0,4482,4,35,134,25000000,1909090.9090909092,30000000.0,5000000.0,,4000000.0,3,3000000,-0.16666666666666666,-0.16666666666666666
503858,Antef,Tsoungui,2024,2727,Belgium,Brussel,Belgium,30-12-02,Centre-Back,Defender,Right,185.0,30-06-25,ESA,https://img.a.transfermarkt.technology/portrait/header/503858-1721657960.jpg?lm=1,BE1,Oud-Heverlee Leuven,800000.0,800000.0,21,95,-75,6,10,9,9,9,10,8,10,8,8,10,6,9,10,14,8,10,9,9,9,8,11,9,12,6,9,11,13,14,10,10,12,11,13,12,11,9,5,19,12,18,1,3,1,1,4,3,2,1,3,1,2,8,11,4,9,12,11,11,18,1,14,20,14,14,14,16,1,14,1,1,1,1,1,0,8,20,26515711,4735,4735,2486,Mixed_Race,74,0,0,3480.0,Unknown,28126164,9111392.0,2.0,7,265,8,1,1,4,146,2,0.3768192643556497,0.2605347593582887,0.1838235294117646,0.0033516575303179,0.0,0.0,0.0037509377344336,0.0037509377344336,0.0505924720131114,0.1428571428571428,0.5116279069767438,0.125,109,4,3,27,2,3220,4,28,150,800000,100000.0,800000.0,50000.0,300000.0,,2,250000,0.0,0.6
503866,Albert,Grønbaek,2024,273,Denmark,Risskov,Denmark,23-05-01,Central Midfield,Midfield,Right,181.0,30-06-29,Nine Group ,https://img.a.transfermarkt.technology/portrait/header/503866-1660548438.jpg?lm=1,FR1,Stade Rennais Football Club,15000000.0,15000000.0,23,116,147,13,12,13,11,13,12,9,13,8,9,12,6,6,13,13,12,14,12,11,12,10,10,13,8,11,8,12,12,13,14,14,12,15,13,11,8,10,10,13,5,12,2,1,4,1,3,1,2,2,2,1,1,14,8,6,9,12,12,12,10,1,1,1,1,1,1,11,11,20,13,15,16,16,1,73,12,20,3196410,5950,5750,4000,Northern_European,109,0,0,2017.0,Unknown,27139574,9111392.0,2.0,28,1237,30,3,1,7,195,1,0.5111140513363324,0.4224598930481283,0.4411764705882353,0.0019389594701464,0.0,0.0,0.0747686921730432,0.0747686921730432,0.0505924720131114,0.1428571428571428,0.418604651162791,0.2083333333333332,239,53,26,22,0,8344,0,0,0,15000000,1229166.6666666667,15000000.0,0.0,,1000000.0,2,3800000,0.25,0.5
503871,Morten,Frendrup,2024,252,Denmark,HolbÃ¦k,Denmark,07-04-01,Central Midfield,Midfield,Right,178.0,30-06-28,Boutique Transfers,https://img.a.transfermarkt.technology/portrait/header/503871-1707815910.jpg?lm=1,IT1,Genoa Cricket and Football Club,15000000.0,15000000.0,23,125,157,8,10,9,8,12,8,11,8,6,13,13,7,13,12,14,12,13,12,13,13,13,12,6,11,12,12,14,15,13,13,11,9,13,14,14,12,13,11,12,5,13,2,2,2,4,3,1,2,3,1,3,2,12,13,4,14,12,14,9,11,1,1,1,8,1,8,15,10,20,1,1,1,1,1,71,13,20,9339999,6250,6000,3250,Northern_European,124,0,0,9500.0,Unknown,27132198,3900000.0,1.0,28,632,30,3,1,7,104,1,0.5441915850754168,0.3422459893048128,0.5514705882352942,0.0091646734716934,0.0,0.0,0.0747686921730432,0.0747686921730432,0.0216394899858329,0.0,0.3488372093023257,0.2083333333333332,243,10,12,33,0,7728,1,1,18,20000000,1243750.0,20000000.0,200000.0,1500000.0,3500000.0,1,200000,0.3333333333333333,1.0
503881,Aster,Vranckx,2024,82,Belgium,Erps-Kwerps,Belgium,04-10-02,Central Midfield,Midfield,Right,183.0,30-06-29,DW Sports Management,https://img.a.transfermarkt.technology/portrait/header/503881-1657202999.jpg?lm=1,L1,Verein fÃ¼r LeibesÃ¼bungen Wolfsburg,12000000.0,12000000.0,22,126,-85,11,9,13,11,12,12,8,11,4,12,13,7,14,14,15,13,14,12,12,12,12,16,13,12,14,12,15,16,12,12,12,11,14,12,13,12,13,12,12,6,13,1,3,1,1,3,3,1,3,3,1,2,13,15,10,11,13,11,12,9,1,1,1,10,1,10,16,10,20,12,10,15,9,1,78,13,20,70880000,6299,5999,5749,Mixed_Race,126,0,0,28766.0,AC Milan,18113140,8000000.0,1.0,7,468,8,3,1,4,213,1,0.5440592749404605,0.6095187165775401,0.5661764705882353,0.0277682557186268,0.0,0.0,0.0597649412353088,0.0597649412353088,0.044417900497236,0.0,0.4651162790697669,0.1666666666666666,121,7,5,20,1,2335,7,26,80,12000000,697058.8235294118,12000000.0,1500000.0,6800000.0,8500000.0,3,6700000,0.0,0.0
503977,Taylor,Harwood-Bellis,2024,180,England,Stockport,England,30-01-02,Centre-Back,Defender,Right,188.0,30-06-28,Unknown,https://img.a.transfermarkt.technology/portrait/header/503977-1687975943.jpg?lm=1,GB1,Southampton Football Club,22000000.0,25000000.0,22,125,-8,6,4,7,7,10,6,13,9,11,15,12,5,13,12,12,10,12,13,13,8,11,15,5,13,4,15,13,13,12,12,12,14,14,13,12,14,15,9,11,11,16,3,2,3,1,1,3,2,2,3,3,1,17,14,4,13,13,15,12,10,1,1,20,15,1,1,1,1,1,1,1,1,1,1,0,7,20,79222355,6242,6242,3993,Northern_European,119,0,0,11599.0,Burnley,28120046,23000000.0,1.0,32,1427,33,1,1,7,186,2,0.5762106377348505,0.421711229946524,0.5147058823529411,0.0111915041130467,0.0,0.0,0.1097774443610902,0.1247811952988247,0.1277535487096864,0.0,0.581395348837209,0.1666666666666666,249,15,9,31,0,6248,2,18,69,25000000,1607142.857142857,25000000.0,3000000.0,2300000.0,13000000.0,6,15700000,0.13636363636363635,0.13636363636363635
503981,Tino,Livramento,2024,762,England,London,England,12-11-02,Right-Back,Defender,Right,182.0,30-06-28,Wasserman,https://img.a.transfermarkt.technology/portrait/header/503981-1699383321.jpg?lm=1,GB1,Newcastle United Football Club,35000000.0,35000000.0,22,134,-9,7,14,14,7,13,7,11,5,9,11,13,7,13,14,12,12,12,11,10,10,12,15,12,10,12,12,12,14,16,12,13,11,14,15,14,12,11,6,12,7,13,4,3,4,3,2,3,1,4,1,2,1,11,11,1,9,11,10,10,13,1,14,14,20,13,17,1,1,1,14,1,1,14,1,80,10,20,88664083,6700,6700,5500,Northern_European,123,0,0,11599.0,Unknown,28124569,31700000.0,2.0,32,858,33,1,1,7,137,11,0.6368086795448531,0.5828877005347594,0.5441176470588236,0.0111915041130467,0.0,0.0,0.1747936984246061,0.1747936984246061,0.1760882246729075,0.1428571428571428,0.4418604651162785,0.1666666666666666,154,6,17,10,1,3838,6,56,354,35000000,2727272.727272727,35000000.0,0.0,12000000.0,30000000.0,1,5000000,0.0,0.0
503987,Noni,Madueke,2024,631,England,London,England,10-03-02,Right Winger,Attack,Left,182.0,30-06-30,Unknown,https://img.a.transfermarkt.technology/portrait/header/503987-1683102348.jpg?lm=1,GB1,Chelsea Football Club,35000000.0,35000000.0,22,139,-9,12,11,17,13,15,10,11,11,11,3,12,11,5,15,10,10,14,15,11,8,11,12,16,5,12,5,10,12,15,15,14,12,15,16,11,14,9,13,6,17,14,3,2,1,4,1,3,3,3,2,3,2,12,11,6,12,11,12,11,13,1,1,1,1,1,1,1,16,12,18,17,16,20,10,0,20,10,134930875,7000,6500,5000,African_Caribbean,132,0,0,14383.0,Unknown,37076092,35000000.0,1.0,32,858,33,0,0,1,50,10,0.6103466525535857,0.5294117647058822,0.6102941176470589,0.0138797825816163,0.0,0.0,0.1747936984246061,0.1747936984246061,0.1944220672796466,0.0,0.4418604651162785,0.1666666666666666,199,55,34,8,1,8317,12,72,82,40000000,2073684.2105263157,40000000.0,5000000.0,14000000.0,15000000.0,1,13000000,0.42857142857142855,0.6
503988,Alex,Mighten,2024,2778,United States,"West Hartford, Connecticut",England,11-04-02,Left Winger,Attack,Right,171.0,31-12-24,Footwork,https://img.a.transfermarkt.technology/portrait/header/503988-1633425708.jpg?lm=1,DK1,Fodbold Club NordsjÃ¦lland,500000.0,600000.0,22,110,135,6,12,13,11,12,5,9,7,3,4,11,9,5,13,5,12,10,9,8,12,9,14,16,6,13,9,9,12,13,14,11,8,11,15,10,9,12,5,11,5,10,2,3,1,3,2,1,3,2,2,2,2,9,12,6,11,12,11,11,10,1,1,1,1,1,1,1,12,1,12,19,14,20,15,0,9,20,9613395,5499,5749,3019,African_Caribbean,101,0,0,5800.0,Sheffield Wednesday,29219153,9111392.0,2.0,104,1657,33,0,1,1,87,7,0.5109817412013761,0.3175401069518716,0.3823529411764706,0.0055918895874593,0.0,0.0,0.0022505626406601,0.0027506876719179,0.0505924720131114,0.1428571428571428,0.1860465116279068,0.1666666666666666,116,14,4,3,0,3784,2,24,56,500000,31818.18181818182,600000.0,100000.0,400000.0,600000.0,3,100000,0.0,-0.16666666666666666
503991,Yunus,Musah,2024,5,United States,"New York City, New York",United States,29-11-02,Central Midfield,Midfield,Right,178.0,30-06-28,Unknown,https://img.a.transfermarkt.technology/portrait/header/503991-1684913655.jpg?lm=1,IT1,Associazione Calcio Milan,22000000.0,25000000.0,22,126,-85,11,12,13,11,14,11,11,10,11,11,11,11,12,13,15,13,12,13,13,13,14,16,11,11,12,13,14,13,14,14,13,10,15,13,13,14,14,7,13,5,15,1,1,2,3,1,2,1,2,1,2,1,18,16,6,14,15,16,14,17,1,1,1,1,1,1,12,13,20,15,12,16,16,1,71,8,20,65100001,6300,6600,4000,African_Caribbean,129,19,0,10000.0,Unknown,28129089,21700000.0,1.0,104,1035,102,3,1,1,27,1,0.6235776660492194,0.4224598930481283,0.588235294117647,0.009647482104698,0.125,0.0,0.1097774443610902,0.1247811952988247,0.1205311258646073,0.0,0.3488372093023257,0.1666666666666666,218,11,10,36,1,3422,5,16,32,22000000,1362500.0,25000000.0,5000000.0,15000000.0,20000000.0,2,6800000,0.0,-0.043478260869565216
504072,Samuel,Soares,2024,294,Portugal,Amadora,Portugal,15-06-02,Goalkeeper,Goalkeeper,Right,190.0,30-06-27,Unknown,https://img.a.transfermarkt.technology/portrait/header/504072-1725535900.jpg?lm=1,PO1,Sport Lisboa e Benfica,3000000.0,3000000.0,22,108,-75,4,3,3,2,10,8,6,2,1,2,11,1,1,11,11,13,12,10,8,10,9,15,11,6,8,11,12,12,12,12,12,13,16,12,12,13,11,5,7,5,12,11,12,12,15,12,16,13,15,15,10,12,12,12,7,12,14,14,14,5,20,1,1,1,1,1,1,1,1,1,1,1,1,1,90,6,20,21079999,5400,5400,3910,African_Caribbean,110,0,0,2749.0,Unknown,83257052,9111392.0,2.0,76,57,79,2,1,1,188,5,0.4648055041016142,0.4128342245989304,0.4485294117647059,0.0026457913088652,0.0,0.0,0.0147536884221055,0.0147536884221055,0.0505924720131114,0.1428571428571428,0.6279069767441858,0.1666666666666666,0,0,0,0,0,0,1,1,7,3000000,250000.0,3000000.0,0.0,,2000000.0,1,0,0.0,0.0
504073,Eduardo,Quaresma,2024,336,Portugal,Barreiro,Portugal,02-03-02,Centre-Back,Defender,Right,185.0,30-06-28,Proeleven S.A.,https://img.a.transfermarkt.technology/portrait/header/504073-1595248439.jpg?lm=1,PO1,Sporting Clube de Portugal,14000000.0,14000000.0,22,117,-8,5,9,12,8,12,6,11,6,11,12,13,11,16,12,13,13,15,11,8,11,9,12,5,12,8,13,12,14,13,13,14,12,14,13,14,13,14,11,14,4,10,3,1,4,1,2,1,1,3,2,3,2,18,9,11,14,8,9,13,14,1,1,20,14,1,10,13,1,1,1,1,1,1,1,78,12,20,26662501,5792,5792,4053,Mediterranean_Hispanic,118,0,0,5028.0,TSG Hoffenheim,83261917,9111392.0,2.0,76,150,79,1,1,3,193,2,0.5166710770044985,0.4281283422459893,0.5073529411764706,0.0048464330581002,0.0,0.0,0.0697674418604651,0.0697674418604651,0.0505924720131114,0.1428571428571428,0.5116279069767438,0.1666666666666666,123,3,2,12,0,4490,7,19,28,14000000,538461.5384615385,14000000.0,1000000.0,6000000.0,4000000.0,3,1000000,0.75,4.6
504075,Rafael,Brito,2024,3268,Portugal,Almada,Portugal,19-01-02,Defensive Midfield,Midfield,Right,183.0,30-06-25,Traquifoot,https://img.a.transfermarkt.technology/portrait/header/504075-1572339154.jpg?lm=1,PO1,Casa Pia AtlÃ©tico Clube,300000.0,850000.0,22,110,-75,4,6,11,7,12,4,13,7,6,12,12,8,13,10,13,13,11,14,13,10,12,14,8,11,10,12,13,12,12,12,12,12,15,12,13,12,13,9,12,10,14,4,2,1,3,2,1,1,2,2,2,1,12,12,6,15,13,13,14,12,1,1,16,13,1,1,20,1,13,1,1,1,1,1,74,9,20,28000000,5500,5500,3000,Mixed_Race,106,0,0,3015.0,Clube Sport MarÃ­timo - SAD,83243058,9111392.0,2.0,76,46,79,3,1,4,48,4,0.4780365175972479,0.3155080213903743,0.4191176470588235,0.0029026455016236,0.0,0.0,0.0012503125781445,0.0040010002500625,0.0505924720131114,0.1428571428571428,0.4651162790697669,0.1666666666666666,129,2,3,46,0,4540,5,37,154,400000,-27272.727272727272,850000.0,350000.0,700000.0,700000.0,2,200000,0.3333333333333333,0.3333333333333333
504087,Tomás,Araújo,2024,294,Portugal,FamalicÃ£o,Portugal,16-05-02,Centre-Back,Defender,Right,187.0,30-06-28,Epic AraÃºjo,https://img.a.transfermarkt.technology/portrait/header/504087-1655898393.jpg?lm=1,PO1,Sport Lisboa e Benfica,15000000.0,15000000.0,22,115,-75,5,7,8,7,11,5,13,5,4,13,12,5,13,12,13,13,14,11,12,12,12,14,12,12,8,12,12,11,13,12,12,13,15,13,12,13,14,5,12,8,8,3,2,3,3,2,3,1,2,2,1,3,8,13,10,15,14,16,15,14,1,1,20,1,1,1,1,1,1,1,1,1,1,1,81,9,20,27099999,5750,5750,3750,Mediterranean_Hispanic,115,0,0,3499.0,Gil Vicente Futebol Clube,83243060,9111392.0,2.0,76,484,79,1,1,3,188,2,0.5111140513363324,0.3957219251336898,0.4852941176470588,0.0033700042583721,0.0,0.0,0.0747686921730432,0.0747686921730432,0.0505924720131114,0.1428571428571428,0.5581395348837206,0.1666666666666666,150,6,6,9,0,4054,2,14,76,28000000,2527272.727272727,28000000.0,0.0,200000.0,3000000.0,3,400000,3.0,4.6
504090,Paulo,Bernardo,2024,371,Portugal,Almada,Portugal,24-01-02,Central Midfield,Midfield,Left,180.0,30-06-29,Gestifute,https://img.a.transfermarkt.technology/portrait/header/504090-1701211884.jpg?lm=1,SC1,The Celtic Football Club,4000000.0,5000000.0,22,133,138,1,1,1,2,8,2,8,3,1,2,10,3,1,8,5,13,14,12,15,7,12,14,6,10,14,14,15,13,10,12,15,15,14,10,13,16,13,5,13,5,1,14,13,13,9,13,12,14,15,10,13,10,10,14,3,12,14,15,12,13,20,1,1,1,1,1,1,1,1,1,1,1,1,1,78,20,6,4556051,6600,5826,4313,Northern_European,131,0,0,22998.0,Unknown,48031584,3000000.0,1.0,76,46,79,3,0,7,200,1,0.521169621593014,0.4559358288770053,0.6029411764705883,0.0221985753282857,0.0,0.0,0.0197549387346836,0.0247561890472618,0.0166393510930859,0.0,0.3953488372093026,0.1666666666666666,178,20,16,26,0,5702,2,22,143,4500000,395454.54545454547,5000000.0,1000000.0,150000.0,4000000.0,3,1000000,0.2857142857142857,0.5
504148,Tariq,Lamptey,2024,1237,England,London,Ghana,30-09-00,Right-Back,Defender,Right,163.0,30-06-25,Unknown,https://img.a.transfermarkt.technology/portrait/header/504148-1692364960.jpg?lm=1,GB1,Brighton and Hove Albion Football Club,12000000.0,18000000.0,24,142,167,6,11,14,8,12,6,7,7,6,7,12,9,11,12,10,12,14,13,12,10,11,14,11,8,12,9,12,14,20,16,15,2,8,16,14,6,18,8,15,7,13,2,2,1,3,3,3,2,1,3,2,3,15,12,5,11,15,14,11,14,1,17,1,20,17,20,1,14,1,15,13,1,13,1,62,10,20,79412582,7100,7100,5500,African_Caribbean,117,0,0,52196.0,Unknown,28112993,1200000.0,1.0,32,858,41,1,1,1,44,11,0.6897327335273882,0.5828877005347594,0.4999999999999999,0.0503926682612226,0.0,0.0,0.0597649412353088,0.0897724431107777,0.0066390733075918,0.0,0.0,0.25,203,10,21,24,1,8253,12,95,197,12000000,653846.1538461539,18000000.0,3000000.0,,18000000.0,0,0,0.0,0.0
504153,Joe,Scally,2024,18,United States,"Lake Grove, New York",United States,31-12-02,Right-Back,Defender,Right,184.0,30-06-27,Sports360 GmbH,https://img.a.transfermarkt.technology/portrait/header/504153-1662965954.jpg?lm=1,L1,Borussia Verein fÃ¼r LeibesÃ¼bungen 1900 MÃ¶nchengladbach,10000000.0,12000000.0,21,125,-8,5,12,12,7,11,4,8,7,12,11,12,6,12,12,14,11,14,11,12,11,11,16,12,5,12,12,15,16,14,12,12,11,17,15,14,11,12,8,11,4,16,2,1,3,3,3,1,3,3,2,1,3,18,14,7,12,12,16,10,10,1,17,1,20,16,18,1,10,1,12,1,1,1,1,80,12,20,60800000,6250,6000,4750,Northern_European,116,2,0,16684.0,Unknown,72051619,1800000.0,1.0,104,793,102,1,1,7,42,11,0.5441915850754168,0.5026737967914437,0.4926470588235294,0.0161016679107035,0.0131578947368421,0.0,0.0497624406101525,0.0597649412353088,0.0099724992360898,0.0,0.4883720930232553,0.125,143,4,6,19,0,1006,3,1,12,10000000,660000.0,12000000.0,2000000.0,8000000.0,12000000.0,1,0,0.0,-0.16666666666666666
504209,Gianluca,Busio,2024,607,United States,"Greensboro, North Carolina",United States,28-05-02,Central Midfield,Midfield,Right,172.0,30-06-26,Octagon,https://img.a.transfermarkt.technology/portrait/header/504209-1717660047.jpg?lm=1,IT1,Venezia Football Club,6500000.0,10000000.0,22,121,-8,11,11,12,10,13,13,9,10,6,9,15,11,13,14,10,13,12,11,11,13,10,11,13,10,12,13,12,10,12,14,12,9,11,12,12,10,12,9,9,10,12,2,3,3,3,3,1,3,3,1,1,2,12,15,6,12,10,12,13,13,1,1,1,1,1,1,19,1,20,1,1,16,1,1,71,13,20,11040074,6050,6150,4950,Mixed_Race,119,8,0,10989.0,Unknown,72049787,9111392.0,2.0,104,560,102,3,1,4,210,1,0.5640381053188674,0.5240641711229946,0.5147058823529411,0.0106024775807811,0.0526315789473684,0.0,0.032258064516129,0.0497624406101525,0.0505924720131114,0.1428571428571428,0.2093023255813952,0.1666666666666666,207,18,18,24,0,3049,9,31,45,6500000,370588.23529411765,10000000.0,2000000.0,4000000.0,5000000.0,2,3000000,0.0,0.5116279069767442
504215,Giovanni,Reyna,2024,16,England,Sunderland,United States,13-11-02,Attacking Midfield,Midfield,Right,185.0,30-06-26,Gestifute,https://img.a.transfermarkt.technology/portrait/header/504215-1719657655.jpg?lm=1,L1,Borussia Dortmund,12000000.0,42000000.0,22,140,-9,13,12,16,12,15,14,7,13,4,6,15,10,7,15,13,13,11,15,11,14,11,13,13,8,15,7,13,14,14,15,13,10,16,15,13,10,11,7,16,14,15,1,1,1,1,2,3,3,3,2,2,3,13,16,10,8,14,12,12,15,1,1,1,1,1,1,1,17,18,12,17,20,12,10,79,12,20,115855997,7000,7000,5750,Mediterranean_Hispanic,139,12,4,47944.0,Unknown,72051281,9111392.0,2.0,32,1436,102,3,1,3,41,0,0.6765017200317545,0.6096256684491979,0.6617647058823528,0.0462868636461514,0.0789473684210526,0.0526315789473684,0.0597649412353088,0.2098024506126531,0.0505924720131114,0.1428571428571428,0.5116279069767438,0.1666666666666666,163,27,28,10,0,5133,17,82,90,12000000,333333.3333333333,42000000.0,7000000.0,42000000.0,20000000.0,2,8000000,-0.3333333333333333,-0.4
504518,Kofi,Balmer,2024,987,Northern Ireland,Newtownabbey,Northern Ireland,19-09-00,Centre-Back,Defender,Right,189.0,30-06-26,Deadline Day Soccer ,https://img.a.transfermarkt.technology/portrait/header/504518-1659522093.jpg?lm=1,SC1,Motherwell Football Club,175000.0,200000.0,24,103,139,4,5,8,6,10,4,14,5,14,13,11,4,12,10,13,11,13,13,12,10,13,14,7,11,7,11,12,12,10,9,12,12,10,10,11,13,13,8,13,7,8,3,3,3,3,3,2,1,3,1,1,3,13,15,5,13,12,15,13,13,1,1,20,14,1,1,12,1,1,1,1,1,1,1,82,10,20,1739876,5750,5733,3240,Northern_European,103,0,0,3480.0,Unknown,52085051,9111392.0,2.0,70,1038,72,1,1,7,135,2,0.5088647790420746,0.3411764705882352,0.3970588235294117,0.0033516575303179,0.0,0.0,0.0006251562890722,0.0007501875468867,0.0505924720131114,0.1428571428571428,0.6046511627906974,0.25,209,14,8,49,2,4771,1,16,63,200000,25000.0,200000.0,25000.0,,,3,100000,0.14285714285714285,0.14285714285714285
504849,Kaoru,Mitoma,2024,1237,Japan,"Kawasaki, Kanagawa",Japan,20-05-97,Left Winger,Attack,Right,178.0,30-06-27,Unknown,https://img.a.transfermarkt.technology/portrait/header/504849-1642264453.jpg?lm=1,GB1,Brighton and Hove Albion Football Club,45000000.0,50000000.0,27,126,135,10,10,14,11,14,9,8,9,7,8,11,8,8,14,14,9,13,12,11,12,11,8,15,6,14,7,12,12,17,14,12,9,14,15,12,7,11,1,13,6,16,3,3,2,1,1,1,4,1,1,3,2,13,11,7,12,11,12,10,10,1,1,1,1,14,1,1,17,1,1,20,1,13,1,72,8,20,5639097,6294,6594,4494,10,121,7,4,23198.0,Unknown,45111891,3000000.0,1.0,54,715,56,0,1,0,44,7,0.6227838052394814,0.4752941176470587,0.5294117647058822,0.0223916987814875,0.0460526315789473,0.0526315789473684,0.2248062015503876,0.2498124531132783,0.0166393510930859,0.0,0.3488372093023257,0.375,191,60,41,11,0,2941,4,39,129,45000000,2809375.0,50000000.0,5000000.0,,,2,1200000,0.0,-0.1
505194,Luke,Thomas,2024,1003,England,Syston,England,10-06-01,Left-Back,Defender,Left,181.0,30-06-26,Wasserman,https://img.a.transfermarkt.technology/portrait/header/505194-1687975540.jpg?lm=1,GB1,Leicester City Football Club,6000000.0,12000000.0,23,134,160,10,15,13,10,14,11,12,11,11,13,14,9,14,13,8,13,13,13,12,11,13,14,7,10,11,12,13,16,14,12,9,11,14,13,15,10,14,8,13,5,16,2,1,3,3,1,1,2,3,1,2,1,11,12,6,15,12,14,14,15,1,20,8,1,17,1,8,12,8,1,1,1,1,1,0,20,10,44529227,6700,6700,5150,Northern_European,131,0,0,28998.0,Unknown,28117365,9111392.0,2.0,32,1441,33,1,0,7,127,8,0.6368086795448531,0.5454545454545454,0.6029411764705883,0.0279922789243409,0.0,0.0,0.0297574393598399,0.0597649412353088,0.0505924720131114,0.1428571428571428,0.418604651162791,0.2083333333333332,185,10,10,23,0,7414,0,0,0,6000000,357142.85714285716,12000000.0,2000000.0,,8000000.0,3,4000000,0.0,-0.4
505219,James,Garner,2024,29,England,Birkenhead,England,13-03-01,Defensive Midfield,Midfield,Right,182.0,30-06-26,Triple S Sports,https://img.a.transfermarkt.technology/portrait/header/505219-1662067244.jpg?lm=1,GB1,Everton Football Club,22000000.0,22000000.0,23,130,-8,12,13,6,11,14,12,8,13,2,8,15,10,12,14,10,14,11,14,14,14,13,16,5,11,12,13,16,14,11,12,13,12,15,12,16,11,14,7,13,4,14,1,2,1,2,2,3,3,2,2,3,1,7,14,2,13,12,15,14,12,1,1,5,1,1,1,17,1,20,1,1,10,1,1,77,10,20,91198502,6500,6500,4500,Northern_European,130,0,0,46397.0,Unknown,28115831,10400000.0,1.0,32,197,33,3,1,7,65,4,0.6103466525535857,0.4759358288770053,0.5955882352941175,0.0447930537356352,0.0,0.0,0.1097774443610902,0.1097774443610902,0.057751604211228,0.0,0.4418604651162785,0.2083333333333332,237,25,23,36,0,6275,3,30,99,20000000,1133333.3333333333,22000000.0,2000000.0,3000000.0,4000000.0,3,4800000,-0.09090909090909091,0.0
505653,Fábio,Silva,2024,472,Portugal,Porto,Portugal,19-07-02,Centre-Forward,Attack,Right,185.0,30-06-25,STV ,https://img.a.transfermarkt.technology/portrait/header/505653-1723794084.png?lm=1,ES1,UniÃ³n Deportiva Las Palmas S.A.D.,11000000.0,25000000.0,22,125,-85,8,8,14,13,14,7,11,10,7,5,13,12,6,14,11,11,13,14,12,12,13,15,13,6,14,8,11,14,13,13,12,13,12,13,12,13,11,5,13,8,12,2,1,1,2,2,2,1,3,2,2,1,7,15,8,8,14,16,10,10,1,1,1,1,1,1,1,1,1,1,10,8,8,20,75,10,20,86993802,6419,5769,4769,Mediterranean_Hispanic,124,0,0,46397.0,RSC Anderlecht,83228802,40000000.0,1.0,76,1170,79,0,1,3,207,3,0.5136279439005028,0.5047058823529411,0.5514705882352942,0.0447930537356352,0.0,0.0,0.0547636909227306,0.1247811952988247,0.2222006166837967,0.0,0.5116279069767438,0.1666666666666666,202,45,20,25,0,6767,1,1,14,18000000,937500.0,25000000.0,4000000.0,25000000.0,13000000.0,6,26000000,0.6363636363636364,0.38461538461538464
505655,Henrique,Pereira,2024,3268,Portugal,Lisboa,Portugal,15-02-02,Left Winger,Attack,Right,178.0,30-06-25,CAA Stellar,https://img.a.transfermarkt.technology/portrait/header/505655-1625667504.jpg?lm=1,PO1,Casa Pia AtlÃ©tico Clube,1800000.0,2000000.0,22,106,-8,7,12,14,12,12,7,6,9,5,6,12,9,5,12,11,10,10,12,12,12,12,15,14,8,13,6,11,10,14,13,11,8,14,14,11,8,14,6,10,6,12,2,2,2,1,1,2,1,3,3,1,3,14,13,6,14,14,15,15,16,1,1,1,1,1,1,1,12,1,7,20,1,16,8,69,7,20,24599999,5300,5300,3803,Mediterranean_Hispanic,105,0,0,3149.0,Unknown,83243056,9111392.0,2.0,76,843,79,0,1,3,48,7,0.4515744906059804,0.4013903743315508,0.411764705882353,0.0030320382152689,0.0,0.0,0.0087521880470117,0.0097524381095273,0.0505924720131114,0.1428571428571428,0.3488372093023257,0.1666666666666666,134,27,12,12,0,3374,2,14,79,1000000,112500.0,2000000.0,800000.0,,475000.0,1,800000,-0.4444444444444444,-0.5
505674,Sergio,Camello,2024,367,Spain,Madrid,Spain,10-02-01,Centre-Forward,Attack,Right,182.0,30-06-27,Best of You,https://img.a.transfermarkt.technology/portrait/header/505674-1617806102.jpg?lm=1,ES1,Rayo Vallecano de Madrid S.A.D.,3000000.0,10000000.0,23,127,154,7,8,12,16,14,7,11,9,7,8,11,15,9,12,8,13,11,14,13,12,12,16,13,8,14,15,12,12,13,12,11,9,10,13,13,12,11,5,16,9,16,1,1,3,1,3,3,1,2,3,1,1,15,8,8,13,11,11,11,11,1,1,1,1,1,1,1,1,1,1,1,1,1,20,69,12,20,10305000,6348,6348,4348,Mediterranean_Hispanic,126,0,0,9843.0,Vallecano,67272502,5000000.0,1.0,89,892,89,0,1,3,163,3,0.5902355120402223,0.4596791443850267,0.5661764705882353,0.0094958801939345,0.0,0.0,0.0147536884221055,0.0497624406101525,0.0277507708547459,0.0,0.4418604651162785,0.2083333333333332,206,51,13,23,0,2904,0,0,0,3500000,47619.04761904762,10000000.0,5000000.0,2500000.0,2400000.0,2,1300000,0.16666666666666666,-0.125
506189,Flynn,Downes,2024,180,England,Brentwood,England,20-01-99,Defensive Midfield,Midfield,Right,178.0,30-06-28,Wasserman,https://img.a.transfermarkt.technology/portrait/header/506189-1659355597.jpg?lm=1,GB1,Southampton Football Club,13000000.0,13000000.0,25,124,148,9,7,13,8,14,8,9,7,8,12,12,8,14,13,16,15,13,15,13,12,13,15,8,10,9,14,13,15,13,12,14,10,14,13,14,13,15,14,9,11,8,1,3,3,2,3,2,1,2,1,3,1,11,16,14,7,10,15,9,7,1,1,8,1,1,1,18,1,20,1,1,1,1,1,0,7,20,12327674,6199,6199,4499,Northern_European,121,0,0,34798.0,Unknown,29156436,10066666.67,3.0,32,256,33,3,1,7,186,4,0.570521301931728,0.4758288770053475,0.5294117647058822,0.0335928590671944,0.0,0.0,0.0647661915478869,0.0647661915478869,0.0558997009361371,0.2857142857142857,0.3488372093023257,0.2916666666666665,240,7,9,69,1,3567,4,10,3566,15000000,1064285.7142857143,15000000.0,1000000.0,100000.0,1000000.0,3,7300000,0.6666666666666666,0.875
506248,Edu,Expósito,2024,714,Spain,Barcelona,Spain,01-08-96,Central Midfield,Midfield,Right,178.0,30-06-27,Promoesport,https://img.a.transfermarkt.technology/portrait/header/506248-1544776296.jpg?lm=1,ES1,Reial Club Deportiu Espanyol de Barcelona S.A.D.,2500000.0,6000000.0,28,134,143,9,10,12,12,14,12,9,14,7,12,14,12,13,13,11,15,14,14,15,11,15,11,9,13,10,14,13,13,13,12,12,8,11,13,12,11,16,11,13,11,13,2,3,2,1,4,1,2,2,3,1,3,14,9,7,13,11,11,11,18,1,1,1,1,1,1,14,1,20,1,1,14,1,1,0,13,20,6242651,6550,6550,4700,Mediterranean_Hispanic,134,0,0,11317.0,Unknown,67224139,4250000.0,2.0,89,141,89,3,1,3,170,1,0.6169621593014025,0.4973262032085561,0.625,0.0109192000440321,0.0,0.0,0.0122530632658164,0.0297574393598399,0.0235839884441234,0.1428571428571428,0.3488372093023257,0.4166666666666665,251,24,22,28,2,1943,1,1,11,1500000,76315.78947368421,6000000.0,2000000.0,,,3,2500000,-0.4,-0.625
507223,Kristijan,Belic,2024,1090,Belgium,Sint-Truiden,Serbia,25-03-01,Defensive Midfield,Midfield,Right,177.0,30-06-28,Unknown,https://img.a.transfermarkt.technology/portrait/header/507223-1721657390.jpg?lm=1,NL1,Alkmaar Zaanstreek,5000000.0,5000000.0,23,112,139,6,8,9,7,12,6,8,9,8,13,12,10,14,10,16,11,15,11,10,11,10,14,8,11,10,15,15,15,12,13,13,9,10,12,13,14,11,15,11,8,10,2,1,2,3,2,2,1,3,3,2,1,8,13,14,9,9,13,9,7,1,1,12,1,1,1,20,1,18,1,1,1,1,1,70,10,20,1178399,5350,5350,3200,Northern_European,113,0,0,1000.0,Unknown,28116527,4000000.0,1.0,7,1376,85,3,1,7,16,4,0.4581899973537973,0.3368983957219251,0.4705882352941176,0.0009569267106151,0.0,0.0,0.0247561890472618,0.0247561890472618,0.0221950609739159,0.0,0.3255813953488373,0.2083333333333332,151,7,10,51,3,5717,3,19,80,4000000,380000.0,5000000.0,1000000.0,,200000.0,2,1400000,-0.2,0.6
507341,Fabian,Rieder,2024,79,Switzerland,Bern,Switzerland,16-02-02,Attacking Midfield,Midfield,Left,179.0,30-06-25,Wasserman,https://img.a.transfermarkt.technology/portrait/header/507341-1723707005.jpg?lm=1,L1,Verein fÃ¼r Bewegungsspiele Stuttgart 1893,8000000.0,15000000.0,22,124,-85,12,12,13,8,15,12,8,12,5,7,14,8,11,15,13,13,10,14,14,13,15,15,13,10,12,9,14,14,12,13,11,8,13,13,14,10,13,11,13,11,11,2,1,1,1,1,4,2,2,4,3,2,15,14,12,14,16,15,11,12,1,1,1,1,1,1,6,10,20,9,1,17,1,1,74,20,8,13602279,6198,6198,4599,Northern_European,124,0,0,7562.0,Unknown,84152512,15000000.0,1.0,92,179,92,3,0,7,211,0,0.5703889917967716,0.4865240641711229,0.5514705882352942,0.0072933072101675,0.0,0.0,0.0397599399849962,0.0747686921730432,0.0833078696630462,0.0,0.3720930232558141,0.1666666666666666,218,34,32,22,0,5951,9,69,110,10000000,698214.2857142857,15000000.0,5000000.0,2000000.0,10000000.0,4,2500000,0.25,-0.3333333333333333
507344,Becir,Omeragic,2024,969,Switzerland,Genf,Switzerland,20-01-02,Centre-Back,Defender,Right,187.0,30-06-28,Unknown,https://img.a.transfermarkt.technology/portrait/header/507344-1702665167.JPG?lm=1,FR1,Montpellier HÃ©rault Sport Club,6000000.0,8000000.0,22,120,-8,4,6,11,5,11,7,12,7,9,14,13,8,15,12,13,14,12,14,12,12,12,13,7,12,9,13,13,11,11,10,12,14,11,11,14,13,12,10,12,12,14,3,3,2,2,2,3,3,3,3,2,1,13,14,12,7,14,13,12,12,1,1,20,12,1,1,10,1,6,1,1,1,1,1,76,10,20,7245239,5981,6426,4382,Northern_European,120,4,0,6106.0,Unknown,98046083,9111392.0,2.0,92,530,92,1,1,7,133,2,0.6005557025668167,0.4633155080213903,0.5220588235294117,0.0058873684708581,0.0263157894736842,0.0,0.0297574393598399,0.0397599399849962,0.0505924720131114,0.1428571428571428,0.5581395348837206,0.1666666666666666,187,2,1,13,0,2299,19,113,155,5000000,233333.33333333334,8000000.0,2000000.0,5000000.0,6000000.0,1,2000000,-0.16666666666666666,0.0
507345,Leonidas,Stergiou,2024,79,Switzerland,Wattwil,Switzerland,03-03-02,Centre-Back,Defender,Right,181.0,30-06-28,Unknown,https://img.a.transfermarkt.technology/portrait/header/507345-1723707260.jpg?lm=1,L1,Verein fÃ¼r Bewegungsspiele Stuttgart 1893,5000000.0,7000000.0,22,120,-8,5,6,10,4,12,5,12,6,8,13,12,8,14,12,13,14,13,13,11,10,13,13,7,8,7,12,13,12,14,13,13,10,15,14,14,12,13,7,11,8,7,1,2,1,3,1,2,3,2,2,1,4,14,15,6,12,11,16,12,12,1,1,20,1,1,1,1,1,1,1,1,1,1,1,75,12,20,6686650,6000,6300,4550,Mediterranean_Hispanic,120,1,0,3426.0,Unknown,84154025,2000000.0,1.0,92,1649,92,1,1,3,211,2,0.5838846255623181,0.481283422459893,0.5220588235294117,0.0032995141979534,0.006578947368421,0.0,0.0247561890472618,0.0347586896724181,0.0110836412122558,0.0,0.418604651162791,0.1666666666666666,192,2,3,13,0,3963,10,41,71,5000000,294117.64705882355,7000000.0,1500000.0,5000000.0,4500000.0,2,1750000,0.0,1.5
507486,Simon,Sohm,2024,130,Switzerland,ZÃ¼rich,Switzerland,11-04-01,Central Midfield,Midfield,Right,188.0,30-06-27,Wasserman,https://img.a.transfermarkt.technology/portrait/header/507486-1686211320.jpg?lm=1,IT1,Parma Calcio 1913,2700000.0,5000000.0,23,117,149,7,8,10,7,12,7,11,9,8,12,13,8,12,12,13,13,15,13,10,12,12,11,8,7,10,12,14,13,11,12,15,13,13,12,14,14,12,11,8,10,14,1,1,3,2,2,2,1,1,2,1,2,11,13,5,10,10,15,11,18,1,1,3,3,1,3,20,3,16,3,1,1,1,1,85,11,20,5246251,5798,6467,4681,North_African__Middle_Eastern,115,1,0,11692.0,Unknown,84151691,6400000.0,1.0,92,1711,92,3,1,6,155,1,0.6059804181000265,0.4952941176470588,0.4852941176470588,0.0112813065187856,0.006578947368421,0.0,0.013253313328332,0.0247561890472618,0.0355287646879079,0.0,0.581395348837209,0.2083333333333332,227,9,15,28,0,3260,7,16,29,4000000,216666.66666666666,5000000.0,1200000.0,1100000.0,3500000.0,1,3900000,0.48148148148148145,0.3333333333333333
508639,Naci,ÃÅNãÂ¼Var,2024,714,Netherlands,Zaandam,TÃ¼rkiye,13-06-03,Left Winger,Attack,Right,168.0,30-06-25,Unknown,https://img.a.transfermarkt.technology/portrait/header/508639-1694855282.jpg?lm=1,ES1,Reial Club Deportiu Espanyol de Barcelona S.A.D.,2500000.0,6000000.0,21,119,-85,10,8,15,11,15,13,4,11,5,10,13,12,6,17,12,12,10,11,9,13,12,15,16,6,11,7,10,10,12,14,12,6,13,12,10,8,11,8,13,8,8,3,2,1,1,4,3,3,2,2,2,2,10,14,6,13,12,13,9,12,1,1,1,1,1,1,1,14,14,1,20,20,1,17,60,12,20,55400001,6300,5850,4300,North_African__Middle_Eastern,112,0,0,4999.0,Trabzonspor A.Åž.,37079279,9111392.0,2.0,67,1692,100,0,1,6,170,7,0.5243450648319662,0.4545454545454545,0.463235294117647,0.0048184301573859,0.0,0.0,0.0122530632658164,0.0297574393598399,0.0505924720131114,0.1428571428571428,0.1162790697674416,0.125,177,53,36,18,0,6125,7,22,76,2000000,-133333.33333333334,6000000.0,1500000.0,3500000.0,2500000.0,4,1300000,-0.2,-0.2
509022,Federico,Gatti,2024,506,Italy,Rivoli,Italy,24-06-98,Centre-Back,Defender,Right,190.0,30-06-28,One Players' Agent,https://img.a.transfermarkt.technology/portrait/header/509022-1725531068.jpg?lm=1,IT1,Juventus Football Club,18000000.0,18000000.0,26,130,149,7,7,8,10,10,7,15,7,8,13,11,7,14,10,14,15,15,14,12,10,12,15,7,12,7,13,16,16,12,11,12,15,14,13,14,15,14,7,14,10,12,2,3,2,1,1,1,2,2,3,1,3,12,15,5,13,12,16,14,15,1,1,20,1,1,1,12,1,10,1,1,1,1,1,84,9,20,2305249,6500,7000,5250,Mediterranean_Hispanic,130,1,0,35577.0,Unknown,43491384,4575000.0,2.0,52,1240,54,1,1,3,116,2,0.6765017200317545,0.5561497326203209,0.5955882352941175,0.0343450749174155,0.006578947368421,0.0,0.0897724431107777,0.0897724431107777,0.0253895941553932,0.1428571428571428,0.6279069767441858,0.3333333333333332,190,16,4,42,0,2179,2,4,13,25000000,1783928.5714285714,25000000.0,0.0,,,3,1375000,0.3888888888888889,0.3888888888888889
510310,Sivert,Mannsverk,2024,610,Norway,Ã˜vre Ã…rdal,Norway,08-05-02,Defensive Midfield,Midfield,Right,185.0,30-06-28,Unknown,https://img.a.transfermarkt.technology/portrait/header/510310-1668692766.jpg?lm=1,NL1,AFC Ajax Amsterdam,6000000.0,6500000.0,22,125,-85,12,12,10,8,13,10,11,11,8,13,13,12,13,12,14,14,14,12,14,13,13,14,10,13,11,13,12,14,11,11,13,12,13,13,15,12,14,16,13,6,11,3,1,3,3,2,1,4,2,2,1,3,14,17,8,13,14,15,15,14,1,1,10,1,1,1,14,1,20,1,1,12,1,1,77,10,20,4718821,6309,6309,4052,Northern_European,125,0,0,3531.0,Unknown,53159880,3875000.0,2.0,71,1716,73,3,1,7,6,4,0.5850754167769251,0.4280213903743315,0.5588235294117647,0.0034009040108844,0.0,0.0,0.0297574393598399,0.032258064516129,0.0215005972388121,0.1428571428571428,0.5116279069767438,0.1666666666666666,173,15,10,42,0,5650,2,48,131,5000000,490000.0,6500000.0,1000000.0,500000.0,4500000.0,2,1800000,-0.16666666666666666,-0.23076923076923078
510396,Alex,Suárez,2024,472,Spain,Las Palmas de Gran Canaria,Spain,18-03-93,Centre-Back,Defender,Right,180.0,30-06-26,Wasserman,https://img.a.transfermarkt.technology/portrait/header/510396-1702391032.jpg?lm=1,ES1,UniÃ³n Deportiva Las Palmas S.A.D.,1200000.0,1200000.0,31,102,-75,10,15,13,10,15,9,5,10,9,5,14,2,10,13,11,10,6,10,10,15,12,9,10,5,8,9,10,10,13,13,10,8,10,12,7,7,18,11,13,15,13,1,2,1,3,3,2,1,2,2,1,4,8,10,6,11,12,13,12,16,1,1,1,1,1,1,1,1,1,15,1,1,20,1,0,6,20,4001993,5000,5000,1750,Mediterranean_Hispanic,97,0,0,29.0,Unknown,2000175688,9111392.0,2.0,89,803,89,1,1,3,207,2,0.4118814501190792,0.1818181818181818,0.3529411764705882,1.93123453201842e-05,0.0,0.0,0.0057514378594648,0.0057514378594648,0.0505924720131114,0.1428571428571428,0.3953488372093026,0.5416666666666665,221,10,2,56,1,1684,0,0,0,1000000,47500.0,1200000.0,300000.0,,,1,50000,-0.16666666666666666,-0.16666666666666666
510782,Unknown,Rodrigão,2024,964,Brazil,BrasÃ­lia,Brazil,11-09-95,Centre-Back,Defender,Left,191.0,30-06-25,Unknown,https://img.a.transfermarkt.technology/portrait/header/510782-1721722762.png?lm=1,RU1,AO FK Zenit Sankt-Peterburg,4500000.0,7000000.0,29,139,165,11,12,14,11,15,12,8,12,3,5,13,13,7,15,13,13,14,13,8,13,12,13,14,11,15,4,13,12,16,16,14,12,14,15,14,11,8,10,14,7,13,2,3,3,3,1,2,1,2,1,2,1,12,14,6,11,8,15,13,8,1,1,1,1,1,1,1,1,14,1,15,17,15,20,77,20,8,347975206,6946,7046,6496,Mixed_Race,129,27,8,115992.0,Unknown,67086280,3500000.0,1.0,10,244,11,1,0,4,7,2,0.6825879862397459,0.6894117647058823,0.588235294117647,0.1119951873635462,0.1776315789473684,0.1052631578947368,0.0222555638909727,0.0347586896724181,0.0194172060335009,0.0,0.6511627906976742,0.4583333333333332,165,9,5,26,3,4009,6,52,128,3500000,200000.0,7000000.0,2000000.0,,,2,1300000,-0.3,-0.5
511021,Manu,Fuster,2024,472,Spain,Valencia,Spain,22-10-97,Left Winger,Attack,Right,169.0,30-06-28,Identity Sports,https://img.a.transfermarkt.technology/portrait/header/511021-1683202707.jpg?lm=1,ES1,UniÃ³n Deportiva Las Palmas S.A.D.,2400000.0,2400000.0,27,121,134,12,11,14,13,13,9,9,12,11,9,13,12,8,14,7,10,6,10,11,14,13,15,12,12,13,12,11,12,13,14,13,10,12,13,13,11,11,5,11,7,13,3,3,2,3,2,2,2,2,4,1,2,6,13,4,17,9,16,10,18,1,1,1,1,1,1,1,1,10,1,15,20,1,16,62,10,20,1632598,6050,6050,4050,Mediterranean_Hispanic,124,0,0,4340.0,Unknown,67272544,840000.0,2.0,89,1556,89,0,1,3,207,7,0.5508070918232336,0.427807486631016,0.5514705882352942,0.0041820883790858,0.0,0.0,0.0117529382345586,0.0117529382345586,0.004639017750493,0.1428571428571428,0.13953488372093,0.375,280,46,31,30,2,1645,1,4,31,1500000,71052.63157894737,2400000.0,900000.0,,250000.0,2,950000,-0.375,-0.25
512385,Luis,Sinisterra,2024,989,Colombia,Santander de Quilichao,Colombia,17-06-99,Left Winger,Attack,Right,172.0,Unknown,Wasserman,https://img.a.transfermarkt.technology/portrait/header/512385-1674557520.jpg?lm=1,GB1,Association Football Club Bournemouth,17000000.0,25000000.0,25,141,152,11,13,16,13,14,13,11,13,2,5,11,6,4,14,10,13,11,12,10,10,12,13,17,5,13,5,12,13,16,16,14,10,17,16,12,9,13,5,15,6,13,3,3,3,4,1,2,2,3,3,1,2,15,11,9,14,12,11,10,10,1,1,1,1,1,1,1,19,1,18,20,1,19,13,66,11,20,36235818,7050,7050,5750,African_Caribbean,135,7,3,81194.0,Unknown,76047347,9111392.0,2.0,20,1332,20,0,1,1,22,7,0.6831172267795713,0.6096256684491979,0.6323529411764706,0.0783936377409577,0.0460526315789473,0.0394736842105263,0.0847711927981995,0.1247811952988247,0.0505924720131114,0.1428571428571428,0.2093023255813952,0.2916666666666665,230,59,39,18,0,6733,9,73,298,17000000,768181.8181818182,25000000.0,3000000.0,100000.0,10000000.0,3,5900000,0.0,0.0
512913,Stephen,Eustaquio,2024,720,Canada,"Leamington, Ontario",Canada,21-12-96,Central Midfield,Midfield,Right,177.0,30-06-27,Nomi Sports,https://img.a.transfermarkt.technology/portrait/header/512913-1720430046.jpg?lm=1,PO1,Futebol Clube do Porto,11000000.0,15000000.0,28,143,151,11,11,13,10,14,8,11,10,11,8,15,10,12,14,11,16,12,16,14,16,14,13,12,11,12,13,15,14,13,15,15,9,16,13,16,8,15,9,12,6,5,2,1,1,2,3,2,2,2,1,3,2,5,11,11,10,16,16,14,16,1,1,1,1,1,1,20,1,20,5,1,5,1,1,71,12,20,22007699,7150,6900,6000,Mediterranean_Hispanic,140,24,3,18249.0,Unknown,55079798,2677500.0,4.0,16,807,16,3,1,3,100,1,0.6632707065361206,0.6363636363636364,0.6691176470588234,0.0176128589320079,0.1578947368421052,0.0394736842105263,0.0547636909227306,0.0747686921730432,0.0148476346565182,0.4285714285714285,0.3255813953488373,0.4166666666666665,268,19,16,51,2,5911,6,49,219,11000000,514285.71428571426,15000000.0,3000000.0,,200000.0,6,2800000,0.0,-0.26666666666666666
513245,Jesper,Lindstrøm,2024,29,Denmark,Taastrup,Denmark,29-02-00,Attacking Midfield,Midfield,Right,182.0,30-06-25,NSG ApS,https://img.a.transfermarkt.technology/portrait/header/513245-1663065433.jpg?lm=1,GB1,Everton Football Club,22000000.0,28000000.0,24,135,151,12,11,14,12,13,12,7,13,7,8,13,12,10,13,9,13,12,12,11,13,13,13,13,8,14,9,12,15,15,14,11,8,15,15,13,8,12,7,12,5,12,3,1,3,1,2,3,3,2,1,4,3,12,14,5,14,15,14,12,12,1,1,1,1,1,1,8,12,14,12,17,20,16,14,66,11,20,10962000,6750,6500,4500,Northern_European,131,5,1,21999.0,Unknown,27143432,18500000.0,2.0,28,1462,30,3,1,7,65,0,0.6103466525535857,0.4759358288770053,0.6029411764705883,0.0212339236795425,0.0328947368421052,0.0131578947368421,0.1097774443610902,0.1397849462365591,0.1027528542459512,0.1428571428571428,0.4418604651162785,0.25,258,55,37,21,1,6244,10,21,48,20000000,1330000.0,28000000.0,3000000.0,50000.0,6000000.0,4,8650000,-0.09090909090909091,-0.2
513330,Romano,Postema,2024,202,Netherlands,Groningen,Netherlands,07-02-02,Centre-Forward,Attack,Right,175.0,30-06-27,SEG,https://img.a.transfermarkt.technology/portrait/header/513330-1723455910.jpg?lm=1,NL1,Football Club Groningen,750000.0,750000.0,22,108,-75,10,10,16,11,10,10,10,8,6,5,9,8,5,10,9,11,12,12,11,11,12,11,11,5,13,5,7,12,14,11,8,11,12,14,11,8,11,12,9,6,12,2,1,2,3,3,2,1,1,1,3,4,8,13,2,10,11,13,8,20,1,1,1,1,1,1,1,1,1,1,1,1,1,20,67,15,20,14640000,5350,5350,3750,Northern_European,105,0,0,2000.0,Roda JC Kerkrade,37076259,9111392.0,2.0,67,565,68,0,1,7,88,3,0.4581899973537973,0.3957219251336898,0.411764705882353,0.0019225439766243,0.0,0.0,0.0035008752188047,0.0035008752188047,0.0505924720131114,0.1428571428571428,0.2790697674418605,0.1666666666666666,0,0,0,0,0,0,4,10,51,650000,57500.0,750000.0,100000.0,325000.0,450000.0,2,125000,-0.13333333333333333,0.4444444444444444
513970,Julián,Araujo,2024,989,United States,"Lompoc, California",Mexico,13-08-01,Right-Back,Defender,Right,176.0,30-06-29,CAA Stellar,https://img.a.transfermarkt.technology/portrait/header/513970-1646079609.JPG?lm=1,GB1,Association Football Club Bournemouth,8000000.0,8000000.0,23,115,137,4,12,12,6,12,5,10,6,9,12,12,11,13,12,12,10,15,11,11,10,10,11,6,3,11,12,14,14,14,13,14,9,11,14,15,9,11,5,3,7,14,1,4,1,2,3,3,1,1,1,2,2,19,12,7,8,13,11,10,12,1,10,1,20,10,18,1,8,1,15,5,1,10,1,70,8,20,5217786,5756,5456,3225,Mediterranean_Hispanic,111,3,0,13160.0,Unknown,72053642,4000000.0,1.0,104,857,64,1,1,3,22,11,0.4722148716591691,0.3395721925133689,0.4558823529411764,0.0126988326652871,0.0197368421052631,0.0,0.0397599399849962,0.0397599399849962,0.0221950609739159,0.0,0.3023255813953489,0.2083333333333332,148,4,14,31,2,2311,3,29,120,10000000,585294.1176470588,10000000.0,2000000.0,400000.0,4500000.0,3,4500000,0.25,0.6666666666666666
515051,Aleksandr,Silyanov,2024,932,Russia,Moskau,Russia,17-02-01,Right-Back,Defender,Right,185.0,30-06-26,Field Management,https://img.a.transfermarkt.technology/portrait/header/515051-1721715296.png?lm=1,RU1,"?????????? ???? ""?????????"" ??????",6000000.0,6000000.0,23,116,-75,10,10,13,8,10,8,14,9,10,12,12,7,14,12,12,12,12,11,13,11,12,13,12,8,9,12,14,15,12,10,13,12,11,14,14,13,13,11,10,9,8,1,1,3,2,2,2,3,3,2,1,3,8,12,4,10,10,10,14,10,1,17,10,20,11,13,1,1,1,1,1,1,1,1,85,7,20,23449970,5550,5550,3132,Northern_European,115,0,0,19303.0,FC Rostov,58151771,9111392.0,2.0,78,985,81,1,1,7,3,11,0.4846520243450648,0.3296256684491978,0.4852941176470588,0.0186306195303816,0.0,0.0,0.0297574393598399,0.0297574393598399,0.0505924720131114,0.1428571428571428,0.5116279069767438,0.2083333333333332,161,11,8,19,0,4917,4,10,37,6000000,311842.1052631579,6000000.0,500000.0,150000.0,900000.0,5,1775000,0.3333333333333333,0.3333333333333333
515208,Unknown,Pedrinho,2024,660,Brazil,MaceiÃ³,Brazil,13-04-98,Right Winger,Attack,Right,172.0,30-06-26,Bertolucci Sports,https://img.a.transfermarkt.technology/portrait/header/515208-1723486899.png?lm=1,UKR1,FC Shakhtar Donetsk,5000000.0,17000000.0,26,136,138,13,13,11,10,12,14,7,13,8,10,14,13,13,13,15,12,16,13,14,15,13,15,10,14,12,12,16,16,12,14,16,6,16,12,15,11,17,7,13,7,17,2,1,3,2,3,3,1,1,2,1,3,9,14,11,14,15,16,12,12,1,1,1,1,1,1,13,1,20,10,1,19,12,1,68,11,20,7295838,6800,6800,5500,Mediterranean_Hispanic,136,0,0,34999.0,Unknown,55045472,18000000.0,2.0,10,891,11,0,1,3,72,10,0.6500396930404869,0.5828877005347594,0.6397058823529411,0.0337869481376622,0.0,0.0,0.0247561890472618,0.0847711927981995,0.0999749993055362,0.1428571428571428,0.2093023255813952,0.3333333333333332,262,18,30,18,0,8426,6,33,125,5000000,175000.0,17000000.0,5000000.0,,15000000.0,4,5500000,0.0,-0.2857142857142857
515613,Marko,Divkovic,2024,206,Croatia,Vinkovci,Croatia,11-06-99,Left-Back,Defender,Left,181.0,30-06-26,Unknown,https://img.a.transfermarkt.technology/portrait/header/515613-1581667422.png?lm=1,DK1,BrÃ¸ndby IdrÃ¦tsforening,2000000.0,2000000.0,25,111,135,8,11,13,13,13,10,9,10,6,5,12,8,6,11,8,12,10,11,9,13,10,12,8,10,14,5,12,10,14,11,11,10,10,13,9,8,7,5,17,6,10,4,2,3,1,1,3,2,3,1,1,2,7,12,1,13,10,10,6,12,1,1,1,1,1,1,1,1,1,11,14,1,17,20,72,20,14,1951327,5600,5750,2500,Northern_European,105,0,0,2918.0,Unknown,63033476,1000000.0,1.0,24,1613,25,1,0,7,45,8,0.5111140513363324,0.2620320855614972,0.411764705882353,0.0028089806268207,0.0,0.0,0.0097524381095273,0.0097524381095273,0.0055279313314258,0.0,0.418604651162791,0.2916666666666665,244,43,38,16,0,10835,6,13,39,1800000,103125.0,2000000.0,200000.0,150000.0,325000.0,1,150000,-0.1,0.2
515744,Eduard,Spertsyan,2024,16704,Russia,Stavropol,Armenia,07-06-00,Attacking Midfield,Midfield,Right,178.0,30-06-26,Rafaela Pimenta,https://img.a.transfermarkt.technology/portrait/header/515744-1721724398.png?lm=1,RU1,FK Krasnodar,20000000.0,20000000.0,24,125,142,14,13,12,13,13,13,4,13,10,10,13,12,10,13,12,13,10,12,12,14,13,9,12,13,14,9,12,9,13,14,11,8,11,12,13,6,15,10,15,3,10,1,2,2,1,2,3,3,2,3,3,1,11,10,7,9,11,12,7,11,1,1,1,1,1,1,9,1,19,1,11,20,1,1,66,13,20,7894379,6250,6000,4750,North_African__Middle_Eastern,125,12,2,35169.0,Unknown,58147629,9111392.0,2.0,78,1421,5,3,1,6,78,0,0.5441915850754168,0.5026737967914437,0.5588235294117647,0.0339511030728838,0.0789473684210526,0.0263157894736842,0.0997749437359339,0.0997749437359339,0.0505924720131114,0.1428571428571428,0.3488372093023257,0.25,241,63,47,51,1,5312,2,4,25,20000000,997500.0,20000000.0,0.0,125000.0,800000.0,3,300000,0.0,0.1111111111111111
516716,Unknown,Bremer,2024,506,Brazil,Itapitanga,Brazil,18-03-97,Centre-Back,Defender,Right,188.0,30-06-29,CAA Base Ltd,https://img.a.transfermarkt.technology/portrait/header/516716-1725531520.jpg?lm=1,IT1,Juventus Football Club,60000000.0,60000000.0,27,151,162,4,6,10,10,11,4,15,7,5,17,12,5,17,12,14,17,13,13,14,12,13,16,7,9,7,13,12,14,13,12,13,16,16,14,14,18,16,12,13,8,9,1,1,2,1,2,1,3,2,1,1,3,14,16,7,13,14,16,12,13,1,1,20,1,1,1,1,1,1,1,1,1,1,1,80,9,20,54215145,7550,7550,5750,African_Caribbean,147,0,0,178076.0,Unknown,19270493,17595333.33,3.0,10,673,11,1,1,1,116,2,0.7492722942577401,0.6096256684491979,0.7205882352941175,0.171944569706462,0.0,0.0,0.2998249562390597,0.2998249562390597,0.0977267886885746,0.2857142857142857,0.581395348837209,0.375,234,22,6,41,0,5082,10,54,205,60000000,2468750.0,60000000.0,1000000.0,,800000.0,2,6000000,0.0,0.2
516749,Vladislav,Shitov,2024,2696,Russia,Yaroslavl,Russia,07-05-03,Centre-Forward,Attack,Left,177.0,30-06-26,Pavel Andreev,https://img.a.transfermarkt.technology/portrait/header/516749-1722144724.png?lm=1,RU1,PFK Krylya Sovetov Samara,1200000.0,1200000.0,21,100,-8,9,7,12,12,12,10,9,9,8,3,9,9,3,12,9,10,9,10,10,9,10,16,16,11,12,3,9,11,14,14,10,11,8,12,11,8,13,8,10,5,13,1,1,4,3,3,3,3,2,3,2,1,9,11,7,12,11,12,11,15,1,1,1,1,1,1,1,1,1,7,12,10,9,20,70,20,13,18120431,4750,4750,2400,Northern_European,97,0,0,7285.0,Krylja Sovetov Samara,2000050392,500000.0,1.0,78,1683,81,0,0,7,149,3,0.3788039163799948,0.2513368983957219,0.3529411764705882,0.007025831227483,0.0,0.0,0.0057514378594648,0.0057514378594648,0.0027500763910108,0.0,0.3255813953488373,0.125,150,32,15,7,0,3250,1,4,24,900000,66666.66666666667,1200000.0,300000.0,450000.0,900000.0,1,100000,-0.25,0.0
516751,Sergey,Pinyaev,2024,932,Russia,Saratov,Russia,02-11-04,Left Winger,Attack,Right,167.0,30-06-28,Pavel Andreev,https://img.a.transfermarkt.technology/portrait/header/516751-1721715910.png?lm=1,RU1,"?????????? ???? ""?????????"" ??????",8000000.0,8000000.0,20,105,-85,12,12,14,9,13,11,6,11,6,5,10,7,6,13,12,8,9,10,10,11,11,4,15,10,13,7,6,5,14,15,13,4,9,12,9,4,14,6,15,7,11,2,2,1,2,2,4,4,3,2,3,2,16,9,8,10,10,12,10,16,1,1,1,1,1,1,1,15,1,1,20,13,15,15,63,11,20,7101609,5000,5000,3250,Northern_European,96,0,0,8805.0,Unknown,58156290,1550000.0,2.0,78,1344,81,0,1,7,3,7,0.4118814501190792,0.3422459893048128,0.3455882352941176,0.008493569471817,0.0,0.0,0.0397599399849962,0.0397599399849962,0.0085835717658823,0.1428571428571428,0.0930232558139532,0.0833333333333332,159,23,23,15,0,4340,3,20,44,8000000,681818.1818181818,8000000.0,0.0,8000000.0,8000000.0,2,4200000,0.0,0.0
517753,ÃÂScar,Valentín,2024,367,Spain,AjofrÃ­n,Spain,20-08-94,Central Midfield,Midfield,Right,177.0,30-06-27,Unknown,https://img.a.transfermarkt.technology/portrait/header/517753-1641140471.jpg?lm=1,ES1,Rayo Vallecano de Madrid S.A.D.,4000000.0,5000000.0,30,132,135,8,8,12,11,13,10,9,10,6,13,13,10,13,12,13,14,16,13,14,11,13,14,9,14,11,13,17,16,13,12,12,8,11,12,15,11,15,8,7,8,14,3,3,2,3,1,1,1,2,3,1,2,15,13,7,15,11,16,14,14,1,1,10,6,1,1,20,1,19,1,1,1,1,1,72,12,20,4062390,6600,6600,4600,Mediterranean_Hispanic,130,0,0,11664.0,Unknown,67213714,9111392.0,2.0,89,30,89,3,1,3,163,1,0.6235776660492194,0.4866310160427807,0.5955882352941175,0.0112542692353373,0.0,0.0,0.0197549387346836,0.0247561890472618,0.0505924720131114,0.1428571428571428,0.3255813953488373,0.5,290,5,4,68,0,2437,0,0,0,3500000,191666.66666666666,5000000.0,1000000.0,,,1,0,-0.125,-0.3
517842,Aihen,Muñoz,2024,681,Spain,Etxauri,Spain,16-08-97,Left-Back,Defender,Left,175.0,30-06-27,YOU FIRST,https://img.a.transfermarkt.technology/portrait/header/517842-1699007158.jpg?lm=1,ES1,Real Sociedad de FÃºtbol S.A.D.,8000000.0,8000000.0,27,130,147,8,12,13,9,12,10,10,12,12,14,12,9,15,13,15,13,13,13,14,8,13,13,7,11,8,15,14,16,14,13,14,8,13,13,14,12,13,6,13,9,11,4,2,1,2,3,1,1,1,2,1,3,15,12,6,18,13,14,13,11,1,20,1,1,15,1,1,1,1,1,1,1,1,1,72,20,8,3446145,6495,6495,3395,Mediterranean_Hispanic,131,0,0,11339.0,Unknown,67246383,9111392.0,2.0,89,478,89,1,0,3,168,8,0.6096851018788039,0.3577540106951871,0.6029411764705883,0.0109404436238843,0.0,0.0,0.0397599399849962,0.0397599399849962,0.0505924720131114,0.1428571428571428,0.2790697674418605,0.375,200,1,5,29,0,5455,3,35,209,6000000,350000.0,8000000.0,2500000.0,,150000.0,1,2500000,-0.25,-0.25
517894,Matheus,Cunha,2024,543,Brazil,JoÃ£o Pessoa,Brazil,27-05-99,Centre-Forward,Attack,Right,183.0,30-06-27,Bertolucci Sports,https://img.a.transfermarkt.technology/portrait/header/517894-1696599737.jpg?lm=1,GB1,Wolverhampton Wanderers Football Club,45000000.0,45000000.0,25,143,162,12,12,17,15,15,13,11,16,5,4,14,13,6,17,16,11,15,12,6,11,8,16,17,10,12,5,7,12,15,15,14,12,12,15,13,12,10,14,14,6,14,2,3,3,3,1,3,2,2,2,1,2,14,17,13,7,12,9,5,6,1,1,1,1,1,1,1,10,1,12,17,20,15,17,76,14,20,26534113,7100,1887,7865,Mixed_Race,134,7,0,76711.0,Unknown,19334410,29500000.0,4.0,10,692,11,0,1,4,222,3,0.0,0.8358288770053476,0.625,0.0740647755374384,0.0460526315789473,0.0,0.2248062015503876,0.2248062015503876,0.1638656629350815,0.4285714285714285,0.4651162790697669,0.2916666666666665,0,0,0,0,0,0,9,25,43,50000000,2169565.217391304,50000000.0,10000000.0,1500000.0,13500000.0,4,23000000,0.1111111111111111,0.5625
518472,Willyan,Rocha,2024,2410,Brazil,Rio de Janeiro,Brazil,27-01-95,Centre-Back,Defender,Right,191.0,30-06-27,Unknown,https://img.a.transfermarkt.technology/portrait/header/518472-1662068635.png?lm=1,RU1,PFK CSKA Moskva,6000000.0,7000000.0,29,128,130,5,6,7,4,10,4,16,5,8,16,11,7,17,8,18,16,16,10,14,9,9,15,5,13,12,13,14,14,12,12,14,15,15,12,15,14,11,17,14,4,6,1,4,3,4,1,3,1,1,1,4,1,12,17,15,8,7,14,10,7,1,1,20,1,1,1,19,1,1,1,1,1,1,1,87,6,20,6944852,6150,6000,4650,Mediterranean_Hispanic,128,0,0,33277.0,Unknown,19248746,2000000.0,1.0,10,1234,11,1,1,3,148,2,0.5441915850754168,0.4919786096256684,0.5808823529411764,0.0321241552055944,0.0,0.0,0.0297574393598399,0.0347586896724181,0.0110836412122558,0.0,0.6511627906976742,0.4583333333333332,224,16,15,79,5,3105,5,29,158,6000000,292500.0,7000000.0,1000000.0,,,2,700000,0.0,-0.14285714285714285
518505,Jamie,Leweling,2024,79,Germany,NÃ¼rnberg,Germany,26-02-01,Right Winger,Attack,Right,185.0,30-06-28,Unknown,https://img.a.transfermarkt.technology/portrait/header/518505-1691999306.jpg?lm=1,L1,Verein fÃ¼r Bewegungsspiele Stuttgart 1893,13000000.0,13000000.0,23,124,145,11,11,13,11,12,10,7,10,4,4,11,12,4,13,13,11,11,11,11,11,9,16,12,7,11,8,12,12,15,13,12,11,12,15,12,12,9,7,9,8,9,1,2,3,3,2,4,1,2,2,2,2,19,11,6,13,12,15,14,14,1,1,1,1,1,1,1,8,1,12,15,20,15,17,86,16,20,5400000,5900,5900,3700,African_Caribbean,117,0,0,19177.0,Unknown,92103754,4500000.0,2.0,38,1067,40,0,1,1,211,10,0.530960571579783,0.3903743315508021,0.4999999999999999,0.0185089517548645,0.0,0.0,0.0647661915478869,0.0647661915478869,0.0249729159143309,0.1428571428571428,0.5116279069767438,0.2083333333333332,177,18,18,15,0,2995,5,14,50,20000000,1097222.2222222222,20000000.0,1000000.0,400000.0,2000000.0,2,1500000,1.2222222222222223,3.4444444444444446
519748,Unknown,Zé Ricardo,2024,110302,Brazil,GoiÃ¢nia,Brazil,04-09-98,Left-Back,Defender,Right,175.0,30-06-25,Unknown,https://img.a.transfermarkt.technology/portrait/header/default.jpg?lm=1,PO1,Avs Futebol SAD,250000.0,600000.0,26,120,124,10,10,11,11,13,10,8,10,6,12,13,6,13,12,7,12,12,12,12,12,13,3,5,11,12,12,13,13,13,13,11,10,10,13,13,11,13,9,15,12,12,3,2,2,2,3,1,1,3,4,3,3,14,10,5,14,13,11,13,18,1,1,1,1,1,1,20,1,18,1,1,1,1,1,74,10,20,445673,5913,5913,2798,Mediterranean_Hispanic,119,0,0,5385.0,Unknown,19261273,9111392.0,2.0,10,547,11,1,1,3,35,8,0.5326806033342154,0.293903743315508,0.5147058823529411,0.0051911584220655,0.0,0.0,0.0010002500625156,0.0027506876719179,0.0505924720131114,0.1428571428571428,0.2790697674418605,0.3333333333333332,136,7,8,44,2,2500,0,0,0,200000,15384.615384615385,600000.0,200000.0,,0.0,3,450000,-0.2,-0.3333333333333333
520073,Ruslan,Litvinov,2024,232,Russia,Voronezh,Russia,18-08-01,Defensive Midfield,Midfield,Right,184.0,30-06-26,prosm,https://img.a.transfermarkt.technology/portrait/header/520073-1632578054.png?lm=1,RU1,FK Spartak Moskva,5000000.0,5000000.0,23,117,-8,8,7,10,8,11,10,13,10,2,11,12,12,11,12,16,13,16,14,16,9,12,13,7,12,8,10,14,17,12,12,12,12,8,13,16,10,15,10,9,5,12,2,2,3,3,3,1,3,1,2,2,2,9,13,8,10,13,14,11,14,1,1,17,1,1,1,20,1,13,1,1,1,1,1,73,10,20,18120431,5749,5749,3849,Northern_European,114,0,0,24311.0,Unknown,58152189,9111392.0,2.0,78,1630,81,3,1,7,82,4,0.5109817412013761,0.4063101604278074,0.4779411764705882,0.0234664307985558,0.0,0.0,0.0247561890472618,0.0247561890472618,0.0505924720131114,0.1428571428571428,0.4883720930232553,0.2083333333333332,178,10,9,37,2,5012,7,15,48,5000000,289705.8823529412,5000000.0,0.0,200000.0,1200000.0,3,900000,0.0,0.0
520454,Unknown,Nino,2024,964,Brazil,Recife,Brazil,10-04-97,Centre-Back,Defender,Right,188.0,30-06-28,Elenko Sports Ltda.,https://img.a.transfermarkt.technology/portrait/header/520454-1721722648.png?lm=1,RU1,AO FK Zenit Sankt-Peterburg,10000000.0,11000000.0,27,133,144,7,9,12,6,12,5,13,5,8,14,14,7,14,12,11,15,14,13,16,8,12,12,10,12,9,15,14,14,13,13,13,14,14,13,13,13,13,12,11,4,7,1,3,3,3,1,3,1,2,3,2,2,15,12,7,11,9,11,9,10,1,1,20,1,1,1,1,1,1,1,1,1,1,1,80,7,20,15990331,7078,7078,4160,Mediterranean_Hispanic,133,0,0,27014.0,Unknown,19261503,3000000.0,2.0,10,1208,11,1,1,3,7,2,0.6868219105583487,0.4395721925133689,0.6176470588235294,0.0260764942685787,0.0,0.0,0.0497624406101525,0.0547636909227306,0.0166393510930859,0.1428571428571428,0.581395348837209,0.375,363,16,5,64,4,9497,3,8,19,10000000,485000.0,11000000.0,1000000.0,,300000.0,2,1700000,0.0,-0.09090909090909091
520492,Unknown,Paulinho,2024,865,Brazil,SÃ£o Paulo,Brazil,03-01-95,Left-Back,Defender,Right,178.0,30-06-26,LINK SPORTS,https://img.a.transfermarkt.technology/portrait/header/520492-1601544772.jpg?lm=1,DK1,Fodbold Club Midtjylland,1000000.0,1500000.0,29,143,154,10,10,12,14,13,12,14,13,11,13,12,12,14,13,11,16,12,12,14,13,15,16,14,12,16,12,15,14,13,13,14,12,14,13,14,16,15,13,12,7,12,2,3,2,2,2,2,2,3,2,1,4,11,13,12,15,12,13,10,12,1,1,1,1,1,1,15,1,20,1,1,15,1,1,81,10,20,347975206,7600,7350,6000,Mixed_Race,143,56,13,33545.0,Unknown,19003703,700000.0,1.0,10,1456,11,1,1,4,86,8,0.7228102672664726,0.6363636363636364,0.6911764705882353,0.0323829406328848,0.3684210526315789,0.1710526315789473,0.0047511877969492,0.0072518129532383,0.0038612183671768,0.0,0.3488372093023257,0.4583333333333332,0,0,0,0,0,0,2,26,73,1000000,46666.666666666664,1500000.0,500000.0,,,2,300000,0.0,0.0
520624,Bruno,Guimarães,2024,762,Brazil,Rio de Janeiro,Brazil,16-11-97,Defensive Midfield,Midfield,Right,182.0,30-06-28,Bertolucci Sports,https://img.a.transfermarkt.technology/portrait/header/520624-1668522672.jpg?lm=1,GB1,Newcastle United Football Club,85000000.0,85000000.0,27,150,166,11,11,15,13,15,12,11,11,5,13,16,11,14,15,12,15,14,17,15,17,15,14,14,12,14,15,15,15,12,13,11,12,14,13,14,12,15,14,13,7,17,4,2,1,1,3,1,3,1,3,3,4,19,13,6,12,14,14,9,11,1,1,10,1,1,1,19,12,20,1,1,1,1,1,74,8,20,84814753,7499,7999,6249,Mediterranean_Hispanic,151,8,1,185587.0,Unknown,19297055,31050000.0,2.0,10,1234,11,3,1,3,137,4,0.8086795448531356,0.6629946524064171,0.75,0.1791973209914572,0.0526315789473684,0.0131578947368421,0.4248562140535133,0.4248562140535133,0.172477013250368,0.1428571428571428,0.4418604651162785,0.375,313,30,37,63,1,6265,3,8,23,80000000,4441666.666666667,85000000.0,7000000.0,,400000.0,2,25000000,-0.058823529411764705,-0.058823529411764705
520662,Unknown,Pepê,2024,720,Brazil,Foz do IguaÃ§u,Brazil,24-02-97,Left Winger,Attack,Right,175.0,30-06-27,ADRIANO SPORTS,https://img.a.transfermarkt.technology/portrait/header/520662-1669115201.png?lm=1,PO1,Futebol Clube do Porto,30000000.0,30000000.0,27,148,157,7,11,17,12,14,8,11,12,8,8,13,11,8,16,10,13,13,14,12,12,13,14,16,5,15,9,11,14,16,15,13,8,13,15,16,9,14,5,15,6,16,1,3,2,3,3,3,1,3,4,1,1,13,13,6,14,12,14,11,13,1,1,1,14,1,10,1,15,14,15,20,12,18,12,69,9,20,29601000,7400,7300,6000,Mediterranean_Hispanic,143,0,0,29750.0,Unknown,19340940,7762500.0,2.0,10,504,11,0,1,3,100,7,0.7161947605186557,0.6363636363636364,0.6911764705882353,0.0287184231083799,0.0,0.0,0.1497874468617154,0.1497874468617154,0.0430984194005389,0.1428571428571428,0.2790697674418605,0.375,323,56,50,27,1,8844,2,4,12,27000000,1631250.0,30000000.0,3000000.0,,,1,0,-0.1,0.08
521127,Ayoub,El Kaabi,2024,683,Morocco,Casablanca,Morocco,25-06-93,Centre-Forward,Attack,Left,182.0,30-06-26,Unknown,https://img.a.transfermarkt.technology/portrait/header/521127-1728418218.png?lm=1,GR1,Olympiakos Syndesmos Filathlon Peiraios,5000000.0,5000000.0,31,125,135,5,5,12,15,10,5,15,10,5,8,10,14,6,12,10,13,12,14,14,10,13,12,13,12,15,8,15,15,13,13,13,12,13,13,12,13,11,5,12,7,14,2,3,2,3,1,2,2,2,2,2,3,14,15,2,13,12,15,8,12,1,1,1,1,1,1,1,1,1,1,19,10,14,20,79,20,10,3179833,6250,6250,5200,North_African__Middle_Eastern,125,36,20,8000.0,Unknown,13197862,3940000.0,2.0,66,322,67,0,0,6,141,3,0.5772691188145012,0.5508021390374331,0.5588235294117647,0.0077162475726795,0.2368421052631578,0.2631578947368421,0.0247561890472618,0.0247561890472618,0.0218617183810661,0.1428571428571428,0.4418604651162785,0.5416666666666665,270,151,26,12,0,8167,1,2,6,5000000,242500.0,5000000.0,900001.0,,,5,1149999,0.0,0.42857142857142855
521407,Walid,Cheddira,2024,714,Italy,Loreto,Morocco,22-01-98,Centre-Forward,Attack,Right,187.0,30-06-25,BDN,https://img.a.transfermarkt.technology/portrait/header/521407-1686124424.jpg?lm=1,ES1,Reial Club Deportiu Espanyol de Barcelona S.A.D.,6000000.0,8000000.0,26,126,135,7,8,12,14,11,5,12,9,7,6,11,10,11,11,13,12,14,11,12,12,11,14,5,9,14,7,15,17,15,13,14,13,14,15,14,13,13,10,12,7,12,4,2,3,3,2,3,1,2,2,2,3,12,13,7,10,10,13,8,12,1,1,1,1,1,1,1,1,1,1,15,10,7,20,80,10,20,3003809,6300,6200,3753,North_African__Middle_Eastern,125,0,0,16268.0,Unknown,43391696,3591000.0,3.0,52,862,67,0,1,6,170,3,0.5706536120666843,0.396042780748663,0.5588235294117647,0.0156999711280437,0.0,0.0,0.0297574393598399,0.0397599399849962,0.0199227756326564,0.2857142857142857,0.5581395348837206,0.3333333333333332,267,67,20,18,0,2680,1,0,93,4000000,219444.44444444444,8000000.0,2000000.0,,100000.0,6,3550000,-0.3333333333333333,-0.3333333333333333
521964,Malick,Thiaw,2024,5,Germany,DÃ¼sseldorf,Germany,08-08-01,Centre-Back,Defender,Right,194.0,30-06-27,Unique Sports Group,https://img.a.transfermarkt.technology/portrait/header/521964-1682063635.jpg?lm=1,IT1,Associazione Calcio Milan,25000000.0,30000000.0,23,125,159,2,7,11,7,12,3,13,7,4,13,13,10,14,12,14,12,13,13,13,12,11,16,12,12,8,13,12,12,13,11,14,16,15,13,12,13,15,8,14,6,12,3,1,2,3,2,1,2,3,2,4,2,16,15,5,15,15,16,12,10,1,12,20,12,1,1,15,1,12,1,1,1,1,1,89,13,20,16030000,6250,6250,4500,Mixed_Race,124,0,0,19808.0,Unknown,91206164,8800000.0,1.0,38,443,40,1,1,4,27,2,0.5772691188145012,0.4759358288770053,0.5514705882352942,0.0191182562497163,0.0,0.0,0.1247811952988247,0.1497874468617154,0.0488624684019,0.0,0.7209302325581395,0.2083333333333332,220,15,6,33,2,3189,8,32,79,20000000,1206250.0,30000000.0,5000000.0,700000.0,6000000.0,1,0,-0.2,-0.3333333333333333
522030,Ilya,Samoshnikov,2024,932,Russia,"Reutov, Moskau Oblast",Russia,14-11-97,Left-Back,Defender,Right,177.0,31-05-27,Unknown,https://img.a.transfermarkt.technology/portrait/header/522030-1721715661.png?lm=1,RU1,"?????????? ???? ""?????????"" ??????",3500000.0,3500000.0,27,123,133,10,9,11,9,12,7,14,5,15,11,9,11,14,12,14,13,14,10,10,8,10,16,13,10,12,12,17,16,16,14,13,8,10,15,16,7,10,10,13,12,12,4,3,1,3,3,2,2,3,3,1,2,9,12,6,11,12,11,12,16,1,20,1,16,14,12,8,12,7,9,9,1,7,1,64,8,20,4086779,5979,5979,3485,Northern_European,121,3,0,19999.0,Unknown,58140281,50000.0,1.0,78,1220,81,1,1,7,3,8,0.5414130722413337,0.3673796791443849,0.5294117647058822,0.0193026891475241,0.0197368421052631,0.0,0.0172543135783946,0.0172543135783946,0.0002500069446373,0.0,0.3255813953488373,0.375,208,12,17,49,1,2235,4,8,83,4000000,169565.21739130435,4000000.0,500000.0,,250000.0,4,775000,0.6,1.0
522145,Daniil,Kuznetsov,2024,2698,Russia,St. Petersburg,Russia,23-04-03,Left Winger,Attack,Left,182.0,31-12-26,InFootball,https://img.a.transfermarkt.technology/portrait/header/522145-1722142658.png?lm=1,RU1,FC Rubin Kazan,500000.0,500000.0,21,90,-75,7,8,10,11,10,7,7,8,10,8,9,5,8,12,14,8,8,10,9,8,10,2,15,1,8,9,10,10,12,11,10,10,15,12,11,8,10,9,13,12,14,3,1,1,1,1,1,2,3,4,2,2,17,11,3,12,11,13,12,20,1,1,1,1,1,1,1,13,1,10,20,1,17,12,74,20,16,8220812,4250,4250,1600,Northern_European,84,0,0,2804.0,Unknown,2000082368,400000.0,1.0,78,1413,81,0,0,7,71,7,0.3126488489018258,0.1657754010695187,0.2573529411764706,0.0026989002584957,0.0,0.0,0.0022505626406601,0.0022505626406601,0.0021945054029278,0.0,0.4418604651162785,0.125,101,19,11,9,0,4129,1,28,281,400000,35000.0,500000.0,100000.0,250000.0,500000.0,4,250000,-0.2,-0.2
523977,Miguel,Baeza,2024,982,Spain,CÃ³rdoba,Spain,27-03-00,Attacking Midfield,Midfield,Left,177.0,30-06-25,MRH Football Agency,https://img.a.transfermarkt.technology/portrait/header/523977-1676547473.jpg?lm=1,PO1,Clube Desportivo Nacional,400000.0,2500000.0,24,123,149,12,12,13,14,14,15,11,14,7,9,14,11,6,14,14,10,9,13,11,14,10,12,16,12,14,9,10,7,13,12,11,13,10,13,12,7,12,9,7,7,16,2,2,2,2,1,2,4,2,3,3,2,9,9,1,10,13,10,9,18,1,1,1,1,1,1,1,12,20,13,17,20,15,13,76,20,14,9689999,6150,6150,4650,Mediterranean_Hispanic,116,0,0,5724.0,Rio Ave Futebol Clube,67258577,2500000.0,1.0,89,400,89,3,0,3,56,0,0.5640381053188674,0.4919786096256684,0.4926470588235294,0.0055185026752426,0.0,0.0,0.0017504376094023,0.0122530632658164,0.0138614961526709,0.0,0.3255813953488373,0.25,127,18,11,2,0,3761,2,48,214,400000,21428.571428571428,2500000.0,500000.0,,2500000.0,5,3100000,0.0,-0.2
524000,Dani,Vivian,2024,621,Spain,Vitoria-Gasteiz,Spain,05-07-99,Centre-Back,Defender,Right,184.0,30-06-32,AcciÃ³n Sport,https://img.a.transfermarkt.technology/portrait/header/524000-1709674998.png?lm=1,ES1,Athletic Club Bilbao,25000000.0,25000000.0,25,139,158,8,8,10,9,12,7,15,7,14,14,13,7,14,13,13,12,15,15,13,11,13,15,8,14,8,14,14,14,14,13,9,13,13,15,14,13,15,10,8,7,14,3,3,1,1,2,3,2,2,3,3,1,10,14,5,15,13,15,11,8,1,1,20,1,1,1,17,1,1,1,1,1,1,1,83,11,20,37151248,6950,6950,5450,Mediterranean_Hispanic,139,0,0,21264.0,Unknown,67256618,9111392.0,2.0,89,1617,89,1,1,3,33,2,0.6698862132839376,0.5775401069518716,0.6617647058823528,0.0205241949890257,0.0,0.0,0.1247811952988247,0.1247811952988247,0.0505924720131114,0.1428571428571428,0.4883720930232553,0.2916666666666665,214,12,5,43,2,3491,5,20,49,40000000,1664583.3333333333,40000000.0,1000000.0,50000.0,200000.0,2,6000000,0.6,1.0
524081,Nicolai,Vallys,2024,206,Unknown,Unknown,Denmark,04-09-96,Attacking Midfield,Midfield,Right,189.0,30-06-26,Beckster Int.,https://img.a.transfermarkt.technology/portrait/header/524081-1662016446.jpg?lm=1,DK1,BrÃ¸ndby IdrÃ¦tsforening,6000000.0,6000000.0,28,122,130,8,12,13,12,13,8,11,12,6,6,13,10,4,13,11,14,11,13,12,14,12,12,12,7,13,5,14,15,13,12,9,14,12,12,13,13,12,6,13,6,14,2,3,3,2,3,1,3,2,1,2,1,9,14,5,14,12,12,14,14,1,1,1,1,1,1,1,13,8,10,20,16,18,9,82,12,20,5965288,6300,6000,2000,Northern_European,121,0,0,13443.0,Unknown,27111118,3000000.0,1.0,105,1549,30,3,1,7,45,0,0.5441915850754168,0.2085561497326203,0.5294117647058822,0.0129721023515677,0.0,0.0,0.0297574393598399,0.0297574393598399,0.0166393510930859,0.0,0.6046511627906974,0.4166666666666665,233,67,42,25,0,7238,5,25,72,5000000,275000.0,6000000.0,1000000.0,,,3,700000,-0.16666666666666666,0.0
524285,Luca,Netz,2024,18,Germany,Berlin,Germany,15-05-03,Left-Back,Defender,Left,184.0,30-06-26,11WINS,https://img.a.transfermarkt.technology/portrait/header/524285-1662966052.jpg?lm=1,L1,Borussia Verein fÃ¼r LeibesÃ¼bungen 1900 MÃ¶nchengladbach,8000000.0,10000000.0,21,123,-85,15,13,12,9,12,12,7,9,8,11,12,7,11,13,8,12,12,11,10,12,10,15,13,7,13,11,12,12,15,12,12,9,14,15,14,12,13,3,12,8,14,2,1,1,3,2,2,1,1,2,1,4,8,15,6,14,14,15,15,17,1,20,10,1,18,1,1,15,1,1,11,1,1,1,83,20,10,60800000,6150,6150,5150,Northern_European,114,0,0,38355.0,Unknown,91195878,2000000.0,1.0,38,178,40,1,0,7,42,8,0.5640381053188674,0.5454545454545454,0.4779411764705882,0.0370275596823891,0.0,0.0,0.0397599399849962,0.0497624406101525,0.0110836412122558,0.0,0.4883720930232553,0.125,168,12,29,6,0,3624,9,33,98,8000000,636363.6363636364,10000000.0,2000000.0,5000000.0,10000000.0,1,0,-0.2,-0.2
524315,Hidemasa,Morita,2024,336,Japan,"Takatsuki, Osaka",Japan,10-05-95,Central Midfield,Midfield,Right,177.0,30-06-26,HEROE,https://img.a.transfermarkt.technology/portrait/header/524315-1666099446.jpg?lm=1,PO1,Sporting Clube de Portugal,15000000.0,15000000.0,29,144,145,10,10,12,11,16,8,8,11,8,11,14,10,14,14,16,15,14,16,15,15,14,16,8,13,12,13,15,14,12,13,16,8,14,13,14,12,17,6,14,4,16,1,2,2,1,1,2,3,3,2,2,3,18,16,6,13,16,17,16,14,1,1,5,10,1,1,20,1,20,1,1,1,1,1,74,12,20,23230347,7200,7250,5700,10,143,15,2,17649.0,Unknown,45109174,9111392.0,2.0,54,1467,56,3,1,0,193,1,0.7095792537708389,0.6042780748663101,0.6911764705882353,0.0170334885724024,0.0986842105263157,0.0263157894736842,0.0747686921730432,0.0747686921730432,0.0505924720131114,0.1428571428571428,0.3255813953488373,0.4583333333333332,277,16,19,31,0,5151,16,48,36,15000000,879411.7647058824,15000000.0,300000.0,,,2,3200000,0.0,0.25
524925,Modibo,Sagnan,2024,969,France,Saint-Denis,Mali,14-04-99,Centre-Back,Defender,Left,187.0,30-06-28,Unknown,https://img.a.transfermarkt.technology/portrait/header/524925-1548769689.jpg?lm=1,FR1,Montpellier HÃ©rault Sport Club,3000000.0,4500000.0,25,121,137,6,8,11,8,12,7,14,7,9,13,12,8,16,12,14,10,11,9,8,10,11,12,6,11,6,12,13,13,12,11,9,15,18,12,16,17,14,13,11,7,3,1,2,1,2,4,1,2,1,3,3,2,9,14,6,13,11,13,14,17,1,1,20,1,1,1,1,1,1,1,1,1,1,1,83,20,10,1969779,6050,4969,4405,African_Caribbean,118,0,0,4866.0,FC Utrecht,48036568,2900000.0,3.0,34,1271,61,1,0,1,133,2,0.4077798359354326,0.4657754010695186,0.5073529411764706,0.0046900030610067,0.0,0.0,0.0147536884221055,0.0222555638909727,0.0160837801050029,0.2857142857142857,0.5581395348837206,0.2916666666666665,187,11,1,38,0,4814,4,16,70,3000000,133333.33333333334,4500000.0,1500000.0,,2700000.0,6,3000000,0.0,0.2
525287,Unknown,Carlos Vinícius,2024,931,Brazil,Bom Jesus das Selvas,Brazil,25-03-95,Centre-Forward,Attack,Left,190.0,30-06-25,FK Assessoria,https://img.a.transfermarkt.technology/portrait/header/525287-1662070180.jpg?lm=1,GB1,Fulham Football Club,4000000.0,20000000.0,29,136,145,10,12,12,14,14,11,8,12,2,7,11,15,8,15,12,14,13,16,14,14,14,14,12,10,12,8,13,12,12,11,14,15,16,14,14,17,13,10,16,8,9,2,2,1,3,1,3,3,3,2,2,2,14,14,11,10,16,15,14,13,1,1,1,1,1,1,1,1,1,1,1,1,1,20,86,20,11,6438724,6000,5624,5624,Mixed_Race,135,0,0,63795.0,Unknown,19242476,8666666.667,3.0,10,221,11,0,0,4,95,3,0.4944429743318338,0.5961497326203208,0.6323529411764706,0.0615928629296634,0.0,0.0,0.0197549387346836,0.0997749437359339,0.0481217070863079,0.2857142857142857,0.6279069767441858,0.4583333333333332,249,87,36,37,0,4206,7,20,93,4000000,154166.66666666666,20000000.0,4000000.0,,,8,18300000,0.0,-0.3333333333333333
525299,Miguel,Gutiérrez,2024,12321,Spain,Pinto,Spain,27-07-01,Left-Back,Defender,Left,180.0,30-06-27,Wasserman,https://img.a.transfermarkt.technology/portrait/header/525299-1702292659.jpg?lm=1,ES1,Girona FÃºtbol Club S. A. D.,25000000.0,25000000.0,23,122,155,11,14,15,9,13,9,9,6,13,12,13,4,12,14,11,12,10,10,11,13,13,16,12,15,13,11,11,11,15,12,13,12,12,14,11,9,9,12,10,13,12,2,3,3,3,3,2,3,1,4,1,1,19,10,7,9,10,12,11,20,1,20,1,1,16,1,1,1,1,1,1,1,1,1,73,20,10,10344000,6200,6200,3250,Mediterranean_Hispanic,117,0,0,6023.0,Unknown,67276071,4000000.0,1.0,89,1148,89,1,0,3,107,8,0.5706536120666843,0.3422459893048128,0.4999999999999999,0.0058072222377793,0.0,0.0,0.1247811952988247,0.1247811952988247,0.0221950609739159,0.0,0.3953488372093026,0.2083333333333332,161,14,29,21,0,4011,1,12,55,25000000,1458823.5294117648,25000000.0,4000000.0,,6000000.0,1,2000000,0.0,0.25
525578,Pathé,Ciss,2024,367,Senegal,Dakar,Senegal,16-03-94,Central Midfield,Midfield,Right,186.0,30-06-25,NTS Management,https://img.a.transfermarkt.technology/portrait/header/525578-1541089527.jpg?lm=1,ES1,Rayo Vallecano de Madrid S.A.D.,2500000.0,4000000.0,30,131,138,7,7,9,7,12,7,13,9,11,13,13,8,15,11,12,15,12,12,13,11,13,10,6,11,7,15,14,14,14,11,13,14,15,14,16,16,12,7,12,3,7,1,1,2,2,2,2,3,3,3,1,2,13,12,6,12,12,14,12,13,1,1,12,1,1,1,18,1,20,1,1,1,1,1,71,8,20,4301354,6548,6548,4548,African_Caribbean,123,0,0,10690.0,Unknown,13181623,1000000.0,1.0,83,402,84,3,1,1,163,1,0.6166975390314898,0.4810695187165775,0.5441176470588236,0.0103137580182443,0.0,0.0,0.0122530632658164,0.0197549387346836,0.0055279313314258,0.0,0.5348837209302322,0.5,238,19,9,62,2,797,1,2,17,2000000,92857.14285714286,4000000.0,1000000.0,,,3,525000,-0.2,-0.3333333333333333
525704,Nicolò,Rovella,2024,398,Italy,Segrate,Italy,04-12-01,Defensive Midfield,Midfield,Right,179.0,30-06-25,GR Sports,https://img.a.transfermarkt.technology/portrait/header/525704-1663659000.jpg?lm=1,IT1,SocietÃ  Sportiva Lazio S.p.A.,18000000.0,18000000.0,23,127,-85,14,13,12,8,13,12,8,11,8,11,14,11,15,12,13,12,13,11,13,13,13,15,13,10,13,13,14,13,12,13,13,8,15,13,14,11,14,11,13,6,13,3,2,1,3,2,2,1,2,1,2,2,10,15,4,11,13,15,18,12,1,1,1,1,1,1,20,1,20,1,1,12,1,1,70,10,20,63800001,6350,6300,5100,Mediterranean_Hispanic,127,0,0,35576.0,Brianza,43372892,26000000.0,1.0,52,1355,54,3,1,3,185,4,0.5838846255623181,0.5401069518716577,0.5735294117647058,0.0343441093001495,0.0,0.0,0.0897724431107777,0.0897724431107777,0.1444206783521764,0.0,0.3720930232558141,0.2083333333333332,209,7,21,53,2,2214,11,45,53,25000000,2016666.6666666667,25000000.0,0.0,2500000.0,12000000.0,2,2000000,0.3888888888888889,0.3888888888888889
526845,Noah,Atubolu,2024,60,Germany,Freiburg im Breisgau,Germany,25-05-02,Goalkeeper,Goalkeeper,Right,190.0,Unknown,Unique Sports Group,https://img.a.transfermarkt.technology/portrait/header/526845-1658411548.jpg?lm=1,L1,Sport-Club Freiburg,10000000.0,10000000.0,22,105,-75,3,1,1,2,10,7,5,3,9,2,10,1,2,8,9,11,9,8,11,4,12,11,5,9,4,11,11,14,8,12,10,14,11,11,8,13,11,4,12,4,13,14,10,11,6,12,13,14,14,10,10,12,11,14,9,11,14,14,10,17,20,1,1,1,1,1,1,1,1,1,1,1,1,1,96,5,20,47250000,5250,5260,3257,Mixed_Race,102,0,0,1000.0,Unknown,91188349,9111392.0,2.0,38,511,40,2,1,4,189,5,0.4462820852077269,0.3429946524064171,0.3897058823529412,0.0009569267106151,0.0,0.0,0.0497624406101525,0.0497624406101525,0.0505924720131114,0.1428571428571428,0.6279069767441858,0.1666666666666666,0,0,0,0,0,0,5,8,25,10000000,767307.6923076923,10000000.0,0.0,250000.0,2000000.0,1,150000,0.0,0.5384615384615384
527279,Emilio,Kehrer,2024,403,Unknown,Unknown,Germany,20-03-02,Centre-Forward,Attack,Right,177.0,30-06-27,fair-sport GmbH,https://img.a.transfermarkt.technology/portrait/header/527279-1658505303.jpg?lm=1,NL1,Willem II,400000.0,450000.0,22,110,-75,10,11,13,9,12,10,8,10,3,7,10,15,6,13,7,9,11,10,9,11,10,15,13,11,12,7,10,13,14,14,12,7,13,14,11,8,11,4,13,8,12,3,2,1,2,2,3,2,3,2,2,1,9,13,11,9,12,13,9,14,1,1,1,1,1,1,1,13,12,13,17,18,17,20,67,5,20,8863999,5400,5400,3400,Northern_European,89,0,0,2500.0,Unknown,91208046,475000.0,2.0,105,1549,40,0,1,7,221,3,0.4648055041016142,0.3582887700534758,0.2941176470588235,0.0024053526096289,0.0,0.0,0.0017504376094023,0.0020005001250312,0.0026111836439901,0.1428571428571428,0.3255813953488373,0.1666666666666666,156,35,10,14,0,4265,7,25,53,500000,44444.444444444445,500000.0,75000.0,100000.0,400000.0,3,175000,0.25,0.6666666666666666
527425,Luke,Woolfenden,2024,677,England,Ipswich,England,21-10-98,Centre-Back,Defender,Right,193.0,30-06-25,Unknown,https://img.a.transfermarkt.technology/portrait/header/527425-1664180037.jpg?lm=1,GB1,Ipswich Town Football Club,2000000.0,2000000.0,26,109,140,5,7,12,5,12,5,14,4,12,12,12,5,13,10,7,14,11,13,13,12,10,12,10,9,7,12,10,11,13,9,13,13,12,14,13,13,12,13,13,6,17,3,2,3,3,3,1,2,3,2,3,3,10,8,7,10,13,10,9,15,1,7,20,16,1,10,1,1,1,1,1,1,1,1,80,7,20,2089022,5437,5437,2741,Northern_European,109,0,0,5800.0,Unknown,29156431,9111392.0,2.0,32,659,33,1,1,7,115,2,0.4697009790949986,0.287807486631016,0.4411764705882353,0.0055918895874593,0.0,0.0,0.0097524381095273,0.0097524381095273,0.0505924720131114,0.1428571428571428,0.6976744186046511,0.3333333333333332,264,8,4,42,0,3375,0,0,0,2000000,271428.5714285714,2000000.0,0.0,,100000.0,0,0,0.0,0.6666666666666666
528181,Edoardo,Corvi,2024,130,Italy,Parma,Italy,23-03-01,Goalkeeper,Goalkeeper,Right,187.0,30-06-25,Unknown,https://img.a.transfermarkt.technology/portrait/header/528181-1712347686.jpg?lm=1,IT1,Parma Calcio 1913,350000.0,350000.0,23,95,136,3,1,3,2,6,4,10,3,1,3,8,2,1,7,14,10,10,10,12,9,11,9,2,8,9,11,11,11,11,12,11,12,10,9,10,11,11,12,2,7,13,10,11,11,9,13,11,11,13,9,8,10,10,11,8,11,12,11,9,15,20,1,1,1,1,1,1,1,1,1,1,1,1,1,70,4,20,1602000,4750,4750,1000,Mediterranean_Hispanic,95,0,0,1406.0,Unknown,43379760,9111392.0,2.0,52,1125,54,2,1,3,155,5,0.3788039163799948,0.1016042780748663,0.338235294117647,0.0013489673206148,0.0,0.0,0.0015003750937734,0.0015003750937734,0.0505924720131114,0.1428571428571428,0.5581395348837206,0.2083333333333332,0,0,0,0,0,0,0,0,0,350000,33333.333333333336,350000.0,25000.0,,50000.0,2,225000,0.0,0.0
528451,Tobias,Bech,2024,678,Denmark,MÃ¸ldrup,Denmark,19-02-02,Centre-Forward,Attack,Left,189.0,30-06-28,Boutique Transfers,https://img.a.transfermarkt.technology/portrait/header/528451-1659722806.jpg?lm=1,DK1,Aarhus Gymnastik Forening,1500000.0,1500000.0,22,114,-75,9,11,13,12,12,10,9,14,8,7,12,11,6,13,9,13,11,11,11,12,12,11,12,3,11,6,14,13,13,12,12,13,10,12,9,12,12,4,8,12,9,2,1,2,2,2,1,1,3,1,3,1,3,12,2,15,6,12,15,12,1,1,1,1,1,1,1,11,1,17,14,9,20,1,0,20,14,5610001,5700,5700,3800,Northern_European,113,0,0,6529.0,Unknown,27145876,775000.0,2.0,28,1003,30,0,0,7,11,3,0.5044985445885155,0.4010695187165775,0.4705882352941176,0.00629582457438,0.0,0.0,0.0072518129532383,0.0072518129532383,0.0042778966082391,0.1428571428571428,0.6046511627906974,0.1666666666666666,210,58,21,26,0,5101,5,32,154,2500000,153125.0,2500000.0,0.0,300000.0,600000.0,2,650000,0.6666666666666666,1.0833333333333333
528833,Lazar,Samardži?,2024,800,Germany,Berlin,Serbia,24-02-02,Central Midfield,Midfield,Left,184.0,30-06-25,LIOS Sports,https://img.a.transfermarkt.technology/portrait/header/528833-1677073457.jpg?lm=1,IT1,Atalanta Bergamasca Calcio S.p.a.,20000000.0,20000000.0,22,128,164,12,12,15,11,15,10,6,14,5,6,15,11,6,15,10,13,7,14,12,14,13,13,14,8,13,8,12,10,13,14,15,12,11,12,12,12,13,12,11,12,13,2,2,3,3,2,3,2,2,3,1,1,13,15,13,7,11,13,1,13,1,1,1,1,1,1,1,12,18,10,14,20,12,1,79,20,11,18440001,6400,6000,4750,Northern_European,128,0,0,9249.0,Unknown,91182849,1750000.0,2.0,38,178,85,3,0,7,31,1,0.5441915850754168,0.5026737967914437,0.5808823529411764,0.0089223035379251,0.0,0.0,0.0997749437359339,0.0997749437359339,0.0096947137420483,0.1428571428571428,0.4883720930232553,0.1666666666666666,205,74,38,8,0,2937,4,51,169,20000000,1313333.3333333333,20000000.0,0.0,3000000.0,4500000.0,3,1500000,0.0,0.0
529870,Danila,Khotulev,2024,14589,Russia,Orenburg,Russia,01-10-02,Centre-Back,Defender,Left,187.0,30-06-26,prosm,https://img.a.transfermarkt.technology/portrait/header/529870-1690113084.png?lm=1,RU1,FC Orenburg,700000.0,700000.0,22,105,-75,7,8,5,9,9,5,11,8,3,15,9,11,13,9,5,9,12,9,13,10,12,4,7,9,10,13,10,9,11,10,9,15,8,12,12,13,12,8,12,11,10,3,1,3,2,3,3,2,3,2,3,4,13,12,6,10,12,10,12,20,1,10,20,1,1,1,1,1,1,1,1,1,1,1,82,20,14,22597243,5000,5000,2602,Northern_European,110,0,0,10525.0,FC Orenburg,58154550,435000.0,1.0,78,1091,81,1,0,7,70,2,0.4118814501190792,0.2729411764705882,0.4485294117647059,0.0101544311693528,0.0,0.0,0.0032508127031757,0.0032508127031757,0.0023889552487569,0.0,0.5581395348837206,0.1666666666666666,127,13,8,20,0,4979,0,0,0,500000,33333.333333333336,700000.0,200000.0,350000.0,600000.0,2,200000,-0.2857142857142857,0.25
530737,Unknown,Richard,2024,11282,Brazil,Campinas,Brazil,18-02-94,Defensive Midfield,Midfield,Right,191.0,30-06-25,4ComM,https://img.a.transfermarkt.technology/portrait/header/530737-1724671365.jpg?lm=1,TR1,Alanyaspor,900000.0,1500000.0,30,125,133,7,10,10,9,12,8,9,9,8,14,12,10,14,12,12,13,10,11,13,11,12,7,12,10,13,14,12,14,14,13,13,16,12,13,14,15,11,12,13,8,12,1,4,4,3,1,3,2,2,3,3,1,7,7,17,11,7,5,10,7,1,1,1,1,1,1,20,1,15,1,1,1,1,1,76,8,20,3437749,6181,6181,3231,Mixed_Race,125,0,0,4664.0,Unknown,19337991,710000.0,3.0,10,307,11,3,1,4,15,4,0.5681397195025139,0.3402139037433154,0.5588235294117647,0.0044949483732728,0.0,0.0,0.0042510627656914,0.0072518129532383,0.0039167754659851,0.2857142857142857,0.6511627906976742,0.5,290,9,11,86,3,7005,3,5,13,800000,30000.0,1500000.0,500000.0,,,7,900000,-0.15789473684210525,-0.2
530742,Fisayo,Dele-Bashiru,2024,398,Nigeria,Lagos,Nigeria,06-02-01,Attacking Midfield,Midfield,Right,186.0,30-06-25,Unknown,https://img.a.transfermarkt.technology/portrait/header/530742-1683029896.jpg?lm=1,IT1,SocietÃ  Sportiva Lazio S.p.A.,2000000.0,2000000.0,23,107,135,7,9,13,10,11,7,7,11,6,8,12,4,11,12,11,10,13,10,9,10,10,13,11,8,12,9,11,13,13,12,12,9,12,14,13,15,12,11,9,5,10,1,1,2,2,3,2,2,2,1,2,3,10,14,7,10,12,15,9,9,1,1,1,1,1,1,12,1,20,1,1,16,1,1,0,12,20,2417268,5350,5350,2504,North_African__Middle_Eastern,104,0,0,5220.0,Unknown,28115798,9111392.0,2.0,69,789,70,3,1,6,185,0,0.4581899973537973,0.2624598930481283,0.4044117647058823,0.0050318315731739,0.0,0.0,0.0097524381095273,0.0097524381095273,0.0505924720131114,0.1428571428571428,0.5348837209302322,0.2083333333333332,216,26,16,9,0,5578,2,1,8,6000000,442307.6923076923,6000000.0,200000.0,,300000.0,2,3100000,2.0,2.0
531949,Ignatius,Ganago,2024,995,Cameroon,Douala,Cameroon,16-02-99,Centre-Forward,Attack,Right,176.0,30-06-27,Wilders Sport,https://img.a.transfermarkt.technology/portrait/header/531949-1704213628.jpg?lm=1,FR1,Football Club de Nantes,2000000.0,8000000.0,25,119,135,7,9,12,14,12,10,12,11,8,8,11,12,10,12,8,11,13,12,11,8,11,12,12,8,14,6,11,13,15,12,15,11,14,14,12,14,12,6,10,13,6,2,1,1,1,3,3,3,1,2,1,1,13,14,2,9,11,12,11,16,1,1,1,1,1,1,1,1,1,1,10,1,1,20,82,8,20,4378602,5950,5950,3900,African_Caribbean,118,11,0,13919.0,Unknown,49045927,5200000.0,2.0,15,426,15,0,1,1,93,3,0.5375760783275999,0.4117647058823529,0.5073529411764706,0.0134317361701881,0.0723684210526315,0.0,0.0097524381095273,0.0397599399849962,0.0288619128309119,0.1428571428571428,0.3023255813953489,0.2916666666666665,191,35,10,7,0,2740,15,80,217,1800000,-41176.470588235294,8000000.0,1000000.0,,4000000.0,2,4400000,-0.4,-0.4857142857142857
532541,Luke,Cundle,2024,543,England,Warrington,England,26-04-02,Central Midfield,Midfield,Right,171.0,30-06-26,World in Motion,https://img.a.transfermarkt.technology/portrait/header/532541-1661855778.jpg?lm=1,GB1,Wolverhampton Wanderers Football Club,5000000.0,5000000.0,22,108,-75,12,12,11,11,14,9,6,12,3,9,13,5,8,13,8,12,10,13,10,12,12,16,11,7,12,13,13,11,13,13,14,8,10,11,13,8,9,7,14,10,11,2,2,4,1,1,1,1,3,3,3,3,9,12,6,11,11,11,10,10,1,1,1,1,1,1,10,12,20,12,15,18,15,1,62,8,20,27629231,5400,5400,3008,Northern_European,108,0,0,11599.0,Swansea City,28122346,9111392.0,2.0,32,1645,33,3,1,7,222,1,0.4648055041016142,0.3163636363636363,0.4338235294117646,0.0111915041130467,0.0,0.0,0.0247561890472618,0.0247561890472618,0.0505924720131114,0.1428571428571428,0.1860465116279068,0.1666666666666666,186,25,29,14,0,4063,0,0,0,5000000,533333.3333333334,5000000.0,0.0,,1000000.0,5,3700000,0.0,0.25
532676,Konstantin,Tyukavin,2024,121,Russia,"Kotlas, Arkhangelsk Oblast",Russia,22-06-02,Centre-Forward,Attack,Right,180.0,30-06-28,SA-Football Agency,https://img.a.transfermarkt.technology/portrait/header/532676-1721727990.png?lm=1,RU1,FK Dinamo Moskva,16000000.0,16000000.0,22,112,-8,9,9,12,14,12,4,13,7,5,6,9,14,8,12,13,14,13,12,13,12,11,16,8,7,15,8,10,11,13,12,12,13,15,12,10,10,11,8,12,4,4,2,4,1,1,1,2,3,1,2,2,3,8,16,7,16,12,13,13,15,1,1,1,1,1,1,1,1,1,1,7,9,8,20,78,9,20,17454238,5500,5500,3500,Northern_European,111,1,0,16654.0,Unknown,58153778,9111392.0,2.0,78,751,81,0,1,7,74,3,0.4780365175972479,0.3689839572192513,0.4558823529411764,0.0160726993927233,0.006578947368421,0.0,0.0797699424856214,0.0797699424856214,0.0505924720131114,0.1428571428571428,0.3953488372093026,0.1666666666666666,193,68,36,7,0,4414,3,6,30,16000000,938235.2941176471,16000000.0,0.0,3000000.0,7000000.0,3,2350000,0.0,0.6
532732,Igor,Diveev,2024,2410,Russia,Ufa,Russia,27-09-99,Centre-Back,Defender,Right,194.0,30-06-28,APS,https://img.a.transfermarkt.technology/portrait/header/532732-1690030793.png?lm=1,RU1,PFK CSKA Moskva,7500000.0,7500000.0,25,126,148,10,5,7,8,8,12,13,14,9,14,11,12,13,8,14,13,16,13,15,5,13,14,4,5,10,14,14,12,11,10,13,15,17,13,14,15,14,5,14,8,16,2,3,4,2,3,1,2,3,3,3,2,11,13,7,11,13,15,16,18,1,1,20,1,1,1,5,1,1,1,1,1,1,1,85,7,20,11734976,6244,6244,4244,Northern_European,125,14,1,35807.0,Unknown,58127846,1500000.0,1.0,78,1545,81,1,1,7,148,2,0.5764752580047632,0.4485561497326202,0.5588235294117647,0.0345671668885977,0.0921052631578947,0.0131578947368421,0.0372593148287071,0.0372593148287071,0.0083057862718408,0.0,0.7209302325581395,0.2916666666666665,239,23,5,37,1,5935,15,59,208,8000000,415789.4736842105,8000000.0,1000000.0,300000.0,4500000.0,1,1100000,0.3333333333333333,0.14285714285714285
532775,Melvin,Bard,2024,417,France,Ã‰cully,France,06-11-00,Left-Back,Defender,Left,173.0,30-06-28,E CASTAGNINO,https://img.a.transfermarkt.technology/portrait/header/532775-1649428267.jpg?lm=1,FR1,Olympique Gymnaste Club Nice CÃ´te d'Azur,12000000.0,12000000.0,24,122,147,6,15,13,6,13,6,9,8,10,14,14,5,13,14,15,13,15,11,9,13,12,15,13,11,12,12,15,15,14,12,12,8,15,14,11,11,14,14,13,9,18,3,2,3,4,3,4,1,3,3,3,3,13,14,1,13,13,14,14,11,1,20,13,1,20,1,1,15,1,1,12,1,1,1,65,20,8,8454999,6100,6100,3252,Northern_European,117,0,0,15341.0,Unknown,49041157,3000000.0,1.0,34,1722,36,1,0,7,142,8,0.5574225985710506,0.3424598930481283,0.4999999999999999,0.0148048439224532,0.0,0.0,0.0597649412353088,0.0597649412353088,0.0166393510930859,0.0,0.2325581395348837,0.25,208,5,9,33,2,4452,7,24,29,12000000,875000.0,12000000.0,1000000.0,,8000000.0,1,3000000,0.0,0.0
532776,Amine,Adli,2024,15,France,BÃ©ziers,Morocco,10-05-00,Left Winger,Attack,Left,174.0,30-06-26,Concept Sport Agency,https://img.a.transfermarkt.technology/portrait/header/532776-1689710574.jpg?lm=1,L1,Bayer 04 Leverkusen FuÃŸball,30000000.0,30000000.0,24,121,145,11,12,14,12,13,12,10,13,3,6,13,11,5,14,11,13,11,12,10,13,12,14,15,10,13,8,13,14,14,14,12,10,14,15,11,8,12,5,11,5,12,4,3,2,1,3,1,2,2,2,3,2,13,15,11,12,11,13,11,11,1,1,1,1,1,1,1,1,13,1,15,20,13,14,72,20,8,4899999,6050,5800,4250,African_Caribbean,120,0,0,23014.0,Unknown,49037698,9111392.0,2.0,34,289,67,0,0,1,36,7,0.5177295580841492,0.4491978609625668,0.5220588235294117,0.0222140252045418,0.0,0.0,0.1497874468617154,0.1497874468617154,0.0505924720131114,0.1428571428571428,0.2558139534883721,0.25,198,34,30,24,4,5043,4,59,138,22000000,1365625.0,30000000.0,8000000.0,,5000000.0,1,3000000,-0.26666666666666666,-0.12
532900,João,Valido,2024,8024,Portugal,SetÃºbal,Portugal,03-03-00,Goalkeeper,Goalkeeper,Right,185.0,30-06-27,Proeleven S.A.,https://img.a.transfermarkt.technology/portrait/header/532900-1557416800.png?lm=1,PO1,Futebol Clube de Arouca,200000.0,350000.0,24,95,135,5,2,2,3,7,7,6,1,2,2,13,1,1,7,11,10,10,10,12,7,12,19,2,10,3,10,12,12,10,12,9,12,13,9,10,10,15,5,1,13,14,12,12,12,8,11,12,11,13,8,10,8,11,13,5,19,8,18,6,19,20,1,1,1,1,1,1,1,1,1,1,1,1,1,75,3,20,463999,4750,4750,2000,Mediterranean_Hispanic,96,0,0,719.0,Unknown,83169829,9111392.0,2.0,76,1363,79,2,1,3,98,5,0.3788039163799948,0.2085561497326203,0.3455882352941176,0.0006855882588665,0.0,0.0,0.0007501875468867,0.0015003750937734,0.0505924720131114,0.1428571428571428,0.5116279069767438,0.25,0,0,0,0,0,0,1,6,42,200000,10000.0,350000.0,250000.0,,100000.0,1,250000,0.0,-0.2
533295,Patrick,Wimmer,2024,82,Austria,Tulln,Austria,30-05-01,Right Winger,Attack,Right,182.0,30-06-27,More than Sport GmbH,https://img.a.transfermarkt.technology/portrait/header/533295-1657203456.jpg?lm=1,L1,Verein fÃ¼r LeibesÃ¼bungen Wolfsburg,15000000.0,18000000.0,23,135,153,12,10,15,11,12,12,8,11,5,9,12,7,12,13,15,12,16,12,12,13,12,16,15,5,13,10,16,16,15,13,11,11,14,15,13,11,13,9,12,7,19,2,3,2,1,2,2,2,2,1,3,3,14,16,6,8,12,14,11,9,1,10,1,12,10,12,8,15,12,15,18,12,20,10,77,12,20,12473999,6748,6001,5808,Northern_European,133,1,0,38355.0,Unknown,16253898,2850000.0,2.0,6,1534,7,0,1,7,213,10,0.5443238952103732,0.6158288770053475,0.6176470588235294,0.0370275596823891,0.006578947368421,0.0,0.0747686921730432,0.0897724431107777,0.0158059946109614,0.1428571428571428,0.4418604651162785,0.2083333333333332,170,22,32,34,2,3452,11,46,110,12000000,793333.3333333334,18000000.0,3000000.0,200000.0,8000000.0,3,3100000,-0.2,-0.3333333333333333
533568,Nahuel,Tenaglia,2024,1108,Argentina,Saladillo,Argentina,21-02-96,Right-Back,Defender,Right,181.0,30-06-27,Universal Twenty Two,https://img.a.transfermarkt.technology/portrait/header/533568-1647530141.jpg?lm=1,ES1,Deportivo AlavÃ©s S.A.D.,2000000.0,5200000.0,28,129,137,8,11,11,9,12,6,12,7,15,15,15,9,15,11,15,13,14,12,12,13,13,11,7,10,14,14,13,14,14,13,13,10,13,14,12,12,12,8,12,5,14,2,2,1,3,2,1,1,3,3,3,3,12,11,8,14,10,15,10,11,1,12,18,20,8,15,1,1,1,1,1,1,1,1,70,8,20,2248866,6200,6200,3204,Mediterranean_Hispanic,129,0,0,9903.0,AlavÃ©s,14153906,1000000.0,1.0,4,1282,4,1,1,3,59,11,0.5706536120666843,0.3373262032085561,0.588235294117647,0.0095538172298951,0.0,0.0,0.0097524381095273,0.0257564391097774,0.0055279313314258,0.0,0.418604651162791,0.4166666666666665,211,14,14,48,0,5889,0,0,0,3000000,163888.88888888888,5200000.0,2000000.0,,,1,200000,0.5,0.6666666666666666
533662,Cameron,Archer,2024,180,England,Walsall,England,09-12-01,Centre-Forward,Attack,Right,175.0,30-06-28,Unique Sports Group,https://img.a.transfermarkt.technology/portrait/header/533662-1641461875.jpg?lm=1,GB1,Southampton Football Club,13000000.0,18000000.0,23,118,-75,4,7,11,15,12,7,11,9,3,4,8,10,4,12,9,10,10,14,11,10,11,16,13,8,14,11,10,14,15,13,10,11,13,14,12,12,10,7,9,8,9,2,2,3,3,1,2,1,1,1,3,2,12,12,4,12,10,12,11,13,1,1,1,1,1,1,1,1,1,1,1,1,1,20,71,10,20,65883306,5900,5900,3500,African_Caribbean,115,0,0,11599.0,Unknown,29219088,9111392.0,2.0,32,1642,33,0,1,1,186,3,0.530960571579783,0.3689839572192513,0.4852941176470588,0.0111915041130467,0.0,0.0,0.0647661915478869,0.0897724431107777,0.0505924720131114,0.1428571428571428,0.2790697674418605,0.2083333333333332,196,54,17,7,0,3894,2,7,52,14000000,1245454.5454545454,18000000.0,3000000.0,,8000000.0,6,18500000,0.07692307692307693,-0.2222222222222222
533738,Jonathan,David,2024,1082,United States,"Brooklyn, New York",Canada,14-01-00,Centre-Forward,Attack,Right,178.0,30-06-25,Unknown,https://img.a.transfermarkt.technology/portrait/header/533738-1666690584.jpg?lm=1,FR1,Lille Olympique Sporting Club Lille MÃ©tropole,45000000.0,60000000.0,24,139,155,8,10,13,14,14,10,7,11,5,7,13,15,6,13,12,13,12,13,11,12,12,12,12,12,12,4,12,14,16,12,12,9,14,15,12,13,12,8,14,7,14,2,1,3,1,2,1,3,1,2,1,1,11,14,2,9,10,11,13,20,1,1,1,1,1,1,1,1,1,1,18,20,18,19,77,12,20,66878046,6950,6900,5750,African_Caribbean,127,32,21,41424.0,Unknown,18108540,27000000.0,1.0,104,261,16,0,1,1,128,3,0.6632707065361206,0.6096256684491979,0.5735294117647058,0.0399910390717714,0.2105263157894736,0.2763157894736842,0.2248062015503876,0.2998249562390597,0.1499763882330064,0.0,0.3488372093023257,0.25,301,141,42,27,0,6061,2,3,10,45000000,2138095.238095238,60000000.0,10000000.0,2000000.0,30000000.0,2,6900000,-0.1,-0.1
534033,Alexis,Mac Allister,2024,31,Argentina,Santa Rosa,Argentina,24-12-98,Central Midfield,Midfield,Right,176.0,30-06-28,Unknown,https://img.a.transfermarkt.technology/portrait/header/534033-1669835342.jpg?lm=1,GB1,Liverpool Football Club,75000000.0,75000000.0,26,144,159,14,14,13,14,14,15,10,15,9,7,16,16,14,16,15,13,12,14,13,16,13,14,14,10,14,13,13,14,13,11,11,9,14,13,14,12,13,8,13,6,14,2,2,4,2,4,3,2,3,2,2,2,9,12,3,12,14,16,15,10,1,1,1,1,1,1,18,13,18,1,14,20,14,12,71,8,20,52732047,7199,6649,5499,Mediterranean_Hispanic,141,5,0,69595.0,Unknown,14157184,25000000.0,2.0,4,1330,4,3,1,3,129,1,0.63006086266208,0.5827807486631016,0.6764705882352942,0.0671934430725168,0.0328947368421052,0.0,0.3748437109277319,0.3748437109277319,0.1388649684713464,0.1428571428571428,0.3023255813953489,0.3333333333333332,296,45,34,49,1,5579,3,12,36,80000000,4194736.842105263,80000000.0,1500000.0,300000.0,12500000.0,3,6500000,0.06666666666666667,0.23076923076923078
534376,Marco,Moreno,2024,4294,Spain,Las Palmas de Gran Canaria,Spain,20-02-01,Centre-Back,Defender,Left,191.0,30-06-27,NLN SPORT MANAGEMENT,https://img.a.transfermarkt.technology/portrait/header/default.jpg?lm=1,PO1,Sporting Clube Farense,400000.0,400000.0,23,129,134,12,12,15,10,13,9,8,14,9,7,13,8,9,14,12,11,12,13,14,13,12,13,15,8,13,12,13,15,13,14,13,6,14,15,14,10,11,8,11,4,17,3,1,3,3,1,3,1,3,3,1,2,15,12,8,14,9,14,16,13,1,1,1,1,1,1,1,1,20,1,17,18,17,12,65,20,8,6613792,6496,6257,4065,Mediterranean_Hispanic,123,0,0,8919.0,Unknown,14079992,9111392.0,2.0,89,803,89,1,0,3,191,2,0.5781952897591955,0.4294117647058823,0.5441176470588236,0.008603649840142,0.0,0.0,0.0017504376094023,0.0017504376094023,0.0505924720131114,0.1428571428571428,0.6511627906976742,0.2083333333333332,101,7,0,33,0,2530,0,0,0,600000,45833.333333333336,600000.0,50000.0,,50000.0,1,200000,0.5,1.0
534379,Unknown,Pejiño,2024,472,Spain,Barbate (CÃ¡diz),Spain,29-07-96,Left Winger,Attack,Left,178.0,30-06-26,Unknown,https://img.a.transfermarkt.technology/portrait/header/534379-1630918134.jpg?lm=1,ES1,UniÃ³n Deportiva Las Palmas S.A.D.,1200000.0,1800000.0,28,127,142,13,13,15,13,15,10,5,12,6,4,12,9,5,15,8,12,11,13,11,15,12,12,15,10,14,5,12,12,13,15,14,4,9,12,12,9,12,6,8,15,11,1,3,2,2,3,2,1,3,3,1,1,15,11,8,10,11,13,12,13,1,1,1,1,12,1,1,18,1,13,20,12,17,1,67,20,14,2432573,6197,6197,3697,Mediterranean_Hispanic,127,0,0,7056.0,Unknown,67213926,9111392.0,2.0,89,140,89,0,0,3,207,7,0.5702566816618153,0.3900534759358288,0.5735294117647058,0.0068047048735669,0.0,0.0,0.0057514378594648,0.0087521880470117,0.0505924720131114,0.1428571428571428,0.3488372093023257,0.4166666666666665,146,22,12,23,1,1791,2,19,74,1000000,27777.777777777777,1800000.0,300000.0,,,1,100000,-0.16666666666666666,-0.3333333333333333
535469,Valentin,Mih?Il?,2024,130,Romania,Finta,Romania,02-02-00,Left Winger,Attack,Right,180.0,30-06-27,Ioan Becali,https://img.a.transfermarkt.technology/portrait/header/535469-1718261714.jpg?lm=1,IT1,Parma Calcio 1913,2800000.0,8500000.0,24,120,141,6,11,12,11,12,8,7,10,3,6,11,5,6,13,7,9,8,9,9,12,11,13,11,6,13,5,10,13,15,14,10,7,12,16,12,7,13,5,12,9,12,1,2,2,1,2,3,1,1,3,3,2,10,13,5,12,12,14,13,15,1,1,1,1,1,1,1,15,1,5,20,10,8,8,65,15,20,3224999,6000,5750,5000,Mediterranean_Hispanic,114,10,1,13153.0,Unknown,57168149,9111392.0,2.0,77,492,80,0,1,3,155,7,0.5111140513363324,0.5294117647058822,0.4779411764705882,0.012692073344425,0.0657894736842105,0.0131578947368421,0.0137534383595899,0.0422605651412853,0.0505924720131114,0.1428571428571428,0.3953488372093026,0.25,183,25,25,34,0,4903,11,64,105,3000000,155263.15789473685,8500000.0,2500000.0,400000.0,6000000.0,4,5350000,0.07142857142857142,0.5
535551,Bartosz,Bialek,2024,82,Poland,Brzeg,Poland,11-11-01,Centre-Forward,Attack,Right,191.0,30-06-25,BMG-SPORT,https://img.a.transfermarkt.technology/portrait/header/535551-1657203695.jpg?lm=1,L1,Verein fÃ¼r LeibesÃ¼bungen Wolfsburg,1000000.0,5000000.0,23,115,-75,5,7,11,14,11,6,13,10,6,4,10,13,6,11,11,13,14,13,12,10,12,13,12,6,14,6,12,12,12,11,14,14,12,12,11,14,12,7,11,8,10,2,2,4,2,3,2,3,4,2,4,1,12,13,6,13,14,14,14,14,1,1,1,1,1,1,1,1,1,1,12,16,12,20,84,12,20,43710001,5749,4947,4360,Northern_European,115,0,0,14383.0,Vitesse,96131663,5000000.0,1.0,75,267,78,0,1,7,213,3,0.4048690129663932,0.4609625668449197,0.4852941176470588,0.0138797825816163,0.0,0.0,0.0047511877969492,0.0247561890472618,0.0277507708547459,0.0,0.6511627906976742,0.2083333333333332,136,30,8,6,0,3631,4,90,248,800000,26666.666666666668,5000000.0,1000000.0,3000000.0,4000000.0,4,3200000,-0.2,-0.4666666666666667
535834,Eliot,Matazo,2024,162,Belgium,Woluwe-Saint-Lambert,Belgium,15-02-02,Central Midfield,Midfield,Right,170.0,30-06-26,SEG,https://img.a.transfermarkt.technology/portrait/header/535834-1706869303.jpg?lm=1,FR1,Association sportive de Monaco Football Club,5000000.0,8000000.0,22,115,-8,8,9,13,10,13,9,9,10,2,12,13,8,12,13,14,12,13,10,12,12,12,14,12,12,9,11,14,14,13,14,13,9,14,13,13,13,11,11,10,8,12,1,2,3,3,3,1,3,3,1,1,3,13,18,4,8,8,12,11,13,1,1,1,1,1,1,16,1,20,15,1,1,1,1,67,8,20,48403351,5749,5749,2999,African_Caribbean,116,0,0,5717.0,Unknown,18107444,9111392.0,2.0,7,1673,8,3,1,1,24,1,0.5109817412013761,0.3154010695187165,0.4926470588235294,0.0055117433543805,0.0,0.0,0.0247561890472618,0.0397599399849962,0.0505924720131114,0.1428571428571428,0.1627906976744184,0.1666666666666666,116,5,3,12,1,4032,4,21,77,3000000,200000.0,8000000.0,2000000.0,1500000.0,7000000.0,2,3000000,-0.4,-0.5
535955,Nuno,Tavares,2024,398,Portugal,Lisboa,Portugal,26-01-00,Left-Back,Defender,Left,183.0,30-06-25,Prodigy Players,https://img.a.transfermarkt.technology/portrait/header/535955-1666815026.jpg?lm=1,IT1,SocietÃ  Sportiva Lazio S.p.A.,15000000.0,18000000.0,24,136,154,11,12,13,8,13,8,9,11,11,10,12,7,13,13,12,10,13,10,8,13,10,12,12,6,13,9,13,13,17,14,12,12,16,16,14,13,10,9,10,6,12,1,2,2,3,1,4,2,2,2,3,1,16,15,16,7,8,9,9,11,1,20,1,14,18,14,1,16,1,1,13,1,1,1,75,20,11,32361694,6800,6800,5000,African_Caribbean,122,0,0,34798.0,Olympique de Marseille,83169864,8000000.0,1.0,76,843,79,1,0,1,185,8,0.6500396930404869,0.5294117647058822,0.536764705882353,0.0335928590671944,0.0,0.0,0.0747686921730432,0.0897724431107777,0.044417900497236,0.0,0.4651162790697669,0.25,168,9,23,26,1,5774,8,26,36,25000000,1550000.0,25000000.0,2000000.0,,5000000.0,5,22800000,0.6666666666666666,0.5625
535974,Konstantin,Maradishvili,2024,49702,Russia,Moskau,Russia,07-02-00,Defensive Midfield,Midfield,Right,179.0,30-06-25,Unknown,https://img.a.transfermarkt.technology/portrait/header/535974-1722314721.png?lm=1,RU1,FK Nizhny Novgorod,900000.0,3500000.0,24,117,145,7,6,11,8,12,10,8,6,7,14,9,7,13,11,15,13,15,13,15,10,13,15,7,8,10,12,15,16,14,14,14,10,14,13,15,10,14,6,14,8,15,2,1,3,2,3,1,2,1,4,2,4,7,10,3,12,14,15,13,16,1,1,1,13,1,1,17,9,20,13,6,13,13,1,75,8,20,6995018,5750,5750,3650,Mediterranean_Hispanic,113,0,0,21095.0,Unknown,58146443,7000000.0,1.0,78,985,81,3,1,3,79,4,0.5111140513363324,0.3850267379679144,0.4705882352941176,0.0203610056710702,0.0,0.0,0.0042510627656914,0.0172543135783946,0.038862190616406,0.0,0.3720930232558141,0.25,172,10,22,29,1,4517,4,39,254,700000,34210.52631578947,3500000.0,600000.0,150000.0,2500000.0,3,1550000,-0.2222222222222222,-0.4166666666666667
536482,Junior,Dina Ebimbe,2024,24,France,Stains,France,21-11-00,Right Midfield,Midfield,Right,184.0,30-06-27,Sports360 GmbH,https://img.a.transfermarkt.technology/portrait/header/536482-1663065378.jpg?lm=1,L1,Eintracht Frankfurt FuÃŸball AG,9000000.0,14000000.0,24,118,150,9,11,12,8,12,9,11,11,11,11,12,9,11,13,11,12,13,12,12,13,11,12,10,8,12,9,12,13,12,14,13,11,14,12,14,14,11,9,11,6,14,3,4,2,1,1,1,2,4,3,3,3,11,14,7,10,12,12,11,11,1,1,1,12,1,14,13,1,20,18,1,12,15,1,81,10,20,9984999,5900,5900,3650,African_Caribbean,117,0,0,7642.0,Eintracht Frankfurt,49039272,6500000.0,1.0,34,1417,36,3,1,1,63,9,0.530960571579783,0.3850267379679144,0.4999999999999999,0.0073705565914483,0.0,0.0,0.0447611902975743,0.0697674418604651,0.0360843356759909,0.0,0.4883720930232553,0.25,183,21,13,28,1,2426,6,23,58,9000000,546666.6666666666,14000000.0,3000000.0,800000.0,6000000.0,3,4100000,-0.25,-0.35714285714285715
536507,Giulian,Biancone,2024,683,France,FrÃ©jus,France,31-03-00,Centre-Back,Defender,Right,187.0,30-06-25,Unknown,https://img.a.transfermarkt.technology/portrait/header/536507-1728417425.png?lm=1,GR1,Olympiakos Syndesmos Filathlon Peiraios,3000000.0,8000000.0,24,110,135,8,9,9,7,10,6,11,10,12,13,10,9,12,10,13,12,12,11,10,11,10,14,8,11,10,12,13,12,13,11,14,11,13,13,14,11,12,11,12,5,14,1,2,3,1,3,4,2,1,3,1,1,14,12,5,13,13,14,13,17,1,1,19,20,1,12,17,1,14,1,1,1,1,1,79,8,20,7609058,5493,5493,3243,Northern_European,104,0,0,23198.0,Unknown,49045308,6250000.0,2.0,34,515,36,1,1,7,141,2,0.4771103466525536,0.3414973262032085,0.4044117647058823,0.0223916987814875,0.0,0.0,0.0147536884221055,0.0397599399849962,0.0346954082057834,0.1428571428571428,0.5581395348837206,0.25,139,7,9,35,0,3512,2,37,272,2500000,117647.05882352941,8000000.0,1000000.0,500000.0,1300000.0,4,6700000,-0.16666666666666666,-0.5
536835,Amad,Diallo,2024,985,Cote d'Ivoire,Abidjan,Cote d'Ivoire,11-07-02,Right Winger,Attack,Left,173.0,30-06-25,#LEADERS,https://img.a.transfermarkt.technology/portrait/header/536835-1694616776.jpg?lm=1,GB1,Manchester United Football Club,22000000.0,22000000.0,22,118,-8,8,10,15,12,16,10,4,11,2,4,13,8,3,15,14,11,7,9,7,13,8,17,16,5,12,5,7,11,16,16,13,6,15,15,10,6,7,8,14,5,11,1,2,2,1,3,2,2,1,3,1,1,15,18,8,13,14,16,16,11,1,1,1,1,1,1,1,10,10,16,15,15,20,15,68,20,8,81426198,5900,6250,5000,African_Caribbean,109,3,1,28998.0,Sunderland,43425040,21300000.0,1.0,23,14,24,0,0,1,132,10,0.5772691188145012,0.5294117647058822,0.4411764705882353,0.0279922789243409,0.0197368421052631,0.0131578947368421,0.1097774443610902,0.1097774443610902,0.1183088419122753,0.0,0.2325581395348837,0.1666666666666666,216,73,41,15,0,5374,5,55,127,25000000,714285.7142857143,25000000.0,5000000.0,18000000.0,18000000.0,3,10000000,0.3888888888888889,0.3888888888888889
537382,Bryan,Gil,2024,12321,Spain,Barbate (CÃ¡diz),Spain,11-02-01,Left Winger,Attack,Left,175.0,30-06-25,IFM,https://img.a.transfermarkt.technology/portrait/header/537382-1704812537.jpg?lm=1,ES1,Girona FÃºtbol Club S. A. D.,14000000.0,30000000.0,23,135,-85,10,14,16,13,13,10,8,11,6,6,12,10,5,14,10,13,9,11,11,13,12,15,17,7,14,5,10,12,16,15,14,7,12,14,13,8,12,7,12,10,11,1,1,3,1,3,3,2,3,3,1,2,8,14,6,14,16,16,15,10,1,13,1,1,14,1,1,19,1,14,20,18,15,8,69,20,9,82446926,6750,6750,6000,Mediterranean_Hispanic,129,4,0,92793.0,Unknown,67260440,25000000.0,1.0,89,140,89,0,0,3,107,7,0.6434241862926701,0.6363636363636364,0.588235294117647,0.0895938324093985,0.0263157894736842,0.0,0.0697674418604651,0.1497874468617154,0.1388649684713464,0.0,0.2790697674418605,0.2083333333333332,200,17,22,37,1,5288,7,31,65,15000000,816666.6666666666,30000000.0,7000000.0,10000000.0,28000000.0,9,19200000,0.07142857142857142,-0.0625
537475,Hugo,Cunha,2024,3329,Portugal,Viana do Castelo,Portugal,06-09-01,Goalkeeper,Goalkeeper,Left,198.0,30-06-26,MRP.POSITIONUMBER,https://img.a.transfermarkt.technology/portrait/header/537475-1571743997.jpg?lm=1,PO1,Futebol Clube de FamalicÃ£o,100000.0,100000.0,23,80,-75,5,8,11,7,12,6,5,12,6,5,11,8,5,13,7,8,11,7,6,12,10,10,13,9,11,6,9,10,13,13,11,11,15,13,8,6,8,6,7,7,10,2,3,1,3,2,2,3,3,3,2,1,11,13,3,11,12,8,10,16,1,1,1,1,1,1,1,1,15,10,1,20,13,1,73,20,6,2662000,3400,3030,151,Mediterranean_Hispanic,78,0,0,255.0,Unknown,2000091624,9111392.0,2.0,76,1580,79,2,0,3,99,5,0.1512304842550939,0.0108021390374331,0.213235294117647,0.0002375418474382,0.0,0.0,0.0002500625156289,0.0002500625156289,0.0505924720131114,0.1428571428571428,0.8139534883720931,0.2083333333333332,0,0,0,0,0,0,0,0,0,100000,0.0,100000.0,0.0,,,0,0,0.0,0.0
537598,Fábio,Vieira,2024,720,Portugal,Santa Maria da Feira,Portugal,30-05-00,Attacking Midfield,Midfield,Left,170.0,30-06-25,Gestifute,https://img.a.transfermarkt.technology/portrait/header/537598-1678468077.jpg?lm=1,PO1,Futebol Clube do Porto,22000000.0,30000000.0,24,142,165,14,14,15,12,16,14,8,13,5,6,16,13,8,17,13,13,12,14,12,16,15,13,15,11,13,9,12,14,13,14,15,6,13,14,13,9,14,6,15,4,13,3,1,1,2,1,3,3,3,2,3,1,14,12,5,16,16,15,12,12,1,1,1,1,1,1,1,13,17,11,15,20,19,10,64,20,9,91559236,7098,7098,5598,Mediterranean_Hispanic,142,0,0,92793.0,Unknown,83174759,35000000.0,1.0,76,1327,79,3,0,3,100,0,0.6894681132574755,0.5933689839572192,0.6838235294117647,0.0895938324093985,0.0,0.0,0.1097774443610902,0.1497874468617154,0.1944220672796466,0.0,0.1627906976744184,0.25,195,29,36,18,1,6504,5,25,84,22000000,1331250.0,30000000.0,3000000.0,,9000000.0,3,11375000,0.0,-0.21428571428571427
537844,Anatoliy,Trubin,2024,294,Ukraine,Donetsk,Ukraine,01-08-01,Goalkeeper,Goalkeeper,Right,199.0,30-06-28,PART of the GAME,https://img.a.transfermarkt.technology/portrait/header/537844-1725527125.jpg?lm=1,PO1,Sport Lisboa e Benfica,25000000.0,25000000.0,23,135,-85,1,3,3,1,11,2,8,2,1,5,13,11,5,9,7,14,14,13,12,11,13,12,5,7,9,16,12,14,12,13,12,18,14,13,13,14,14,2,18,5,1,16,12,11,3,15,11,11,15,6,9,8,8,12,3,20,15,15,15,5,20,1,1,1,1,1,1,1,1,1,1,1,1,1,86,10,20,51037152,6250,6250,4500,Northern_European,137,2,0,6827.0,Unknown,71101334,10000000.0,1.0,103,422,101,2,1,7,188,5,0.5772691188145012,0.4759358288770053,0.6470588235294117,0.0065835785196507,0.0131578947368421,0.0,0.1247811952988247,0.1247811952988247,0.055529320258896,0.0,0.8372093023255816,0.2083333333333332,0,0,0,0,0,0,1,6,31,25000000,1892307.6923076923,25000000.0,50000.0,350000.0,8000000.0,1,3000000,0.0,0.0
537860,Mykhaylo,Mudryk,2024,631,Ukraine,"Krasnograd, Kharkiv Oblast",Ukraine,05-01-01,Left Winger,Attack,Right,175.0,30-06-31,ProStar,https://img.a.transfermarkt.technology/portrait/header/537860-1681908631.jpg?lm=1,GB1,Chelsea Football Club,30000000.0,60000000.0,23,140,163,10,13,14,13,12,10,4,9,4,6,13,12,4,14,6,8,12,11,10,12,10,16,16,8,10,10,10,13,16,15,11,5,10,17,11,14,12,5,14,10,10,3,2,2,4,1,3,1,2,3,3,2,11,13,12,20,9,19,12,5,1,1,1,1,1,1,1,15,1,1,20,15,15,1,61,10,20,122204661,8000,7940,6848,Northern_European,124,5,0,5800.0,Unknown,71101331,70000000.0,1.0,103,758,101,0,1,7,50,7,0.8008732468907118,0.7270588235294118,0.5514705882352942,0.0055918895874593,0.0328947368421052,0.0,0.1497874468617154,0.2998249562390597,0.3888719131086974,0.0,0.2790697674418605,0.2083333333333332,150,22,28,19,1,6404,8,12,14,30000000,1661111.111111111,60000000.0,10000000.0,200000.0,4000000.0,3,20400000,-0.14285714285714285,-0.25
538253,Unknown,Simão,2024,110302,Brazil,AntÃ´nio Prado,Brazil,02-07-93,Goalkeeper,Goalkeeper,Right,187.0,30-06-26,Players Trust,https://img.a.transfermarkt.technology/portrait/header/538253-1660730331.jpg?lm=1,PO1,Avs Futebol SAD,100000.0,200000.0,31,115,135,10,13,14,10,12,8,7,8,7,5,12,8,9,12,12,11,13,11,12,11,12,15,14,12,13,7,12,15,14,13,12,8,14,13,12,8,14,12,16,5,12,1,1,3,3,2,2,3,2,2,2,1,13,12,10,12,12,13,12,7,1,1,1,1,1,1,1,17,1,12,20,14,15,10,0,7,20,680250,5750,5750,3250,Mediterranean_Hispanic,112,0,0,3222.0,Unknown,2000107738,9111392.0,2.0,10,75,11,2,1,3,35,5,0.5111140513363324,0.3422459893048128,0.463235294117647,0.0031025282756875,0.0,0.0,0.0002500625156289,0.0007501875468867,0.0505924720131114,0.1428571428571428,0.5581395348837206,0.5416666666666665,0,0,0,0,0,0,0,0,0,300000,22222.222222222223,300000.0,50000.0,,,3,50000,2.0,2.0
538281,Víctor,Méndez,2024,2696,Chile,Valdivia,Chile,23-09-99,Defensive Midfield,Midfield,Right,172.0,30-06-25,AIM fÃºtbol,https://img.a.transfermarkt.technology/portrait/header/538281-1726166092.png?lm=1,RU1,PFK Krylya Sovetov Samara,3500000.0,5000000.0,25,117,143,7,8,11,7,12,8,9,11,5,13,13,6,13,13,12,13,13,12,13,11,13,12,10,12,11,14,14,13,11,10,12,10,13,11,13,12,12,10,12,6,10,3,1,2,2,1,2,2,3,1,1,1,15,12,7,13,10,12,11,12,1,1,1,1,1,1,20,1,17,1,1,1,1,1,65,13,20,6995018,5750,5750,5000,Mixed_Race,117,3,0,24571.0,Unknown,75044474,2500000.0,1.0,19,1555,19,3,1,4,149,4,0.5111140513363324,0.5294117647058822,0.4999999999999999,0.0237174912877182,0.0197368421052631,0.0,0.0172543135783946,0.0247561890472618,0.0138614961526709,0.0,0.2093023255813952,0.2916666666666665,215,5,17,19,0,3367,1,5,24,3000000,155263.15789473685,5000000.0,1000000.0,100000.0,400000.0,2,1200000,-0.3333333333333333,-0.4
538874,Terem,Moffi,2024,417,Nigeria,Calabar,Nigeria,25-05-99,Centre-Forward,Attack,Left,188.0,30-06-27,Unknown,https://img.a.transfermarkt.technology/portrait/header/538874-1603021287.jpg?lm=1,FR1,Olympique Gymnaste Club Nice CÃ´te d'Azur,20000000.0,25000000.0,25,133,150,7,8,13,13,12,9,13,9,7,8,12,13,8,13,12,13,14,12,12,12,11,13,12,7,13,10,12,13,16,13,16,14,14,15,13,17,13,12,14,7,10,1,1,1,4,1,2,2,1,4,2,3,13,12,7,12,11,14,14,18,1,1,1,1,1,1,1,1,1,1,1,1,1,20,89,20,8,7346217,6650,6400,4272,African_Caribbean,132,7,2,18801.0,Unknown,47079007,10616666.67,3.0,69,296,70,0,0,1,142,3,0.5971156390579518,0.4515508021390373,0.6102941176470589,0.018145879662845,0.0460526315789473,0.0263157894736842,0.0997749437359339,0.1247811952988247,0.0589553413705936,0.2857142857142857,0.581395348837209,0.2916666666666665,193,82,12,12,1,2536,2,35,207,18000000,853571.4285714285,25000000.0,5000000.0,75000.0,1300000.0,3,8275000,-0.28,-0.28
538918,Sebastiano,Esposito,2024,749,Italy,Castellammare di Stabia,Italy,02-07-02,Second Striker,Attack,Right,183.0,30-06-25,Unknown,https://img.a.transfermarkt.technology/portrait/header/538918-1666810018.jpg?lm=1,IT1,Empoli Football Club S.r.l.,5000000.0,10000000.0,22,112,-75,12,11,13,13,15,13,12,13,2,3,13,14,4,11,10,13,10,12,11,13,11,14,14,6,12,4,12,12,10,13,13,14,16,12,12,11,5,7,12,9,13,2,1,3,3,1,1,4,2,3,1,3,12,14,15,13,13,10,8,5,1,1,1,1,1,1,1,1,1,1,12,19,12,20,75,9,20,46000000,5995,6207,4374,Mediterranean_Hispanic,111,0,0,11506.0,RSC Anderlecht,43425069,9111392.0,2.0,52,328,54,0,1,3,64,12,0.5715797830113787,0.4624598930481283,0.4558823529411764,0.0111017017073078,0.0,0.0,0.0247561890472618,0.0497624406101525,0.0505924720131114,0.1428571428571428,0.4651162790697669,0.1666666666666666,226,78,25,21,1,6456,10,43,46,7000000,153846.15384615384,10000000.0,3000000.0,6000000.0,3500000.0,6,7400000,0.4,0.5909090909090909
538964,Thijs,Dallinga,2024,1025,Netherlands,Groningen,Netherlands,03-08-00,Centre-Forward,Attack,Right,190.0,30-06-28,V4S,https://img.a.transfermarkt.technology/portrait/header/538964-1682946635.jpg?lm=1,IT1,Bologna Football Club 1909,18000000.0,18000000.0,24,120,135,7,6,12,14,12,8,13,12,5,5,12,13,5,12,5,12,13,14,12,12,13,15,15,13,13,13,12,13,13,13,14,14,16,13,12,12,13,5,14,3,12,3,1,2,1,2,1,1,1,2,2,2,14,9,6,8,11,14,12,13,1,1,1,1,1,1,1,1,1,1,1,1,1,20,70,8,20,2767999,5999,5999,3758,Northern_European,122,0,0,2500.0,Unknown,37070210,5866666.667,3.0,67,565,68,0,1,7,40,3,0.5440592749404605,0.3965775401069518,0.536764705882353,0.0024053526096289,0.0,0.0,0.0897724431107777,0.0897724431107777,0.0325657194199838,0.2857142857142857,0.6279069767441858,0.25,237,111,21,16,0,6818,1,1,4,12000000,748437.5,18000000.0,3000000.0,75000.0,75000.0,4,4775000,-0.3333333333333333,-0.2
538971,Naouirou,Ahamada,2024,273,France,Marseille,France,29-03-02,Central Midfield,Midfield,Right,183.0,30-06-25,YA'ATS SPORTS,https://img.a.transfermarkt.technology/portrait/header/538971-1657181756.jpg?lm=1,FR1,Stade Rennais Football Club,8000000.0,10000000.0,22,115,-75,5,8,13,8,13,6,8,10,5,12,14,6,11,15,14,11,13,12,12,12,12,15,14,7,1,12,12,15,13,13,12,11,12,13,13,13,11,8,10,10,8,2,1,3,3,3,3,2,3,2,1,1,12,13,8,11,10,14,10,10,1,1,1,1,1,1,18,1,20,1,1,14,1,1,73,10,20,54000001,5996,4412,4096,African_Caribbean,112,0,0,14383.0,Unknown,49048373,5396666.667,3.0,34,919,36,3,1,1,195,1,0.3340830907647526,0.4327272727272727,0.463235294117647,0.0138797825816163,0.0,0.0,0.0397599399849962,0.0497624406101525,0.0299545357759937,0.2857142857142857,0.4651162790697669,0.1666666666666666,128,9,6,16,1,2544,8,62,111,6000000,472727.2727272727,10000000.0,2000000.0,800000.0,10000000.0,2,6500000,-0.25,-0.25
538977,Georginio,Rutter,2024,1237,France,Plescop,France,20-04-02,Centre-Forward,Attack,Left,182.0,30-06-28,ROGON,https://img.a.transfermarkt.technology/portrait/header/538977-1727785742.jpg?lm=1,GB1,Brighton and Hove Albion Football Club,28000000.0,28000000.0,22,131,160,8,9,15,12,13,7,12,12,6,6,12,12,6,15,8,11,12,12,10,12,10,11,16,7,12,6,11,11,15,14,11,11,13,15,12,12,11,7,9,7,13,1,3,3,2,3,2,2,4,1,2,2,18,13,7,14,10,12,10,14,1,1,1,1,1,1,1,1,1,1,12,10,17,20,77,20,17,26400001,6550,5364,5197,African_Caribbean,128,0,0,16781.0,Unknown,49048380,29316666.67,3.0,34,1153,36,0,0,1,44,3,0.460042339243186,0.5504812834224598,0.5808823529411764,0.0161953327855064,0.0,0.0,0.1397849462365591,0.1397849462365591,0.162847116142115,0.2857142857142857,0.4418604651162785,0.1666666666666666,197,36,31,17,0,4239,2,2,50,32000000,2123333.3333333335,32000000.0,4000000.0,3500000.0,22000000.0,4,18350000,0.7777777777777778,0.7777777777777778
538996,Tanguy,Nianzou,2024,368,France,Paris,France,07-06-02,Centre-Back,Defender,Right,191.0,30-06-27,VV Consulting,https://img.a.transfermarkt.technology/portrait/header/538996-1681463642.jpg?lm=1,ES1,Sevilla FÃºtbol Club S.A.D.,3000000.0,12000000.0,22,134,-85,4,7,12,7,12,4,16,7,5,13,14,6,13,13,16,13,14,15,13,13,13,16,12,12,10,14,14,13,12,11,15,16,13,13,13,15,12,13,12,8,14,1,1,2,2,3,4,2,2,1,2,1,10,16,12,12,12,13,12,10,1,1,20,10,1,1,16,1,15,1,1,1,1,1,85,9,20,66000000,6700,6400,5700,African_Caribbean,134,0,0,76711.0,Unknown,49048365,16000000.0,1.0,34,1122,36,1,1,1,181,2,0.5971156390579518,0.6042780748663101,0.625,0.0740647755374384,0.0,0.0,0.0147536884221055,0.0597649412353088,0.0888635795438762,0.0,0.6511627906976742,0.1666666666666666,117,12,5,22,2,5090,12,86,93,3000000,178125.0,12000000.0,2000000.0,11000000.0,9000000.0,2,0,0.0,-0.4
538998,Timothée,Pembélé,2024,738,France,Beaumont-sur-Oise,France,09-09-02,Right-Back,Defender,Right,183.0,30-06-25,Sport Cover,https://img.a.transfermarkt.technology/portrait/header/538998-1602848514.jpg?lm=1,FR1,Le Havre Athletic Club,2500000.0,7000000.0,22,119,-8,6,13,13,10,12,9,13,7,11,11,12,9,12,12,12,11,12,13,11,10,10,14,12,8,10,13,13,14,14,12,14,14,15,14,13,13,10,11,13,8,13,1,4,3,1,2,1,2,1,2,3,3,12,14,9,10,12,12,11,8,1,10,17,20,1,10,1,1,1,1,1,1,1,1,0,10,20,56265190,5950,5950,3900,African_Caribbean,119,0,0,5752.0,Unknown,49058792,9111392.0,2.0,34,160,36,1,1,1,126,11,0.5375760783275999,0.4117647058823529,0.5147058823529411,0.0055455399586908,0.0,0.0,0.0122530632658164,0.0347586896724181,0.0505924720131114,0.1428571428571428,0.4651162790697669,0.1666666666666666,103,13,8,11,0,4303,3,56,281,2500000,153846.15384615384,7000000.0,1000000.0,4000000.0,5000000.0,4,5000000,0.0,-0.375
539134,Daniel,Maldini,2024,2919,Italy,Milano,Italy,11-10-01,Attacking Midfield,Midfield,Right,188.0,30-06-26,GR Sports,https://img.a.transfermarkt.technology/portrait/header/539134-1695031448.jpg?lm=1,IT1,Associazione Calcio Monza,4500000.0,4500000.0,23,115,145,13,12,12,9,13,14,13,11,5,6,12,11,7,14,9,13,12,11,11,12,11,15,12,7,13,6,13,12,13,13,11,10,12,13,12,11,11,8,5,8,13,1,3,2,1,4,2,1,2,3,2,3,18,13,4,16,11,15,13,12,1,1,1,1,1,1,1,1,1,1,18,20,17,12,74,10,20,4780000,5750,6050,3500,Mediterranean_Hispanic,112,0,0,10672.0,Spezia Calcio,43371896,9111392.0,2.0,52,952,54,3,1,3,28,0,0.5508070918232336,0.3689839572192513,0.463235294117647,0.0102963769074562,0.0,0.0,0.0222555638909727,0.0222555638909727,0.0505924720131114,0.1428571428571428,0.581395348837209,0.2083333333333332,153,43,7,15,1,3264,13,60,81,6000000,438461.53846153844,6000000.0,0.0,300000.0,2000000.0,4,2000000,0.3333333333333333,1.0
539252,Unknown,Costinha,2024,683,Unknown,Unknown,Portugal,26-03-00,Right-Back,Defender,Right,181.0,30-06-28,Sportsbloom,https://img.a.transfermarkt.technology/portrait/header/539252-1728417625.png?lm=1,GR1,Olympiakos Syndesmos Filathlon Peiraios,4000000.0,4000000.0,24,121,140,9,13,12,8,12,7,8,7,12,11,10,7,15,12,10,13,14,12,12,10,11,14,8,8,12,12,14,14,14,12,12,9,15,14,13,13,12,6,10,8,10,3,1,3,1,1,1,3,3,3,3,1,11,13,7,10,11,12,13,12,1,1,1,20,1,20,1,1,1,14,1,1,12,1,77,8,20,1279999,6047,6047,4059,Mediterranean_Hispanic,117,0,0,1649.0,Unknown,83244144,2500000.0,1.0,105,1549,79,1,1,3,141,11,0.5504101614183646,0.4287700534759358,0.4999999999999999,0.0015836123162551,0.0,0.0,0.0197549387346836,0.0197549387346836,0.0138614961526709,0.0,0.418604651162791,0.25,179,17,17,22,1,3855,0,0,0,4500000,381818.1818181818,4500000.0,0.0,,,1,500000,0.125,0.2857142857142857
539665,Fredrik,Oppegård,2024,383,Norway,Oslo,Norway,07-08-02,Left-Back,Defender,Left,175.0,30-06-25,Keypass AS,https://img.a.transfermarkt.technology/portrait/header/539665-1621853412.jpg?lm=1,NL1,Eindhovense Voetbalvereniging Philips Sport Vereniging,600000.0,650000.0,22,108,138,10,12,9,7,11,5,7,9,7,10,11,5,11,12,15,13,10,13,13,12,13,10,11,6,12,8,13,13,12,13,11,10,13,12,13,8,14,9,10,13,12,3,1,2,3,3,3,2,1,3,1,2,9,10,8,12,13,9,11,13,1,20,1,1,18,1,1,16,13,1,1,13,1,1,0,20,8,6043999,5350,5500,3758,African_Caribbean,100,0,0,1503.0,Unknown,53165604,9111392.0,2.0,71,1096,73,1,0,1,62,8,0.4780365175972479,0.3965775401069518,0.3749999999999999,0.0014426321954177,0.0,0.0,0.0027506876719179,0.0030007501875468,0.0505924720131114,0.1428571428571428,0.2790697674418605,0.1666666666666666,130,1,11,4,0,4850,7,64,131,600000,35000.0,650000.0,50000.0,250000.0,650000.0,6,400000,0.0,0.0
539949,Unknown,Tiago Reis,2024,982,Brazil,BrasÃ­lia,Brazil,14-08-99,Centre-Forward,Attack,Right,183.0,30-06-27,VTN IMAGE,https://img.a.transfermarkt.technology/portrait/header/539949-1663319904.jpg?lm=1,PO1,Clube Desportivo Nacional,300000.0,500000.0,25,70,-85,8,9,10,8,11,7,5,9,4,8,11,8,7,11,11,8,7,10,10,13,10,13,15,8,9,8,9,9,11,11,9,6,15,11,7,8,12,8,12,8,12,1,4,3,3,3,1,3,3,4,3,3,16,8,2,9,12,12,12,11,1,1,1,1,1,1,1,1,20,1,1,18,1,1,73,8,20,3109999,3498,3498,999,Mediterranean_Hispanic,68,0,0,64.0,Unknown,2000199270,9111392.0,2.0,10,244,11,0,1,3,56,3,0.2131516274146599,0.1014973262032085,0.1397058823529411,5.310894963050656e-05,0.0,0.0,0.0012503125781445,0.0022505626406601,0.0505924720131114,0.1428571428571428,0.4651162790697669,0.2916666666666665,140,31,4,7,0,5269,1,0,16,300000,20000.0,500000.0,350000.0,,350000.0,4,1050000,0.0,0.0
540664,Dilane,Bakwa,2024,667,France,CrÃ©teil,France,26-08-02,Right Winger,Attack,Left,180.0,30-06-27,Sport Cover,https://img.a.transfermarkt.technology/portrait/header/540664-1618220545.jpg?lm=1,FR1,Racing Club de Strasbourg Alsace,10000000.0,10000000.0,22,110,-75,7,13,15,7,13,5,6,6,6,5,12,8,5,13,8,8,13,12,12,9,11,13,17,8,10,7,11,12,15,12,12,10,12,15,11,11,12,5,11,8,12,1,3,1,3,3,2,4,1,3,2,2,20,12,3,10,11,10,11,17,1,1,1,1,1,1,1,1,1,1,20,13,17,14,78,20,6,15800000,5500,5500,2000,African_Caribbean,106,0,0,3916.0,Unknown,49048348,10000000.0,1.0,34,395,36,0,0,1,159,10,0.4780365175972479,0.2085561497326203,0.4191176470588235,0.0037726666582979,0.0,0.0,0.0497624406101525,0.0497624406101525,0.055529320258896,0.0,0.3953488372093026,0.1666666666666666,129,15,25,13,1,1881,1,4,24,15000000,1130769.2307692308,15000000.0,1000000.0,700000.0,4000000.0,1,3000000,0.5,1.5
540941,Mikkel,Damsgaard,2024,1148,Denmark,Jyllinge,Denmark,03-07-00,Left Winger,Attack,Right,180.0,30-06-27,Boutique Transfers,https://img.a.transfermarkt.technology/portrait/header/540941-1668183899.jpg?lm=1,GB1,Brentford Football Club,10000000.0,20000000.0,24,140,161,12,13,15,12,13,10,6,12,4,4,15,12,6,16,10,13,11,11,12,16,11,14,16,6,15,6,11,11,15,15,12,6,12,15,12,6,11,4,10,4,16,3,2,3,3,2,2,3,2,2,3,1,12,13,4,12,10,13,13,14,1,1,1,1,1,1,1,16,13,16,20,19,17,12,71,15,20,59823893,7000,7250,5000,Northern_European,134,16,4,57996.0,Unknown,27128917,10875000.0,2.0,28,696,30,0,1,7,43,7,0.7095792537708389,0.5294117647058822,0.625,0.055993248404076,0.1052631578947368,0.0526315789473684,0.0497624406101525,0.0997749437359339,0.0603905664046223,0.1428571428571428,0.3953488372093026,0.25,243,22,36,20,0,7776,4,61,186,15000000,784210.5263157894,20000000.0,3000000.0,1750000.0,13000000.0,2,1500000,0.5,0.5
541134,Souffian,El Karouani,2024,200,Netherlands,â€™s-Hertogenbosch,Morocco,19-10-00,Left-Back,Defender,Left,178.0,30-06-26,SEG,https://img.a.transfermarkt.technology/portrait/header/541134-1723460557.jpg?lm=1,NL1,Football Club Utrecht,2400000.0,2400000.0,24,113,135,10,12,10,11,11,11,9,11,6,9,11,11,13,11,6,12,12,10,11,13,16,14,7,11,13,10,14,13,12,13,11,11,11,12,12,10,12,10,11,5,14,2,2,1,2,1,1,1,3,1,3,1,14,11,2,11,12,11,1,13,1,20,1,1,19,1,9,17,12,1,16,1,1,1,74,20,10,3871999,5497,5497,3349,North_African__Middle_Eastern,114,3,0,1600.0,Unknown,37072818,9111392.0,2.0,67,1730,67,1,0,6,92,8,0.477639587192379,0.3528342245989304,0.4779411764705882,0.0015362970702206,0.0197368421052631,0.0,0.0117529382345586,0.0117529382345586,0.0505924720131114,0.1428571428571428,0.3488372093023257,0.25,231,10,25,28,1,5230,3,2,15,5000000,309375.0,5000000.0,200000.0,50000.0,600000.0,1,200000,1.0833333333333333,3.1666666666666665
541231,Sepp,Van Den Berg,2024,1148,Netherlands,Zwolle,Netherlands,20-12-01,Centre-Back,Defender,Right,192.0,30-06-29,Key United,https://img.a.transfermarkt.technology/portrait/header/541231-1692000386.jpg?lm=1,GB1,Brentford Football Club,18000000.0,18000000.0,23,122,-8,3,9,8,8,11,8,13,7,7,13,12,6,13,12,13,13,12,12,12,11,12,14,11,8,12,13,14,13,13,12,12,15,14,13,13,12,12,10,11,7,12,2,2,1,2,2,3,1,2,3,2,1,14,15,6,13,12,15,8,10,1,1,20,16,1,16,1,1,1,1,1,1,1,1,87,10,20,71914876,6100,5750,4100,Northern_European,121,0,0,13919.0,FC Schalke 04,37074900,12750000.0,2.0,67,1710,68,1,1,7,43,2,0.5111140513363324,0.4331550802139037,0.5294117647058822,0.0134317361701881,0.0,0.0,0.0897724431107777,0.0897724431107777,0.0708075224311786,0.1428571428571428,0.6744186046511627,0.2083333333333332,0,0,0,0,0,0,7,30,150,18000000,994444.4444444445,18000000.0,200000.0,1800000.0,5000000.0,6,6900000,0.5,2.6
541555,Enzo,Boyomo,2024,331,France,Toulouse,Cameroon,07-10-01,Centre-Back,Defender,Right,184.0,30-05-29,InterStarDeporte,https://img.a.transfermarkt.technology/portrait/header/541555-1728038860.jpg?lm=1,ES1,Club AtlÃ©tico Osasuna,3000000.0,3000000.0,23,120,156,5,11,11,5,13,7,13,9,10,13,13,8,14,13,10,14,11,12,13,13,13,14,5,7,8,11,12,14,14,12,10,12,12,12,13,13,14,5,13,5,9,3,2,2,1,2,1,1,2,2,2,1,13,12,1,11,12,11,10,12,1,1,20,15,1,1,1,1,1,1,1,1,1,1,76,13,20,3996000,6000,3924,4212,African_Caribbean,124,0,0,3709.0,Unknown,29219115,3400000.0,2.0,34,1512,15,1,1,1,51,2,0.2695157449060598,0.4451336898395721,0.5514705882352942,0.003572783884234,0.0,0.0,0.0147536884221055,0.0147536884221055,0.0188616350454179,0.1428571428571428,0.4883720930232553,0.2083333333333332,219,7,8,38,3,1748,0,0,0,20000000,1523076.923076923,20000000.0,100000.0,,400000.0,2,7400000,5.666666666666667,11.5
542776,Jonathan,Amon,2024,369,United States,"Summerville, South Carolina",United States,30-04-99,Left Winger,Attack,Right,175.0,30-06-26,Unknown,https://img.a.transfermarkt.technology/portrait/header/542776-1538464804.jpg?lm=1,DK1,Lyngby Boldklubben af 1921,500000.0,700000.0,25,105,140,6,10,15,9,14,6,5,10,5,3,12,9,3,14,9,14,9,5,5,8,5,9,16,3,14,3,11,13,17,16,11,7,11,14,8,6,5,3,8,17,12,2,3,3,3,3,1,1,1,1,3,3,11,15,5,12,8,13,12,11,1,1,1,1,1,1,1,18,7,17,20,13,19,12,70,9,20,-1,4500,5750,3250,African_Caribbean,98,2,0,32655.0,Unknown,27128907,9111392.0,2.0,104,1435,102,0,1,1,130,7,0.5111140513363324,0.3422459893048128,0.3602941176470588,0.0315235412661366,0.0131578947368421,0.0,0.0022505626406601,0.0032508127031757,0.0505924720131114,0.1428571428571428,0.2790697674418605,0.2916666666666665,110,20,9,2,0,4530,3,54,489,700000,30000.0,700000.0,125000.0,250000.0,625000.0,1,0,0.4,1.3333333333333333
542796,Mathias,Jørgensen,2024,1053,Denmark,Hundested,Denmark,20-09-00,Right Winger,Attack,Right,185.0,30-06-27,PEP Consulting,https://img.a.transfermarkt.technology/portrait/header/542796-1664283915.png?lm=1,DK1,Aalborg Boldspilklub,600000.0,1000000.0,24,123,155,5,5,11,7,13,8,13,6,11,13,14,7,13,13,12,13,13,15,9,12,11,13,10,14,8,13,13,12,12,11,15,15,13,12,13,14,11,16,17,9,7,2,1,3,1,1,1,1,3,2,2,1,16,14,16,10,16,12,8,8,1,1,20,10,1,1,5,1,1,1,1,1,1,1,79,12,20,628985,6150,6150,5200,Mixed_Race,123,35,2,25000.0,Unknown,27000592,1170000.0,2.0,28,642,30,0,1,4,10,10,0.5640381053188674,0.5508021390374331,0.5441176470588236,0.0241317410948361,0.2302631578947368,0.0263157894736842,0.0027506876719179,0.0047511877969492,0.0064724020111669,0.1428571428571428,0.5116279069767438,0.25,199,99,30,9,0,5503,2,5,61,1300000,92307.69230769231,1300000.0,400000.0,1000000.0,500000.0,6,1800000,1.1666666666666667,0.0
543387,Cheick,Doucouré,2024,873,Mali,Bamako,Mali,08-01-00,Defensive Midfield,Midfield,Right,180.0,30-06-29,Unknown,https://img.a.transfermarkt.technology/portrait/header/543387-1693826399.jpg?lm=1,GB1,Crystal Palace Football Club,35000000.0,35000000.0,24,135,158,8,8,12,11,13,8,12,14,13,13,15,10,13,13,12,13,14,12,12,15,13,15,11,10,12,12,14,14,13,13,12,12,14,13,13,14,13,10,12,8,11,3,2,1,1,2,2,2,1,1,1,3,12,12,8,9,11,14,12,20,1,1,6,1,1,1,20,1,19,1,1,1,1,1,73,10,20,31958043,6745,6745,3745,African_Caribbean,134,8,0,52196.0,Unknown,13194021,22600000.0,1.0,61,133,61,3,1,1,58,4,0.6427626356178884,0.395187165775401,0.625,0.0503926682612226,0.0526315789473684,0.0,0.1747936984246061,0.1747936984246061,0.1255312647573543,0.0,0.3953488372093026,0.25,197,8,10,36,1,3102,5,59,187,35000000,2093750.0,35000000.0,200000.0,,3500000.0,1,7000000,0.0,0.0
543499,Mohammed,Kudus,2024,379,Ghana,Accra,Ghana,02-08-00,Attacking Midfield,Midfield,Left,177.0,30-06-28,Unknown,https://img.a.transfermarkt.technology/portrait/header/543499-1668429218.jpg?lm=1,GB1,West Ham United Football Club,50000000.0,50000000.0,24,142,160,12,10,15,13,14,11,7,10,11,7,14,14,6,16,15,14,13,13,11,12,10,13,13,6,13,7,12,12,16,15,14,8,14,14,13,14,10,5,8,9,13,2,1,2,3,3,1,3,2,4,1,1,16,11,12,12,10,13,13,14,1,1,1,1,1,1,13,12,18,12,12,20,12,17,70,20,12,33817504,7089,6489,5489,African_Caribbean,135,16,5,18000.0,Unknown,13200568,26000000.0,2.0,39,20,41,3,0,1,220,0,0.6088912410690659,0.581711229946524,0.6323529411764706,0.0173724202327716,0.1052631578947368,0.0657894736842105,0.2498124531132783,0.2498124531132783,0.1444206783521764,0.1428571428571428,0.3255813953488373,0.25,223,65,23,22,1,6734,8,56,84,50000000,2480000.0,50000000.0,4000000.0,800000.0,15000000.0,2,8000000,0.0,0.1111111111111111
543501,Ibrahim,Sadiq,2024,1090,Ghana,Accra,Ghana,07-05-00,Right Winger,Attack,Right,167.0,30-06-28,Nordic Sky,https://img.a.transfermarkt.technology/portrait/header/543501-1721657462.jpg?lm=1,NL1,Alkmaar Zaanstreek,2500000.0,3000000.0,24,116,137,9,11,13,10,13,9,4,11,7,4,12,11,7,13,13,12,12,12,12,10,12,12,12,6,13,7,13,13,16,12,8,6,11,15,12,8,12,12,9,14,10,2,3,1,3,2,2,1,1,3,3,1,13,12,12,11,7,10,10,10,1,1,1,1,1,1,1,13,1,13,18,1,20,14,65,6,20,1230102,5800,4244,1750,African_Caribbean,113,0,0,839.0,Unknown,13200569,4000000.0,1.0,39,20,41,0,1,1,16,10,0.3118549880920879,0.1818181818181818,0.4705882352941176,0.0008014623307876,0.0,0.0,0.0122530632658164,0.0147536884221055,0.0221950609739159,0.0,0.0930232558139532,0.25,159,58,19,19,2,7429,11,58,303,4000000,216666.66666666666,4000000.0,1000000.0,100000.0,600000.0,2,1000000,0.6,0.3333333333333333
543666,Stefano,Turati,2024,2919,Italy,Milano,Italy,05-09-01,Goalkeeper,Goalkeeper,Right,188.0,30-06-25,Unique Sports Group,https://img.a.transfermarkt.technology/portrait/header/543666-1686126590.jpg?lm=1,IT1,Associazione Calcio Monza,7000000.0,7000000.0,23,121,159,1,2,1,1,7,3,6,1,6,3,6,3,1,8,10,11,10,11,13,8,12,15,4,13,8,15,13,14,12,12,11,13,12,13,12,12,13,4,14,5,7,12,14,12,8,14,8,16,15,11,10,13,11,13,4,13,15,14,12,11,20,1,1,1,1,1,1,1,1,1,1,1,1,1,85,7,20,8961000,6050,6050,3158,Mediterranean_Hispanic,121,0,0,5337.0,Frosinone,43378804,65000.0,1.0,52,952,54,2,1,3,28,5,0.5508070918232336,0.3324064171122994,0.5294117647058822,0.005144808793297,0.0,0.0,0.0347586896724181,0.0347586896724181,0.0003333425928498,0.0,0.581395348837209,0.2083333333333332,0,0,0,0,0,0,4,10,36,7500000,600000.0,7500000.0,0.0,400000.0,900000.0,3,1800000,0.07142857142857142,0.07142857142857142
543727,Botond,Balogh,2024,130,Hungary,Sopron,Hungary,06-06-02,Centre-Back,Defender,Right,189.0,30-06-27,FMF Hungary Kft,https://img.a.transfermarkt.technology/portrait/header/543727-1712348148.jpg?lm=1,IT1,Parma Calcio 1913,1800000.0,1800000.0,22,110,-75,5,5,7,5,10,6,13,6,5,13,11,5,14,11,11,14,15,9,13,8,11,15,9,9,7,12,13,13,13,12,13,14,10,12,11,12,11,6,15,6,6,1,2,3,1,1,1,1,3,3,1,2,10,13,5,11,10,14,7,20,1,1,20,1,1,1,1,1,1,1,1,1,1,1,80,7,20,7479000,5500,4909,2902,Northern_European,110,1,0,4161.0,Unknown,38059041,150000.0,1.0,45,1395,47,1,1,7,155,2,0.3998412278380524,0.3050267379679144,0.4485294117647059,0.0040092428884702,0.006578947368421,0.0,0.0087521880470117,0.0087521880470117,0.0008055779327203,0.0,0.6046511627906974,0.1666666666666666,82,2,1,18,1,3282,2,8,58,2500000,183333.33333333334,2500000.0,150000.0,800000.0,900000.0,0,0,0.3888888888888889,1.7777777777777777
543771,Kristjan,Asllani,2024,46,Albania,Elbasan,Albania,09-03-02,Defensive Midfield,Midfield,Right,175.0,30-06-28,BE Sport Management,https://img.a.transfermarkt.technology/portrait/header/543771-1716969431.jpg?lm=1,IT1,Football Club Internazionale Milano S.p.A.,18000000.0,18000000.0,22,132,159,12,11,11,10,15,13,7,13,5,9,15,13,10,13,10,14,12,14,12,13,12,14,10,10,14,14,14,12,13,12,13,9,13,12,16,10,13,8,14,6,11,3,1,1,2,3,2,1,3,3,3,4,15,15,8,12,13,15,12,12,1,1,1,1,1,1,19,1,20,1,1,16,1,1,68,10,20,36800002,6600,4419,5198,Mediterranean_Hispanic,129,4,0,27299.0,FC Internazionale Milano,43424567,15700000.0,1.0,0,455,0,3,1,3,89,4,0.335009261709447,0.5505882352941176,0.588235294117647,0.0263516951893913,0.0263157894736842,0.0,0.0897724431107777,0.0897724431107777,0.0871968665796272,0.0,0.2790697674418605,0.1666666666666666,193,25,10,23,1,4925,3,4,8,18000000,1483333.3333333333,18000000.0,0.0,,12000000.0,1,2000000,0.0,0.2857142857142857
544106,ÃÂScar,Gil,2024,2727,Spain,Elche,Spain,26-04-98,Right-Back,Defender,Right,175.0,30-06-26,LIAN Sports Group,https://img.a.transfermarkt.technology/portrait/header/544106-1625835288.jpg?lm=1,BE1,Oud-Heverlee Leuven,800000.0,3000000.0,26,129,141,7,10,9,9,11,7,9,8,11,14,12,8,13,10,6,10,15,9,12,7,12,15,15,10,11,12,16,18,15,14,10,10,14,15,16,14,11,2,9,8,12,3,2,3,1,3,1,3,2,3,1,2,12,11,3,16,12,18,18,2,1,12,1,20,1,18,1,1,1,11,1,1,1,1,75,9,20,4121075,6450,6450,4450,Mediterranean_Hispanic,126,1,0,9588.0,Unknown,67227188,500000.0,1.0,89,457,89,1,1,3,146,11,0.6037311458057687,0.4705882352941176,0.5661764705882353,0.0092496477911022,0.006578947368421,0.0,0.0037509377344336,0.0147536884221055,0.0027500763910108,0.0,0.2790697674418605,0.3333333333333332,167,2,9,48,1,2750,1,5,31,700000,26666.666666666668,3000000.0,1000000.0,,,2,200000,-0.125,-0.5333333333333333
545538,Lameck,Banda,2024,1005,Zambia,Lusaka,Zambia,29-01-01,Left Winger,Attack,Right,169.0,30-06-26,Wasserman,https://img.a.transfermarkt.technology/portrait/header/545538-1663744937.jpg?lm=1,IT1,Unione Sportiva Lecce,6000000.0,6000000.0,23,123,149,8,11,13,10,13,9,7,7,7,7,9,11,7,12,11,8,11,10,10,10,11,13,9,8,12,8,10,10,16,15,12,9,12,16,12,7,12,5,11,5,7,2,3,1,2,3,3,3,3,3,1,3,12,13,5,12,12,13,14,12,1,1,1,1,1,1,1,1,1,1,20,1,18,17,69,9,20,4659999,6150,5107,3881,African_Caribbean,112,4,0,14621.0,Unknown,13205265,850000.0,3.0,112,877,107,0,1,1,206,7,0.4260386345594072,0.4097326203208555,0.463235294117647,0.0141095994909265,0.0263157894736842,0.0,0.0297574393598399,0.0297574393598399,0.0046945748493013,0.2857142857142857,0.13953488372093,0.2083333333333332,150,17,13,29,2,2446,8,34,93,6000000,407142.85714285716,6000000.0,50000.0,350000.0,200000.0,3,1750000,0.0,0.0
545647,Sergio,Carreira,2024,940,Spain,Vigo,Spain,13-10-00,Right-Back,Defender,Right,170.0,30-06-25,MRH Football Agency,https://img.a.transfermarkt.technology/portrait/header/545647-1637743729.jpg?lm=1,ES1,Real Club Celta de Vigo S. A. D.,1200000.0,1500000.0,24,128,153,7,13,13,7,12,7,9,8,12,13,13,7,12,14,15,13,15,13,13,12,12,14,9,8,12,12,14,13,14,13,15,6,10,14,14,12,13,8,4,8,19,3,1,3,1,3,2,3,3,3,2,2,10,10,5,10,13,9,12,13,1,1,1,20,1,19,1,1,1,14,1,1,13,1,67,9,20,12930000,6400,6400,4900,Mediterranean_Hispanic,124,0,0,8988.0,Villarreal,67263766,9111392.0,2.0,89,1587,89,1,1,3,165,11,0.5971156390579518,0.5187165775401069,0.5514705882352942,0.0086702774314966,0.0,0.0,0.0057514378594648,0.0072518129532383,0.0505924720131114,0.1428571428571428,0.1627906976744184,0.25,175,4,10,9,0,4243,0,0,0,1200000,88461.53846153847,1500000.0,300000.0,50000.0,1000000.0,4,500000,0.0,0.0
546212,Unknown,Diego Costa,2024,16704,Brazil,Campo Grande,Brazil,21-07-99,Centre-Back,Defender,Right,184.0,30-06-29,ADM Esporte,https://img.a.transfermarkt.technology/portrait/header/546212-1721636039.png?lm=1,RU1,FK Krasnodar,6000000.0,6000000.0,25,142,168,11,12,11,14,14,11,15,11,7,5,12,15,9,13,19,13,19,14,12,13,15,19,15,12,16,6,16,17,12,11,12,14,9,13,11,15,11,18,16,14,13,2,4,3,3,2,2,3,1,1,1,1,16,17,13,12,15,14,5,3,1,1,1,1,1,1,1,1,1,1,9,13,12,20,87,15,20,8874269,7100,7100,6250,Native_American,142,24,10,69595.0,Unknown,55002038,7500000.0,1.0,10,309,11,1,1,5,78,2,0.6897327335273882,0.6631016042780749,0.6838235294117647,0.0671934430725168,0.1578947368421052,0.131578947368421,0.0297574393598399,0.0297574393598399,0.041640045556821,0.0,0.4883720930232553,0.2916666666666665,181,6,0,36,1,7399,1,22,158,7000000,371428.5714285714,7000000.0,500000.0,,,1,2500000,1.0,0.75
546213,Unknown,Tuta,2024,24,Brazil,"SÃ£o Paulo, Sao Paulo",Brazil,04-07-99,Centre-Back,Defender,Right,185.0,30-06-26,StarFactory Brasil,https://img.a.transfermarkt.technology/portrait/header/546213-1663064755.jpg?lm=1,L1,Eintracht Frankfurt FuÃŸball AG,12000000.0,15000000.0,25,130,147,5,9,9,6,12,5,13,6,13,13,11,9,14,12,13,13,14,14,12,10,11,14,8,11,8,14,13,14,14,14,14,14,16,15,14,13,13,9,13,5,11,1,2,3,2,1,3,4,3,3,2,1,9,14,9,10,13,10,12,11,1,1,20,14,1,10,12,1,1,1,1,1,1,1,75,10,20,5802967,6600,6000,4600,Mixed_Race,131,0,0,8500.0,Unknown,19290884,1800000.0,1.0,10,1457,11,1,1,4,63,2,0.5441915850754168,0.4866310160427807,0.6029411764705883,0.0081990562056842,0.0,0.0,0.0597649412353088,0.0747686921730432,0.0099724992360898,0.0,0.5116279069767438,0.2916666666666665,191,11,3,28,1,4016,6,7,26,15000000,694736.8421052631,15000000.0,3000000.0,,2000000.0,2,2600000,0.25,0.0
546543,Darwin,Núñez,2024,31,Uruguay,Artigas,Uruguay,24-06-99,Centre-Forward,Attack,Right,187.0,30-06-28,Gestifute,https://img.a.transfermarkt.technology/portrait/header/546543-1681827179.jpg?lm=1,GB1,Liverpool Football Club,65000000.0,70000000.0,25,150,164,7,12,12,15,10,11,13,13,5,6,11,15,9,12,16,13,17,12,13,14,11,17,14,6,15,6,16,18,17,13,12,15,15,17,16,15,12,7,11,9,10,4,3,3,1,3,2,1,1,1,1,1,12,16,3,10,12,14,12,11,1,1,1,1,1,1,1,1,1,1,14,1,12,20,82,13,20,74455712,7300,6950,6000,Mediterranean_Hispanic,149,11,2,162388.0,Unknown,78090138,43666666.67,3.0,106,95,103,0,1,3,129,3,0.6698862132839376,0.6363636363636364,0.7352941176470587,0.1567959660373095,0.0723684210526315,0.0263157894736842,0.3248312078019504,0.3498374593648412,0.2425715529320259,0.2857142857142857,0.5581395348837206,0.2916666666666665,269,107,42,34,1,6498,20,92,309,65000000,3085714.285714286,70000000.0,5000000.0,,1800000.0,3,24250000,-0.07142857142857142,0.0
546880,Brandon,Soppy,2024,800,France,Aubervilliers,France,21-02-02,Right-Back,Defender,Right,180.0,30-06-26,CAA Stellar,https://img.a.transfermarkt.technology/portrait/header/546880-1629979523.jpg?lm=1,IT1,Atalanta Bergamasca Calcio S.p.a.,2000000.0,10000000.0,22,134,-85,7,12,11,6,11,5,9,8,11,11,11,7,11,12,14,12,14,12,11,10,10,13,12,8,9,11,14,14,16,14,13,11,15,15,13,15,12,13,12,5,13,1,2,2,3,1,2,2,1,1,3,1,10,14,12,15,11,13,11,18,1,18,10,20,18,20,1,14,1,16,1,1,1,1,80,10,20,53000000,6700,5778,4773,African_Caribbean,119,0,0,14808.0,Unknown,49048382,5950000.0,2.0,34,106,36,1,1,1,31,11,0.5148187351151098,0.5051336898395722,0.5147058823529411,0.0142901699196702,0.0,0.0,0.0097524381095273,0.0497624406101525,0.0330286952415344,0.1428571428571428,0.3953488372093026,0.1666666666666666,90,0,4,16,0,4284,10,28,64,1500000,-107142.85714285714,10000000.0,3000000.0,7000000.0,10000000.0,5,10500000,-0.25,-0.75
547248,Iker,Álvarez,2024,1050,Andorra,Andorra la Vella,Andorra,25-07-01,Goalkeeper,Goalkeeper,Right,190.0,30-06-26,Promoesport,https://img.a.transfermarkt.technology/portrait/header/547248-1698946239.jpg?lm=1,ES1,Villarreal Club de FÃºtbol S.A.D.,800000.0,800000.0,23,110,146,3,2,3,3,8,8,2,1,2,3,10,4,2,5,11,11,11,11,11,9,12,9,1,10,1,15,11,10,10,12,11,15,7,12,6,6,11,10,4,13,13,15,10,11,5,15,15,15,13,8,12,10,19,9,2,10,11,11,11,11,20,1,1,1,1,1,1,1,1,1,1,1,1,1,0,11,20,5119999,5500,5500,3500,Mediterranean_Hispanic,114,7,0,1869.0,Unknown,67295644,9111392.0,2.0,2,69,2,2,1,3,216,5,0.4780365175972479,0.3689839572192513,0.4779411764705882,0.0017960481147771,0.0460526315789473,0.0,0.0037509377344336,0.0037509377344336,0.0505924720131114,0.1428571428571428,0.6279069767441858,0.2083333333333332,0,0,0,0,0,0,1,9,198,800000,62500.0,800000.0,0.0,,300000.0,1,150000,0.0,0.0
547985,Fabiano,Parisi,2024,430,Italy,Solofra,Italy,09-11-00,Left-Back,Defender,Left,178.0,30-06-28,Unknown,https://img.a.transfermarkt.technology/portrait/header/547985-1663677780.jpg?lm=1,IT1,Associazione Calcio Fiorentina,9500000.0,10000000.0,24,133,159,10,13,15,9,13,6,7,10,8,11,13,6,14,13,12,12,13,12,13,11,12,16,5,10,12,12,13,14,16,15,14,8,12,15,14,11,14,15,11,7,12,1,1,1,2,2,1,1,3,1,2,2,13,16,8,12,12,16,14,12,1,20,1,1,19,1,1,15,9,1,1,1,1,1,70,20,7,27200002,6650,6650,5000,Mediterranean_Hispanic,127,0,0,3654.0,Unknown,43429372,5225000.0,2.0,52,1394,54,1,0,3,26,8,0.6301931727970362,0.5294117647058822,0.5735294117647058,0.0035196749346035,0.0,0.0,0.0472618154538634,0.0497624406101525,0.0290008055779327,0.1428571428571428,0.3488372093023257,0.25,234,8,13,48,3,2823,3,7,31,5000000,310937.5,10000000.0,2500000.0,75000.0,2500000.0,2,2250000,-0.47368421052631576,-0.47368421052631576
548031,Yusuf,Demir,2024,141,Austria,Wien,Austria,02-06-03,Right Winger,Attack,Left,173.0,30-06-26,SBE Management AG,https://img.a.transfermarkt.technology/portrait/header/548031-1671104592.png?lm=1,TR1,Galatasaray Spor KulÃ¼bÃ¼,2500000.0,12000000.0,21,115,-8,12,9,15,10,14,12,7,11,5,5,12,8,6,16,7,10,11,9,11,13,12,14,15,5,12,6,12,9,14,15,12,8,12,13,11,7,6,5,6,5,14,2,1,1,1,2,1,3,1,1,2,1,8,17,1,12,11,15,16,16,1,1,1,1,1,1,1,8,14,12,15,18,20,16,69,20,9,10059683,6050,5900,4100,North_African__Middle_Eastern,110,4,0,20832.0,Unknown,16283659,6000000.0,1.0,6,1663,7,0,0,6,102,10,0.530960571579783,0.4331550802139037,0.4485294117647059,0.0201070483301097,0.0263157894736842,0.0,0.0122530632658164,0.0597649412353088,0.0333064807355759,0.0,0.2325581395348837,0.125,121,20,10,6,0,5168,19,60,131,2200000,88636.36363636363,12000000.0,3000000.0,5000000.0,2700000.0,5,10200000,-0.18518518518518517,-0.37142857142857144
548111,Álex,Baena,2024,1050,Spain,Roquetas de Mar,Spain,20-07-01,Left Winger,Attack,Right,174.0,30-06-28,CAA Stellar,https://img.a.transfermarkt.technology/portrait/header/548111-1714487266.jpg?lm=1,ES1,Villarreal Club de FÃºtbol S.A.D.,40000000.0,40000000.0,23,131,156,10,11,14,12,13,9,10,11,9,8,15,11,9,15,13,12,11,11,11,14,13,9,14,3,11,12,11,11,12,14,13,8,12,12,12,11,12,10,12,5,20,1,1,3,3,2,2,3,3,1,1,1,19,10,8,11,12,10,13,12,1,1,1,1,1,1,1,1,14,1,18,20,16,14,69,15,20,16950000,6550,6550,4550,Mediterranean_Hispanic,126,0,0,11599.0,Unknown,67287665,9111392.0,2.0,89,1247,89,0,1,3,216,7,0.6169621593014025,0.481283422459893,0.5661764705882353,0.0111915041130467,0.0,0.0,0.1997999499874969,0.1997999499874969,0.0505924720131114,0.1428571428571428,0.2558139534883721,0.2083333333333332,206,30,48,61,1,2875,2,1,8,50000000,3112500.0,50000000.0,0.0,200000.0,3000000.0,3,7000000,0.25,1.0
548188,Germán,Valera,2024,1049,Spain,Murcia,Spain,16-03-02,Right Winger,Attack,Left,170.0,30-06-28,Excellence Sport,https://img.a.transfermarkt.technology/portrait/header/548188-1588605205.jpg?lm=1,ES1,Valencia Club de FÃºtbol S. A. D.,2000000.0,2500000.0,22,109,-75,11,11,14,10,13,10,7,9,10,3,10,6,4,14,9,11,12,9,10,13,10,11,15,12,11,5,7,8,15,15,12,7,9,15,9,8,9,5,19,12,13,2,2,3,3,1,2,2,3,1,2,3,10,11,7,12,11,12,13,17,1,1,1,1,1,1,1,16,1,18,18,1,20,15,68,20,6,21825000,5450,5450,2502,Mediterranean_Hispanic,103,0,0,1779.0,F.C. Andorra,67278144,9111392.0,2.0,89,993,89,0,0,3,208,10,0.4714210108494311,0.2622459893048128,0.3970588235294117,0.0017091425608363,0.0,0.0,0.0097524381095273,0.0122530632658164,0.0505924720131114,0.1428571428571428,0.1627906976744184,0.1666666666666666,163,12,6,12,0,3964,1,18,62,1500000,86666.66666666667,2500000.0,1000000.0,1800000.0,1500000.0,5,2700000,-0.25,-0.25
548193,Zeno,Debast,2024,336,Belgium,Halle,Belgium,24-10-03,Centre-Back,Defender,Right,191.0,30-06-29,TEAM DEBAST,https://img.a.transfermarkt.technology/portrait/header/548193-1725523076.jpg?lm=1,PO1,Sporting Clube de Portugal,22000000.0,22000000.0,21,109,-85,6,12,8,8,13,8,14,8,8,14,15,9,12,13,14,12,10,13,14,12,10,12,13,7,8,12,12,12,11,12,12,14,10,11,10,9,11,8,12,11,10,3,1,3,3,1,1,2,2,3,2,3,10,14,4,11,12,11,13,20,1,1,20,1,1,1,12,1,1,1,1,1,1,1,73,10,20,24620000,5500,5500,2138,Northern_European,109,0,0,2500.0,Unknown,18115016,15500000.0,1.0,7,591,8,1,1,7,193,2,0.4780365175972479,0.2233155080213903,0.4411764705882353,0.0024053526096289,0.0,0.0,0.1097774443610902,0.1097774443610902,0.0860857246034612,0.0,0.6511627906976742,0.125,127,1,3,18,1,3751,5,21,92,24000000,1685714.2857142857,24000000.0,0.0,4000000.0,22000000.0,2,4000000,0.3333333333333333,0.8461538461538461
548254,Nathan,Ngoy,2024,3057,Unknown,Unknown,Belgium,10-06-03,Centre-Back,Defender,Right,183.0,30-06-26,Stirr Associates,https://img.a.transfermarkt.technology/portrait/header/548254-1705573683.jpg?lm=1,BE1,Royal Standard Club de LiÃ¨ge,4000000.0,4000000.0,21,104,-75,4,4,9,8,12,4,11,9,9,13,13,5,12,13,7,12,14,12,12,10,11,11,8,9,9,10,13,13,12,13,11,11,13,13,12,12,11,11,11,5,16,1,2,1,2,3,1,1,3,3,4,3,13,9,1,12,12,12,11,16,1,1,20,1,1,1,1,1,1,1,1,1,1,1,71,7,20,19260000,5099,5099,1999,African_Caribbean,103,0,0,1000.0,Unknown,18114991,9111392.0,2.0,105,1549,8,1,1,1,176,2,0.4249801534797566,0.2084491978609625,0.3970588235294117,0.0009569267106151,0.0,0.0,0.0197549387346836,0.0197549387346836,0.0505924720131114,0.1428571428571428,0.4651162790697669,0.125,42,1,0,12,1,1637,10,70,172,3500000,275000.0,4000000.0,500000.0,450000.0,3500000.0,0,0,0.0,-0.125
548270,Furkan,Bay?R,2024,11282,TÃ¼rkiye,Izmir,TÃ¼rkiye,09-02-00,Centre-Back,Defender,Right,188.0,30-06-25,Unknown,https://img.a.transfermarkt.technology/portrait/header/548270-1724670960.jpg?lm=1,TR1,Alanyaspor,2100000.0,3000000.0,24,110,135,5,12,11,5,12,5,14,5,6,13,11,6,14,11,12,10,14,11,16,7,9,15,7,5,8,11,13,13,15,15,11,12,13,13,13,12,6,12,10,11,14,2,1,2,2,2,1,1,3,3,1,1,11,11,11,10,9,12,11,9,1,1,20,10,1,1,1,1,1,1,1,1,1,1,0,10,20,2666608,5650,5650,3650,North_African__Middle_Eastern,113,0,0,2764.0,Unknown,70111586,115000.0,1.0,100,682,100,1,1,6,15,2,0.4978830378406986,0.3850267379679144,0.4705882352941176,0.0026602755678553,0.0,0.0,0.0102525631407851,0.0147536884221055,0.0006111280868913,0.0,0.581395348837209,0.25,137,3,2,24,0,1914,0,0,0,1500000,72500.0,3000000.0,600000.0,50000.0,350000.0,1,125000,-0.34782608695652173,-0.4
548348,Kiliann,Sildillia,2024,60,France,Metz,France,16-05-02,Right-Back,Defender,Right,186.0,30-06-26,KS__Team,https://img.a.transfermarkt.technology/portrait/header/548348-1691998588.jpg?lm=1,L1,Sport-Club Freiburg,15000000.0,18000000.0,22,122,-8,6,10,9,6,12,7,15,6,16,12,11,7,13,11,10,12,12,8,11,8,12,13,9,11,11,12,14,14,15,12,7,13,13,14,14,10,12,9,12,7,11,3,1,1,1,3,2,3,1,3,4,1,14,12,9,14,14,12,11,7,1,1,19,20,1,17,13,1,1,12,1,1,1,1,79,11,20,60800000,6087,5130,4575,African_Caribbean,116,0,0,5273.0,Unknown,49048381,9111392.0,2.0,34,945,36,1,1,1,189,11,0.429081767663403,0.4839572192513368,0.4926470588235294,0.0050830092882724,0.0,0.0,0.0747686921730432,0.0897724431107777,0.0505924720131114,0.1428571428571428,0.5348837209302322,0.1666666666666666,160,10,4,26,2,3010,4,10,19,10000000,712500.0,18000000.0,5000000.0,400000.0,12000000.0,1,550000,-0.3333333333333333,-0.4444444444444444
548729,Zeki,Amdouni,2024,294,Switzerland,GenÃ¨ve,Switzerland,04-12-00,Centre-Forward,Attack,Right,185.0,30-06-25,Unknown,https://img.a.transfermarkt.technology/portrait/header/548729-1715938870.jpg?lm=1,PO1,Sport Lisboa e Benfica,12000000.0,15000000.0,24,121,143,7,8,15,13,12,9,12,12,4,5,12,13,6,15,8,13,8,13,10,13,12,12,14,7,14,5,12,13,10,12,13,12,13,12,13,12,11,9,11,8,12,1,3,3,1,4,1,2,2,2,1,2,9,12,7,11,11,13,9,13,1,1,1,1,1,1,1,6,4,6,13,19,12,20,79,15,20,5988411,6061,6405,3904,North_African__Middle_Eastern,121,0,0,7949.0,FC Basel 1893,84154064,8366666.667,3.0,92,533,92,0,1,6,188,3,0.5977771897327335,0.4121925133689839,0.5294117647058822,0.0076670010921131,0.0,0.0,0.0597649412353088,0.0747686921730432,0.0464549941220589,0.2857142857142857,0.5116279069767438,0.25,265,86,14,24,0,4063,3,16,66,15000000,986666.6666666666,15000000.0,3000000.0,200000.0,600000.0,4,8900000,0.25,0.0
549006,Gonçalo,Inácio,2024,336,Portugal,Almada,Portugal,25-08-01,Centre-Back,Defender,Left,186.0,30-06-27,MRP.POSITIONUMBER,https://img.a.transfermarkt.technology/portrait/header/549006-1716296254.jpg?lm=1,PO1,Sporting Clube de Portugal,45000000.0,45000000.0,23,138,156,7,11,12,10,12,7,14,9,9,15,14,10,13,14,15,13,12,14,15,14,13,13,4,12,10,14,14,13,12,12,13,15,15,13,14,14,14,7,11,9,10,4,1,2,4,2,2,4,3,2,2,2,8,13,6,14,15,14,14,13,1,10,20,1,1,1,1,1,1,1,1,1,1,1,80,20,8,37179998,6900,6900,5400,Mediterranean_Hispanic,138,0,0,18522.0,Unknown,83228731,9111392.0,2.0,76,46,79,1,0,3,193,2,0.6632707065361206,0.5721925133689839,0.6544117647058822,0.0178764724456285,0.0,0.0,0.2248062015503876,0.2248062015503876,0.0505924720131114,0.1428571428571428,0.5348837209302322,0.2083333333333332,201,18,12,23,0,5554,9,20,28,45000000,3384615.3846153845,45000000.0,0.0,,23000000.0,0,0,0.0,0.125
549027,Martim,Neto,2024,2425,Portugal,Viana do Castelo,Portugal,14-01-03,Central Midfield,Midfield,Right,185.0,30-06-25,Unknown,https://img.a.transfermarkt.technology/portrait/header/549027-1710239527.png?lm=1,PO1,Rio Ave Futebol Clube,3000000.0,3000000.0,21,109,-8,10,10,12,10,13,7,10,11,4,10,13,9,10,12,11,12,12,12,12,14,12,15,13,9,12,8,13,13,12,12,13,12,13,13,11,12,13,8,12,5,12,2,2,1,2,3,3,3,1,3,1,2,14,15,6,12,14,15,15,16,1,1,1,1,1,1,10,1,20,1,1,13,1,1,78,8,20,29000000,5450,5450,2700,Mediterranean_Hispanic,110,0,0,3499.0,Unknown,83261901,9111392.0,2.0,76,1580,79,3,1,3,171,1,0.4714210108494311,0.2834224598930481,0.4485294117647059,0.0033700042583721,0.0,0.0,0.0147536884221055,0.0147536884221055,0.0505924720131114,0.1428571428571428,0.5116279069767438,0.125,0,0,0,0,0,0,2,17,81,3000000,350000.0,3000000.0,200000.0,200000.0,2500000.0,2,1200000,0.0,0.2
549038,Rodrigo,Pinheiro,2024,3329,Portugal,GuimarÃ£es,Portugal,28-08-02,Right-Back,Defender,Right,183.0,30-06-28,MRP.POSITIONUMBER,https://img.a.transfermarkt.technology/portrait/header/549038-1519849965.jpg?lm=1,PO1,Futebol Clube de FamalicÃ£o,1300000.0,1300000.0,22,99,-8,7,12,11,7,11,6,7,8,11,13,11,7,12,11,9,11,9,9,11,9,10,13,11,7,12,11,12,13,13,13,7,11,10,14,12,10,12,7,11,6,15,1,3,2,2,1,1,2,2,3,1,3,10,13,5,13,10,11,11,17,1,14,1,20,11,16,1,1,1,1,1,1,1,1,66,8,20,25050002,4945,4945,3449,Mediterranean_Hispanic,97,0,0,2350.0,Unknown,83228783,9111392.0,2.0,76,579,79,1,1,3,99,11,0.4046043926964805,0.3635294117647058,0.3529411764705882,0.0022605100197275,0.0,0.0,0.0062515628907226,0.0062515628907226,0.0505924720131114,0.1428571428571428,0.4651162790697669,0.1666666666666666,127,4,7,22,0,1847,0,0,0,1500000,130000.0,1500000.0,0.0,250000.0,600000.0,1,200000,0.15384615384615385,0.875
550106,Matteo,Cancellieri,2024,130,Italy,Roma,Italy,12-02-02,Right Winger,Attack,Left,180.0,30-06-25,MM-Management,https://img.a.transfermarkt.technology/portrait/header/550106-1687191024.jpg?lm=1,IT1,Parma Calcio 1913,4800000.0,5000000.0,22,130,-85,11,12,14,11,12,12,10,13,3,4,12,11,5,13,9,11,11,12,13,12,12,16,13,8,14,6,13,13,15,12,13,10,12,16,12,10,12,7,11,5,17,3,1,2,1,2,3,4,3,2,2,2,12,15,6,11,13,14,14,14,1,1,1,1,1,1,1,10,1,18,12,12,20,17,79,20,9,7289863,6500,7100,3900,Mediterranean_Hispanic,124,1,0,24439.0,S.S. Lazio,43424754,6250000.0,2.0,52,1244,54,0,0,3,155,10,0.6897327335273882,0.4117647058823529,0.5514705882352942,0.023590029808605,0.006578947368421,0.0,0.0237559389847461,0.0247561890472618,0.0346954082057834,0.1428571428571428,0.3953488372093026,0.1666666666666666,162,47,17,27,1,3488,5,8,17,5000000,490000.0,5000000.0,200000.0,,5000000.0,4,3300000,0.041666666666666664,0.041666666666666664
550108,Nicola,Zalewski,2024,12,Italy,Tivoli,Poland,23-01-02,Left Midfield,Midfield,Right,175.0,30-06-25,Unknown,https://img.a.transfermarkt.technology/portrait/header/550108-1725530902.jpg?lm=1,IT1,Associazione Sportiva Roma,12000000.0,20000000.0,22,137,-85,10,11,15,8,15,9,5,10,4,10,14,11,13,14,12,12,12,11,10,14,11,14,16,4,14,10,12,12,15,15,12,7,13,14,12,8,14,9,15,4,18,2,2,3,2,3,1,3,2,2,3,2,13,14,7,13,13,12,13,12,1,15,1,10,20,12,1,18,1,10,20,10,10,1,63,15,20,55520001,6847,5922,4446,Northern_European,124,5,0,17885.0,Unknown,43426126,9111392.0,2.0,52,1495,78,3,1,7,29,6,0.5338713945488225,0.4701604278074865,0.5514705882352942,0.0172613742471806,0.0328947368421052,0.0,0.0597649412353088,0.0997749437359339,0.0505924720131114,0.1428571428571428,0.2790697674418605,0.1666666666666666,199,25,28,16,0,6252,5,5,12,10000000,910000.0,20000000.0,4000000.0,,15000000.0,1,100000,-0.16666666666666666,-0.375
550550,Gonçalo,Ramos,2024,583,Portugal,OlhÃ£o,Portugal,20-06-01,Centre-Forward,Attack,Right,185.0,30-06-28,Gestifute,https://img.a.transfermarkt.technology/portrait/header/550550-1681906158.jpg?lm=1,FR1,Paris Saint-Germain Football Club,50000000.0,50000000.0,23,140,152,10,10,13,13,13,8,15,10,5,7,12,12,8,14,13,13,14,13,14,13,14,15,13,10,14,8,15,15,13,14,14,12,15,14,15,12,14,7,12,5,13,1,1,2,2,2,1,3,4,2,1,3,10,13,5,16,14,16,15,16,1,1,1,1,1,1,1,1,1,1,1,14,1,20,80,13,20,17199999,6999,6949,5499,Mediterranean_Hispanic,139,0,0,17500.0,Unknown,83209468,65000000.0,1.0,76,1079,79,0,1,3,154,3,0.6697539031489812,0.5827807486631016,0.6617647058823528,0.016889611599767,0.0,0.0,0.2498124531132783,0.2498124531132783,0.3610933637045473,0.0,0.5116279069767438,0.2083333333333332,221,90,26,23,0,6203,5,23,92,50000000,3078125.0,50000000.0,75000.0,675000.0,14000000.0,2,4325000,0.0,0.0
551085,Luca,Oyen,2024,1184,England,Nottingham,Belgium,14-03-03,Left Winger,Attack,Right,174.0,30-06-27,M.P. Sports,https://img.a.transfermarkt.technology/portrait/header/551085-1714038539.png?lm=1,BE1,Koninklijke Racing Club Genk,2500000.0,4000000.0,21,114,-8,10,13,14,14,14,10,12,12,10,10,14,9,11,14,11,11,9,11,10,11,15,13,11,8,15,11,11,8,15,12,4,6,14,15,4,4,12,5,12,5,12,1,3,3,3,1,2,1,2,2,1,3,13,12,7,13,10,12,11,11,1,1,1,1,1,1,1,1,1,1,18,20,14,19,69,10,20,22560000,5100,5103,2501,Northern_European,111,0,0,1000.0,Unknown,18111195,9111392.0,2.0,32,1055,8,0,1,7,122,7,0.4255093940195819,0.262139037433155,0.4558823529411764,0.0009569267106151,0.0,0.0,0.0122530632658164,0.0197549387346836,0.0505924720131114,0.1428571428571428,0.2558139534883721,0.125,100,4,9,3,0,4242,3,68,271,2500000,181818.18181818182,4000000.0,1000000.0,3000000.0,3000000.0,0,0,0.0,-0.16666666666666666
551182,Fran,Vieites,2024,150,Spain,Pontecesures,Spain,07-05-99,Goalkeeper,Goalkeeper,Right,196.0,30-06-26,F.J.VILLAVERDE,https://img.a.transfermarkt.technology/portrait/header/551182-1701083106.jpg?lm=1,ES1,Real Betis BalompiÃ© S.A.D.,500000.0,500000.0,25,92,135,5,2,3,2,5,7,3,1,2,3,11,1,3,3,8,12,12,8,9,7,13,13,3,8,3,10,9,7,11,12,8,14,12,10,8,8,10,5,8,12,12,10,8,12,6,12,12,8,13,14,10,8,10,12,2,11,10,12,10,13,20,1,1,1,1,1,1,1,1,1,1,1,1,1,88,9,20,20406,4600,4600,1600,Mediterranean_Hispanic,88,0,0,595.0,Unknown,67263765,9111392.0,2.0,89,1164,89,2,1,3,164,5,0.3589573961365441,0.1657754010695187,0.286764705882353,0.0005658517178813,0.0,0.0,0.0022505626406601,0.0022505626406601,0.0505924720131114,0.1428571428571428,0.7674418604651163,0.2916666666666665,0,0,0,0,0,0,0,0,0,800000,46875.0,800000.0,0.0,,50000.0,3,350000,0.6,0.6
551695,Lassina,Traoré,2024,660,Burkina Faso,Bobo-Dioulasso,Burkina Faso,12-01-01,Centre-Forward,Attack,Right,183.0,30-06-26,Forza Sports Group,https://img.a.transfermarkt.technology/portrait/header/551695-1723486926.png?lm=1,UKR1,FC Shakhtar Donetsk,5000000.0,9000000.0,23,130,150,5,5,11,15,14,13,13,11,5,5,13,12,4,12,12,12,14,13,9,8,12,15,11,5,12,5,13,10,13,14,15,12,14,14,13,16,12,5,11,11,7,3,3,1,3,3,4,2,3,2,1,2,15,14,2,10,12,12,12,14,1,1,1,1,1,1,1,1,1,1,1,1,1,20,90,15,20,25863420,7000,5170,4394,North_African__Middle_Eastern,129,17,7,38462.0,Unknown,13196622,9111392.0,2.0,12,209,13,0,1,6,72,3,0.4343741730616565,0.4645989304812833,0.588235294117647,0.0371308807298521,0.1118421052631578,0.0921052631578947,0.0247561890472618,0.0447611902975743,0.0505924720131114,0.1428571428571428,0.4651162790697669,0.2083333333333332,158,57,37,17,0,6095,4,84,276,5000000,276470.5882352941,9000000.0,2000000.0,3500000.0,9000000.0,2,3200000,0.0,-0.16666666666666666
552057,Adam,Hlozek,2024,533,Czech Republic,Ivan?ice,Czech Republic,25-07-02,Second Striker,Attack,Right,188.0,30-06-29,Unknown,https://img.a.transfermarkt.technology/portrait/header/552057-1695368334.jpg?lm=1,L1,TSG 1899 Hoffenheim FuÃŸball-Spielbetriebs GmbH,18000000.0,20000000.0,22,129,-85,6,8,13,14,13,7,12,12,7,7,9,14,7,12,13,11,11,13,12,11,10,12,17,7,11,3,9,11,16,14,14,12,12,16,12,12,13,11,11,11,7,4,1,1,1,1,1,3,1,2,3,3,12,16,8,7,10,13,12,11,1,1,1,1,1,1,1,1,1,1,20,11,15,19,83,11,20,75104000,6450,6450,4750,Northern_European,121,18,1,28766.0,Unknown,31041522,15500000.0,2.0,26,678,28,0,1,7,199,12,0.6037311458057687,0.5026737967914437,0.5294117647058822,0.0277682557186268,0.1184210526315789,0.0131578947368421,0.0897724431107777,0.0997749437359339,0.0860857246034612,0.1428571428571428,0.581395348837209,0.1666666666666666,0,0,0,0,0,0,10,49,134,18000000,936842.1052631579,20000000.0,5000000.0,17000000.0,18000000.0,2,11000000,0.5,0.2
552223,Filip,Stankovic,2024,607,Italy,Roma,Serbia,25-02-02,Goalkeeper,Goalkeeper,Right,187.0,30-06-25,Roc Nation Sports,https://img.a.transfermarkt.technology/portrait/header/552223-1677782675.PNG?lm=1,IT1,Venezia Football Club,3000000.0,3000000.0,22,107,-75,4,3,2,3,11,9,4,2,2,3,11,2,3,11,8,11,10,12,13,10,12,14,11,9,1,14,12,14,12,12,10,12,5,11,12,6,12,11,16,15,14,14,11,11,6,12,9,12,12,12,11,11,8,13,3,13,10,13,12,19,20,1,1,1,1,1,1,1,1,1,1,1,1,1,72,6,20,39400000,5350,4766,3005,Mediterranean_Hispanic,105,0,0,4590.0,FC Volendam,43425978,9111392.0,2.0,52,1244,85,2,1,3,210,5,0.3809208785392961,0.316042780748663,0.411764705882353,0.0044234926955881,0.0,0.0,0.0147536884221055,0.0147536884221055,0.0505924720131114,0.1428571428571428,0.5581395348837206,0.1666666666666666,0,0,0,0,0,0,4,24,93,4500000,315384.6153846154,4500000.0,50000.0,400000.0,700000.0,3,1550000,0.5,1.25
552425,Jon,Moncayola,2024,331,Spain,Garinoain,Spain,13-05-98,Central Midfield,Midfield,Right,182.0,30-06-31,Unknown,https://img.a.transfermarkt.technology/portrait/header/552425-1583310847.jpg?lm=1,ES1,Club AtlÃ©tico Osasuna,7000000.0,12000000.0,26,136,150,11,10,9,10,12,9,11,14,6,9,14,12,13,13,14,15,16,11,15,14,12,14,10,13,13,14,16,14,14,12,12,12,14,13,15,13,14,10,13,7,16,1,3,3,3,4,1,3,1,2,1,3,7,11,6,11,12,11,11,15,1,1,1,1,1,1,20,1,20,1,1,1,1,1,73,12,20,11787368,6800,6800,3350,Mediterranean_Hispanic,136,0,0,15875.0,Unknown,67267210,9111392.0,2.0,89,522,89,3,1,3,51,1,0.6500396930404869,0.3529411764705882,0.6397058823529411,0.0153204835425021,0.0,0.0,0.0347586896724181,0.0597649412353088,0.0505924720131114,0.1428571428571428,0.4418604651162785,0.3333333333333332,234,8,13,36,1,1657,4,8,61,7000000,386111.1111111111,12000000.0,3000000.0,,50000.0,1,1450000,0.0,-0.2222222222222222
552655,Troy,Parrott,2024,1090,Ireland,Dublin,Ireland,04-02-02,Centre-Forward,Attack,Right,185.0,30-06-29,Unique Sports Group,https://img.a.transfermarkt.technology/portrait/header/552655-1721657549.jpg?lm=1,NL1,Alkmaar Zaanstreek,4500000.0,5000000.0,22,118,-8,8,11,12,13,14,10,7,10,5,6,13,11,9,13,14,12,10,11,11,13,11,12,13,7,13,7,12,14,13,13,13,11,12,13,14,12,13,6,14,6,12,1,4,3,1,2,3,1,2,3,2,1,14,15,5,11,10,13,11,18,1,1,1,1,1,1,1,1,1,1,15,12,15,20,0,13,20,83398058,5898,5898,5448,Northern_European,117,15,4,23198.0,Preston North End,28122837,4000000.0,1.0,49,433,52,0,1,7,16,3,0.5306959513098704,0.5773262032085561,0.4999999999999999,0.0223916987814875,0.0986842105263157,0.0526315789473684,0.0222555638909727,0.0247561890472618,0.0221950609739159,0.0,0.5116279069767438,0.1666666666666666,0,0,0,0,0,0,5,45,88,7500000,545454.5454545454,7500000.0,1000000.0,3600000.0,4000000.0,6,5400000,0.6666666666666666,0.875
552955,Santiago,Gimenez,2024,234,Argentina,Buenos Aires,Mexico,18-04-01,Centre-Forward,Attack,Left,183.0,30-06-27,Unknown,https://img.a.transfermarkt.technology/portrait/header/552955-1679137361.jpg?lm=1,NL1,Feyenoord Rotterdam,40000000.0,50000000.0,23,125,150,8,8,11,15,12,8,14,11,9,6,13,12,5,13,8,14,13,12,13,12,12,15,12,12,14,8,13,16,12,12,15,12,13,13,14,9,12,11,12,7,8,2,2,1,1,3,2,3,3,2,3,2,14,16,8,13,13,14,13,12,1,1,1,1,1,1,1,1,1,1,1,1,1,20,69,20,12,11250000,6250,6250,3750,Mediterranean_Hispanic,125,7,2,19999.0,Unknown,51067947,6000000.0,1.0,4,275,64,0,0,3,85,3,0.5772691188145012,0.3957219251336898,0.5588235294117647,0.0193026891475241,0.0460526315789473,0.0263157894736842,0.1997999499874969,0.2498124531132783,0.0333064807355759,0.0,0.4651162790697669,0.2083333333333332,269,110,26,46,2,10319,5,16,65,37000000,2460000.0,50000000.0,5000000.0,100000.0,4000000.0,2,2000000,-0.075,-0.26
553062,Vítor,Carvalho,2024,1075,Brazil,Palmas,Brazil,27-05-97,Defensive Midfield,Midfield,Right,186.0,30-06-28,VSR Assessoria,https://img.a.transfermarkt.technology/portrait/header/553062-1558111186.jpg?lm=1,PO1,Sporting Clube de Braga,5000000.0,5000000.0,27,124,131,7,10,11,11,12,7,12,10,7,11,14,11,14,13,16,13,12,11,14,14,11,15,10,8,9,13,14,15,11,13,13,13,13,12,14,12,13,13,11,6,12,2,1,1,2,3,3,2,2,4,2,3,13,9,5,14,13,14,13,13,1,1,1,1,1,1,19,1,20,1,1,1,1,1,74,11,20,1880999,6200,6200,4200,Mixed_Race,122,0,0,1950.0,Unknown,19233489,2000000.0,1.0,10,1114,11,3,1,4,192,4,0.5706536120666843,0.4438502673796791,0.536764705882353,0.0018742631133238,0.0,0.0,0.0247561890472618,0.0247561890472618,0.0110836412122558,0.0,0.5348837209302322,0.375,231,12,7,54,1,4376,4,9,100,6000000,457692.3076923077,6000000.0,0.0,,50000.0,2,250000,0.2,0.2
553469,Gabriel,Sara,2024,141,Brazil,Joinville,Brazil,26-06-99,Central Midfield,Midfield,Right,177.0,30-06-29,Carlos Leite,https://img.a.transfermarkt.technology/portrait/header/553469-1661432978.jpg?lm=1,TR1,Galatasaray Spor KulÃ¼bÃ¼,20000000.0,20000000.0,25,135,145,5,2,2,3,8,7,3,1,1,2,10,4,2,11,12,13,13,14,14,11,13,11,10,13,10,14,12,12,11,12,13,14,11,11,11,11,13,11,15,11,12,13,14,14,8,14,11,16,16,12,12,11,12,8,5,15,9,12,14,11,20,1,1,1,1,1,1,1,1,1,1,1,1,1,91,8,20,347975206,7000,7000,4500,Mediterranean_Hispanic,134,13,0,21200.0,Unknown,14000828,14250000.0,2.0,10,690,11,3,1,3,102,1,0.6765017200317545,0.4759358288770053,0.625,0.0204623954840011,0.0855263157894736,0.0,0.0997749437359339,0.0997749437359339,0.0791410872524236,0.1428571428571428,0.3255813953488373,0.2916666666666665,240,40,33,24,0,4911,2,16,124,23000000,1413333.3333333333,23000000.0,1000000.0,,,2,3000000,0.2777777777777778,0.4375
553663,Francisco,Ortega,2024,683,Argentina,Santa FÃ©,Argentina,19-03-99,Left-Back,Defender,Left,177.0,30-06-28,Score Futbol,https://img.a.transfermarkt.technology/portrait/header/553663-1728417555.png?lm=1,GR1,Olympiakos Syndesmos Filathlon Peiraios,6000000.0,6000000.0,25,126,138,8,12,13,6,12,8,9,11,12,12,12,11,12,13,14,13,13,14,12,12,13,14,13,8,13,12,14,15,14,14,12,9,16,15,15,10,12,8,11,5,16,1,2,1,3,2,1,2,1,2,1,3,10,12,8,12,13,14,13,12,1,20,1,1,15,1,1,14,1,8,12,1,10,1,75,20,7,4698696,6183,6183,3667,Mediterranean_Hispanic,126,0,0,15690.0,Unknown,14186538,4500000.0,1.0,4,1326,4,1,0,3,141,8,0.5684043397724265,0.3868449197860962,0.5661764705882353,0.0151418443482904,0.0,0.0,0.0297574393598399,0.0297574393598399,0.0249729159143309,0.0,0.3255813953488373,0.2916666666666665,219,3,19,29,2,7797,3,12,27,6000000,350000.0,6000000.0,200000.0,,2500000.0,1,700000,0.0,0.2
553875,Pedro,Porro,2024,148,Spain,Don Benito,Spain,13-09-99,Right-Back,Defender,Right,173.0,30-06-28,CAA Base Ltd,https://img.a.transfermarkt.technology/portrait/header/553875-1602774481.jpg?lm=1,GB1,Tottenham Hotspur Football Club,45000000.0,45000000.0,25,150,164,13,17,15,11,15,13,8,14,11,8,15,12,14,15,15,12,17,11,12,15,12,16,17,8,16,9,10,13,16,16,13,8,17,15,15,12,14,16,14,6,15,1,1,1,2,3,1,1,1,1,3,3,16,15,13,11,14,13,7,11,1,9,1,19,9,20,1,1,1,17,1,1,14,1,71,8,20,44668000,7500,6570,6318,Mediterranean_Hispanic,146,1,0,31500.0,Unknown,67268221,15217500.0,4.0,89,420,89,1,1,3,202,11,0.6196083620005293,0.6703743315508021,0.713235294117647,0.030408253323896,0.006578947368421,0.0,0.2248062015503876,0.2248062015503876,0.0845162365621267,0.4285714285714285,0.2325581395348837,0.2916666666666665,243,25,41,40,2,4600,12,47,46,45000000,2444444.4444444445,45000000.0,1000000.0,1000000.0,9000000.0,4,14000000,0.0,0.0
554284,Kacper,Kozlowski,2024,2832,Poland,Koszalin,Poland,16-10-03,Central Midfield,Midfield,Right,182.0,30-06-27,CAA Stellar,https://img.a.transfermarkt.technology/portrait/header/554284-1725460185.jpg?lm=1,TR1,Gaziantep Futbol KulÃ¼bÃ¼ A.?.,4500000.0,10000000.0,21,110,-85,7,9,11,10,12,9,7,13,4,7,14,9,10,13,7,12,14,13,12,15,12,16,10,12,13,3,12,11,11,12,12,9,7,11,11,11,13,6,11,5,11,4,2,2,1,2,2,3,3,2,2,2,16,18,12,12,17,15,13,10,1,1,1,1,1,1,10,1,20,1,1,20,1,1,75,12,20,65512132,5500,5500,3262,Northern_European,107,6,0,11599.0,Vitesse,96145145,11000000.0,1.0,75,750,78,3,1,7,103,1,0.4780365175972479,0.3435294117647058,0.4264705882352941,0.0111915041130467,0.0394736842105263,0.0,0.0222555638909727,0.0497624406101525,0.0610850301397261,0.0,0.4418604651162785,0.125,174,28,32,27,0,3902,11,35,165,4500000,317857.14285714284,10000000.0,3000000.0,8000000.0,4500000.0,3,1500000,-0.1,-0.1
554300,Unknown,Madson,2024,979,Unknown,Unknown,Brazil,26-08-99,Left Winger,Attack,Right,164.0,30-06-27,Energy Sports,https://img.a.transfermarkt.technology/portrait/header/554300-1705665101.png?lm=1,PO1,Moreirense Futebol Clube,1500000.0,1500000.0,25,122,133,10,13,13,12,12,9,14,8,13,12,10,12,13,13,11,13,12,10,12,12,13,12,12,4,13,11,14,14,14,14,7,13,13,14,13,10,11,10,8,7,13,2,3,2,3,2,4,3,1,2,3,1,10,13,13,10,10,11,8,11,1,1,1,20,1,16,1,1,1,1,1,1,1,1,69,8,20,679130,6149,6149,3285,African_Caribbean,122,0,0,10105.0,Unknown,19073917,9111392.0,2.0,105,1549,11,0,1,1,134,7,0.5639057951839112,0.3459893048128342,0.536764705882353,0.0097488719176289,0.0,0.0,0.0072518129532383,0.0072518129532383,0.0505924720131114,0.1428571428571428,0.0232558139534884,0.2916666666666665,171,15,14,24,0,4180,3,9,41,1500000,113636.36363636363,1500000.0,75000.0,,250000.0,2,150000,0.5,1.5
554389,Konstantinos,Tzolakis,2024,683,Greece,Chania,Greece,08-11-02,Goalkeeper,Goalkeeper,Left,193.0,30-06-27,Sports360 GmbH,https://img.a.transfermarkt.technology/portrait/header/554389-1728417024.png?lm=1,GR1,Olympiakos Syndesmos Filathlon Peiraios,4000000.0,4000000.0,22,126,133,6,7,10,6,11,8,13,11,9,15,12,8,13,11,9,13,13,13,13,8,13,15,7,12,10,14,14,11,13,11,12,12,13,12,14,14,14,8,13,7,15,1,4,2,1,1,4,1,1,2,1,2,12,16,3,11,12,11,14,10,1,14,20,1,8,1,14,1,10,1,1,1,1,1,82,20,8,4702301,6299,6249,5499,Mediterranean_Hispanic,125,46,3,21999.0,Unknown,28051267,40000.0,1.0,40,346,42,2,0,3,141,5,0.5771368086795449,0.5827807486631016,0.5588235294117647,0.0212339236795425,0.3026315789473684,0.0394736842105263,0.0197549387346836,0.0197549387346836,0.000194449845829,0.0,0.6976744186046511,0.1666666666666666,0,0,0,0,0,0,3,2,11,6000000,450000.0,6000000.0,300000.0,1200000.0,1500000.0,0,0,2.0,3.0
554530,Tein,Troost,2024,132,Netherlands,Breda,Netherlands,15-01-02,Goalkeeper,Goalkeeper,Left,189.0,30-06-26,Unknown,https://img.a.transfermarkt.technology/portrait/header/554530-1686056175.jpg?lm=1,NL1,Nooit Opgeven Altijd Doorzetten Aangenaam Door Vermaak En Nuttig Door Ontspanning Combinatie Breda,250000.0,250000.0,22,105,-75,2,3,1,1,4,7,1,2,2,3,11,3,2,1,5,12,12,13,12,9,12,12,3,11,1,15,10,9,13,11,9,15,13,13,5,8,18,12,16,9,15,13,13,11,5,12,15,11,11,12,11,8,10,10,4,12,13,11,10,17,20,1,1,1,1,1,1,1,1,1,1,1,1,1,0,20,5,21720000,4950,4950,3250,Northern_European,106,0,0,995.0,Unknown,37076185,70000.0,1.0,67,248,68,2,0,7,139,5,0.4052659433712622,0.3422459893048128,0.4191176470588235,0.000952098624285,0.0,0.0,0.0010002500625156,0.0010002500625156,0.0003611211422539,0.0,0.6046511627906974,0.1666666666666666,0,0,0,0,0,0,1,7,85,200000,12500.0,250000.0,50000.0,,100000.0,1,100000,-0.2,0.0
554903,Mateo,Retegui,2024,800,Argentina,San Fernando,Italy,29-04-99,Centre-Forward,Attack,Right,186.0,30-06-28,Unknown,https://img.a.transfermarkt.technology/portrait/header/554903-1681311414.jpg?lm=1,IT1,Atalanta Bergamasca Calcio S.p.a.,16000000.0,16000000.0,25,129,138,8,8,12,13,11,6,14,11,2,5,12,13,4,13,14,13,13,12,12,12,13,15,12,10,14,9,15,16,14,12,14,14,15,12,14,15,13,12,12,7,8,1,1,1,3,2,2,3,2,2,3,2,10,13,5,12,10,13,13,7,1,1,1,1,1,1,1,1,1,1,1,1,1,20,81,11,20,7905342,6471,6471,3822,Mediterranean_Hispanic,128,0,0,17902.0,Club AtlÃ©tico Tigre,14180903,15226666.67,3.0,4,1297,54,0,1,3,31,3,0.6065096586398518,0.4034224598930481,0.5808823529411764,0.0172777897407027,0.0,0.0,0.0797699424856214,0.0797699424856214,0.08456716392122,0.2857142857142857,0.5348837209302322,0.2916666666666665,227,79,15,26,1,5155,8,30,37,35000000,2323333.3333333335,35000000.0,75000.0,,675000.0,5,12425000,1.1875,1.1875
555076,Romain,Faivre,2024,3911,France,AsniÃ¨res-sur-Seine,France,14-07-98,Right Midfield,Midfield,Left,180.0,30-06-25,Goalactic,https://img.a.transfermarkt.technology/portrait/header/555076-1672831296.jpg?lm=1,FR1,Stade brestois 29,10000000.0,15000000.0,26,134,146,11,11,14,12,14,13,9,12,5,6,13,11,6,14,10,11,11,13,13,13,12,13,12,8,13,8,13,12,14,14,13,12,13,14,14,12,13,7,12,6,13,2,3,3,3,2,1,2,1,1,1,2,14,12,6,13,12,14,14,13,1,1,1,1,1,1,1,13,18,13,17,20,19,1,75,20,12,23437930,6700,6700,3900,North_African__Middle_Eastern,130,0,0,24687.0,Unknown,49040542,10133333.33,3.0,34,99,36,3,0,6,196,9,0.6368086795448531,0.4117647058823529,0.5955882352941175,0.0238295028905752,0.0,0.0,0.0497624406101525,0.0747686921730432,0.056270081557821,0.2857142857142857,0.3953488372093026,0.3333333333333332,222,39,23,13,0,3503,3,4,15,9000000,423809.5238095238,15000000.0,5000000.0,,500000.0,5,7050000,-0.4,-0.4
555143,Arsen,Zakharyan,2024,681,Russia,Samara,Russia,26-05-03,Attacking Midfield,Midfield,Right,183.0,30-06-29,Pavel Andreev,https://img.a.transfermarkt.technology/portrait/header/555143-1683292149.jpg?lm=1,ES1,Real Sociedad de FÃºtbol S.A.D.,18000000.0,18000000.0,21,125,-9,13,11,12,13,13,12,6,12,4,6,13,13,5,14,7,12,8,13,11,16,14,14,14,8,14,10,13,11,13,13,12,13,8,13,10,9,10,6,16,9,12,1,3,1,1,1,3,1,2,3,2,3,7,17,7,8,11,14,12,11,1,1,1,1,1,1,10,10,14,12,17,20,17,1,72,13,20,15000000,6000,6000,4270,Mediterranean_Hispanic,125,4,0,28962.0,Unknown,2000014077,13000000.0,1.0,78,1292,81,3,1,3,168,0,0.5441915850754168,0.4513368983957219,0.5588235294117647,0.0279575167027646,0.0263157894736842,0.0,0.0897724431107777,0.0897724431107777,0.0721964499013861,0.0,0.4651162790697669,0.125,163,36,40,22,0,4129,11,37,153,18000000,1376923.076923077,18000000.0,0.0,12000000.0,15000000.0,3,3100000,0.0,0.2
555146,Vladislav,Torop,2024,2410,Russia,Moskau,Russia,07-11-03,Goalkeeper,Goalkeeper,Left,191.0,30-06-26,Unknown,https://img.a.transfermarkt.technology/portrait/header/555146-1629034549.png?lm=1,RU1,PFK CSKA Moskva,1000000.0,1000000.0,21,85,-75,4,2,2,2,6,6,2,3,3,1,9,4,3,6,5,15,10,15,14,5,11,12,3,10,1,12,10,7,6,8,9,13,13,7,2,13,13,4,11,4,12,11,13,11,5,13,10,7,12,10,7,14,16,13,6,13,12,14,12,14,20,1,1,1,1,1,1,1,1,1,1,1,1,1,84,20,5,10975518,3987,3987,1987,Northern_European,88,0,0,1402.0,Unknown,58159066,9111392.0,2.0,78,985,81,2,0,7,148,5,0.2778512834083091,0.2071657754010695,0.286764705882353,0.0013451048515508,0.0,0.0,0.0047511877969492,0.0047511877969492,0.0505924720131114,0.1428571428571428,0.6511627906976742,0.125,0,0,0,0,0,0,3,6,52,1000000,71153.84615384616,1000000.0,0.0,400000.0,1000000.0,1,125000,0.0,0.25
555719,Ali,Akman,2024,9010,TÃ¼rkiye,Bursa,TÃ¼rkiye,18-04-02,Centre-Forward,Attack,Right,173.0,30-06-25,o2football ,https://img.a.transfermarkt.technology/portrait/header/555719-1663973805.png?lm=1,BE1,FC Verbroedering Denderhoutem Denderleeuw Eendracht Hekelgem,400000.0,1500000.0,22,115,-8,6,8,11,14,13,7,10,7,3,4,12,13,6,13,8,13,9,12,12,12,11,13,14,8,15,6,12,13,13,14,12,9,12,12,11,9,12,5,11,8,7,2,2,1,1,1,1,4,3,1,3,1,7,14,5,11,12,15,12,14,1,1,1,1,1,1,1,1,1,1,1,1,1,20,66,15,20,64580001,6047,6047,5497,Mediterranean_Hispanic,114,0,0,10511.0,GÃ¶ztepe A.Åž.,70118958,9111392.0,2.0,100,280,100,0,1,3,73,3,0.5504101614183646,0.582566844919786,0.4779411764705882,0.0101409125276287,0.0,0.0,0.0017504376094023,0.0072518129532383,0.0505924720131114,0.1428571428571428,0.2325581395348837,0.1666666666666666,129,29,7,7,1,2977,2,4,23,300000,13888.888888888889,1500000.0,300000.0,1500000.0,900000.0,4,350000,-0.25,-0.25
555820,Martín,Payero,2024,410,Argentina,Pascanas,Argentina,11-09-98,Central Midfield,Midfield,Right,182.0,30-06-27,Hernan Berman,https://img.a.transfermarkt.technology/portrait/header/555820-1707213845.jpg?lm=1,IT1,Udinese Calcio,4500000.0,5000000.0,26,125,137,12,11,11,11,14,12,7,14,9,9,14,14,11,14,10,13,12,14,12,14,13,11,12,9,11,10,13,14,13,12,11,9,11,13,13,10,13,7,9,7,10,2,3,4,3,2,2,3,1,1,1,3,11,12,5,9,11,11,10,5,1,1,1,1,1,1,10,1,20,1,12,15,1,1,80,10,20,6148476,6260,6110,4006,Mediterranean_Hispanic,125,0,0,17399.0,Club AtlÃ©tico Boca Juniors,14196681,4875000.0,2.0,4,1127,4,3,1,3,205,1,0.558745699920614,0.4231016042780748,0.5588235294117647,0.0167920842559001,0.0,0.0,0.0222555638909727,0.0247561890472618,0.0270563071196422,0.1428571428571428,0.4418604651162785,0.3333333333333332,159,12,18,26,3,7012,7,19,34,4500000,358333.3333333333,5000000.0,1000000.0,,2500000.0,6,6500000,0.0,0.0
556385,Destiny,Udogie,2024,148,Italy,Verona,Italy,28-11-02,Left-Back,Defender,Left,188.0,30-06-30,Football Service,https://img.a.transfermarkt.technology/portrait/header/556385-1697208468.jpg?lm=1,GB1,Tottenham Hotspur Football Club,45000000.0,45000000.0,22,142,-9,7,13,14,11,12,7,12,10,12,11,13,10,12,13,10,13,12,10,12,12,12,14,12,8,13,11,12,15,16,15,14,13,14,16,15,12,14,8,13,7,14,2,3,2,4,1,2,2,2,2,3,2,15,14,7,12,13,15,12,8,1,20,1,1,20,1,10,16,12,1,1,1,1,1,73,20,9,71914876,7100,6500,5000,African_Caribbean,134,0,0,57996.0,Udinese Calcio,43426047,11600000.0,2.0,52,1577,54,1,0,1,202,8,0.6103466525535857,0.5294117647058822,0.625,0.055993248404076,0.0,0.0,0.2248062015503876,0.2248062015503876,0.0644184560682241,0.1428571428571428,0.581395348837209,0.1666666666666666,172,19,16,27,0,2654,14,56,108,45000000,2960000.0,45000000.0,0.0,4000000.0,38000000.0,2,16000000,0.0,0.125
557147,José,Gragera,2024,714,Spain,GijÃ³n,Spain,14-05-00,Central Midfield,Midfield,Right,186.0,30-06-28,Unknown,https://img.a.transfermarkt.technology/portrait/header/557147-1664207582.jpg?lm=1,ES1,Reial Club Deportiu Espanyol de Barcelona S.A.D.,2500000.0,3000000.0,24,121,150,7,8,11,8,14,7,16,10,7,12,14,7,13,16,11,14,11,10,12,13,11,13,8,6,7,14,14,11,13,14,10,16,9,12,12,12,9,8,11,7,7,3,3,1,1,2,2,2,2,1,1,3,16,12,6,14,8,13,13,13,1,1,10,1,1,1,20,1,19,1,1,1,1,1,81,10,20,3748499,6041,6041,4041,Mediterranean_Hispanic,121,0,0,4966.0,Unknown,67263880,2800000.0,1.0,89,539,89,3,1,3,170,1,0.5496163006086267,0.4268449197860962,0.5294117647058822,0.0047865647876076,0.0,0.0,0.0122530632658164,0.0147536884221055,0.0155282091169199,0.0,0.5348837209302322,0.25,208,7,3,46,0,2013,0,0,0,2000000,111764.70588235294,3000000.0,500000.0,150000.0,700000.0,2,600000,-0.2,-0.2
557149,Kang-In,Lee,2024,583,"Korea, South",Incheon,"Korea, South",19-02-01,Attacking Midfield,Midfield,Left,173.0,30-06-28,WAKAI SPORTS,https://img.a.transfermarkt.technology/portrait/header/557149-1703978046.jpg?lm=1,FR1,Paris Saint-Germain Football Club,25000000.0,25000000.0,23,130,-85,12,12,14,13,14,12,7,14,7,6,15,13,6,15,13,11,11,11,10,14,11,16,17,9,13,8,8,11,13,14,13,8,12,12,11,10,10,8,13,8,14,2,2,1,2,2,3,1,1,3,4,2,13,14,6,15,15,15,10,10,1,1,1,1,1,1,1,17,17,17,19,20,19,14,68,20,14,55264003,6500,7000,6000,Asian,123,6,0,9724.0,Unknown,67260506,22000000.0,1.0,57,656,58,3,0,2,154,0,0.6765017200317545,0.6363636363636364,0.5441176470588236,0.0093809717392794,0.0394736842105263,0.0,0.1247811952988247,0.1247811952988247,0.1221978388288563,0.0,0.2325581395348837,0.2083333333333332,235,26,25,30,2,3646,4,16,35,30000000,1423809.5238095238,30000000.0,5000000.0,20000000.0,10000000.0,3,6500000,0.2,0.36363636363636365
557407,Devyne,Rensch,2024,610,Netherlands,Lelystad,Netherlands,18-01-03,Right-Back,Defender,Right,179.0,30-06-25,Unknown,https://img.a.transfermarkt.technology/portrait/header/557407-1683881379.jpg?lm=1,NL1,AFC Ajax Amsterdam,10000000.0,10000000.0,21,131,-85,4,10,12,7,12,7,9,5,6,12,14,9,13,13,6,11,11,12,11,12,11,16,13,10,14,13,15,14,13,13,12,10,12,13,12,13,11,4,9,7,16,2,2,2,1,3,2,1,1,3,2,1,12,14,6,14,13,14,13,13,1,17,20,19,14,17,18,10,12,10,1,1,1,1,0,16,20,80120000,6489,6489,5239,African_Caribbean,116,1,0,21999.0,Unknown,37073313,9111392.0,2.0,67,819,68,1,1,1,6,11,0.6088912410690659,0.5549732620320855,0.4926470588235294,0.0212339236795425,0.006578947368421,0.0,0.0497624406101525,0.0497624406101525,0.0505924720131114,0.1428571428571428,0.3720930232558141,0.125,0,0,0,0,0,0,11,38,43,12000000,839285.7142857143,12000000.0,2000000.0,10000000.0,8000000.0,1,1700000,0.2,0.5
557459,Micky,Van De Ven,2024,148,Netherlands,Wormer,Netherlands,19-04-01,Centre-Back,Defender,Left,193.0,30-06-29,Team Raiola,https://img.a.transfermarkt.technology/portrait/header/557459-1657202743.jpg?lm=1,GB1,Tottenham Hotspur Football Club,55000000.0,55000000.0,23,128,150,3,11,13,7,12,4,13,7,7,13,13,6,13,12,14,12,13,13,12,12,12,16,13,13,11,13,12,14,14,11,15,14,13,17,13,14,14,7,14,7,12,1,1,2,1,3,4,3,1,2,2,2,8,14,13,7,12,14,12,12,1,18,20,1,16,1,10,1,1,1,1,1,1,1,81,20,8,8999999,6600,6000,5000,Northern_European,128,0,0,23972.0,Unknown,37084591,24250000.0,2.0,67,1674,68,1,0,7,202,2,0.5441915850754168,0.5294117647058822,0.5808823529411764,0.0231390865453787,0.0,0.0,0.274818704676169,0.274818704676169,0.1346981860607239,0.1428571428571428,0.6976744186046511,0.2083333333333332,170,8,10,28,0,2673,12,84,77,55000000,3161764.705882353,55000000.0,150000.0,1100000.0,3000000.0,2,11700000,0.0,0.2222222222222222
557612,Sékou,Mara,2024,667,France,Paris,France,30-07-02,Centre-Forward,Attack,Right,183.0,30-06-29,BS Group - BS Law,https://img.a.transfermarkt.technology/portrait/header/557612-1618220805.jpg?lm=1,FR1,Racing Club de Strasbourg Alsace,6000000.0,12000000.0,22,120,-8,6,6,14,12,12,9,13,11,6,7,13,10,7,13,9,13,13,13,14,14,12,17,12,8,14,9,13,14,14,12,11,12,12,14,12,12,12,8,10,8,12,3,1,2,3,2,3,3,3,2,3,3,12,15,7,12,12,16,12,7,1,1,1,1,1,1,1,1,1,1,13,1,14,20,80,8,20,50943570,6000,6000,4250,African_Caribbean,121,0,0,46397.0,Unknown,49048369,11750000.0,2.0,34,1122,36,0,1,1,159,3,0.5441915850754168,0.4491978609625668,0.5294117647058822,0.0447930537356352,0.0,0.0,0.0297574393598399,0.0597649412353088,0.0652518125503486,0.1428571428571428,0.4651162790697669,0.1666666666666666,136,27,10,8,0,4955,0,0,0,6000000,438461.53846153844,12000000.0,2000000.0,800000.0,10000000.0,2,9000000,0.0,-0.14285714285714285
557613,Quentin,Merlin,2024,244,France,Nantes,France,16-05-02,Left-Back,Defender,Left,174.0,30-06-28,LÃ©andre Chouya,https://img.a.transfermarkt.technology/portrait/header/557613-1704213356.jpg?lm=1,FR1,Olympique de Marseille,10000000.0,10000000.0,22,123,-8,15,15,12,11,13,11,8,13,6,12,13,11,11,13,8,12,12,13,12,13,11,15,11,10,11,11,12,12,12,12,11,8,11,12,13,10,13,7,10,5,12,3,2,3,3,2,2,3,1,1,1,1,12,12,10,13,13,14,13,10,1,20,1,1,19,1,1,18,13,1,17,13,1,12,64,20,9,56265190,6142,6142,2242,Northern_European,111,0,0,9367.0,Unknown,49048372,10000000.0,1.0,34,1014,36,1,0,7,144,8,0.5629796242392168,0.2344385026737968,0.4558823529411764,0.0090362463753141,0.0,0.0,0.0497624406101525,0.0497624406101525,0.055529320258896,0.0,0.2558139534883721,0.1666666666666666,128,5,12,7,0,3314,4,28,66,12000000,983333.3333333334,12000000.0,0.0,200000.0,7000000.0,2,600000,0.2,0.2
559263,Fábio,Carvalho,2024,1148,Portugal,Torres Vedras,Portugal,30-08-02,Attacking Midfield,Midfield,Right,170.0,Unknown,Concilium Sport,https://img.a.transfermarkt.technology/portrait/header/559263-1687517452.jpg?lm=1,GB1,Brentford Football Club,18000000.0,20000000.0,22,134,-85,10,12,16,12,14,13,7,10,2,7,14,10,7,15,13,14,8,13,11,14,12,14,15,4,13,6,12,13,15,13,12,6,14,14,14,7,10,12,10,7,11,2,2,2,3,1,2,3,2,2,2,2,14,15,5,10,12,13,12,12,1,1,1,1,1,1,1,1,7,1,17,20,17,15,63,11,20,78967174,6700,6700,5000,Mixed_Race,126,0,0,34798.0,Unknown,28122195,16400000.0,2.0,76,1510,79,3,1,4,43,0,0.6368086795448531,0.5294117647058822,0.5661764705882353,0.0335928590671944,0.0,0.0,0.0897724431107777,0.0997749437359339,0.0910858634962082,0.1428571428571428,0.1627906976744184,0.1666666666666666,206,59,32,19,0,5943,5,21,52,18000000,1775000.0,20000000.0,4000000.0,250000.0,16000000.0,5,12250000,0.2857142857142857,0.2857142857142857
559320,Dani,Van Den Heuvel,2024,2282,Netherlands,Delft,Netherlands,28-05-03,Goalkeeper,Goalkeeper,Left,188.0,30-06-26,Forza Sports Group,https://img.a.transfermarkt.technology/portrait/header/559320-1623149802.jpg?lm=1,BE1,Club Brugge Koninklijke Voetbalvereniging,200000.0,200000.0,21,92,-75,8,12,6,9,14,8,8,9,6,10,12,7,11,13,5,10,9,7,8,8,13,12,5,12,10,11,14,14,11,11,13,12,10,10,10,8,10,7,12,9,17,3,3,1,2,2,2,3,3,2,3,3,9,12,3,13,10,9,11,10,1,1,1,12,1,13,17,1,20,1,1,1,1,1,0,20,12,13800000,4599,4599,2199,Northern_European,93,0,0,612.0,Unknown,2000118596,9111392.0,2.0,67,406,68,2,0,7,53,5,0.3588250860015877,0.2298395721925133,0.3235294117647059,0.0005822672114035,0.0,0.0,0.0007501875468867,0.0007501875468867,0.0505924720131114,0.1428571428571428,0.581395348837209,0.125,0,0,0,0,0,0,2,28,216,200000,0.0,200000.0,0.0,,,0,0,0.0,0.0
559324,Youri,Regeer,2024,317,Netherlands,Haarlem,Netherlands,18-08-03,Central Midfield,Midfield,Right,177.0,30-06-27,Wasserman,https://img.a.transfermarkt.technology/portrait/header/559324-1723819538.jpg?lm=1,NL1,Football Club Twente,3500000.0,3500000.0,21,106,-75,10,9,6,13,12,13,11,11,5,10,13,11,12,12,12,9,11,12,11,12,12,15,7,13,11,10,14,12,10,10,12,11,14,10,12,10,11,8,13,7,17,1,3,2,2,2,1,1,3,2,2,1,7,13,3,11,9,13,10,17,1,1,15,18,1,18,20,1,16,13,1,13,12,1,0,10,20,33400000,5199,5199,3403,Northern_European,99,0,0,7600.0,Unknown,37079280,900000.0,1.0,67,585,68,3,1,7,91,1,0.4382111669753903,0.3586096256684492,0.3676470588235294,0.0073300006662759,0.0,0.0,0.0172543135783946,0.0172543135783946,0.0049723603433428,0.0,0.3255813953488373,0.125,212,21,26,23,2,3837,9,30,60,6000000,391666.6666666667,6000000.0,500000.0,2400000.0,3500000.0,2,2100000,0.7142857142857143,1.0
559328,Emanuel,Emegha,2024,667,Netherlands,Den Haag,Netherlands,03-02-03,Centre-Forward,Attack,Right,195.0,30-06-28,Prime11,https://img.a.transfermarkt.technology/portrait/header/559328-1664876881.png?lm=1,FR1,Racing Club de Strasbourg Alsace,15000000.0,15000000.0,21,115,-8,9,7,13,11,12,8,13,12,11,5,12,6,5,11,9,10,12,9,10,7,9,14,12,6,14,5,8,10,15,12,11,17,14,14,10,12,9,6,6,8,14,3,1,1,3,2,1,3,1,1,3,2,13,14,5,13,11,11,9,13,1,1,1,1,1,1,1,1,1,1,12,1,12,20,0,12,20,13085000,5750,5750,3500,African_Caribbean,110,0,0,4999.0,Unknown,37088234,9111392.0,2.0,67,407,68,0,1,1,159,3,0.5111140513363324,0.3689839572192513,0.4485294117647059,0.0048184301573859,0.0,0.0,0.0747686921730432,0.0747686921730432,0.0505924720131114,0.1428571428571428,0.7441860465116279,0.125,149,46,12,20,0,4072,5,13,43,15000000,1057142.857142857,15000000.0,0.0,500000.0,12000000.0,3,4000000,0.25,0.25
559333,Kian,Fitz-Jim,2024,610,Netherlands,Amsterdam,Netherlands,05-07-03,Central Midfield,Midfield,Right,174.0,30-06-27,Unknown,https://img.a.transfermarkt.technology/portrait/header/559333-1660811546.jpg?lm=1,NL1,AFC Ajax Amsterdam,1000000.0,1300000.0,21,109,-8,12,9,13,6,13,10,4,6,4,11,14,5,10,15,4,11,8,11,12,13,12,14,13,8,12,8,15,14,12,14,10,4,14,12,13,5,14,9,17,4,15,2,3,3,3,3,2,2,3,1,1,3,12,11,9,11,11,11,11,10,1,1,1,1,16,16,18,16,20,1,14,14,1,1,0,10,20,51000000,5350,5350,3667,African_Caribbean,105,0,0,5499.0,Unknown,37079089,56000.0,1.0,67,64,68,3,1,1,6,1,0.4581899973537973,0.3868449197860962,0.411764705882353,0.0053012387903905,0.0,0.0,0.0047511877969492,0.0062515628907226,0.0002833412039223,0.0,0.2558139534883721,0.125,196,15,21,21,0,5712,6,33,107,5000000,475000.0,5000000.0,300000.0,800000.0,1000000.0,3,800000,4.0,4.0
559794,Jack,Clarke,2024,677,England,York,England,23-11-00,Left Winger,Attack,Right,181.0,30-06-29,Unknown,https://img.a.transfermarkt.technology/portrait/header/559794-1708003059.jpg?lm=1,GB1,Ipswich Town Football Club,15000000.0,15000000.0,24,118,140,5,13,14,12,13,5,6,9,2,4,9,10,5,13,8,12,6,12,7,11,8,14,16,6,13,6,10,10,16,15,13,9,9,15,11,5,11,5,11,9,12,3,1,1,1,1,2,3,2,1,1,1,13,16,2,10,15,13,11,12,1,1,1,1,15,1,1,12,1,15,17,4,20,11,0,11,20,7210046,5900,5900,4000,Northern_European,110,0,0,17399.0,Unknown,29186418,9111392.0,2.0,32,1688,33,0,1,7,115,7,0.530960571579783,0.4224598930481283,0.4485294117647059,0.0167920842559001,0.0,0.0,0.0747686921730432,0.0747686921730432,0.0505924720131114,0.1428571428571428,0.418604651162791,0.25,217,39,37,31,0,5719,1,7,44,15000000,875000.0,15000000.0,1500000.0,6000000.0,5000000.0,6,900000,0.0,0.0
560483,Randy,Nteka,2024,367,France,Paris,Angola,06-12-97,Attacking Midfield,Midfield,Left,189.0,30-06-26,Unknown,https://img.a.transfermarkt.technology/portrait/header/560483-1600680162.jpg?lm=1,ES1,Rayo Vallecano de Madrid S.A.D.,1500000.0,4000000.0,27,128,147,11,10,11,12,11,11,14,11,7,9,13,7,12,12,14,12,14,12,13,14,14,12,14,14,12,11,11,12,12,11,9,14,14,13,14,14,12,7,16,6,15,3,1,3,1,2,2,3,2,3,2,2,12,12,1,13,13,9,11,17,1,1,1,1,1,1,16,13,18,1,1,20,1,16,75,20,11,3087097,6400,6400,4400,African_Caribbean,122,0,0,8491.0,Unknown,67277397,1300000.0,1.0,34,1122,3,3,0,1,163,0,0.5971156390579518,0.4652406417112299,0.536764705882353,0.0081903656502901,0.0,0.0,0.0072518129532383,0.0197549387346836,0.0071946442956748,0.0,0.6046511627906974,0.375,248,32,8,45,3,3942,3,13,47,1500000,72500.0,4000000.0,1500000.0,,100000.0,3,1200000,0.0,-0.16666666666666666
560593,Hicham,Boudaoui,2024,417,Algeria,BÃ©char,Algeria,23-09-99,Central Midfield,Midfield,Right,175.0,30-06-27,Unknown,https://img.a.transfermarkt.technology/portrait/header/560593-1649428044.jpg?lm=1,FR1,Olympique Gymnaste Club Nice CÃ´te d'Azur,10000000.0,10000000.0,25,128,145,9,13,13,9,14,11,11,13,9,12,14,8,13,14,9,12,12,13,11,14,13,15,16,13,12,11,13,12,13,14,12,7,15,13,12,8,14,5,14,9,15,2,2,2,1,1,1,1,3,4,1,1,15,14,8,14,13,15,10,13,1,1,1,1,1,1,12,1,20,18,1,1,15,1,61,10,20,6243999,6398,6398,3798,North_African__Middle_Eastern,126,10,0,14483.0,Unknown,13227048,4000000.0,1.0,1,287,1,3,1,6,142,1,0.5968510187880391,0.400855614973262,0.5661764705882353,0.0139763443082173,0.0657894736842105,0.0,0.0497624406101525,0.0497624406101525,0.0221950609739159,0.0,0.2790697674418605,0.2916666666666665,205,13,14,46,1,2902,11,44,60,10000000,452272.7272727273,10000000.0,1000000.0,100000.0,3600000.0,1,600000,0.1111111111111111,0.1111111111111111
560903,Unknown,Patrick William,2024,2425,Brazil,SÃ£o Leopoldo,Brazil,03-06-97,Centre-Back,Defender,Right,187.0,30-06-25,FIRST Football,https://img.a.transfermarkt.technology/portrait/header/560903-1676542575.jpg?lm=1,PO1,Rio Ave Futebol Clube,800000.0,2000000.0,27,120,134,6,8,11,9,11,13,12,9,9,14,12,8,13,11,15,12,16,12,14,10,11,15,8,10,8,12,13,14,12,12,13,12,12,13,13,14,12,12,12,8,12,3,2,2,3,2,1,1,1,1,2,1,15,15,6,10,13,14,10,10,1,1,20,15,1,1,1,1,1,1,1,1,1,1,78,9,20,707808,5993,5993,3997,Northern_European,120,0,0,3149.0,Unknown,19261528,9111392.0,2.0,10,1455,11,1,1,7,171,2,0.5432654141307224,0.422139037433155,0.5220588235294117,0.0030320382152689,0.0,0.0,0.0037509377344336,0.0097524381095273,0.0505924720131114,0.1428571428571428,0.5581395348837206,0.375,149,5,1,38,1,3880,1,5,49,1000000,67857.14285714286,2000000.0,400000.0,,50000.0,3,1250000,0.25,1.0
561613,Joan,García,2024,714,Spain,Sallent de Llobregat,Spain,04-05-01,Goalkeeper,Goalkeeper,Right,191.0,30-06-28,Unknown,https://img.a.transfermarkt.technology/portrait/header/561613-1719399406.jpg?lm=1,ES1,Reial Club Deportiu Espanyol de Barcelona S.A.D.,800000.0,800000.0,23,120,156,3,1,3,3,1,8,1,1,3,1,11,2,3,3,9,13,15,9,10,9,14,12,3,9,2,11,4,4,13,15,10,9,12,11,8,7,10,7,11,6,13,12,14,12,5,14,14,7,13,5,13,11,15,11,1,11,12,11,13,10,20,1,1,1,1,1,1,1,1,1,1,1,1,1,79,12,20,8225999,5900,5900,1500,Mediterranean_Hispanic,114,0,0,3459.0,Unknown,67277675,9111392.0,2.0,89,1287,89,2,1,3,170,5,0.530960571579783,0.1550802139037433,0.4779411764705882,0.0033313795677317,0.0,0.0,0.0037509377344336,0.0037509377344336,0.0505924720131114,0.1428571428571428,0.6511627906976742,0.2083333333333332,0,0,0,0,0,0,1,2,183,10000000,765384.6153846154,10000000.0,0.0,50000.0,400000.0,2,250000,11.5,24.0
562049,Edoardo,Bove,2024,430,Italy,Roma,Italy,16-05-02,Central Midfield,Midfield,Right,181.0,30-06-25,BSM,https://img.a.transfermarkt.technology/portrait/header/562049-1725532201.jpg?lm=1,IT1,Associazione Calcio Fiorentina,18000000.0,18000000.0,22,119,-8,8,10,12,8,14,7,8,9,5,10,14,9,12,14,14,12,12,13,12,12,12,16,12,7,11,11,15,15,13,13,13,8,15,12,14,11,13,10,12,4,15,2,3,3,2,2,1,3,1,3,1,2,9,13,4,14,15,17,13,14,1,1,1,1,1,1,20,1,20,1,1,1,1,1,68,10,20,29549999,5949,5749,3607,Mediterranean_Hispanic,117,0,0,7115.0,Unknown,43424702,9111392.0,2.0,52,1244,54,3,1,3,26,1,0.5109817412013761,0.3804278074866309,0.4999999999999999,0.0068616762922614,0.0,0.0,0.0897724431107777,0.0897724431107777,0.0505924720131114,0.1428571428571428,0.418604651162791,0.1666666666666666,169,27,16,16,0,4897,2,17,83,14000000,1370000.0,18000000.0,4000000.0,,3000000.0,2,4300000,-0.2222222222222222,-0.06666666666666667
562671,Unknown,Talys,2024,4294,Brazil,Itabuna,Brazil,10-02-99,Left-Back,Defender,Left,181.0,30-06-25,Unknown,https://img.a.transfermarkt.technology/portrait/header/562671-1600971308.jpg?lm=1,PO1,Sporting Clube Farense,600000.0,850000.0,25,71,-75,5,7,12,12,9,5,6,7,5,3,10,6,6,12,12,6,6,7,5,12,12,11,13,9,12,6,6,7,12,12,6,10,14,12,12,3,7,12,15,11,9,1,3,1,3,1,1,1,1,1,3,3,11,11,6,10,9,13,10,14,1,1,1,1,1,1,1,7,12,7,12,20,18,15,0,20,9,268126,3550,3550,250,Mixed_Race,71,0,0,46.0,Unknown,2000221580,9111392.0,2.0,10,670,11,1,0,4,191,8,0.2200317544323895,0.0213903743315508,0.1617647058823529,3.5727838842340775e-05,0.0,0.0,0.0027506876719179,0.0040010002500625,0.0505924720131114,0.1428571428571428,0.418604651162791,0.2916666666666665,135,1,8,20,0,5240,0,0,0,400000,17857.14285714286,850000.0,450000.0,,750000.0,4,500000,-0.3333333333333333,0.3333333333333333
562702,Mees,Hilgers,2024,317,Netherlands,Amersfoort,Indonesia,13-05-01,Centre-Back,Defender,Right,185.0,30-06-26,Wasserman,https://img.a.transfermarkt.technology/portrait/header/562702-1694856242.jpg?lm=1,NL1,Football Club Twente,7000000.0,7000000.0,23,116,-75,10,11,6,6,12,8,13,10,5,12,11,9,12,9,13,12,13,13,13,11,13,11,5,8,11,12,13,15,10,10,15,14,12,10,12,13,14,6,16,9,14,1,2,1,3,3,1,4,1,3,3,3,11,14,6,9,12,10,11,11,1,10,20,14,1,1,1,1,1,1,1,1,1,1,0,8,20,35069999,5800,5800,3851,South_East_Asian,111,0,0,2340.0,Unknown,37078404,9111392.0,2.0,67,61,49,1,1,9,91,2,0.5177295580841492,0.4065240641711229,0.4558823529411764,0.0022508538470674,0.0,0.0,0.0347586896724181,0.0347586896724181,0.0505924720131114,0.1428571428571428,0.5116279069767438,0.2083333333333332,189,8,2,19,1,6154,8,32,50,9000000,686538.4615384615,10000000.0,1000000.0,,1000000.0,0,0,0.2857142857142857,0.8
562742,Leo,Román,2024,237,Spain,Ibiza,Spain,06-07-00,Goalkeeper,Goalkeeper,Right,189.0,30-06-26,Unknown,https://img.a.transfermarkt.technology/portrait/header/562742-1648453168.jpg?lm=1,ES1,Real Club Deportivo Mallorca S.A.D.,1800000.0,1800000.0,24,115,140,5,2,3,3,9,6,1,2,1,2,9,4,3,7,5,13,12,10,10,9,11,11,1,13,1,12,10,9,11,14,4,8,13,10,7,7,20,9,8,15,15,12,12,14,5,14,13,13,14,6,8,10,10,11,8,13,12,12,13,13,20,1,1,1,1,1,1,1,1,1,1,1,1,1,81,7,20,2943999,5750,5750,2750,Mediterranean_Hispanic,107,0,0,3215.0,Unknown,2000028428,9111392.0,2.0,89,651,89,2,1,3,166,5,0.5111140513363324,0.2887700534759358,0.4264705882352941,0.0030957689548255,0.0,0.0,0.0087521880470117,0.0087521880470117,0.0505924720131114,0.1428571428571428,0.6046511627906974,0.25,0,0,0,0,0,0,0,0,0,2500000,200000.0,2500000.0,0.0,,,4,1100000,0.3888888888888889,1.5
563137,Robert,Navarro,2024,237,Spain,Barcelona,Spain,12-04-02,Attacking Midfield,Midfield,Right,178.0,30-06-25,Unknown,https://img.a.transfermarkt.technology/portrait/header/563137-1567246327.jpg?lm=1,ES1,Real Club Deportivo Mallorca S.A.D.,6000000.0,6000000.0,22,123,-8,12,11,13,9,15,12,6,13,3,6,13,11,7,15,12,15,7,10,9,14,13,11,14,10,16,8,12,12,15,13,14,9,13,14,12,11,13,11,13,6,12,3,2,1,2,3,2,1,2,2,1,3,7,14,7,12,12,9,8,17,1,1,1,1,1,1,1,1,14,1,18,20,16,1,65,8,20,60000001,6000,6000,3900,Mediterranean_Hispanic,124,0,0,4158.0,Unknown,49052213,3425000.0,2.0,89,141,89,3,1,3,166,0,0.5441915850754168,0.4117647058823529,0.5514705882352942,0.0040063460366722,0.0,0.0,0.0297574393598399,0.0297574393598399,0.0190005277924386,0.1428571428571428,0.3488372093023257,0.1666666666666666,166,22,13,7,1,2810,1,2,34,6000000,214285.7142857143,6000000.0,1000000.0,2500000.0,4000000.0,5,2000000,0.0,2.0
563139,José,Marsà,2024,354,Spain,Esplugues de Llobregat,Spain,04-03-02,Centre-Back,Defender,Left,185.0,30-06-27,Unique Sports Group,https://img.a.transfermarkt.technology/portrait/header/563139-1666099864.jpg?lm=1,BE1,Yellow-Red Koninklijke Voetbalclub Mechelen,800000.0,2000000.0,22,125,-8,6,11,11,7,12,6,12,7,11,13,13,6,14,13,14,14,13,13,12,13,14,14,12,9,9,12,14,12,13,13,13,13,15,14,13,12,15,5,15,8,15,1,3,1,3,2,3,1,1,1,1,2,12,13,5,14,16,14,13,15,1,15,20,1,14,1,1,11,1,1,1,1,1,1,77,20,8,28687501,6250,6250,4250,Mediterranean_Hispanic,125,0,0,6449.0,Unknown,67279755,120000.0,2.0,89,473,89,1,0,3,223,2,0.5772691188145012,0.4491978609625668,0.5588235294117647,0.0062185751930993,0.0,0.0,0.0037509377344336,0.0097524381095273,0.0006389066362954,0.1428571428571428,0.5116279069767438,0.1666666666666666,106,0,7,11,1,3526,0,0,0,1200000,111111.11111111111,2000000.0,500000.0,,2000000.0,4,1200000,0.5,0.2
563963,Mohammed,Salisu,2024,162,Ghana,Kumasi,Ghana,17-04-99,Centre-Back,Defender,Left,188.0,30-06-28,CAA Stellar,https://img.a.transfermarkt.technology/portrait/header/563963-1668428508.jpg?lm=1,FR1,Association sportive de Monaco Football Club,15000000.0,18000000.0,25,144,160,7,9,10,6,11,6,16,8,14,14,11,6,16,12,12,15,14,12,14,12,12,14,9,12,9,15,15,15,14,13,12,15,13,14,15,16,14,9,13,8,11,2,1,1,3,1,1,2,1,4,1,2,9,8,8,12,12,11,11,13,1,11,20,1,1,1,1,1,1,1,1,1,1,1,82,20,7,48071035,7200,7200,5750,African_Caribbean,144,0,0,46397.0,Unknown,67270690,13500000.0,2.0,39,768,41,1,0,1,24,2,0.702963747023022,0.6096256684491979,0.6985294117647058,0.0447930537356352,0.0,0.0,0.0747686921730432,0.0897724431107777,0.0749743048418011,0.1428571428571428,0.581395348837209,0.2916666666666665,188,6,3,34,0,2770,10,79,154,15000000,745000.0,18000000.0,3000000.0,100000.0,11000000.0,2,3000000,0.0,0.0
564489,Kamal,Sowah,2024,2282,Ghana,Sabon Zango,Ghana,09-01-00,Right Winger,Attack,Left,179.0,30-06-25,CAA Stellar,https://img.a.transfermarkt.technology/portrait/header/564489-1704982385.jpg?lm=1,BE1,Club Brugge Koninklijke Voetbalvereniging,1300000.0,7000000.0,24,126,134,10,11,12,12,12,9,7,10,5,5,10,12,12,11,11,14,13,13,12,12,9,14,15,5,15,8,14,14,16,13,12,13,13,14,14,11,5,5,12,5,13,1,3,3,1,1,2,2,2,1,3,3,18,18,6,12,14,12,11,14,1,1,1,1,1,1,1,12,10,17,17,16,20,13,66,20,7,4974999,6198,6198,4498,African_Caribbean,121,0,0,19999.0,Unknown,13183090,9000000.0,1.0,39,1268,41,0,0,1,53,10,0.5703889917967716,0.4757219251336897,0.5294117647058822,0.0193026891475241,0.0,0.0,0.0062515628907226,0.0347586896724181,0.049973610378066,0.0,0.3720930232558141,0.25,165,17,16,9,0,2848,1,1,4,1000000,43181.818181818184,7000000.0,2000000.0,150000.0,3000000.0,5,8500000,-0.4444444444444444,-0.6
564529,Victor,Kristiansen,2024,1003,Denmark,KÃ¸benhavn,Denmark,16-12-02,Left-Back,Defender,Left,181.0,30-06-28,Boutique Transfers,https://img.a.transfermarkt.technology/portrait/header/564529-1718628197.jpg?lm=1,GB1,Leicester City Football Club,15000000.0,15000000.0,22,123,-8,6,13,12,8,13,4,9,9,7,9,12,5,11,13,16,12,15,12,11,12,13,15,11,12,13,11,14,15,14,12,12,12,15,13,15,11,11,5,14,6,12,4,4,2,1,1,3,3,2,3,3,1,10,15,5,15,15,15,14,13,1,20,12,1,19,1,1,1,1,1,1,1,1,1,73,20,10,9098744,6250,5900,2750,Northern_European,118,0,0,3360.0,Unknown,27161400,14000000.0,1.0,28,778,30,1,0,7,127,8,0.530960571579783,0.2887700534759358,0.5073529411764706,0.0032357834583968,0.0,0.0,0.0747686921730432,0.0747686921730432,0.0777521597822161,0.0,0.418604651162791,0.1666666666666666,179,2,18,25,0,5636,4,19,91,16000000,1141071.4285714286,16000000.0,0.0,3000000.0,12000000.0,4,11000000,0.06666666666666667,0.3333333333333333
564545,Edmond,Tapsoba,2024,15,Burkina Faso,Ouagadougou,Burkina Faso,02-02-99,Centre-Back,Defender,Right,194.0,30-06-28,FMA Sports,https://img.a.transfermarkt.technology/portrait/header/564545-1695368009.jpg?lm=1,L1,Bayer 04 Leverkusen FuÃŸball,45000000.0,45000000.0,25,148,160,6,9,12,7,13,7,14,8,8,15,14,16,15,12,12,15,13,16,14,13,15,13,10,9,8,14,13,12,14,14,13,16,13,14,15,13,14,6,12,4,8,1,2,1,2,1,3,3,2,2,1,3,14,13,6,8,15,12,14,15,1,1,20,1,1,1,1,1,1,1,1,1,1,1,84,8,20,50409257,7389,6614,5516,African_Caribbean,149,29,0,57533.0,Unknown,13196616,20200000.0,1.0,12,1100,13,1,1,1,36,2,0.6254300079386081,0.5845989304812834,0.7352941176470587,0.0555461676099138,0.1907894736842105,0.0,0.2248062015503876,0.2248062015503876,0.1121975610433623,0.0,0.7209302325581395,0.2916666666666665,279,23,7,45,1,6838,5,23,92,40000000,1902380.9523809524,45000000.0,5000000.0,,4500000.0,2,13150000,-0.1111111111111111,0.0
564968,Francisco,Meixedo,2024,2431,Portugal,Porto,Portugal,19-05-01,Goalkeeper,Goalkeeper,Right,190.0,30-06-27,Unknown,https://img.a.transfermarkt.technology/portrait/header/564968-1686132168.png?lm=1,PO1,Club Football Estrela da Amadora,500000.0,1000000.0,23,102,138,3,2,1,2,8,8,2,1,2,2,16,4,3,4,5,9,12,11,12,5,12,14,2,11,1,10,11,11,10,11,8,12,12,10,11,8,11,6,12,6,13,12,11,13,10,13,10,12,14,12,8,7,9,10,6,13,11,11,10,16,20,1,1,1,1,1,1,1,1,1,1,1,1,1,67,7,20,635999,5100,5100,3600,Northern_European,100,0,0,2500.0,Unknown,83228782,9111392.0,2.0,76,1170,79,2,1,7,55,5,0.4251124636147129,0.3796791443850267,0.3749999999999999,0.0024053526096289,0.0,0.0,0.0022505626406601,0.0047511877969492,0.0505924720131114,0.1428571428571428,0.6279069767441858,0.2083333333333332,0,0,0,0,0,0,2,11,106,300000,20000.0,1000000.0,200000.0,,50000.0,1,200000,-0.4,-0.5714285714285714
565093,Bart,Verbruggen,2024,1237,Netherlands,Zwolle,Netherlands,18-08-02,Goalkeeper,Goalkeeper,Right,194.0,30-06-28,Stirr Associates,https://img.a.transfermarkt.technology/portrait/header/565093-1716990260.jpg?lm=1,GB1,Brighton and Hove Albion Football Club,22000000.0,22000000.0,22,115,-75,5,3,2,3,14,9,4,2,1,1,15,6,2,11,5,12,13,15,13,13,13,13,12,8,2,11,12,12,11,12,13,15,15,12,12,8,14,9,8,7,10,13,16,13,12,11,14,12,9,11,14,13,11,12,5,10,9,12,10,18,20,1,1,1,1,1,1,1,1,1,1,1,1,1,75,7,20,24620000,5600,5250,2752,Northern_European,120,0,0,1199.0,Unknown,37076355,11150000.0,2.0,67,1710,68,2,1,7,44,5,0.4449589838581635,0.2889839572192513,0.5220588235294117,0.0011490845465509,0.0,0.0,0.1097774443610902,0.1097774443610902,0.0619183866218506,0.1428571428571428,0.7209302325581395,0.1666666666666666,0,0,0,0,0,0,1,2,3,25000000,1921153.8461538462,25000000.0,0.0,750000.0,10000000.0,2,5225000,0.3888888888888889,0.6666666666666666
565424,Johan,Bakayoko,2024,383,Belgium,Overijse,Belgium,20-04-03,Right Winger,Attack,Left,179.0,30-06-26,sa AEPC,https://img.a.transfermarkt.technology/portrait/header/565424-1697637209.jpg?lm=1,NL1,Eindhovense Voetbalvereniging Philips Sport Vereniging,45000000.0,45000000.0,21,118,-8,12,12,14,8,12,14,9,12,11,4,16,10,5,14,6,9,12,9,9,8,10,12,14,4,12,5,9,11,14,14,12,10,12,14,12,8,11,10,11,11,13,2,1,2,1,4,2,1,1,2,4,1,13,10,4,7,11,8,11,16,1,1,1,1,1,1,1,14,1,14,18,10,20,10,0,20,12,57600001,5650,4830,3930,African_Caribbean,112,0,0,2156.0,Unknown,18111484,9111392.0,2.0,7,1103,8,0,0,1,62,10,0.3893887271765017,0.4149732620320855,0.463235294117647,0.0020731802701217,0.0,0.0,0.2248062015503876,0.2248062015503876,0.0505924720131114,0.1428571428571428,0.3720930232558141,0.125,192,61,40,12,0,5606,2,2,7,40000000,3325000.0,45000000.0,5000000.0,500000.0,40000000.0,1,1500000,-0.1111111111111111,0.0
565822,Harvey,Elliott,2024,31,England,London,England,04-04-03,Central Midfield,Midfield,Left,170.0,30-06-27,ROOF,https://img.a.transfermarkt.technology/portrait/header/565822-1665128076.jpg?lm=1,GB1,Liverpool Football Club,35000000.0,35000000.0,21,141,170,12,15,15,11,17,12,6,11,6,9,16,11,9,16,13,14,12,15,13,16,13,16,15,9,15,11,16,17,12,14,16,6,11,13,13,11,11,5,13,7,12,3,3,3,3,1,1,1,3,1,1,3,14,15,8,16,14,13,9,12,1,1,1,1,1,1,1,14,18,14,17,15,20,6,64,20,7,63795455,7050,7050,5750,Northern_European,141,0,0,52196.0,Unknown,29233143,1700000.0,1.0,32,858,33,3,0,7,129,1,0.6831172267795713,0.6096256684491979,0.6764705882352942,0.0503926682612226,0.0,0.0,0.1747936984246061,0.1747936984246061,0.0094169282480068,0.0,0.1627906976744184,0.125,227,29,41,18,0,6514,2,48,141,35000000,2066666.6666666667,35000000.0,5000000.0,22000000.0,35000000.0,2,4000000,0.0,0.16666666666666666
566025,Mohamed,Abdelmonem,2024,417,Egypt,Zagazig,Egypt,01-02-99,Centre-Back,Defender,Right,183.0,30-06-28,Unknown,https://img.a.transfermarkt.technology/portrait/header/566025-1641136609.jpg?lm=1,FR1,Olympique Gymnaste Club Nice CÃ´te d'Azur,4000000.0,4000000.0,25,122,150,4,6,10,5,13,2,13,3,3,14,11,13,14,11,14,14,12,12,13,11,14,15,6,11,7,14,11,12,12,11,11,14,12,14,14,13,14,10,14,8,10,1,1,1,3,2,2,2,3,1,3,3,12,14,7,12,13,13,12,14,1,1,20,10,1,1,1,1,1,1,1,1,1,1,0,12,20,4340436,5750,6500,3750,North_African__Middle_Eastern,128,10,1,7396.0,Unknown,2000067300,4200000.0,1.0,31,1696,32,1,1,6,142,2,0.6103466525535857,0.3957219251336898,0.5808823529411764,0.00713301474401,0.0657894736842105,0.0131578947368421,0.0197549387346836,0.0197549387346836,0.0233062029500819,0.0,0.4651162790697669,0.2916666666666665,170,10,0,31,2,5211,2,6,32,4000000,305769.23076923075,4000000.0,0.0,,25000.0,6,2175000,0.3333333333333333,0.3333333333333333
566036,Borja,Garcés,2024,13,Spain,Melilla,Spain,06-08-99,Centre-Forward,Attack,Right,183.0,30-06-25,Unknown,https://img.a.transfermarkt.technology/portrait/header/566036-1635147184.jpg?lm=1,ES1,Club AtlÃ©tico de Madrid S.A.D.,2000000.0,3000000.0,25,114,138,6,8,10,13,11,8,13,11,6,6,10,8,7,11,12,13,15,10,10,10,11,13,12,11,14,7,12,15,13,12,11,13,13,14,13,12,12,14,13,12,8,1,2,1,4,3,2,3,1,1,2,1,13,14,13,10,10,9,12,8,1,1,1,1,1,1,1,1,1,1,1,1,1,20,75,10,20,1949999,5750,5750,3800,Mediterranean_Hispanic,112,0,0,4231.0,Tenerife,67270540,9111392.0,2.0,89,939,89,0,1,3,52,3,0.5111140513363324,0.4010695187165775,0.463235294117647,0.0040768360970908,0.0,0.0,0.0097524381095273,0.0147536884221055,0.0505924720131114,0.1428571428571428,0.4651162790697669,0.2916666666666665,0,0,0,0,0,0,3,50,245,1500000,-88235.29411764706,3000000.0,500000.0,,2700000.0,5,1200000,-0.25,-0.25
566271,Yusuf,Baras?,2024,3840,Germany,Bremen,TÃ¼rkiye,31-03-03,Centre-Forward,Attack,Right,182.0,30-06-26,Unknown,https://img.a.transfermarkt.technology/portrait/header/566271-1728553161.jpg?lm=1,TR1,Adana Demirspor KulÃ¼bÃ¼,1000000.0,1000000.0,21,103,-75,4,8,12,13,13,5,10,9,3,5,11,15,4,12,7,13,8,12,10,9,10,13,13,6,13,4,8,9,13,14,12,9,12,12,10,10,11,5,12,2,5,1,3,2,3,4,4,3,4,1,3,3,18,12,5,11,11,9,11,17,1,1,1,1,1,1,1,1,1,1,18,10,10,20,66,13,20,35600000,5049,5049,3303,North_African__Middle_Eastern,102,0,0,1114.0,Unknown,37079095,300000.0,1.0,38,253,100,0,1,6,13,3,0.4183646467319397,0.3479144385026738,0.3897058823529412,0.0010670070789401,0.0,0.0,0.0047511877969492,0.0047511877969492,0.0016389344148448,0.0,0.4418604651162785,0.125,179,55,18,5,2,5599,3,25,113,1000000,67857.14285714286,1000000.0,50000.0,500000.0,775000.0,2,50000,0.05263157894736842,0.5384615384615384
566571,Oliver,Bundgaard,2024,1063,Denmark,Randers,Denmark,15-06-01,Left-Back,Defender,Left,189.0,30-06-26,BWM Fodbold,https://img.a.transfermarkt.technology/portrait/header/566571-1627564849.jpg?lm=1,DK1,Viborg Fodsports Forening,1200000.0,1200000.0,23,123,129,7,8,10,9,10,10,13,12,9,12,11,12,14,10,15,12,15,11,14,11,13,17,6,11,11,13,14,16,11,10,14,16,15,13,17,15,15,10,14,5,14,1,3,3,1,3,3,1,3,1,2,3,10,12,5,13,11,12,12,10,1,10,10,1,11,1,20,12,17,10,9,10,8,1,82,20,8,4699152,6000,6000,3250,Northern_European,122,1,0,18000.0,Celtic,27093157,363000.0,1.0,28,1204,30,1,0,7,215,8,0.5441915850754168,0.3422459893048128,0.536764705882353,0.0173724202327716,0.006578947368421,0.0,0.0057514378594648,0.0057514378594648,0.0019889441373371,0.0,0.6046511627906974,0.2083333333333332,199,15,8,11,0,7939,2,15,396,1200000,88461.53846153847,1200000.0,100000.0,100000.0,400000.0,1,100000,0.0,0.3333333333333333
566574,Kirian,Rodríguez,2024,472,Spain,Santa Cruz de Tenerife,Spain,05-03-96,Attacking Midfield,Midfield,Right,178.0,30-06-28,Wasserman,https://img.a.transfermarkt.technology/portrait/header/566574-1658407760.jpg?lm=1,ES1,UniÃ³n Deportiva Las Palmas S.A.D.,12000000.0,12000000.0,28,126,-8,9,13,15,11,14,10,7,11,11,5,13,13,5,14,6,13,9,10,8,12,11,10,15,4,14,6,10,13,16,15,10,8,6,12,12,7,9,5,11,5,13,3,2,4,2,2,2,2,1,1,2,1,14,14,11,8,8,7,10,11,1,1,1,1,1,1,1,1,8,1,18,16,20,14,69,11,20,11141362,6450,6850,5250,Mediterranean_Hispanic,120,17,3,16249.0,Unknown,78088254,9111392.0,2.0,89,1324,89,3,1,3,207,0,0.6566551997883038,0.5561497326203209,0.5220588235294117,0.0156816243999895,0.1118421052631578,0.0394736842105263,0.0597649412353088,0.0597649412353088,0.0505924720131114,0.1428571428571428,0.3488372093023257,0.4166666666666665,213,18,15,27,0,1867,2,29,185,12000000,663888.8888888889,12000000.0,100000.0,,,1,50000,0.0,1.0
566615,Mikael Egill,Ellertsson,2024,607,Iceland,ReykjavÃ­k,Iceland,11-03-02,Central Midfield,Midfield,Left,182.0,30-06-27,CAA Stellar,https://img.a.transfermarkt.technology/portrait/header/566615-1656583739.jpg?lm=1,IT1,Venezia Football Club,2000000.0,2000000.0,22,115,-75,7,8,13,12,13,8,8,9,6,12,12,8,12,12,8,12,11,11,11,11,12,14,12,10,13,13,12,12,13,13,11,12,17,13,13,12,13,8,11,8,10,1,1,3,1,1,1,3,3,1,1,3,13,14,10,12,12,14,13,14,1,10,1,1,12,1,1,14,20,1,12,14,1,8,0,20,11,22720002,5750,5750,4500,Northern_European,115,6,0,7579.0,Unknown,39056943,9111392.0,2.0,46,1222,48,3,0,7,210,1,0.5111140513363324,0.4759358288770053,0.4852941176470588,0.0073097227036897,0.0394736842105263,0.0,0.0097524381095273,0.0097524381095273,0.0505924720131114,0.1428571428571428,0.4418604651162785,0.1666666666666666,195,29,11,25,0,2940,1,19,90,2800000,277777.77777777775,2800000.0,0.0,,1000000.0,3,1200000,0.4,0.4
566723,Michael,Olise,2024,27,England,London,France,12-12-01,Right Winger,Attack,Left,184.0,30-06-29,Unknown,https://img.a.transfermarkt.technology/portrait/header/566723-1725873883.jpg?lm=1,L1,FC Bayern MÃ¼nchen,65000000.0,65000000.0,23,138,-9,12,14,16,11,15,14,7,13,4,9,15,12,8,15,6,11,9,13,11,14,14,12,16,9,13,10,11,12,15,15,14,11,13,14,12,10,13,5,12,9,8,2,2,2,1,3,1,4,3,2,1,3,8,16,5,8,15,13,11,8,1,1,1,1,1,1,1,12,11,13,14,16,20,1,71,20,9,57995868,6900,6900,5650,African_Caribbean,138,0,0,52196.0,Unknown,29221846,31150000.0,2.0,32,858,36,0,0,1,68,10,0.6632707065361206,0.5989304812834224,0.6544117647058822,0.0503926682612226,0.0,0.0,0.3248312078019504,0.3248312078019504,0.173032584238451,0.1428571428571428,0.4883720930232553,0.2083333333333332,231,42,56,18,0,4588,4,32,136,65000000,3600000.0,65000000.0,100000.0,4500000.0,22000000.0,3,13700000,0.18181818181818182,0.3
566931,Xavi,Simons,2024,23826,Netherlands,Amsterdam,Netherlands,21-04-03,Attacking Midfield,Midfield,Right,179.0,30-06-25,Darren Dein,https://img.a.transfermarkt.technology/portrait/header/566931-1695158618.jpg?lm=1,L1,RasenBallsport Leipzig,80000000.0,80000000.0,21,133,-85,8,10,14,11,16,8,6,10,5,8,13,8,10,15,15,12,13,13,12,14,12,16,15,9,13,9,14,13,15,15,12,6,15,13,12,10,15,6,15,5,15,2,1,2,3,4,1,1,2,2,3,2,15,17,5,14,16,15,14,10,1,1,1,1,1,1,14,1,20,1,1,18,1,10,67,13,20,85725000,6799,6799,4299,African_Caribbean,127,0,0,29999.0,Unknown,67288555,4000000.0,1.0,67,64,68,3,1,1,162,0,0.6499073829055305,0.4544385026737967,0.5735294117647058,0.0289588618076162,0.0,0.0,0.3998499624906226,0.3998499624906226,0.0221950609739159,0.0,0.3720930232558141,0.125,163,59,49,25,1,5523,1,13,70,80000000,5678571.428571428,80000000.0,0.0,3000000.0,80000000.0,3,35500000,0.0,0.14285714285714285
566965,Diego,Collado,2024,2424,Spain,Granada,Spain,09-01-01,Left Winger,Attack,Right,183.0,30-06-27,LEADERBROCK,https://img.a.transfermarkt.technology/portrait/header/566965-1698947126.jpg?lm=1,PO1,Gil Vicente Futebol Clube,800000.0,1000000.0,23,116,139,10,8,14,12,15,10,11,12,10,10,11,8,7,15,8,15,9,10,11,7,12,8,13,9,12,10,11,11,15,12,15,10,12,14,6,8,8,7,14,5,13,3,4,3,2,2,3,2,3,1,3,2,13,10,6,11,13,13,10,19,1,1,1,1,1,1,1,1,1,1,20,1,16,16,0,10,20,4039999,5400,5400,2900,Mediterranean_Hispanic,110,0,0,1681.0,Unknown,67287668,9111392.0,2.0,89,552,89,0,1,3,106,7,0.4648055041016142,0.3048128342245988,0.4485294117647059,0.0016145120687673,0.0,0.0,0.0037509377344336,0.0047511877969492,0.0505924720131114,0.1428571428571428,0.4651162790697669,0.2083333333333332,149,17,9,7,2,1846,2,43,810,400000,21428.571428571428,1000000.0,400000.0,100000.0,100000.0,1,400000,-0.5,-0.6
567023,Gamid,Agalarov,2024,75231,Russia,Makhachkala,Russia,16-07-00,Centre-Forward,Attack,Left,181.0,30-06-27,Unknown,https://img.a.transfermarkt.technology/portrait/header/567023-1599993681.png?lm=1,RU1,Dinamo Makhachkala,900000.0,6000000.0,24,116,135,6,6,9,15,12,7,12,8,6,6,8,12,8,11,9,12,15,10,15,10,12,8,11,4,13,6,8,10,14,14,14,10,14,13,14,10,14,10,8,7,5,2,1,3,3,3,2,3,1,3,1,2,16,8,12,11,10,11,7,7,1,1,1,1,1,1,1,1,1,1,1,10,1,20,75,20,12,3437552,5781,5781,3517,Northern_European,112,0,0,21452.0,Unknown,58137501,1513333.333,3.0,78,897,81,0,0,7,60,3,0.5152156655199789,0.3708021390374331,0.463235294117647,0.0207057310350354,0.0,0.0,0.0042510627656914,0.0297574393598399,0.0083798624017333,0.2857142857142857,0.418604651162791,0.25,202,62,15,40,0,6354,5,13,49,1000000,48684.21052631579,6000000.0,2000000.0,300000.0,350000.0,6,2150000,0.1111111111111111,-0.3333333333333333
567576,Elliot,Anderson,2024,703,England,Whitley Bay,England,06-11-02,Central Midfield,Midfield,Right,179.0,30-06-29,CAA Stellar,https://img.a.transfermarkt.technology/portrait/header/567576-1696453772.jpg?lm=1,GB1,Nottingham Forest Football Club,22000000.0,22000000.0,22,123,-85,10,11,13,12,13,12,9,12,3,8,12,11,10,12,14,12,14,13,11,12,12,5,13,8,11,12,14,15,12,12,13,8,11,12,13,12,11,11,10,10,11,2,1,4,2,2,1,4,3,1,4,3,13,13,4,10,10,13,10,10,1,1,1,1,1,1,8,1,18,1,18,20,15,1,0,15,20,72541231,6150,6150,4260,Northern_European,123,0,0,11599.0,Unknown,28127254,41200000.0,1.0,32,1662,33,3,1,7,140,1,0.5640381053188674,0.4502673796791443,0.5441176470588236,0.0111915041130467,0.0,0.0,0.1097774443610902,0.1097774443610902,0.2288674685407928,0.0,0.3720930232558141,0.1666666666666666,156,32,21,15,0,5092,2,28,126,24000000,2644444.4444444445,24000000.0,0.0,200000.0,13000000.0,2,8300000,0.6,0.8461538461538461
568154,Lucas,Cañizares,2024,4294,Spain,Valencia,Spain,10-05-02,Goalkeeper,Goalkeeper,Right,188.0,30-06-27,DV7 Management,https://img.a.transfermarkt.technology/portrait/header/568154-1603003972.jpg?lm=1,PO1,Sporting Clube Farense,400000.0,700000.0,22,105,-85,4,1,2,2,3,5,1,2,1,1,7,3,2,2,6,7,15,8,11,7,13,14,1,9,3,13,8,7,13,12,8,15,14,9,7,13,14,9,12,13,13,13,13,12,5,13,7,13,13,10,5,11,17,13,8,9,11,12,14,17,20,1,1,1,1,1,1,1,1,1,1,1,1,1,82,11,20,24300001,5250,5250,3250,Mediterranean_Hispanic,107,0,0,1944.0,Unknown,67294853,9111392.0,2.0,89,1556,89,2,1,3,191,5,0.4449589838581635,0.3422459893048128,0.4264705882352941,0.0018684694097278,0.0,0.0,0.0017504376094023,0.0032508127031757,0.0505924720131114,0.1428571428571428,0.581395348837209,0.1666666666666666,0,0,0,0,0,0,1,25,282,400000,-33333.333333333336,700000.0,500000.0,,200000.0,1,0,0.0,1.0
568157,Yéremy,Pino,2024,1050,Spain,Las Palmas,Spain,20-10-02,Right Winger,Attack,Right,172.0,30-06-27,CAA Stellar,https://img.a.transfermarkt.technology/portrait/header/568157-1686664370.jpg?lm=1,ES1,Villarreal Club de FÃºtbol S.A.D.,30000000.0,40000000.0,22,142,175,12,13,16,12,14,12,9,11,9,8,14,12,9,16,12,13,10,13,13,14,13,14,16,10,9,8,10,10,14,15,14,7,13,14,13,9,13,6,14,7,14,4,1,1,3,3,3,2,1,3,3,1,12,14,6,14,16,17,12,18,1,1,1,1,1,1,1,10,1,12,18,16,20,16,65,12,20,72929999,7100,7100,4250,Mediterranean_Hispanic,136,4,1,27476.0,Unknown,67295650,9111392.0,2.0,89,802,89,0,1,3,216,10,0.6897327335273882,0.4491978609625668,0.6397058823529411,0.0265226094454749,0.0263157894736842,0.0131578947368421,0.1497874468617154,0.1997999499874969,0.0505924720131114,0.1428571428571428,0.2093023255813952,0.1666666666666666,155,19,19,32,0,3139,5,61,214,30000000,2115384.6153846155,40000000.0,5000000.0,30000000.0,35000000.0,0,0,0.0,0.0
568158,Javi,López,2024,681,Spain,Santa Cruz de Tenerife,Spain,25-03-02,Left-Back,Defender,Right,183.0,30-06-30,Gesport Espizua SL,https://img.a.transfermarkt.technology/portrait/header/568158-1647530894.jpg?lm=1,ES1,Real Sociedad de FÃºtbol S.A.D.,7500000.0,7500000.0,22,125,141,9,12,11,8,11,8,7,10,11,12,13,8,13,11,13,12,14,11,13,11,11,10,8,13,14,14,15,16,12,12,13,8,13,12,13,11,15,9,16,5,17,1,3,3,2,3,2,3,2,3,2,3,11,12,7,12,11,10,12,11,1,5,1,20,8,18,14,10,15,19,8,1,14,1,74,12,20,85482,6250,6250,4000,Mediterranean_Hispanic,117,0,0,2053.0,Unknown,67006184,6500000.0,1.0,89,1324,89,1,1,3,168,8,0.5772691188145012,0.4224598930481283,0.4999999999999999,0.0019737216917228,0.0,0.0,0.0372593148287071,0.0372593148287071,0.0360843356759909,0.0,0.4651162790697669,0.1666666666666666,135,1,4,14,1,2013,3,14,65,7500000,532142.8571428572,7500000.0,100000.0,600000.0,700000.0,1,0,0.0,1.5
568177,Cole,Palmer,2024,631,England,Manchester,England,06-05-02,Attacking Midfield,Midfield,Left,189.0,30-06-33,CAA Base Ltd,https://img.a.transfermarkt.technology/portrait/header/568177-1712320986.jpg?lm=1,GB1,Chelsea Football Club,90000000.0,90000000.0,22,135,-85,12,12,14,13,13,12,8,13,3,6,13,13,8,16,8,13,8,13,12,13,12,13,14,7,13,8,11,13,15,14,13,13,13,14,13,8,12,5,13,5,10,2,1,1,3,1,1,1,3,2,3,3,7,13,8,10,9,12,13,9,1,1,1,1,1,1,1,1,15,1,17,20,20,13,0,20,9,81310207,6742,6742,5742,Northern_European,127,0,0,28998.0,Unknown,28120042,47000000.0,1.0,32,905,33,3,0,7,50,0,0.6423657052130193,0.6087700534759358,0.5735294117647058,0.0279922789243409,0.0,0.0,0.4498624656164041,0.4498624656164041,0.2610905858496069,0.0,0.6046511627906974,0.1666666666666666,178,87,42,20,1,4939,4,24,94,130000000,9961538.461538462,130000000.0,0.0,500000.0,15000000.0,2,16500000,0.625,1.8888888888888888
568333,Adam,Obert,2024,1390,Slovakia,Bratislava,Slovakia,23-08-02,Centre-Back,Defender,Left,188.0,30-06-27,Unknown,https://img.a.transfermarkt.technology/portrait/header/568333-1695033793.jpg?lm=1,IT1,Cagliari Calcio,3500000.0,3500000.0,22,116,-75,3,9,8,7,10,8,13,8,8,13,10,8,14,9,10,13,14,12,13,8,12,14,7,8,8,13,12,13,13,11,13,15,12,13,14,12,13,8,12,5,12,4,3,3,3,3,3,3,1,3,1,4,14,13,6,13,14,10,12,13,1,16,20,1,14,1,1,12,1,1,1,1,1,1,80,20,6,11142000,5792,4505,3573,Northern_European,117,0,0,7996.0,Unknown,43461908,50000.0,1.0,86,245,86,1,0,7,46,2,0.3463879333156919,0.3767914438502673,0.4999999999999999,0.0077123851036155,0.0,0.0,0.0172543135783946,0.0172543135783946,0.0002500069446373,0.0,0.581395348837209,0.1666666666666666,166,5,6,11,0,4870,3,5,16,3000000,331250.0,3500000.0,500000.0,350000.0,1800000.0,1,550000,-0.14285714285714285,0.6666666666666666
568362,Suphanat,Mueanta,2024,2727,Thailand,Sisaket,Thailand,02-08-02,Right Winger,Attack,Right,173.0,30-06-25,Unknown,https://img.a.transfermarkt.technology/portrait/header/568362-1713338920.jpg?lm=1,BE1,Oud-Heverlee Leuven,800000.0,1000000.0,22,107,143,3,8,13,14,13,5,8,7,4,5,10,12,7,13,9,13,11,13,13,12,13,15,14,3,14,5,12,11,12,13,7,8,13,12,12,10,13,6,13,9,10,2,3,2,1,1,2,2,1,1,2,2,14,15,4,14,13,15,16,13,1,1,1,1,1,1,1,1,1,1,17,1,17,20,63,13,20,990182,5430,5830,2474,South_East_Asian,107,7,3,951.0,Unknown,23414964,9111392.0,2.0,95,1378,95,0,1,9,146,10,0.5216988621328393,0.2592513368983957,0.4264705882352941,0.0009096114645806,0.0460526315789473,0.0394736842105263,0.0037509377344336,0.0047511877969492,0.0505924720131114,0.1428571428571428,0.2325581395348837,0.1666666666666666,172,40,29,4,0,5982,5,24,99,800000,65000.0,1000000.0,200000.0,500000.0,700000.0,1,300000,0.0,0.0
568559,Radu,Dr?Gu?In,2024,148,Romania,Bucharest,Romania,03-02-02,Centre-Back,Defender,Right,191.0,30-06-30,GG11 ,https://img.a.transfermarkt.technology/portrait/header/568559-1718259698.jpg?lm=1,GB1,Tottenham Hotspur Football Club,25000000.0,25000000.0,22,120,-75,6,10,10,6,12,6,13,6,10,14,13,6,15,10,13,12,13,11,11,10,11,14,10,12,6,13,11,12,12,12,13,12,13,12,15,15,12,9,11,4,12,3,2,2,3,3,3,2,1,2,1,3,15,14,12,12,13,14,13,12,1,1,20,16,1,1,1,1,1,1,1,1,1,1,82,9,20,5500000,6000,5500,5000,Mediterranean_Hispanic,119,1,0,13483.0,Genoa CFC,57178516,12266666.67,3.0,77,270,80,1,1,3,202,2,0.4780365175972479,0.5294117647058822,0.5147058823529411,0.013010727042208,0.006578947368421,0.0,0.1247811952988247,0.1247811952988247,0.0681222626739631,0.2857142857142857,0.6511627906976742,0.1666666666666666,182,12,2,16,1,5416,3,26,182,25000000,1861538.4615384615,25000000.0,0.0,800000.0,3500000.0,4,5500000,0.0,0.25
568693,Pape Matar,Sarr,2024,148,Senegal,Thiaroye,Senegal,14-09-02,Central Midfield,Midfield,Right,184.0,30-06-30,CAA Base Ltd,https://img.a.transfermarkt.technology/portrait/header/568693-1668163083.jpg?lm=1,GB1,Tottenham Hotspur Football Club,45000000.0,45000000.0,22,115,-8,7,7,12,9,13,8,12,13,8,10,12,9,13,12,12,13,12,13,11,13,11,6,13,10,11,14,12,12,11,14,13,12,14,9,12,12,11,13,9,6,11,1,2,3,2,2,2,2,2,1,1,3,13,10,3,12,11,11,11,16,1,1,1,1,1,1,14,10,20,10,8,14,8,1,70,11,20,72842810,6197,6197,4255,African_Caribbean,114,8,0,13919.0,Unknown,12080051,16900000.0,1.0,83,1487,84,3,1,1,202,1,0.5702566816618153,0.4497326203208556,0.4779411764705882,0.0134317361701881,0.0526315789473684,0.0,0.2248062015503876,0.2248062015503876,0.0938637184366232,0.0,0.4883720930232553,0.1666666666666666,0,0,0,0,0,0,3,7,16,45000000,3500000.0,45000000.0,5000000.0,10000000.0,15000000.0,1,0,0.0,0.2857142857142857
568698,Issa,Soumaré,2024,738,Senegal,Podor,Senegal,10-10-00,Left Winger,Attack,Right,182.0,30-06-26,FAIR SPORT MNG,https://img.a.transfermarkt.technology/portrait/header/568698-1669738231.jpg?lm=1,FR1,Le Havre Athletic Club,800000.0,1000000.0,24,110,143,6,12,13,11,13,10,11,10,8,8,11,6,7,12,9,12,7,13,11,11,10,14,10,8,12,12,13,12,14,12,11,11,12,13,11,10,12,8,13,8,12,2,1,3,3,2,1,1,2,2,2,1,12,11,4,12,9,12,11,18,1,1,1,1,1,1,1,14,1,13,20,1,17,16,78,7,20,7675000,5497,5497,2497,African_Caribbean,107,0,0,2000.0,Quevilly Rouen,12078293,400000.0,1.0,83,1157,84,0,1,1,126,7,0.477639587192379,0.261711229946524,0.4264705882352941,0.0019225439766243,0.0,0.0,0.0037509377344336,0.0047511877969492,0.0021945054029278,0.0,0.4418604651162785,0.25,160,19,13,14,2,3779,2,5,38,1000000,57692.307692307695,1000000.0,100000.0,,500000.0,5,750000,0.25,0.1111111111111111
569033,Armindo,Sieb,2024,39,Germany,Halle (Saale),Germany,17-02-03,Second Striker,Attack,Right,175.0,30-06-26,CAA Stellar,https://img.a.transfermarkt.technology/portrait/header/569033-1722886149.jpg?lm=1,L1,1. FuÃŸball- und Sportverein Mainz 05,4000000.0,4000000.0,21,108,-75,4,8,13,12,12,11,11,11,3,6,12,12,6,13,12,10,11,10,9,11,8,12,14,3,12,6,9,9,13,12,11,10,13,15,11,11,12,6,8,8,13,2,2,3,3,3,3,3,4,1,1,2,11,16,10,8,12,8,10,12,1,1,1,1,8,10,1,10,1,12,15,15,18,20,76,13,20,5879999,5428,5428,3923,Mixed_Race,103,0,0,6711.0,Unknown,2000065610,775000.0,2.0,38,592,40,0,1,4,1,12,0.4685101878803916,0.4142245989304812,0.3970588235294117,0.0064715669167937,0.0,0.0,0.0197549387346836,0.0197549387346836,0.0042778966082391,0.1428571428571428,0.2790697674418605,0.125,184,56,21,12,1,2415,3,13,80,4000000,325000.0,4000000.0,0.0,1500000.0,2000000.0,2,0,0.0,1.0
569366,Enzo,Millot,2024,79,France,LucÃ©,France,17-07-02,Attacking Midfield,Midfield,Left,174.0,30-06-28,Unknown,https://img.a.transfermarkt.technology/portrait/header/569366-1723707547.jpg?lm=1,L1,Verein fÃ¼r Bewegungsspiele Stuttgart 1893,42000000.0,42000000.0,22,110,-8,10,12,12,8,13,11,8,11,3,3,13,11,5,13,11,12,13,13,11,14,12,13,13,10,12,9,13,13,13,13,11,8,13,12,12,8,12,7,12,10,12,1,2,2,3,3,2,2,2,1,3,2,10,14,6,10,14,14,12,14,1,1,1,1,1,1,8,12,20,12,16,18,16,1,0,20,9,60352001,5495,5495,3495,African_Caribbean,104,0,0,7691.0,Unknown,49048469,1750000.0,1.0,34,871,36,3,0,1,211,0,0.4773749669224663,0.3684491978609625,0.4044117647058823,0.0074178718374827,0.0,0.0,0.2098024506126531,0.2098024506126531,0.0096947137420483,0.0,0.2558139534883721,0.1666666666666666,123,20,21,19,0,3601,7,22,81,42000000,2790000.0,42000000.0,0.0,1000000.0,7000000.0,2,1350000,0.4,0.68
569383,Chrislain,Matsima,2024,167,France,Colombes,France,15-05-02,Centre-Back,Defender,Right,193.0,30-06-25,Classico,https://img.a.transfermarkt.technology/portrait/header/569383-1726605447.jpg?lm=1,L1,FC Augsburg 1907,7000000.0,7000000.0,22,100,-75,4,4,8,6,11,5,13,6,4,12,11,5,13,12,10,11,13,10,12,9,12,12,6,8,7,11,12,11,12,9,12,14,14,12,13,13,12,8,10,6,11,3,1,4,3,2,3,1,2,1,2,3,10,13,8,10,11,11,12,14,1,1,20,14,1,12,16,1,1,1,1,1,1,1,0,6,20,32173876,4995,5245,2245,African_Caribbean,100,0,0,1246.0,FC Lorient,49048468,9111392.0,2.0,34,375,36,1,1,1,67,2,0.4442974331833819,0.23475935828877,0.3749999999999999,0.0011944685580533,0.0,0.0,0.0347586896724181,0.0347586896724181,0.0505924720131114,0.1428571428571428,0.6976744186046511,0.1666666666666666,104,3,2,11,0,2747,2,4,11,7000000,620000.0,7000000.0,1000000.0,4000000.0,4000000.0,4,3000000,0.0,0.0
569384,Lucien,Agoumé,2024,368,Cameroon,YaoundÃ©,France,09-02-02,Defensive Midfield,Midfield,Right,185.0,30-06-28,ND SPORTS MANAGEMENT,https://img.a.transfermarkt.technology/portrait/header/569384-1656577561.jpg?lm=1,ES1,Sevilla FÃºtbol Club S.A.D.,6000000.0,7000000.0,22,119,-8,10,9,12,9,12,11,11,10,8,10,14,10,12,13,8,11,10,8,12,14,12,12,12,6,13,12,12,12,12,12,14,13,17,12,15,13,12,7,13,6,11,1,2,2,1,2,3,2,3,2,2,3,10,14,10,12,11,14,12,10,1,1,1,1,1,1,18,1,20,1,1,15,1,1,72,10,20,59750000,5949,4792,4658,African_Caribbean,118,0,0,7115.0,ESTAC Troyes,49048461,4250000.0,2.0,15,1682,36,3,1,1,181,4,0.3843609420481609,0.4928342245989304,0.5073529411764706,0.0068616762922614,0.0,0.0,0.0297574393598399,0.0347586896724181,0.0235839884441234,0.1428571428571428,0.5116279069767438,0.1666666666666666,133,1,5,24,1,4617,4,16,50,7000000,269230.76923076925,7000000.0,1000000.0,3500000.0,7000000.0,6,2000000,0.16666666666666666,0.16666666666666666
569386,Logan,Delaurier-Chaubet,2024,723,France,Saint-Jean-de-Verges,France,22-04-02,Right Winger,Attack,Left,173.0,30-06-27,2SAgency,https://img.a.transfermarkt.technology/portrait/header/569386-1640724675.jpg?lm=1,NL1,Almere City Football Club,600000.0,600000.0,22,104,-75,13,11,13,9,13,13,5,8,6,5,11,10,6,12,14,10,14,12,13,11,11,16,15,10,12,6,12,13,13,14,12,5,13,13,11,7,12,10,13,6,12,2,1,1,2,3,2,2,2,1,1,2,15,12,3,13,10,12,10,16,1,1,1,1,1,1,1,17,15,1,20,17,1,1,0,20,8,15800000,5200,5200,2000,North_African__Middle_Eastern,104,0,0,2329.0,Unknown,49048463,9111392.0,2.0,34,1273,36,0,0,6,17,10,0.4383434771103467,0.2085561497326203,0.4044117647058823,0.0022402320571413,0.0,0.0,0.0027506876719179,0.0027506876719179,0.0505924720131114,0.1428571428571428,0.2325581395348837,0.1666666666666666,117,21,12,7,1,2415,1,4,29,500000,37500.0,600000.0,100000.0,200000.0,600000.0,3,600000,-0.16666666666666666,-0.16666666666666666
569387,Valentin,Gendrey,2024,533,France,La Garenne-Colombes,France,21-06-00,Right-Back,Defender,Right,179.0,Unknown,BS & PARTNERS,https://img.a.transfermarkt.technology/portrait/header/569387-1663745931.jpg?lm=1,L1,TSG 1899 Hoffenheim FuÃŸball-Spielbetriebs GmbH,8500000.0,8500000.0,24,120,143,7,13,11,5,13,6,9,8,11,12,12,8,14,12,11,13,10,12,12,11,11,13,7,8,13,14,12,12,14,14,12,8,12,14,14,11,12,9,12,8,10,3,3,2,1,1,2,4,3,3,3,1,13,14,5,12,12,13,12,13,1,1,15,20,1,7,1,1,1,1,1,1,1,1,70,10,20,3655999,5995,5243,2524,North_African__Middle_Eastern,120,0,0,1153.0,Unknown,49047752,4400000.0,2.0,34,780,36,1,1,6,199,11,0.4440328129134692,0.2645989304812834,0.5220588235294117,0.0011046661523145,0.0,0.0,0.0422605651412853,0.0422605651412853,0.0244173449262479,0.1428571428571428,0.3720930232558141,0.25,188,4,10,15,0,2155,2,7,26,8500000,521875.0,8500000.0,0.0,150000.0,400000.0,3,2000000,0.21428571428571427,0.8888888888888888
569389,Sofiane,Diop,2024,417,France,Tours,Morocco,09-06-00,Left Winger,Attack,Right,175.0,30-06-27,Unknown,https://img.a.transfermarkt.technology/portrait/header/569389-1614091046.jpg?lm=1,FR1,Olympique Gymnaste Club Nice CÃ´te d'Azur,12000000.0,20000000.0,24,134,152,13,12,14,11,14,12,8,10,2,4,14,12,8,15,13,12,13,12,13,13,12,15,15,8,13,6,12,14,15,14,13,6,14,15,14,10,14,7,12,6,15,3,3,3,1,2,2,2,1,3,3,2,11,16,8,12,13,13,13,12,1,1,1,1,1,1,1,17,12,16,15,20,17,1,65,9,20,19965200,6700,6700,4500,North_African__Middle_Eastern,128,0,0,19999.0,Unknown,49037827,22000000.0,1.0,34,1513,67,0,1,6,142,7,0.6368086795448531,0.4759358288770053,0.5808823529411764,0.0193026891475241,0.0,0.0,0.0597649412353088,0.0997749437359339,0.1221978388288563,0.0,0.2790697674418605,0.25,211,30,21,19,1,5906,8,67,220,12000000,473684.2105263158,20000000.0,3000000.0,5000000.0,16000000.0,3,6300000,0.0,-0.2
569457,Tim,Breithaupt,2024,167,Germany,Offenburg,Germany,07-02-02,Defensive Midfield,Midfield,Right,192.0,30-06-28,Unknown,https://img.a.transfermarkt.technology/portrait/header/569457-1723534386.jpg?lm=1,L1,FC Augsburg 1907,3000000.0,3500000.0,22,112,-75,5,6,11,7,12,5,13,8,6,12,13,6,13,12,12,12,11,13,12,12,13,15,10,6,8,13,13,14,11,11,14,16,15,12,14,13,14,7,12,4,7,1,2,3,3,1,3,3,1,3,2,2,7,13,3,16,13,15,12,12,1,1,14,1,1,1,20,1,18,1,1,10,1,1,78,9,20,4410000,5600,5600,3750,Northern_European,112,0,0,5273.0,Unknown,2000065418,2500000.0,1.0,38,1073,40,3,1,7,67,4,0.4912675310928817,0.3957219251336898,0.463235294117647,0.0050830092882724,0.0,0.0,0.0147536884221055,0.0172543135783946,0.0138614961526709,0.0,0.6744186046511627,0.1666666666666666,135,4,9,17,0,2554,4,23,103,3000000,237500.0,3500000.0,500000.0,,3500000.0,1,0,0.0,-0.14285714285714285
569598,Youssouf,Fofana,2024,5,France,Paris,France,10-01-99,Defensive Midfield,Midfield,Right,185.0,30-06-28,AIS SPORT SERVICE,https://img.a.transfermarkt.technology/portrait/header/569598-1725528517.jpg?lm=1,IT1,Associazione Calcio Milan,30000000.0,30000000.0,25,139,153,7,9,14,8,14,7,12,10,8,12,14,8,15,12,15,14,14,13,14,13,14,15,10,8,13,13,14,15,13,12,15,9,16,13,16,15,12,9,12,7,10,2,2,3,3,4,1,4,1,2,3,1,16,14,8,14,12,14,14,16,1,1,1,1,1,1,20,1,19,1,1,1,1,1,0,10,20,20334671,6945,6945,4995,African_Caribbean,138,0,0,9204.0,Unknown,49045776,17500000.0,2.0,34,1122,36,3,1,1,27,4,0.6692246626091559,0.5288770053475935,0.6544117647058822,0.0088788507609546,0.0,0.0,0.1497874468617154,0.1497874468617154,0.0971971443651212,0.1428571428571428,0.5116279069767438,0.2916666666666665,0,0,0,0,0,0,4,20,53,30000000,1492500.0,30000000.0,2000000.0,,6000000.0,2,6000000,0.0,0.07142857142857142
569663,Mathias,Kvistgaarden,2024,206,Denmark,BirkerÃ¸d,Denmark,15-04-02,Centre-Forward,Attack,Right,174.0,30-06-27,Elite Consulting,https://img.a.transfermarkt.technology/portrait/header/569663-1624457803.jpg?lm=1,DK1,BrÃ¸ndby IdrÃ¦tsforening,5000000.0,5000000.0,22,109,140,10,10,11,13,11,10,12,11,9,6,11,9,7,11,13,11,13,11,12,11,10,13,13,7,11,6,12,14,13,14,12,9,12,14,12,9,11,7,14,6,11,2,2,2,1,3,3,3,2,1,4,2,8,12,6,13,9,12,11,18,1,1,1,1,1,1,1,1,1,1,8,6,10,20,0,12,20,2167135,5400,5100,1100,Northern_European,107,0,0,2485.0,Unknown,27161953,9111392.0,2.0,28,198,30,0,1,7,45,3,0.4251124636147129,0.1122994652406417,0.4264705882352941,0.0023908683506388,0.0,0.0,0.0247561890472618,0.0247561890472618,0.0505924720131114,0.1428571428571428,0.2558139534883721,0.1666666666666666,169,73,29,22,0,5134,6,14,105,8000000,785000.0,8000000.0,0.0,200000.0,2000000.0,1,0,0.6,0.6
569777,Alassane,Ndao,2024,2293,Senegal,Dakar,Senegal,20-12-96,Right Winger,Attack,Right,176.0,30-06-26,Do?an Ercan,https://img.a.transfermarkt.technology/portrait/header/569777-1727457317.png?lm=1,TR1,Konyaspor,1300000.0,4500000.0,28,120,135,8,9,13,11,12,5,8,9,5,9,11,12,10,14,13,13,12,14,11,10,12,20,13,12,15,10,12,15,14,13,11,8,12,14,14,10,12,12,12,13,14,1,2,2,2,2,2,1,2,3,1,2,15,12,3,11,12,11,12,13,1,1,1,1,1,1,1,12,15,15,12,18,20,10,68,10,20,7093647,6047,5192,4454,African_Caribbean,121,5,1,29999.0,Antalyaspor,12075171,1075000.0,3.0,83,402,84,0,1,1,125,10,0.4372849960306959,0.4710160427807486,0.5294117647058822,0.0289588618076162,0.0328947368421052,0.0131578947368421,0.0062515628907226,0.0222555638909727,0.0059446095724881,0.2857142857142857,0.3023255813953489,0.4166666666666665,176,28,22,18,0,2633,3,16,93,1300000,56250.0,4500000.0,2000000.0,,,4,2400000,0.0,-0.07142857142857142
569866,Roberto,López,2024,1244,Spain,Zaragoza,Spain,24-04-00,Attacking Midfield,Midfield,Left,179.0,30-06-27,Unknown,https://img.a.transfermarkt.technology/portrait/header/569866-1568978272.png?lm=1,ES1,Club Deportivo LeganÃ©s S.A.D.,2500000.0,8000000.0,24,121,136,14,13,11,14,13,14,10,15,6,8,13,17,7,15,9,8,12,11,12,14,11,11,14,11,13,10,9,13,11,13,14,10,12,11,11,12,11,6,7,7,17,1,3,1,3,3,3,1,3,3,1,1,14,12,8,15,11,12,14,10,1,1,1,1,1,1,1,1,1,1,17,20,13,13,70,20,13,3319999,6050,6050,4050,Mediterranean_Hispanic,120,0,0,5216.0,MirandÃ©s,67272882,9111392.0,2.0,89,1699,89,3,0,3,54,0,0.5508070918232336,0.427807486631016,0.5220588235294117,0.0050279691041099,0.0,0.0,0.0122530632658164,0.0397599399849962,0.0505924720131114,0.1428571428571428,0.3720930232558141,0.25,206,36,30,19,0,1708,1,1,9,2200000,108333.33333333333,8000000.0,4000000.0,1000000.0,8000000.0,5,10900000,-0.12,-0.26666666666666666
570423,Danil,Glebov,2024,1083,Russia,Tomsk,Russia,03-11-99,Defensive Midfield,Midfield,Right,178.0,30-06-28,Pavel Banatin,https://img.a.transfermarkt.technology/portrait/header/570423-1721922832.png?lm=1,RU1,FK Rostov,8000000.0,8000000.0,25,123,143,9,10,9,9,13,4,10,13,4,13,13,7,14,10,10,13,13,10,14,12,13,12,8,15,12,13,13,15,13,13,14,9,12,13,14,9,13,9,13,5,14,1,3,2,3,1,2,1,1,1,3,1,16,14,4,12,13,13,14,20,1,1,1,1,1,9,20,11,17,10,10,11,9,1,68,10,20,7594591,6009,6009,3160,Northern_European,123,2,0,27246.0,Unknown,58137500,50000.0,1.0,78,1502,81,3,1,7,81,4,0.5453823762900238,0.3326203208556149,0.5441176470588236,0.0263005174742928,0.0131578947368421,0.0,0.0397599399849962,0.0397599399849962,0.0002500069446373,0.0,0.3488372093023257,0.2916666666666665,232,15,19,46,2,4046,2,4,86,8000000,418421.05263157893,8000000.0,100000.0,125000.0,1500000.0,2,175000,0.0,0.0
571020,Oihan,Sancet,2024,621,Spain,Pamplona,Spain,25-04-00,Attacking Midfield,Midfield,Right,188.0,30-06-32,Unknown,https://img.a.transfermarkt.technology/portrait/header/571020-1709676037.png?lm=1,ES1,Athletic Club Bilbao,35000000.0,35000000.0,24,131,162,5,8,10,12,15,8,11,8,6,9,15,12,8,15,12,12,9,12,12,15,14,16,16,9,14,11,13,12,13,14,8,14,15,13,14,14,11,8,12,11,8,1,3,1,2,2,1,1,1,1,3,1,9,13,8,18,11,16,11,10,1,1,1,1,1,1,9,1,20,1,1,19,1,1,73,12,20,30000000,6550,6550,5050,Mediterranean_Hispanic,130,0,0,12301.0,Unknown,67260204,300000.0,1.0,89,1115,89,3,1,3,33,0,0.6169621593014025,0.53475935828877,0.5955882352941175,0.0118693674337852,0.0,0.0,0.1747936984246061,0.1747936984246061,0.0016389344148448,0.0,0.581395348837209,0.25,207,45,19,29,2,3012,9,69,182,50000000,2450000.0,50000000.0,500000.0,1000000.0,3500000.0,1,1700000,0.42857142857142855,0.42857142857142855
571149,Gjivai,Zechiël,2024,234,Netherlands,Rotterdam,Netherlands,01-06-04,Defensive Midfield,Midfield,Right,183.0,30-06-28,SeiSei Football,https://img.a.transfermarkt.technology/portrait/header/571149-1691674261.jpg?lm=1,NL1,Feyenoord Rotterdam,600000.0,600000.0,20,99,-75,8,8,10,6,12,8,8,13,3,10,12,4,14,13,11,12,9,8,7,11,14,14,6,1,12,10,11,13,11,13,12,10,6,11,7,6,15,10,13,12,15,4,4,3,3,2,1,2,2,1,2,3,13,12,8,13,14,12,11,12,1,1,1,1,1,1,20,1,18,1,1,12,1,1,0,10,20,19020000,4800,4800,2200,African_Caribbean,93,0,0,832.0,Unknown,2000054498,9111392.0,2.0,67,1253,68,3,1,1,85,4,0.3854194231278116,0.2299465240641711,0.3235294117647059,0.0007947030099255,0.0,0.0,0.0027506876719179,0.0027506876719179,0.0505924720131114,0.1428571428571428,0.4651162790697669,0.0833333333333332,87,8,13,5,0,4523,4,28,116,3500000,580000.0,3500000.0,0.0,,3500000.0,0,0,4.833333333333333,4.833333333333333
571604,Giorgio,Scalvini,2024,800,Italy,Chiari,Italy,11-12-03,Centre-Back,Defender,Right,194.0,30-06-28,TMP SOCCER srl ,https://img.a.transfermarkt.technology/portrait/header/571604-1701860841.jpg?lm=1,IT1,Atalanta Bergamasca Calcio S.p.a.,45000000.0,45000000.0,21,131,-9,4,6,10,6,11,4,13,7,5,14,11,4,14,12,12,15,12,13,15,11,13,16,7,9,7,14,15,13,12,12,12,15,15,13,15,14,14,10,15,6,7,4,1,2,1,2,3,2,3,3,2,2,16,17,6,14,15,18,12,13,1,1,20,1,1,1,17,1,12,1,1,1,1,1,87,10,20,69240000,6550,6250,3513,Mediterranean_Hispanic,130,1,0,29769.0,Unknown,43500755,9111392.0,2.0,52,356,54,1,1,3,31,2,0.5772691188145012,0.370374331550802,0.5955882352941175,0.028736769836434,0.006578947368421,0.0,0.2248062015503876,0.2248062015503876,0.0505924720131114,0.1428571428571428,0.7209302325581395,0.125,166,13,6,27,1,3325,14,63,170,45000000,4045454.5454545454,45000000.0,0.0,20000000.0,45000000.0,0,0,0.0,0.125
571607,Fabio,Miretti,2024,252,Italy,Pinerolo,Italy,03-08-03,Central Midfield,Midfield,Right,180.0,30-06-25,Unknown,https://img.a.transfermarkt.technology/portrait/header/571607-1652773586.jpg?lm=1,IT1,Genoa Cricket and Football Club,15000000.0,15000000.0,21,132,-9,13,11,14,9,14,12,7,10,8,10,13,12,11,14,13,15,13,11,12,13,13,16,11,14,13,12,14,14,12,14,14,8,11,12,14,11,13,11,13,3,11,3,2,3,1,3,3,3,2,1,3,1,13,16,3,15,17,18,10,9,1,1,1,1,1,1,14,11,20,8,1,13,1,1,72,14,20,73200001,6500,6500,2750,Mediterranean_Hispanic,132,0,0,10769.0,Unknown,43500510,9111392.0,2.0,52,1147,54,3,1,3,104,1,0.6103466525535857,0.2887700534759358,0.6102941176470589,0.0103900417822591,0.0,0.0,0.0747686921730432,0.0747686921730432,0.0505924720131114,0.1428571428571428,0.3953488372093026,0.125,183,30,24,18,0,2102,7,20,38,12000000,1400000.0,15000000.0,3000000.0,5000000.0,15000000.0,2,13000000,-0.2,-0.2
571743,Armando,Broja,2024,29,England,Slough,Albania,10-09-01,Centre-Forward,Attack,Right,191.0,31-05-25,FA Sport,https://img.a.transfermarkt.technology/portrait/header/571743-1662362376.jpg?lm=1,GB1,Everton Football Club,18000000.0,30000000.0,23,135,-85,7,8,15,14,12,7,12,8,7,5,7,8,8,13,14,13,11,14,8,9,12,12,13,11,14,6,11,13,16,12,15,14,14,16,13,14,10,7,10,6,11,1,2,1,2,2,3,1,3,1,2,1,13,10,6,10,12,12,12,12,1,1,1,1,1,1,1,1,1,1,15,14,16,20,75,10,20,75046653,6750,6750,5500,Mediterranean_Hispanic,130,14,4,86994.0,Unknown,28121369,9111392.0,2.0,32,1384,0,0,1,3,65,3,0.6434241862926701,0.5828877005347594,0.5955882352941175,0.0839942178838111,0.0921052631578947,0.0526315789473684,0.0897724431107777,0.1497874468617154,0.0505924720131114,0.1428571428571428,0.6511627906976742,0.2083333333333332,178,44,11,9,0,4138,11,83,275,15000000,933333.3333333334,30000000.0,6000000.0,1000000.0,22000000.0,6,23000000,-0.3181818181818182,-0.4642857142857143
572265,Lorenzo,Lucca,2024,410,Italy,Moncalieri,Italy,10-09-00,Centre-Forward,Attack,Right,201.0,30-06-28,GR Sports,https://img.a.transfermarkt.technology/portrait/header/572265-1725531439.jpg?lm=1,IT1,Udinese Calcio,12000000.0,12000000.0,24,121,150,3,7,11,14,12,12,16,12,6,5,9,13,8,13,9,12,13,13,12,10,13,18,11,7,12,10,13,12,11,11,14,17,14,12,13,15,13,8,14,3,7,3,4,3,2,2,2,3,1,2,2,2,15,17,6,13,9,14,12,9,1,1,1,1,1,1,1,1,1,1,1,1,1,20,86,8,20,3832500,6050,6300,3852,Mediterranean_Hispanic,120,0,0,10620.0,AFC Ajax,43409366,9111392.0,2.0,52,969,54,0,1,3,205,3,0.5838846255623181,0.4066310160427807,0.5220588235294117,0.0102461648096237,0.0,0.0,0.0597649412353088,0.0597649412353088,0.0505924720131114,0.1428571428571428,0.8837209302325584,0.25,191,66,17,32,3,1699,3,19,55,18000000,1276785.7142857143,18000000.0,1000000.0,125000.0,300000.0,4,5725000,0.5,2.0
572326,Christopher,Wooh,2024,273,France,Louvres,Cameroon,18-09-01,Centre-Back,Defender,Right,191.0,30-06-26,Sport Cover,https://img.a.transfermarkt.technology/portrait/header/572326-1725959929.jpg?lm=1,FR1,Stade Rennais Football Club,6000000.0,6000000.0,23,110,135,6,5,11,7,10,2,13,11,9,12,11,9,13,11,13,12,11,12,12,11,11,4,8,8,10,12,12,13,11,12,12,15,13,13,12,13,12,11,11,8,19,3,1,1,1,3,2,1,3,1,2,2,15,14,8,12,13,9,11,20,1,13,20,1,1,1,1,1,1,1,1,1,1,1,90,5,20,9924521,5500,5500,2500,African_Caribbean,108,1,0,3722.0,Unknown,49048590,9000000.0,1.0,34,866,15,1,1,1,195,2,0.4780365175972479,0.2620320855614972,0.4338235294117646,0.0035853369086921,0.006578947368421,0.0,0.0297574393598399,0.0297574393598399,0.049973610378066,0.0,0.6511627906976742,0.2083333333333332,101,6,3,22,4,2604,4,8,32,7000000,526923.0769230769,7000000.0,0.0,150000.0,3000000.0,3,4850000,0.16666666666666666,0.16666666666666666
572519,Ar'Jany,Martha,2024,41274,Netherlands,Rotterdam,Curacao,04-09-03,Left-Back,Defender,Left,183.0,Unknown,Wasserman,https://img.a.transfermarkt.technology/portrait/header/572519-1701361604.jpg?lm=1,BE1,Koninklijke Beerschot Voetbalclub Antwerpen,1200000.0,1500000.0,21,102,-75,7,8,13,9,13,9,5,8,9,5,13,5,5,13,9,10,9,9,11,9,10,12,10,6,12,5,11,10,13,14,8,7,14,13,11,9,10,9,7,13,13,2,3,3,3,3,2,3,3,1,3,1,18,8,4,11,9,13,11,18,1,1,1,1,1,1,1,16,16,16,19,17,20,12,0,20,10,29460000,4900,4900,3250,African_Caribbean,94,0,0,941.0,Unknown,37084988,9111392.0,2.0,67,1253,26,1,0,1,121,8,0.3986504366234453,0.3422459893048128,0.3308823529411764,0.0008999552919205,0.0,0.0,0.0057514378594648,0.0072518129532383,0.0505924720131114,0.1428571428571428,0.4651162790697669,0.125,166,15,14,11,0,3496,1,6,32,900000,81250.0,1500000.0,300000.0,350000.0,1200000.0,1,300000,-0.25,-0.4
573775,Hugo,Duro,2024,1049,Spain,Getafe,Spain,10-11-99,Centre-Forward,Attack,Left,177.0,30-06-28,MESAS SPORT,https://img.a.transfermarkt.technology/portrait/header/573775-1683213249.jpg?lm=1,ES1,Valencia Club de FÃºtbol S. A. D.,16000000.0,16000000.0,25,132,155,10,11,13,13,12,11,12,12,9,7,13,15,9,12,14,13,14,14,14,12,13,15,12,12,14,12,13,14,14,13,12,11,12,13,14,13,14,10,11,4,12,2,3,1,1,3,3,2,1,3,1,4,13,14,11,14,9,15,11,10,1,1,1,1,1,1,1,1,1,1,17,15,12,20,76,20,10,13740001,6600,6600,4300,Mediterranean_Hispanic,132,0,0,8000.0,Unknown,67274349,4000000.0,1.0,89,536,89,0,0,3,208,3,0.6235776660492194,0.4545454545454545,0.6102941176470589,0.0077162475726795,0.0,0.0,0.0797699424856214,0.0797699424856214,0.0221950609739159,0.0,0.3255813953488373,0.2916666666666665,214,59,16,24,0,2884,2,3,22,12000000,578947.3684210526,16000000.0,4000000.0,,1800000.0,3,3000000,-0.25,0.5
574385,Mohamed,Daramy,2024,1421,Denmark,Hvidovre,Denmark,07-01-02,Left Winger,Attack,Right,180.0,30-06-28,Unknown,https://img.a.transfermarkt.technology/portrait/header/574385-1723837255.png?lm=1,FR1,Stade de Reims,10000000.0,10000000.0,22,126,-85,6,9,15,10,13,7,6,6,3,4,11,5,3,15,10,13,10,12,10,12,12,14,15,5,14,5,12,10,15,15,14,11,13,15,13,13,10,6,12,6,12,1,3,2,2,2,1,3,2,3,3,3,10,15,3,15,13,14,16,13,1,1,1,1,1,1,1,12,1,12,20,1,16,15,75,10,20,64500000,6250,6250,4750,African_Caribbean,119,4,0,8630.0,Football Club KÃ¸benhavn,27148020,12000000.0,2.0,28,644,30,0,1,1,197,7,0.5772691188145012,0.5026737967914437,0.5147058823529411,0.0083245864502654,0.0263157894736842,0.0,0.0497624406101525,0.0497624406101525,0.0666407400205561,0.1428571428571428,0.3953488372093026,0.1666666666666666,219,54,33,10,0,9329,4,40,174,7000000,407352.9411764706,10000000.0,3000000.0,4000000.0,6000000.0,4,9425000,-0.3,-0.3
574495,Kristoffer,Askildsen,2024,865,Norway,Oslo,Norway,09-01-01,Central Midfield,Midfield,Right,190.0,30-06-28,Unknown,https://img.a.transfermarkt.technology/portrait/header/574495-1630591341.jpg?lm=1,DK1,Fodbold Club Midtjylland,750000.0,2000000.0,23,122,144,10,10,12,10,12,10,15,12,9,13,13,10,13,11,13,13,13,11,13,11,13,11,13,12,13,13,13,15,12,10,12,15,11,11,13,13,13,12,12,4,12,1,1,3,3,2,3,3,2,1,2,3,12,13,5,13,13,12,13,8,1,1,1,1,1,1,16,14,20,1,1,1,1,1,77,12,20,4659999,5749,6049,4949,Northern_European,122,1,0,3557.0,Salento,53159473,2500000.0,1.0,71,1096,73,3,1,7,86,1,0.5506747816882773,0.5239572192513369,0.536764705882353,0.0034260100598006,0.006578947368421,0.0,0.0035008752188047,0.0097524381095273,0.0138614961526709,0.0,0.6279069767441858,0.2083333333333332,134,3,5,21,0,4681,5,13,28,1000000,69230.76923076923,2000000.0,600000.0,200000.0,2000000.0,4,1850000,0.3333333333333333,0.1111111111111111
574660,Strahinja,Erakovic,2024,964,Yugoslavia (Republic),Batajnica,Serbia,22-01-01,Centre-Back,Defender,Right,188.0,30-06-27,Unknown,https://img.a.transfermarkt.technology/portrait/header/574660-1721722681.png?lm=1,RU1,AO FK Zenit Sankt-Peterburg,10000000.0,10000000.0,23,124,156,7,8,7,7,13,6,13,9,8,14,11,9,14,11,13,13,14,12,12,10,13,14,8,11,10,13,12,14,12,13,10,13,12,12,13,12,14,7,12,11,12,3,1,2,2,2,2,2,3,2,3,1,12,12,7,13,12,12,11,12,1,12,20,15,1,1,1,1,1,1,1,1,1,1,75,11,20,6044999,6050,6050,4000,Northern_European,124,1,0,2500.0,Unknown,62219051,8000000.0,1.0,110,155,85,1,1,7,7,2,0.5508070918232336,0.4224598930481283,0.5514705882352942,0.0024053526096289,0.006578947368421,0.0,0.0497624406101525,0.0497624406101525,0.044417900497236,0.0,0.581395348837209,0.2083333333333332,185,2,9,31,0,6457,4,60,139,10000000,829166.6666666666,10000000.0,0.0,300000.0,2500000.0,3,1250000,0.0,0.1111111111111111
574671,Strahinja,Pavlovi?,2024,5,Yugoslavia (Republic),Å abac,Serbia,24-05-01,Centre-Back,Defender,Left,194.0,30-06-28,DSSV&Hat-trick,https://img.a.transfermarkt.technology/portrait/header/574671-1692998611.png?lm=1,IT1,Associazione Calcio Milan,25000000.0,25000000.0,23,127,158,5,5,8,6,11,6,13,7,8,14,10,8,13,11,14,13,15,12,12,10,11,14,10,12,9,15,11,14,11,11,14,16,14,13,14,16,12,12,12,11,7,3,1,3,3,2,3,4,2,3,2,1,11,13,9,13,12,12,12,12,1,1,20,1,1,1,7,1,1,1,1,1,1,1,84,20,8,12140000,6337,6338,3890,Northern_European,125,20,1,25000.0,Unknown,62220026,11666666.67,3.0,110,1725,85,1,0,7,27,2,0.5889124106906589,0.4106951871657753,0.5588235294117647,0.0241317410948361,0.131578947368421,0.0131578947368421,0.1247811952988247,0.1247811952988247,0.0647888367454651,0.2857142857142857,0.7209302325581395,0.2083333333333332,192,11,12,48,2,9452,3,3,20,17000000,997058.8235294118,25000000.0,5000000.0,7200000.0,8000000.0,6,11000000,-0.32,-0.32
574758,Unknown,Garcia,2024,982,Brazil,SÃ£o Paulo,Brazil,04-01-02,Right-Back,Defender,Right,175.0,30-06-25,Energy Sports,https://img.a.transfermarkt.technology/portrait/header/574758-1595155750.jpg?lm=1,PO1,Clube Desportivo Nacional,2000000.0,2000000.0,22,107,-75,11,13,12,7,12,11,8,11,8,10,12,1,14,14,9,10,10,9,10,12,14,9,10,10,12,9,13,13,10,13,9,8,16,10,12,7,14,13,6,12,17,2,4,3,1,3,2,2,1,1,3,3,16,12,1,12,13,11,11,20,1,1,1,20,1,17,1,1,1,1,1,1,1,1,68,10,20,7552978,5314,5314,2728,Mixed_Race,97,0,0,1452.0,Unknown,19360960,9111392.0,2.0,10,1456,11,1,1,4,56,11,0.4534268324953692,0.2864171122994652,0.3529411764705882,0.0013933857148512,0.0,0.0,0.0097524381095273,0.0097524381095273,0.0505924720131114,0.1428571428571428,0.2790697674418605,0.1666666666666666,72,1,5,11,0,3006,0,0,0,2000000,187500.0,2000000.0,0.0,,500000.0,1,0,0.0,0.1111111111111111
575716,Vasco,Sousa,2024,720,Portugal,Penafiel,Portugal,03-04-03,Attacking Midfield,Midfield,Right,169.0,30-06-27,CAA Stellar,https://img.a.transfermarkt.technology/portrait/header/575716-1725014523.png?lm=1,PO1,Futebol Clube do Porto,5000000.0,5000000.0,21,106,-85,8,11,14,11,14,6,4,9,5,8,15,10,7,14,9,12,12,13,11,15,13,3,16,7,12,7,11,11,12,12,13,6,13,12,13,8,10,2,10,7,6,3,1,3,2,1,1,3,3,2,3,1,20,11,6,13,14,10,9,14,1,1,1,1,1,1,1,1,19,1,1,20,12,1,56,6,20,26220001,5296,5296,3796,Mediterranean_Hispanic,107,0,0,3249.0,Unknown,83297509,100000.0,1.0,76,1136,79,3,1,3,100,0,0.451045250066155,0.4006417112299464,0.4264705882352941,0.0031285999418698,0.0,0.0,0.0247561890472618,0.0247561890472618,0.0005277924386788,0.0,0.13953488372093,0.125,115,6,12,17,0,1376,2,2,5,5000000,527777.7777777778,5000000.0,0.0,450000.0,2000000.0,1,3000000,1.5,1.5
575998,Leonardo,Balerdi,2024,244,Argentina,Villa Mercedes,Argentina,26-01-99,Centre-Back,Defender,Right,187.0,30-06-28,SP,https://img.a.transfermarkt.technology/portrait/header/575998-1640777749.jpg?lm=1,FR1,Olympique de Marseille,20000000.0,20000000.0,25,133,147,4,6,7,6,13,4,14,7,5,14,13,8,14,12,13,14,12,15,13,9,14,14,6,9,6,15,14,12,12,12,12,15,13,12,12,13,13,8,16,7,8,1,3,3,2,2,1,1,1,1,1,1,11,15,8,9,16,12,12,14,1,8,20,10,6,8,12,1,1,1,1,1,1,1,76,14,20,9944302,6649,6649,4749,Mediterranean_Hispanic,133,2,0,28747.0,Unknown,14196664,13250000.0,2.0,4,1598,4,1,1,3,144,2,0.63006086266208,0.5025668449197861,0.6176470588235294,0.0277499089905726,0.0131578947368421,0.0,0.0997749437359339,0.0997749437359339,0.0735853773715936,0.1428571428571428,0.5581395348837206,0.2916666666666665,181,6,2,41,3,4499,4,31,120,20000000,1093750.0,20000000.0,4000000.0,,10000000.0,2,12800000,0.0,1.0
576024,Julián,Alvarez,2024,13,Argentina,CalchÃ­n,Argentina,31-01-00,Centre-Forward,Attack,Right,170.0,30-06-30,Fernando Hidalgo,https://img.a.transfermarkt.technology/portrait/header/576024-1684920938.jpg?lm=1,ES1,Club AtlÃ©tico de Madrid S.A.D.,90000000.0,90000000.0,24,146,162,14,11,13,14,16,13,10,15,6,5,13,13,8,15,11,13,8,14,12,12,14,14,17,7,15,8,14,14,15,14,12,7,15,13,15,11,13,8,14,6,13,2,3,1,3,4,3,1,1,1,2,1,14,14,5,12,14,14,17,8,1,1,1,1,1,1,1,1,1,1,15,16,17,20,70,13,20,41525041,7350,7350,4500,Mediterranean_Hispanic,138,9,1,92793.0,Unknown,14183207,48200000.0,2.0,4,299,4,0,1,3,52,3,0.7228102672664726,0.4759358288770053,0.6544117647058822,0.0895938324093985,0.0592105263157894,0.0131578947368421,0.4498624656164041,0.4498624656164041,0.2677574377066029,0.1428571428571428,0.1627906976744184,0.25,262,107,52,13,0,9059,1,1,3,80000000,4157894.736842105,90000000.0,15000000.0,1000000.0,9000000.0,2,20000000,-0.1111111111111111,-0.1111111111111111
576033,Do?An,Alemdar,2024,273,TÃ¼rkiye,Kayseri,TÃ¼rkiye,29-10-02,Goalkeeper,Goalkeeper,Right,192.0,30-06-27,Unknown,https://img.a.transfermarkt.technology/portrait/header/576033-1643968658.jpg?lm=1,FR1,Stade Rennais Football Club,2500000.0,4000000.0,22,105,-75,1,3,2,3,8,1,1,1,2,2,9,5,3,9,8,9,13,12,13,6,9,5,7,8,8,10,14,15,10,11,13,12,12,11,14,14,12,6,12,5,1,13,12,12,7,12,12,13,13,11,12,12,13,10,4,11,13,11,11,11,20,1,1,1,1,1,1,1,1,1,1,1,1,1,0,5,20,38442936,5250,5250,2000,Mediterranean_Hispanic,105,1,0,2465.0,Unknown,70117167,9111392.0,2.0,100,717,100,2,1,3,195,5,0.4449589838581635,0.2085561497326203,0.411764705882353,0.0023715560053186,0.006578947368421,0.0,0.0122530632658164,0.0197549387346836,0.0505924720131114,0.1428571428571428,0.6744186046511627,0.1666666666666666,0,0,0,0,0,0,3,6,244,2000000,114705.88235294117,4000000.0,500000.0,3500000.0,3500000.0,4,2100000,-0.2,-0.42857142857142855
576121,Josh,Wilson-Esbrand,2024,281,England,London,England,26-12-02,Left-Back,Defender,Left,176.0,30-06-27,ROOF,https://img.a.transfermarkt.technology/portrait/header/576121-1650877302.jpg?lm=1,GB1,Manchester City Football Club,4000000.0,4000000.0,21,107,-75,6,13,13,9,12,2,6,6,8,11,12,8,13,13,15,12,9,12,12,10,12,13,13,11,10,10,10,13,15,12,12,9,15,15,8,15,11,7,14,6,13,3,2,3,2,1,3,3,1,4,1,2,20,12,4,9,13,11,10,19,1,20,1,1,17,1,1,11,1,1,14,1,1,1,0,20,9,41942612,5344,5344,3994,African_Caribbean,107,0,0,8119.0,Unknown,28127192,9111392.0,2.0,32,858,33,1,0,1,131,8,0.4573961365440593,0.4218181818181817,0.4264705882352941,0.0078311560273346,0.0,0.0,0.0197549387346836,0.0197549387346836,0.0505924720131114,0.1428571428571428,0.3023255813953489,0.125,114,4,13,8,0,7565,2,11,41,4000000,462500.0,4000000.0,0.0,300000.0,2000000.0,4,3000000,0.0,1.0
576314,Jan Paul,Van Hecke,2024,1237,Netherlands,Arnemuiden,Netherlands,08-06-00,Centre-Back,Defender,Right,189.0,30-06-27,V4S,https://img.a.transfermarkt.technology/portrait/header/576314-1673362272.jpg?lm=1,GB1,Brighton and Hove Albion Football Club,22000000.0,22000000.0,24,124,156,3,5,11,5,11,3,15,3,5,15,12,5,17,12,17,11,15,14,11,10,11,15,7,12,6,14,12,12,11,12,14,15,14,12,14,14,13,13,13,4,7,3,2,1,4,3,3,2,2,1,3,3,11,13,5,10,15,15,15,13,1,1,20,11,1,6,10,1,1,1,1,1,1,1,78,7,20,23940694,6193,6193,3994,Northern_European,122,0,0,4640.0,Unknown,37076335,2000000.0,1.0,67,90,68,1,1,7,44,2,0.5697274411219899,0.4218181818181817,0.536764705882353,0.0044717735588886,0.0,0.0,0.1097774443610902,0.1097774443610902,0.0110836412122558,0.0,0.6046511627906974,0.25,196,16,7,40,1,4643,2,9,31,32000000,2131666.6666666665,32000000.0,1000000.0,,2200000.0,3,400000,0.7777777777777778,1.1333333333333333
577394,Denso,Kasius,2024,1090,Netherlands,Delft,Netherlands,06-10-02,Right-Back,Defender,Right,183.0,30-06-27,Unknown,https://img.a.transfermarkt.technology/portrait/header/577394-1690965709.jpg?lm=1,NL1,Alkmaar Zaanstreek,2000000.0,2000000.0,22,122,-75,7,14,12,9,12,7,8,11,10,10,12,5,13,12,14,12,12,10,10,12,10,11,10,7,13,9,13,14,16,13,11,11,16,15,13,10,11,11,7,5,12,3,1,2,3,1,3,2,1,3,4,2,12,8,3,14,11,12,10,9,1,1,1,20,1,20,1,1,1,19,1,1,10,1,70,8,20,40240001,6100,5900,4500,Northern_European,111,0,0,8893.0,Unknown,37076465,3280000.0,1.0,67,406,68,1,1,7,16,11,0.530960571579783,0.4759358288770053,0.4558823529411764,0.0085785437912258,0.0,0.0,0.0097524381095273,0.0097524381095273,0.0181949498597183,0.0,0.4651162790697669,0.1666666666666666,168,18,16,11,2,6461,7,15,27,3000000,247916.66666666666,3000000.0,300000.0,75000.0,1700000.0,4,2450000,0.5,0.5
577590,Unknown,Pedro Brazão,2024,44006,Portugal,Lisboa,Portugal,30-12-02,Right Winger,Attack,Left,178.0,30-06-26,LIAN Sports Group,https://img.a.transfermarkt.technology/portrait/header/577590-1708250169.png?lm=1,TR1,Bodrumspor Spor Faaliyetleri Anonim ?irketi,650000.0,2000000.0,21,110,-8,12,12,14,8,14,12,7,8,4,5,12,9,5,16,10,9,8,13,11,12,10,11,16,5,10,7,11,10,13,15,12,6,13,13,12,7,9,7,8,5,12,1,1,2,3,3,2,3,1,1,3,4,11,10,7,10,12,14,10,17,1,1,1,1,1,1,1,1,13,1,18,20,19,1,64,20,10,36450000,5497,5497,3547,African_Caribbean,104,0,0,2350.0,Unknown,83261936,9111392.0,2.0,76,843,79,0,0,1,39,10,0.477639587192379,0.3740106951871657,0.4044117647058823,0.0022605100197275,0.0,0.0,0.0030007501875468,0.0097524381095273,0.0505924720131114,0.1428571428571428,0.3488372093023257,0.125,125,11,5,12,2,5269,3,3,7,800000,26666.666666666668,2000000.0,500000.0,2000000.0,700000.0,3,950000,0.14285714285714285,0.14285714285714285
578391,Rayan,Aït-Nouri,2024,543,France,Montreuil,Algeria,06-06-01,Left-Back,Defender,Left,180.0,30-06-26,Gestifute,https://img.a.transfermarkt.technology/portrait/header/578391-1695656762.jpg?lm=1,GB1,Wolverhampton Wanderers Football Club,35000000.0,35000000.0,23,132,-85,11,14,15,9,14,7,11,9,8,12,13,8,14,15,11,13,13,12,12,13,12,15,15,7,14,14,12,13,14,13,12,10,12,14,13,11,14,8,11,10,10,3,3,2,1,3,3,4,2,2,3,3,11,15,8,14,12,15,13,11,1,20,1,1,20,1,1,1,1,1,10,1,1,1,70,20,10,69827025,6350,6250,4600,North_African__Middle_Eastern,128,0,0,40597.0,Unknown,49047581,11100000.0,1.0,34,979,1,1,0,6,222,8,0.5772691188145012,0.4866310160427807,0.5808823529411764,0.0391924735927818,0.0,0.0,0.1747936984246061,0.1747936984246061,0.0616406011278091,0.0,0.3953488372093026,0.2083333333333332,166,11,17,26,0,1707,12,39,79,35000000,1659523.8095238095,35000000.0,3000000.0,15500000.0,15000000.0,1,0,0.0,0.25
578392,Maximilian,Beier,2024,16,Germany,Brandenburg an der Havel,Germany,17-10-02,Centre-Forward,Attack,Right,185.0,30-06-29,11WINS,https://img.a.transfermarkt.technology/portrait/header/578392-1691269428.jpg?lm=1,L1,Borussia Dortmund,30000000.0,30000000.0,22,116,146,4,7,13,12,11,8,12,10,3,7,11,12,8,12,13,12,12,11,9,12,9,16,14,4,13,7,13,16,16,13,11,11,16,15,12,8,11,6,16,4,13,1,1,3,3,3,2,3,1,1,1,1,13,16,4,12,12,18,14,12,1,1,1,1,8,8,1,10,1,10,15,11,15,20,72,12,20,7304000,5992,5992,3995,Northern_European,113,0,0,16300.0,Hannover 96,91207281,28500000.0,1.0,38,242,40,0,1,7,41,3,0.5431331039957661,0.4219251336898395,0.4705882352941176,0.015730870880556,0.0,0.0,0.1497874468617154,0.1497874468617154,0.1583099530542515,0.0,0.5116279069767438,0.1666666666666666,216,79,25,18,0,1784,6,6,8,30000000,1980000.0,30000000.0,500000.0,2000000.0,2000000.0,4,7200000,0.0,1.5
578539,Chris,Richards,2024,873,United States,"Birmingham, Alabama",United States,28-03-00,Centre-Back,Defender,Right,188.0,30-06-27,Roc Nation Sports,https://img.a.transfermarkt.technology/portrait/header/578539-1708426272.jpg?lm=1,GB1,Crystal Palace Football Club,12000000.0,12000000.0,24,132,150,3,11,11,6,12,4,15,6,6,13,13,6,14,12,11,12,15,12,13,11,12,15,11,6,11,13,14,13,13,12,13,16,13,15,13,13,14,6,13,8,14,2,4,1,2,1,2,2,3,2,3,4,19,14,2,10,14,14,12,12,1,14,20,17,12,14,1,1,1,1,1,1,1,1,78,15,20,20878512,6600,6250,5600,African_Caribbean,132,8,0,57996.0,Unknown,72051563,8650000.0,2.0,104,200,102,1,1,1,58,2,0.5772691188145012,0.5935828877005347,0.6102941176470589,0.055993248404076,0.0526315789473684,0.0,0.0597649412353088,0.0597649412353088,0.0480291119197755,0.1428571428571428,0.581395348837209,0.25,171,8,6,21,0,4435,8,36,74,12000000,628947.3684210526,12000000.0,2000000.0,50000.0,5000000.0,3,8450000,0.0,0.5
578680,Hugo,Siquet,2024,2282,Belgium,Marche-en-Famenne,Belgium,09-07-02,Right-Back,Defender,Right,180.0,30-06-28,Eleven Plus,https://img.a.transfermarkt.technology/portrait/header/578680-1658412344.jpg?lm=1,BE1,Club Brugge Koninklijke Voetbalvereniging,5000000.0,7000000.0,22,119,-8,13,14,11,8,10,11,8,10,12,11,11,10,12,12,15,12,14,10,12,11,11,10,13,12,13,8,14,11,15,10,9,8,15,15,15,8,11,12,14,5,13,2,4,2,1,2,3,1,1,4,1,1,18,12,6,12,10,11,10,15,1,1,17,20,1,19,11,1,1,10,1,1,1,1,66,8,20,60800000,5999,5999,3752,Northern_European,108,0,0,7499.0,Unknown,18114980,3750000.0,2.0,7,913,8,1,1,7,53,11,0.5440592749404605,0.3959358288770053,0.4338235294117646,0.0072324733224089,0.0,0.0,0.0247561890472618,0.0347586896724181,0.0208061335037084,0.1428571428571428,0.3953488372093026,0.1666666666666666,0,0,0,0,0,0,4,13,70,3500000,250000.0,7000000.0,1500000.0,5000000.0,3300000.0,3,1800000,-0.3,-0.3
578804,Sven,Mijnans,2024,1090,Netherlands,Spijkenisse,Netherlands,09-03-00,Attacking Midfield,Midfield,Left,190.0,30-06-28,Key United,https://img.a.transfermarkt.technology/portrait/header/578804-1605351983.jpg?lm=1,NL1,Alkmaar Zaanstreek,6500000.0,6500000.0,24,112,-75,13,11,14,11,14,15,11,11,5,12,13,14,6,14,12,12,11,7,6,14,10,10,10,7,13,13,13,14,13,10,11,10,12,10,10,8,10,5,10,10,15,2,1,3,3,3,2,1,2,3,1,1,13,12,6,13,11,12,10,16,1,1,1,1,1,1,1,10,18,10,12,20,12,1,72,20,12,28200001,5650,5650,3952,Northern_European,109,0,0,1649.0,Unknown,37077008,2500000.0,1.0,67,1408,68,3,0,7,16,0,0.4978830378406986,0.4173262032085561,0.4411764705882353,0.0015836123162551,0.0,0.0,0.032258064516129,0.032258064516129,0.0138614961526709,0.0,0.6279069767441858,0.25,240,35,26,20,0,3944,1,9,53,6500000,516666.6666666667,6500000.0,1000000.0,,700000.0,1,2500000,0.0,0.3
579928,Sebastian,Nanasi,2024,667,Sweden,Kristianstad,Sweden,16-05-02,Left Midfield,Midfield,Right,178.0,30-06-29,Unknown,https://img.a.transfermarkt.technology/portrait/header/579928-1627915685.jpg?lm=1,FR1,Racing Club de Strasbourg Alsace,12000000.0,12000000.0,22,113,-75,9,9,13,11,13,10,6,9,5,7,11,11,7,13,8,10,11,12,11,12,11,14,13,5,12,9,11,11,14,13,8,8,12,13,10,8,12,5,11,5,12,2,2,3,3,1,1,2,3,3,3,2,12,13,7,13,13,13,13,14,1,1,1,1,1,1,1,14,15,10,15,20,15,16,70,13,20,1977483,5650,5650,1000,Northern_European,106,0,0,1863.0,Kalmar FF,93121623,9111392.0,2.0,91,762,91,3,1,7,159,6,0.4978830378406986,0.1016042780748663,0.4191176470588235,0.001790254411181,0.0,0.0,0.0597649412353088,0.0597649412353088,0.0505924720131114,0.1428571428571428,0.3488372093023257,0.1666666666666666,150,38,33,5,0,3522,0,0,0,15000000,1146153.8461538462,15000000.0,0.0,100000.0,1800000.0,2,4000000,0.875,2.0
580193,Bright,Arrey-Mbi,2024,1075,Cameroon,Kumba,Germany,26-03-03,Centre-Back,Defender,Left,187.0,30-06-29,Gestifute,https://img.a.transfermarkt.technology/portrait/header/580193-1708164169.jpg?lm=1,PO1,Sporting Clube de Braga,6000000.0,6000000.0,21,106,-75,3,7,11,6,11,4,12,9,6,12,12,7,12,11,15,11,15,12,10,9,9,13,10,6,8,12,12,12,13,10,13,14,13,15,10,16,11,11,9,6,10,1,3,1,1,1,1,2,1,2,1,1,12,13,11,8,10,12,9,8,1,15,20,1,14,1,10,1,1,1,1,1,1,1,83,20,8,30359999,5257,5257,3776,African_Caribbean,105,0,0,6711.0,Hannover 96,91205052,9111392.0,2.0,15,769,40,1,0,1,192,2,0.4458851548028579,0.3985026737967914,0.411764705882353,0.0064715669167937,0.0,0.0,0.0297574393598399,0.0297574393598399,0.0505924720131114,0.1428571428571428,0.5581395348837206,0.125,157,5,1,13,1,3869,6,21,31,6000000,423076.92307692306,6000000.0,500000.0,1300000.0,2500000.0,3,4000000,1.4,1.4
580195,Jamal,Musiala,2024,27,Germany,Stuttgart,Germany,26-02-03,Attacking Midfield,Midfield,Right,184.0,30-06-26,11WINS,https://img.a.transfermarkt.technology/portrait/header/580195-1711745441.jpg?lm=1,L1,FC Bayern MÃ¼nchen,130000000.0,130000000.0,21,155,180,7,8,18,13,16,6,9,13,6,11,14,12,12,18,12,14,12,13,12,15,13,16,18,6,14,11,15,15,15,17,15,10,16,15,12,9,16,6,17,4,16,2,1,1,1,2,2,2,3,3,1,2,18,19,4,14,17,17,16,18,1,1,1,1,1,1,10,12,17,12,18,20,15,12,70,12,20,88884003,8098,8098,7598,African_Caribbean,153,15,1,105478.0,Unknown,28124579,200000.0,1.0,38,1432,40,3,1,1,68,0,0.8217782482138132,0.8072727272727273,0.7647058823529411,0.1018426874287253,0.0986842105263157,0.0131578947368421,0.6499124781195299,0.6499124781195299,0.0010833634267618,0.0,0.4883720930232553,0.125,227,66,41,10,0,6695,18,30,26,140000000,9266666.666666666,140000000.0,0.0,55000000.0,110000000.0,0,0,0.07692307692307693,0.2727272727272727
580560,Jon,Pacheco,2024,681,Spain,Elizondo,Spain,08-01-01,Centre-Back,Defender,Left,184.0,30-06-27,IDUB GLOBAL,https://img.a.transfermarkt.technology/portrait/header/580560-1631178086.jpg?lm=1,ES1,Real Sociedad de FÃºtbol S.A.D.,15000000.0,15000000.0,23,124,-75,8,7,6,10,14,11,14,10,9,14,17,7,13,17,14,14,12,14,14,13,12,16,7,11,10,17,12,13,10,13,13,10,13,12,11,10,16,6,12,11,17,3,2,2,3,3,1,1,3,2,2,3,10,9,1,11,12,11,11,13,1,12,20,1,1,1,1,1,1,1,1,1,1,1,77,20,12,30000000,6200,6200,4102,Mediterranean_Hispanic,129,0,0,7024.0,Unknown,67269422,9111392.0,2.0,89,458,89,1,0,3,168,2,0.5706536120666843,0.4333689839572192,0.588235294117647,0.0067738051210546,0.0,0.0,0.0747686921730432,0.0747686921730432,0.0505924720131114,0.1428571428571428,0.4883720930232553,0.2083333333333332,128,2,4,28,2,4208,3,13,36,10000000,707142.8571428572,15000000.0,5000000.0,100000.0,600000.0,1,5000000,-0.3333333333333333,0.25
580657,Osame,Sahraoui,2024,1082,Norway,Oslo,Morocco,11-06-01,Left Winger,Attack,Right,170.0,30-06-29,Fellah AS,https://img.a.transfermarkt.technology/portrait/header/580657-1723713882.jpg?lm=1,FR1,Lille Olympique Sporting Club Lille MÃ©tropole,8500000.0,8500000.0,23,123,146,6,10,16,8,13,9,4,11,3,6,14,5,5,14,8,8,7,13,12,15,14,15,18,5,12,5,12,13,14,18,16,4,9,12,12,7,13,2,7,6,12,3,3,2,3,2,1,2,2,1,3,3,12,15,4,12,13,12,12,13,1,1,1,1,1,1,1,12,14,10,20,16,14,1,65,12,20,2644303,5981,5981,4412,North_African__Middle_Eastern,119,0,0,1130.0,Unknown,53170352,5300000.0,2.0,71,1096,67,0,1,6,128,7,0.5416776925112464,0.4665240641711229,0.5147058823529411,0.0010824569551963,0.0,0.0,0.0422605651412853,0.0422605651412853,0.0294174838189949,0.1428571428571428,0.1627906976744184,0.2083333333333332,0,0,0,0,0,0,3,4,12,12000000,1180000.0,12000000.0,-400000.0,,1500000.0,2,5000000,0.4117647058823529,0.8461538461538461
580747,Yvann,Maçon,2024,618,Guadeloupe,Baie-Mahault,France,01-10-98,Right-Back,Defender,Right,176.0,30-06-25,Wasserman,https://img.a.transfermarkt.technology/portrait/header/580747-1727722966.jpg?lm=1,FR1,Association sportive de Saint-Ã‰tienne Loire,2000000.0,4500000.0,26,124,135,9,11,12,6,13,7,8,6,11,10,13,7,11,12,10,12,12,13,11,12,13,14,12,11,13,8,14,14,14,13,12,8,14,14,14,12,12,9,9,8,12,2,3,3,2,1,2,4,2,1,2,2,11,14,4,13,13,12,12,19,1,15,1,20,13,17,1,12,1,15,1,1,1,1,74,8,20,3484334,6192,6192,3843,African_Caribbean,114,0,0,958.0,Unknown,48046006,450000.0,1.0,41,129,36,1,1,1,25,11,0.5695951309870336,0.4056684491978609,0.4779411764705882,0.0009163707854427,0.0,0.0,0.0097524381095273,0.0222555638909727,0.0024722908969693,0.0,0.3023255813953489,0.3333333333333332,138,7,8,32,0,4433,5,57,183,2000000,130000.0,4500000.0,1500000.0,,50000.0,4,2050000,0.0,0.25
580765,Henry,Lawrence,2024,3057,England,London,England,21-09-01,Right-Back,Defender,Right,171.0,30-06-25,FA Sport,https://img.a.transfermarkt.technology/portrait/header/580765-1574325751.jpg?lm=1,BE1,Royal Standard Club de LiÃ¨ge,700000.0,800000.0,23,102,-75,7,11,8,6,10,7,6,5,5,9,9,7,12,8,10,9,8,11,13,9,10,16,12,5,12,9,13,13,13,8,10,6,16,12,13,6,11,7,13,5,16,3,3,2,3,3,2,2,3,3,2,1,17,18,4,17,12,17,13,18,1,18,11,20,18,20,17,13,14,12,14,14,14,1,73,12,20,25471785,5245,5245,2959,African_Caribbean,79,0,0,5800.0,Milton Keynes Dons,28121365,9111392.0,2.0,32,858,33,1,1,1,176,11,0.4442974331833819,0.3111229946524064,0.2205882352941177,0.0055918895874593,0.0,0.0,0.0032508127031757,0.0037509377344336,0.0505924720131114,0.1428571428571428,0.1860465116279068,0.2083333333333332,180,13,7,17,1,3140,0,0,0,1000000,33333.333333333336,1000000.0,200000.0,,800000.0,3,650000,1.5,1.2222222222222223
581106,Kristian,Arnstad,2024,678,Norway,Oslo,Norway,07-09-03,Central Midfield,Midfield,Right,175.0,30-06-29,Keypass AS,https://img.a.transfermarkt.technology/portrait/header/581106-1704873743.jpg?lm=1,DK1,Aarhus Gymnastik Forening,2000000.0,3000000.0,21,108,-75,9,11,9,8,13,9,6,9,3,10,14,9,10,12,12,13,11,10,12,12,12,12,12,10,10,10,12,13,13,11,11,8,7,10,13,11,12,6,11,10,10,3,2,2,1,2,2,1,3,2,1,1,14,13,2,10,11,14,11,15,1,1,1,1,1,1,14,1,20,1,1,14,14,1,60,12,20,24320000,5500,5500,3506,Northern_European,106,0,0,3999.0,Unknown,53182865,1350000.0,1.0,71,1096,73,3,1,7,11,1,0.4780365175972479,0.3696256684491978,0.4191176470588235,0.0038528128913767,0.0,0.0,0.0097524381095273,0.0147536884221055,0.0074724297897163,0.0,0.2790697674418605,0.125,86,1,4,19,1,3352,1,2,6,2000000,136363.63636363635,3000000.0,500000.0,1000000.0,2000000.0,1,0,0.0,0.0
581109,Odin Thiago,Holm,2024,371,Norway,Trondheim,Norway,18-01-03,Central Midfield,Midfield,Right,175.0,31-05-28,TPSportManagement,https://img.a.transfermarkt.technology/portrait/header/581109-1687343054.jpg?lm=1,SC1,The Celtic Football Club,2000000.0,3000000.0,21,115,-8,9,7,14,8,13,12,9,8,4,7,13,9,7,14,9,10,9,12,10,13,12,18,16,9,11,7,11,11,14,16,14,13,12,12,12,9,13,5,15,13,9,1,1,2,3,2,4,2,3,3,1,3,8,18,4,12,12,14,8,11,1,1,1,1,1,1,14,1,18,1,10,20,1,1,70,11,20,2396338,5686,5686,4142,Northern_European,113,0,0,503.0,Unknown,53170349,3000000.0,1.0,71,1528,73,3,1,7,200,1,0.5026462026991267,0.4376470588235294,0.4705882352941176,0.0004770149294085,0.0,0.0,0.0097524381095273,0.0147536884221055,0.0166393510930859,0.0,0.2790697674418605,0.125,107,14,6,10,1,3842,3,47,148,2000000,162500.0,3000000.0,500000.0,900000.0,3000000.0,1,300000,0.0,-0.3333333333333333
581140,Joelson,Fernandes,2024,7775,Guinea-Bissau,Bissau,Portugal,28-02-03,Left Winger,Attack,Right,172.0,30-06-26,Sports Invest UK ltd,https://img.a.transfermarkt.technology/portrait/header/581140-1696433273.png?lm=1,TR1,Hatayspor Futbol KulÃ¼bÃ¼,1800000.0,6000000.0,21,125,129,6,9,13,13,13,7,11,12,7,7,12,12,9,13,13,12,13,13,12,11,11,13,13,7,13,10,12,12,14,13,9,9,13,13,13,10,12,8,13,8,12,4,2,3,2,1,2,3,3,1,3,3,11,11,2,10,11,13,6,10,1,1,1,1,1,1,1,1,1,1,20,10,20,18,76,14,20,347975206,6166,6166,3039,Mixed_Race,120,0,0,8407.0,Unknown,19221261,9111392.0,2.0,44,202,79,0,1,4,111,7,0.5661550674781688,0.3196791443850267,0.5220588235294117,0.0081092537999453,0.0,0.0,0.0087521880470117,0.0297574393598399,0.0505924720131114,0.1428571428571428,0.2093023255813952,0.125,149,15,15,22,0,3362,2,3,9,1700000,-358333.3333333333,6000000.0,2500000.0,3500000.0,2200000.0,3,3700000,-0.05555555555555555,-0.22727272727272727
581678,Jude,Bellingham,2024,418,England,Stourbridge,England,29-06-03,Attacking Midfield,Midfield,Right,186.0,30-06-29,Unknown,https://img.a.transfermarkt.technology/portrait/header/581678-1693987944.jpg?lm=1,ES1,Real Madrid Club de FÃºtbol,180000000.0,180000000.0,21,155,-95,10,11,16,13,16,8,12,12,6,12,15,5,13,16,17,14,18,15,12,13,13,20,16,14,14,10,15,17,15,15,14,12,16,15,16,11,14,10,14,5,14,3,1,4,3,2,1,1,1,3,2,1,13,15,13,16,18,18,12,6,1,1,1,1,1,1,18,12,20,12,10,13,10,1,75,11,20,122709606,7500,8000,7050,African_Caribbean,153,15,0,56999.0,Unknown,29232937,71575000.0,2.0,32,1429,33,3,1,1,167,0,0.808811854988092,0.748663101604278,0.7647058823529411,0.0550305279898648,0.0986842105263157,0.0,0.8999749937484371,0.8999749937484371,0.3976221561710047,0.1428571428571428,0.5348837209302322,0.125,253,62,50,54,2,5776,6,15,24,180000000,9861111.111111112,180000000.0,1000000.0,80000000.0,180000000.0,2,46000000,0.0,0.0
581781,Enzo,Loiodice,2024,472,France,Paris,France,27-11-00,Central Midfield,Midfield,Left,177.0,30-06-26,2SAgency,https://img.a.transfermarkt.technology/portrait/header/581781-1539357288.jpg?lm=1,ES1,UniÃ³n Deportiva Las Palmas S.A.D.,4000000.0,5500000.0,24,122,143,9,11,11,7,14,7,5,11,5,12,15,10,12,14,9,13,10,14,13,14,14,12,10,4,10,12,14,13,10,13,13,7,10,12,14,11,13,6,13,12,8,2,1,1,4,2,2,3,1,2,3,3,10,13,6,12,11,12,12,15,1,1,1,1,1,1,10,1,20,1,13,16,1,1,60,20,10,3840000,6000,5500,4100,Mediterranean_Hispanic,122,0,0,4177.0,Unknown,49045906,9111392.0,2.0,34,1122,36,3,0,3,207,1,0.4780365175972479,0.4331550802139037,0.536764705882353,0.0040246927647263,0.0,0.0,0.0197549387346836,0.0272568142035508,0.0505924720131114,0.1428571428571428,0.3255813953488373,0.25,170,7,5,26,0,4187,3,29,93,2000000,75000.0,5500000.0,2000000.0,5500000.0,1000000.0,3,3500000,-0.5,-0.3333333333333333
582987,Adrian,Bajrami,2024,294,Switzerland,Langenthal,Albania,05-04-02,Centre-Back,Defender,Left,188.0,30-06-26,Signature - ISCM AG,https://img.a.transfermarkt.technology/portrait/header/582987-1704294917.jpg?lm=1,PO1,Sport Lisboa e Benfica,1500000.0,1500000.0,22,105,-75,4,8,7,7,11,5,13,11,8,13,13,8,13,10,13,12,12,11,11,11,11,13,10,10,10,12,12,11,11,10,13,14,15,11,11,13,12,5,12,6,10,3,1,3,2,4,1,2,2,1,1,2,12,13,8,10,12,14,14,14,1,13,20,1,1,1,1,1,1,1,1,1,1,1,76,20,7,14218000,5244,5244,3744,Mediterranean_Hispanic,105,1,0,2749.0,Unknown,83273689,9111392.0,2.0,92,798,0,1,0,3,188,2,0.4441651230484255,0.3950802139037432,0.411764705882353,0.0026457913088652,0.006578947368421,0.0,0.0072518129532383,0.0072518129532383,0.0505924720131114,0.1428571428571428,0.581395348837209,0.1666666666666666,107,8,2,10,0,4603,2,12,99,1500000,100000.0,1500000.0,0.0,,1000000.0,1,0,0.0,0.0
583046,Medon,Berisha,2024,1005,Switzerland,MÃ¼nsingen,Albania,21-10-03,Central Midfield,Midfield,Right,186.0,30-06-27,LIAN Sports Group,https://img.a.transfermarkt.technology/portrait/header/583046-1662114572.jpg?lm=1,IT1,Unione Sportiva Lecce,1000000.0,1000000.0,21,125,130,7,10,10,13,11,10,12,7,4,8,11,13,10,11,17,13,16,12,12,11,12,15,12,13,15,9,14,14,13,13,11,10,14,14,15,11,12,8,14,9,8,3,2,1,2,3,3,1,1,1,3,2,12,14,14,9,10,14,10,6,1,1,1,1,1,1,1,10,1,10,14,13,12,20,75,15,20,4010275,6250,6300,5000,Mediterranean_Hispanic,124,10,1,4659.0,Unknown,164074,9111392.0,2.0,92,1007,0,3,1,3,206,1,0.5838846255623181,0.5294117647058822,0.5514705882352942,0.0044901202869428,0.0657894736842105,0.0131578947368421,0.0047511877969492,0.0047511877969492,0.0505924720131114,0.1428571428571428,0.5348837209302322,0.125,125,29,6,14,0,3833,4,17,70,1000000,139285.7142857143,1000000.0,0.0,75000.0,1000000.0,2,75000,0.0,1.0
583189,Anthony,Elanga,2024,703,Sweden,Hyllie,Sweden,27-04-02,Right Winger,Attack,Right,178.0,30-06-28,CAA Stellar,https://img.a.transfermarkt.technology/portrait/header/583189-1700739021.jpg?lm=1,GB1,Nottingham Forest Football Club,25000000.0,25000000.0,22,130,-75,5,8,14,13,12,4,10,12,2,1,10,10,6,13,12,10,8,10,9,6,9,4,16,3,13,5,13,14,18,14,11,10,15,18,14,10,12,4,13,6,17,2,2,2,2,4,1,3,1,1,3,1,15,12,6,10,10,11,11,19,1,1,1,1,1,1,1,18,1,15,20,1,16,13,71,12,20,65883306,6746,6396,4496,African_Caribbean,122,5,1,46397.0,Unknown,28121568,17500000.0,1.0,91,645,91,0,1,1,140,10,0.5965863985181264,0.4755080213903743,0.536764705882353,0.0447930537356352,0.0328947368421052,0.0131578947368421,0.1247811952988247,0.1247811952988247,0.0971971443651212,0.0,0.3488372093023257,0.1666666666666666,0,0,0,0,0,0,0,0,0,25000000,2016666.6666666667,25000000.0,7000000.0,,25000000.0,2,11000000,0.13636363636363635,0.3888888888888889
583199,James,Mcatee,2024,281,England,Salford,England,18-10-02,Attacking Midfield,Midfield,Left,180.0,30-06-26,YMU Management Ltd.,https://img.a.transfermarkt.technology/portrait/header/583199-1692364836.jpg?lm=1,GB1,Manchester City Football Club,12000000.0,12000000.0,22,110,-8,7,11,13,11,12,11,6,11,2,8,14,7,5,15,8,11,12,13,12,13,12,13,14,7,7,5,12,12,14,15,13,8,12,12,10,7,10,4,5,8,17,3,1,4,2,1,2,3,4,4,1,4,18,13,6,10,12,13,14,12,1,1,1,1,1,1,1,1,18,1,1,20,13,13,0,20,8,56975140,5498,5498,3998,Northern_European,105,0,0,11599.0,Sheffield United,28126249,9111392.0,2.0,32,1285,33,3,0,7,131,0,0.4777718973273352,0.4222459893048128,0.411764705882353,0.0111915041130467,0.0,0.0,0.0597649412353088,0.0597649412353088,0.0505924720131114,0.1428571428571428,0.3953488372093026,0.1666666666666666,188,66,37,21,0,2811,0,0,0,14000000,1500000.0,14000000.0,0.0,500000.0,12000000.0,4,9000000,0.16666666666666666,0.16666666666666666
583255,Antoine,Semenyo,2024,989,England,London,Ghana,07-01-00,Right Winger,Attack,Right,185.0,30-06-29,Unknown,https://img.a.transfermarkt.technology/portrait/header/583255-1628669787.jpg?lm=1,GB1,Association Football Club Bournemouth,20000000.0,20000000.0,24,124,145,11,11,13,12,12,11,10,10,6,6,11,8,8,12,12,10,12,11,9,12,10,9,14,8,13,11,11,12,14,14,11,10,9,14,13,12,11,12,8,11,12,1,2,3,2,2,3,4,3,1,3,3,15,12,2,13,10,11,10,10,1,1,1,1,1,1,1,16,1,16,18,1,18,20,63,9,20,10216552,6200,6200,3500,African_Caribbean,111,1,0,2900.0,Unknown,29194724,10250000.0,1.0,32,858,41,0,1,1,22,10,0.5706536120666843,0.3689839572192513,0.4558823529411764,0.0027915995160326,0.006578947368421,0.0,0.0997749437359339,0.0997749437359339,0.0569182477291035,0.0,0.5116279069767438,0.25,0,0,0,0,0,0,0,0,0,28000000,1833333.3333333333,28000000.0,300000.0,,1300000.0,3,6100000,1.8,1.8
583917,Ernest,Muci,2024,114,Albania,TiranÃ«,Albania,19-03-01,Left Winger,Attack,Right,180.0,30-06-27,Unknown,https://img.a.transfermarkt.technology/portrait/header/583917-1727356057.png?lm=1,TR1,Be?ikta? Jimnastik KulÃ¼bÃ¼,12000000.0,13000000.0,23,108,135,9,11,13,10,13,8,12,14,5,5,11,14,7,14,4,8,7,11,11,11,12,13,14,4,10,6,10,8,14,13,7,11,12,14,10,6,10,3,11,3,12,3,2,2,4,2,4,3,2,1,3,2,7,12,2,8,9,13,10,10,1,1,1,1,1,1,1,1,18,1,13,20,13,17,75,12,20,1179218,4994,4994,1994,Northern_European,102,1,0,3000.0,Unknown,11035674,5250000.0,2.0,0,1494,0,0,1,7,37,7,0.4110875893093411,0.2079144385026738,0.3897058823529412,0.0028881612426335,0.006578947368421,0.0,0.0597649412353088,0.0647661915478869,0.0291396983249534,0.1428571428571428,0.3953488372093026,0.2083333333333332,0,0,0,0,0,0,1,3,16,12000000,663888.8888888889,13000000.0,1000000.0,225000.0,1200000.0,2,3225000,-0.07692307692307693,0.5
584769,Dwight,Mcneil,2024,29,England,Rochdale,England,22-11-99,Left Winger,Attack,Left,183.0,30-06-27,Unique Sports Group,https://img.a.transfermarkt.technology/portrait/header/584769-1700651579.jpg?lm=1,GB1,Everton Football Club,22000000.0,25000000.0,25,133,165,13,14,13,12,13,9,7,8,6,10,14,9,12,13,8,13,14,13,12,13,11,16,14,6,13,11,14,13,14,14,10,11,16,14,12,10,13,7,13,5,16,2,2,3,3,4,3,3,1,4,3,1,12,15,2,13,12,14,13,13,1,1,1,1,1,1,1,19,13,16,20,14,17,15,68,20,8,85087185,6650,6750,5600,Mixed_Race,125,0,0,86994.0,Unknown,28110488,17000000.0,1.0,32,1242,33,0,0,4,65,7,0.6434241862926701,0.5935828877005347,0.5588235294117647,0.0839942178838111,0.0,0.0,0.1097774443610902,0.1247811952988247,0.0944192894247062,0.0,0.4651162790697669,0.2916666666666665,244,21,30,20,0,1967,6,28,111,25000000,1500000.0,25000000.0,4000000.0,,25000000.0,1,0,0.13636363636363635,0.25
585068,Aiham,Ousou,2024,172,Sweden,MÃ¶lndal,Syria,09-01-00,Centre-Back,Defender,Right,186.0,30-06-25,11MANGMT,https://img.a.transfermarkt.technology/portrait/header/585068-1697831156.png?lm=1,BE1,Royal Charleroi Sporting Club,1800000.0,2000000.0,24,119,137,5,10,9,6,12,6,12,7,12,14,12,7,13,11,12,14,13,11,11,11,10,13,11,13,10,13,12,12,13,12,13,12,12,13,13,14,12,11,9,10,5,2,4,3,1,1,2,1,2,1,2,3,12,13,9,9,10,9,10,10,1,6,20,12,1,6,12,1,1,1,1,1,1,1,78,10,20,2116849,5942,5942,4492,North_African__Middle_Eastern,119,0,0,6090.0,Unknown,93101493,600000.0,1.0,91,1001,93,1,1,6,174,2,0.5365175972479492,0.4750802139037433,0.5147058823529411,0.005871918594602,0.0,0.0,0.0087521880470117,0.0097524381095273,0.0033056473790938,0.0,0.5348837209302322,0.25,150,2,4,15,2,6206,3,11,11,2200000,140000.0,2200000.0,300000.0,,100000.0,6,1450000,0.2222222222222222,0.1
585323,Filip,Jørgensen,2024,631,Sweden,Lomma,Denmark,16-04-02,Goalkeeper,Goalkeeper,Right,190.0,30-06-31,Goal Management,https://img.a.transfermarkt.technology/portrait/header/585323-1718280485.jpg?lm=1,GB1,Chelsea Football Club,20000000.0,20000000.0,22,111,-75,5,1,3,1,8,6,1,1,1,2,11,3,2,7,9,13,12,10,10,9,10,5,3,12,1,9,10,9,11,7,10,8,18,11,6,7,13,9,6,5,15,14,14,14,5,14,13,14,14,13,15,11,13,12,1,12,12,14,12,15,20,1,1,1,1,1,1,1,1,1,1,1,1,1,77,8,20,31200000,5550,5550,3550,Northern_European,102,0,0,2001.0,Unknown,67283140,24500000.0,1.0,91,856,30,2,1,7,50,5,0.4846520243450648,0.374331550802139,0.3897058823529412,0.0019235095938903,0.0,0.0,0.0997749437359339,0.0997749437359339,0.1360871135309314,0.0,0.6279069767441858,0.1666666666666666,0,0,0,0,0,0,0,0,0,20000000,1425000.0,20000000.0,0.0,250000.0,1500000.0,2,0,0.0,0.3333333333333333
585339,Pape Habib,Guèye,2024,370,Senegal,Ziguinchor,Senegal,20-09-99,Centre-Forward,Attack,Right,188.0,31-05-26,1863,https://img.a.transfermarkt.technology/portrait/header/585339-1711152399.jpg?lm=1,SC1,Aberdeen Football Club,1000000.0,1500000.0,25,118,138,11,11,13,13,12,9,12,9,7,10,10,11,11,12,6,13,11,14,12,9,13,12,12,7,13,11,11,12,12,12,14,13,12,13,13,14,12,8,12,12,16,1,2,3,3,1,2,1,3,1,1,1,10,13,14,8,12,10,11,15,1,1,1,1,1,1,1,1,1,1,1,12,1,20,0,7,20,3979999,5899,5899,2773,African_Caribbean,119,0,0,2000.0,Unknown,13191648,580000.0,1.0,83,1707,84,0,1,1,12,3,0.5308282614448266,0.2912299465240641,0.5147058823529411,0.0019225439766243,0.0,0.0,0.0047511877969492,0.0072518129532383,0.0031945331814772,0.0,0.581395348837209,0.2916666666666665,183,54,18,29,1,3065,2,33,180,1000000,44117.64705882353,1500000.0,650000.0,,450000.0,4,550000,0.42857142857142855,0.8181818181818182
585550,Gavin,Bazunu,2024,180,Ireland,Dublin,Ireland,20-02-02,Goalkeeper,Goalkeeper,Right,188.0,30-06-27,Gest Eleven,https://img.a.transfermarkt.technology/portrait/header/585550-1655476121.jpg?lm=1,GB1,Southampton Football Club,15000000.0,18000000.0,22,126,-85,3,1,3,1,11,4,8,2,2,1,13,3,3,11,8,11,11,12,8,12,10,15,8,7,12,12,12,11,12,13,13,13,13,11,13,10,12,5,8,4,10,14,14,13,4,16,14,14,16,11,9,12,12,15,3,12,14,15,12,15,20,1,1,1,1,1,1,1,1,1,1,1,1,1,79,8,20,81310207,6300,6300,5400,Mixed_Race,125,10,0,46397.0,Unknown,52094936,7250000.0,2.0,49,433,52,2,1,4,186,5,0.5838846255623181,0.5721925133689839,0.5588235294117647,0.0447930537356352,0.0657894736842105,0.0,0.0747686921730432,0.0897724431107777,0.0402511180866135,0.1428571428571428,0.581395348837209,0.1666666666666666,0,0,0,0,0,0,1,37,261,14000000,1488888.888888889,18000000.0,3000000.0,,15000000.0,2,14400000,-0.06666666666666667,-0.06666666666666667
585949,Pierre,Kalulu,2024,506,France,Lyon,France,05-06-00,Centre-Back,Defender,Right,182.0,30-06-25,CAA Stellar,https://img.a.transfermarkt.technology/portrait/header/585949-1684854558.jpg?lm=1,IT1,Juventus Football Club,20000000.0,35000000.0,24,149,169,6,11,11,8,13,5,14,8,12,15,13,6,15,13,11,15,15,14,15,12,14,15,7,11,13,15,14,14,14,13,15,11,15,16,15,14,15,8,13,5,17,1,2,3,3,2,1,2,1,1,1,2,16,16,7,12,13,14,15,17,1,14,20,17,8,12,1,1,1,11,1,1,1,1,79,10,20,72036004,7450,6471,6087,African_Caribbean,149,0,0,14808.0,Unknown,49045184,1390000.0,1.0,34,884,36,1,1,1,116,2,0.6065096586398518,0.6456684491978609,0.7352941176470587,0.0142901699196702,0.0,0.0,0.0997749437359339,0.1747936984246061,0.0076946581849495,0.0,0.4418604651162785,0.25,196,5,6,22,0,5625,6,50,120,26000000,1961538.4615384615,35000000.0,5000000.0,,7000000.0,1,6000000,0.3,0.04
585958,Junior,Kadile,2024,723,France,Rennes,France,16-12-02,Right Winger,Attack,Right,180.0,30-06-27,BS Group - BS Law,https://img.a.transfermarkt.technology/portrait/header/585958-1594050601.JPG?lm=1,NL1,Almere City Football Club,600000.0,700000.0,22,105,138,7,8,13,10,12,9,10,10,10,5,8,4,10,12,14,12,13,7,8,9,7,14,12,7,12,6,8,14,15,14,11,11,14,15,12,10,8,12,5,15,12,2,1,3,1,1,4,2,3,1,2,3,10,13,6,12,13,10,11,11,1,1,1,1,1,1,1,12,1,12,20,1,18,12,76,7,20,2265999,5250,5250,3750,African_Caribbean,101,0,0,2465.0,Futebol Clube de FamalicÃ£o,49057003,9111392.0,2.0,34,1218,36,0,1,1,17,10,0.4449589838581635,0.3957219251336898,0.3823529411764706,0.0023715560053186,0.0,0.0,0.0027506876719179,0.0032508127031757,0.0505924720131114,0.1428571428571428,0.3953488372093026,0.1666666666666666,0,0,0,0,0,0,0,0,0,500000,33333.333333333336,700000.0,100000.0,,700000.0,2,200000,-0.16666666666666666,-0.2857142857142857
585959,Arnaud,Kalimuendo,2024,273,France,Suresnes,France,20-01-02,Centre-Forward,Attack,Right,175.0,30-06-27,DW Sports Management,https://img.a.transfermarkt.technology/portrait/header/585959-1666698479.jpg?lm=1,FR1,Stade Rennais Football Club,20000000.0,25000000.0,22,129,155,7,9,14,15,13,7,11,11,6,7,12,12,7,14,7,13,13,14,12,13,14,15,14,8,15,6,12,14,15,15,13,8,13,14,13,12,13,8,13,8,10,1,1,1,1,2,1,3,3,1,1,3,12,14,7,8,13,14,13,12,1,1,1,1,1,1,1,1,1,1,1,1,1,20,78,8,20,23880000,6450,6450,3900,African_Caribbean,130,0,0,25000.0,Unknown,49048445,20000000.0,1.0,34,1437,36,0,1,1,195,3,0.6037311458057687,0.4117647058823529,0.5955882352941175,0.0241317410948361,0.0,0.0,0.0997749437359339,0.1247811952988247,0.1110864190671963,0.0,0.2790697674418605,0.1666666666666666,209,93,22,12,1,3105,5,16,26,20000000,1461538.4615384615,25000000.0,3000000.0,6000000.0,25000000.0,2,3000000,0.0,0.0
585973,Johann,Lepenant,2024,995,France,Granville,France,22-10-02,Defensive Midfield,Midfield,Right,176.0,30-06-25,Unknown,https://img.a.transfermarkt.technology/portrait/header/585973-1672830993.jpg?lm=1,FR1,Football Club de Nantes,7000000.0,10000000.0,22,118,-8,11,11,10,12,12,11,8,11,5,15,13,9,12,14,12,12,13,10,13,12,12,14,10,8,12,16,13,15,12,13,12,8,14,12,14,8,12,11,6,7,8,2,2,1,2,2,3,4,1,2,1,1,13,12,8,13,10,10,11,17,1,1,1,1,1,1,19,1,20,1,1,1,1,1,71,10,20,38857217,6300,5900,2500,Northern_European,119,0,0,13696.0,Unknown,49056191,4250000.0,1.0,34,555,36,3,1,7,93,4,0.530960571579783,0.2620320855614972,0.5147058823529411,0.013216403519868,0.0,0.0,0.0347586896724181,0.0497624406101525,0.0235839884441234,0.0,0.3023255813953489,0.1666666666666666,130,4,4,20,0,2038,3,17,90,7000000,421875.0,10000000.0,2000000.0,1200000.0,8000000.0,2,4000000,0.16666666666666666,-0.125
585982,Unknown,Carlos Augusto,2024,46,Brazil,Campinas,Brazil,07-01-99,Left-Back,Defender,Left,184.0,30-06-28,GR Sports,https://img.a.transfermarkt.technology/portrait/header/585982-1725531744.jpg?lm=1,IT1,Football Club Internazionale Milano S.p.A.,22000000.0,22000000.0,25,124,141,9,12,12,9,12,9,12,10,12,12,12,9,12,13,14,12,14,13,12,12,13,12,10,9,12,11,11,13,14,13,10,11,8,12,14,12,12,7,12,11,14,1,3,1,2,2,2,1,1,2,1,4,10,12,6,13,13,10,8,12,1,20,15,1,19,1,1,14,1,1,1,1,1,1,0,20,8,2243568,6198,5511,4977,Northern_European,120,0,0,12114.0,Unknown,19350649,8725000.0,2.0,10,307,11,1,0,7,89,8,0.4794919290817676,0.5269518716577539,0.5220588235294117,0.0116887970050414,0.0,0.0,0.1097774443610902,0.1097774443610902,0.0484457901608378,0.1428571428571428,0.4883720930232553,0.2916666666666665,218,16,16,18,1,4698,5,12,27,22000000,1219444.4444444445,22000000.0,1500000.0,,900000.0,2,3200000,0.0,0.375
586659,Yvandro,Borges Sanches,2024,18,Luxembourg,Luxemburg,Luxembourg,24-05-04,Left Winger,Attack,Right,180.0,30-06-26,Wasserman,https://img.a.transfermarkt.technology/portrait/header/586659-1662966289.jpg?lm=1,L1,Borussia Verein fÃ¼r LeibesÃ¼bungen 1900 MÃ¶nchengladbach,750000.0,1500000.0,20,103,-75,12,9,14,11,12,8,4,8,2,4,12,8,6,14,4,9,9,9,8,12,9,14,16,2,11,5,10,10,15,15,8,6,13,15,10,5,12,1,12,3,12,2,1,2,1,1,1,3,1,1,3,3,16,15,6,12,13,14,16,17,1,1,1,1,1,1,1,15,12,15,20,14,18,12,68,8,20,21640000,5245,4028,4016,North_African__Middle_Eastern,96,12,1,6673.0,Unknown,2000124674,9111392.0,2.0,59,880,60,0,1,6,42,7,0.2832759989415189,0.4241711229946523,0.3455882352941176,0.0064348734606853,0.0789473684210526,0.0131578947368421,0.0035008752188047,0.0072518129532383,0.0505924720131114,0.1428571428571428,0.3953488372093026,0.0833333333333332,61,8,12,3,0,2249,10,57,187,500000,33333.333333333336,1500000.0,500000.0,1500000.0,500000.0,3,650000,-0.5,-0.5
586855,Loreintz,Rosier,2024,385,France,Gonesse,France,14-08-98,Defensive Midfield,Midfield,Right,190.0,30-06-25,Proeleven S.A.,https://img.a.transfermarkt.technology/portrait/header/586855-1547563533.png?lm=1,NL1,Fortuna Sittardia Combinatie,900000.0,1000000.0,26,126,138,5,7,8,7,11,8,16,10,5,13,11,8,15,11,14,14,11,12,13,12,11,13,8,11,8,15,13,14,11,11,14,16,17,12,15,16,13,9,12,8,12,2,2,3,1,2,1,3,3,2,3,3,7,14,8,10,12,13,12,11,1,1,14,1,1,1,20,1,16,1,1,1,1,1,82,11,20,1530599,6300,6300,4300,African_Caribbean,122,0,0,2850.0,Unknown,85144972,9111392.0,2.0,34,549,36,3,1,1,94,4,0.5838846255623181,0.4545454545454545,0.536764705882353,0.0027433186527321,0.0,0.0,0.0042510627656914,0.0047511877969492,0.0505924720131114,0.1428571428571428,0.6279069767441858,0.3333333333333332,168,13,3,26,0,1300,3,5,25,1300000,80769.23076923077,1300000.0,100000.0,,300000.0,2,25000,0.4444444444444444,0.3
587019,Fin,Stevens,2024,35,England,Brighton,Wales,10-04-03,Right-Back,Defender,Right,179.0,Unknown,Every Aspect Group,https://img.a.transfermarkt.technology/portrait/header/587019-1722842294.jpg?lm=1,L1,FuÃŸball-Club St. Pauli von 1910,600000.0,600000.0,21,113,-75,11,12,12,8,12,8,11,8,11,11,12,6,12,12,12,12,13,12,12,13,12,14,11,8,7,12,12,13,13,13,12,7,12,13,13,11,14,7,11,4,12,2,1,2,2,1,3,3,1,3,1,2,14,12,3,10,12,13,13,14,1,13,1,20,8,14,8,1,1,1,1,1,1,1,0,9,20,49551669,5650,5650,3500,Northern_European,113,0,0,20299.0,Swansea City,2000019643,600000.0,1.0,32,258,106,1,1,7,101,11,0.4978830378406986,0.3689839572192513,0.4705882352941176,0.0195923743273268,0.0,0.0,0.0027506876719179,0.0027506876719179,0.0033056473790938,0.0,0.3720930232558141,0.125,61,1,5,4,0,1338,0,0,0,600000,50000.0,600000.0,100000.0,400000.0,450000.0,4,400000,0.3333333333333333,0.3333333333333333
588020,ÃÂMer,Beyaz,2024,6890,TÃ¼rkiye,Istanbul,TÃ¼rkiye,29-08-03,Attacking Midfield,Midfield,Left,171.0,30-06-27,FutureBall,https://img.a.transfermarkt.technology/portrait/header/588020-1728310146.jpg?lm=1,TR1,?stanbul Ba?ak?ehir Futbol KulÃ¼bÃ¼,500000.0,1000000.0,21,98,-75,12,10,13,11,14,14,5,9,3,5,13,12,4,15,5,12,8,17,12,15,8,12,15,9,12,5,10,8,12,13,10,6,9,13,8,5,10,5,7,7,9,2,2,1,3,1,1,1,3,3,3,2,16,18,7,12,11,11,12,19,1,1,1,1,1,1,1,1,18,15,1,20,1,1,65,20,8,23640001,5203,5200,3500,Mediterranean_Hispanic,97,0,0,2634.0,1. FC Magdeburg,70118972,9111392.0,2.0,100,667,100,3,0,3,4,0,0.4383434771103467,0.3689839572192513,0.3529411764705882,0.0025347453232741,0.0,0.0,0.0022505626406601,0.0047511877969492,0.0505924720131114,0.1428571428571428,0.1860465116279068,0.125,70,2,1,11,0,736,3,10,21,450000,10000.0,1000000.0,200000.0,1000000.0,650000.0,5,350000,-0.3076923076923077,-0.4375
588866,Mario,Stroeykens,2024,58,Belgium,Zellik,Belgium,29-09-04,Attacking Midfield,Midfield,Right,177.0,30-06-26,CAA Stellar,https://img.a.transfermarkt.technology/portrait/header/588866-1704798060.jpg?lm=1,BE1,Royal Sporting Club Anderlecht,10000000.0,10000000.0,20,108,-85,8,10,13,12,14,8,5,9,4,4,14,7,5,14,12,9,13,12,8,12,8,11,14,6,8,5,12,12,13,11,11,8,9,16,10,10,8,6,14,13,14,2,3,3,2,2,3,1,2,2,3,3,19,14,2,12,11,11,13,14,1,1,1,1,1,1,1,1,1,1,20,16,19,15,79,10,20,24620000,5500,5500,2500,Mixed_Race,102,0,0,4999.0,Unknown,18116329,9111392.0,2.0,7,1704,8,3,1,4,175,0,0.4780365175972479,0.2620320855614972,0.3897058823529412,0.0048184301573859,0.0,0.0,0.0497624406101525,0.0497624406101525,0.0505924720131114,0.1428571428571428,0.3255813953488373,0.0833333333333332,125,15,14,10,0,2274,3,13,48,14000000,1227272.7272727273,14000000.0,500000.0,3000000.0,14000000.0,0,0,0.4,1.5454545454545454
589128,Ayase,Ueda,2024,234,Japan,"Mito, Ibaraki",Japan,28-08-98,Centre-Forward,Attack,Right,182.0,30-06-28,Sarcle Co. Ltd.,https://img.a.transfermarkt.technology/portrait/header/589128-1717664709.jpg?lm=1,NL1,Feyenoord Rotterdam,8000000.0,9000000.0,26,120,125,10,11,10,15,12,12,16,14,5,9,8,9,3,15,12,15,10,9,11,12,15,12,12,13,14,8,7,13,14,12,6,13,13,13,13,13,13,11,12,7,11,1,2,2,2,3,3,3,4,3,1,1,7,10,1,10,8,11,12,19,1,1,1,1,1,1,1,1,1,1,1,1,1,20,76,8,20,3167998,6100,6200,3200,10,124,9,0,7499.0,Unknown,45111868,4650000.0,2.0,54,958,56,0,1,0,85,3,0.5706536120666843,0.3368983957219251,0.5514705882352942,0.0072324733224089,0.0592105263157894,0.0,0.0397599399849962,0.0447611902975743,0.0258062723964554,0.1428571428571428,0.4418604651162785,0.3333333333333332,203,80,11,7,0,4038,7,36,80,8000000,496875.0,9000000.0,1000000.0,,100000.0,2,2500000,0.0,-0.1111111111111111
590302,Kiko,Bondoso,2024,2425,Portugal,Moimenta da Beira,Portugal,17-11-95,Left Winger,Attack,Right,169.0,30-06-25,LEADERBROCK,https://img.a.transfermarkt.technology/portrait/header/590302-1701335059.png?lm=1,PO1,Rio Ave Futebol Clube,600000.0,1000000.0,29,127,131,11,10,15,12,14,12,4,12,5,6,13,10,10,15,13,11,12,13,11,16,12,16,15,8,13,8,13,14,13,15,14,5,15,13,13,8,12,7,13,6,11,2,3,2,1,3,1,2,2,3,1,1,10,14,3,13,15,16,10,13,1,1,1,1,1,1,1,13,13,13,20,17,20,13,65,9,20,2177999,6350,6350,5100,Mediterranean_Hispanic,124,0,0,2350.0,Unknown,55080670,800000.0,1.0,76,962,79,0,1,3,171,7,0.590500132310135,0.5401069518716577,0.5514705882352942,0.0022605100197275,0.0,0.0,0.0027506876719179,0.0047511877969492,0.0044167893552598,0.0,0.13953488372093,0.4583333333333332,159,18,26,10,0,2561,1,5,58,800000,55555.555555555555,1000000.0,200000.0,,,2,400000,0.3333333333333333,0.0
590835,Victor,Lind,2024,865,Denmark,LÃ¸gumkloster,Denmark,12-07-03,Right Winger,Attack,Left,176.0,31-12-26,Boutique Transfers,https://img.a.transfermarkt.technology/portrait/header/590835-1629727250.jpg?lm=1,DK1,Fodbold Club Midtjylland,1500000.0,1500000.0,21,103,-75,5,9,11,12,10,5,6,9,7,6,9,9,5,10,17,9,10,12,9,8,10,11,13,7,11,4,10,14,13,13,8,8,9,13,12,9,8,8,8,2,15,4,2,1,1,1,3,2,2,4,3,2,8,7,8,12,11,7,7,8,1,1,1,1,1,1,1,14,9,13,18,14,16,20,0,20,14,6889932,5058,5103,2639,Northern_European,89,0,0,2008.0,Hamarkameratene,27156356,9111392.0,2.0,28,885,30,0,0,7,86,10,0.4255093940195819,0.2768983957219251,0.2941176470588235,0.0019302689147524,0.0,0.0,0.0072518129532383,0.0072518129532383,0.0505924720131114,0.1428571428571428,0.3023255813953489,0.125,147,53,11,11,0,4210,0,0,0,1500000,161111.11111111112,1500000.0,100000.0,1000000.0,1500000.0,4,700000,0.0,0.0
591193,Niels,Nkounkou,2024,24,France,Pontoise,France,01-11-00,Left-Back,Defender,Left,180.0,30-06-28,TTMA,https://img.a.transfermarkt.technology/portrait/header/591193-1696509000.jpg?lm=1,L1,Eintracht Frankfurt FuÃŸball AG,7500000.0,7500000.0,24,112,137,8,11,13,8,12,7,11,7,13,10,11,6,10,13,12,9,10,12,11,12,10,12,13,8,12,11,10,12,16,11,14,10,14,14,14,14,12,10,10,8,10,2,1,2,3,2,2,1,3,2,1,3,13,14,10,10,10,8,12,13,1,20,1,1,10,1,1,1,1,1,13,1,1,1,0,20,8,10798831,5595,5445,3501,African_Caribbean,109,0,0,19719.0,Cardiff City,49046391,3256666.667,3.0,34,1166,36,1,0,1,63,8,0.4707594601746494,0.369090909090909,0.4411764705882353,0.0190323163130415,0.0,0.0,0.0372593148287071,0.0372593148287071,0.0180653166310175,0.2857142857142857,0.3953488372093026,0.25,0,0,0,0,0,0,2,5,15,6000000,392857.14285714284,7500000.0,1500000.0,,3000000.0,4,3300000,-0.2,0.0
591361,Jayden,Oosterwolde,2024,36,Netherlands,Zwolle,Netherlands,26-04-01,Left-Back,Defender,Left,189.0,30-06-27,Joes Blakborn,https://img.a.transfermarkt.technology/portrait/header/591361-1728392223.JPG?lm=1,TR1,FenerbahÃ§e Spor KulÃ¼bÃ¼,15000000.0,15000000.0,23,114,144,9,13,13,7,13,7,13,9,11,10,13,4,12,14,11,12,13,11,10,12,11,15,7,6,11,11,13,13,12,12,14,13,10,14,12,14,11,9,11,10,8,4,4,3,3,4,2,2,2,1,1,1,18,15,5,10,12,10,12,14,1,20,16,1,10,1,1,5,1,1,2,1,1,1,74,20,9,3832500,5700,5950,4700,African_Caribbean,113,0,0,3999.0,Unknown,37084869,4650000.0,2.0,67,1710,68,1,0,1,84,8,0.5375760783275999,0.4973262032085561,0.4705882352941176,0.0038528128913767,0.0,0.0,0.0747686921730432,0.0747686921730432,0.0258062723964554,0.1428571428571428,0.6046511627906974,0.2083333333333332,162,11,3,32,1,7147,8,61,226,15000000,932812.5,15000000.0,500000.0,,1000000.0,2,3500000,0.15384615384615385,1.1428571428571428
591880,Mimeirhel,Benita,2024,1304,Netherlands,Spijkenisse,Netherlands,17-11-03,Right-Back,Defender,Right,173.0,30-06-25,Unknown,https://img.a.transfermarkt.technology/portrait/header/591880-1724753030.jpg?lm=1,NL1,Heracles Almelo,850000.0,850000.0,21,108,-75,8,12,11,8,12,8,6,7,7,4,14,9,7,13,12,13,10,11,9,8,15,11,13,11,12,11,14,11,13,12,10,6,7,13,11,9,13,15,15,8,15,2,3,1,4,3,3,2,3,1,3,3,16,12,5,13,11,11,13,15,1,1,1,18,1,18,1,1,1,18,1,1,20,1,0,8,20,23940001,4843,4845,2243,African_Caribbean,102,0,0,886.0,Unknown,37076172,9111392.0,2.0,67,1408,68,1,1,1,113,11,0.3913733792008468,0.2345454545454545,0.3897058823529412,0.00084684634229,0.0,0.0,0.0040010002500625,0.0040010002500625,0.0505924720131114,0.1428571428571428,0.2325581395348837,0.125,127,16,19,7,0,5442,4,21,85,1500000,155555.55555555556,1500000.0,200000.0,700000.0,1300000.0,2,650000,0.7647058823529411,2.0
591916,Aitor,Paredes,2024,621,Spain,Bilbao,Spain,29-04-00,Centre-Back,Defender,Right,185.0,30-06-29,CAA Stellar,https://img.a.transfermarkt.technology/portrait/header/591916-1709675052.png?lm=1,ES1,Athletic Club Bilbao,22000000.0,22000000.0,24,105,135,6,4,3,8,13,4,12,10,4,12,16,6,16,13,15,12,11,11,11,14,11,4,6,6,10,15,10,11,12,10,11,15,12,11,11,8,14,8,12,11,12,3,3,1,2,2,2,1,2,2,4,2,15,11,1,11,10,12,9,18,1,1,20,1,1,1,1,1,1,1,1,1,1,1,77,10,20,1624999,5250,5250,3750,Mediterranean_Hispanic,107,0,0,1922.0,Unknown,67276232,9111392.0,2.0,89,191,89,1,1,3,33,2,0.4449589838581635,0.3957219251336898,0.4264705882352941,0.0018472258298756,0.0,0.0,0.1097774443610902,0.1097774443610902,0.0505924720131114,0.1428571428571428,0.5116279069767438,0.25,137,9,1,29,0,3518,3,11,32,22000000,1453333.3333333333,22000000.0,0.0,,200000.0,1,200000,0.0,0.8333333333333334
591949,Aaron,Hickey,2024,1148,Scotland,Glasgow,Scotland,10-06-02,Right-Back,Defender,Left,185.0,30-06-26,PLG,https://img.a.transfermarkt.technology/portrait/header/591949-1684772165.jpg?lm=1,GB1,Brentford Football Club,25000000.0,30000000.0,22,132,-85,7,12,14,9,12,7,7,13,11,9,12,7,11,13,11,12,15,12,11,12,12,14,12,8,12,12,15,14,14,13,11,9,13,14,13,11,13,12,12,8,14,1,2,3,3,1,2,4,4,2,2,2,15,13,3,12,13,14,15,11,1,20,1,18,18,17,5,14,5,5,5,1,1,1,72,20,16,88444858,6600,6600,5500,Northern_European,122,4,0,40597.0,Unknown,61089387,7975000.0,2.0,82,545,83,1,0,7,43,11,0.6235776660492194,0.5828877005347594,0.536764705882353,0.0391924735927818,0.0263157894736842,0.0,0.1247811952988247,0.1497874468617154,0.0442790077502152,0.1428571428571428,0.5116279069767438,0.1666666666666666,118,6,3,27,1,2495,10,102,474,22000000,1213888.888888889,30000000.0,3000000.0,5000000.0,18000000.0,2,1900000,-0.21428571428571427,-0.26666666666666666
592387,Sebastian,Sebulonsen,2024,206,Norway,Stavanger,Norway,27-01-00,Right-Back,Defender,Right,187.0,30-06-26,Unknown,https://img.a.transfermarkt.technology/portrait/header/592387-1671206514.jpg?lm=1,DK1,BrÃ¸ndby IdrÃ¦tsforening,750000.0,1000000.0,24,114,135,7,12,10,12,10,7,10,12,12,11,12,8,10,11,10,10,12,11,11,11,10,14,8,8,11,10,12,12,12,11,13,14,15,13,12,14,9,12,11,9,17,4,1,2,1,2,3,3,3,2,1,1,10,12,4,13,11,10,9,18,1,12,5,20,8,18,14,8,15,15,11,13,15,11,0,12,20,2989534,5634,5634,2020,Northern_European,105,0,0,8066.0,Unknown,53167821,1200000.0,1.0,71,1420,73,1,1,7,45,11,0.4957660756813972,0.2106951871657754,0.411764705882353,0.0077799783122362,0.0,0.0,0.0035008752188047,0.0047511877969492,0.0066390733075918,0.0,0.5581395348837206,0.25,167,24,14,10,0,4503,2,4,22,1500000,127272.72727272728,1500000.0,400000.0,,200000.0,1,100000,1.0,1.5
593482,Azzedine,Ounahi,2024,265,Morocco,Casablanca,Morocco,19-04-00,Central Midfield,Midfield,Right,182.0,30-06-25,Unknown,https://img.a.transfermarkt.technology/portrait/header/593482-1668080946.jpg?lm=1,GR1,Panathinaikos Athlitikos Omilos,12000000.0,15000000.0,24,125,148,9,10,13,7,14,8,11,8,4,12,14,9,11,14,10,12,13,13,11,14,11,9,14,8,12,12,12,13,13,15,11,11,12,13,15,12,12,11,11,13,11,3,1,2,2,1,2,2,2,2,2,3,15,12,5,9,12,13,9,13,1,1,1,1,1,1,17,13,20,1,14,14,1,1,62,10,20,6151999,6249,6249,2505,North_African__Middle_Eastern,124,7,2,10674.0,Unknown,49052370,4035000.0,2.0,66,322,67,3,1,6,150,1,0.5771368086795449,0.262566844919786,0.5514705882352942,0.0102983081419882,0.0460526315789473,0.0263157894736842,0.0597649412353088,0.0747686921730432,0.0223895108197449,0.1428571428571428,0.4418604651162785,0.25,185,14,7,24,0,2880,3,17,82,10000000,808333.3333333334,15000000.0,3000000.0,,300000.0,3,5450000,-0.16666666666666666,-0.16666666666666666
594227,Bjorn,Meijer,2024,2282,Netherlands,Groningen,Netherlands,18-03-03,Left-Back,Defender,Left,190.0,30-06-26,Muy Manero,https://img.a.transfermarkt.technology/portrait/header/594227-1673726046.jpg?lm=1,BE1,Club Brugge Koninklijke Voetbalvereniging,6000000.0,10000000.0,21,108,-75,9,12,9,6,11,10,13,5,12,11,12,7,14,11,12,12,12,13,11,11,11,10,9,8,12,11,14,13,13,10,12,15,15,12,12,8,12,11,4,5,11,1,3,2,2,1,2,3,1,1,1,3,17,11,4,11,10,9,12,15,1,20,1,1,18,1,1,16,1,1,1,1,1,1,0,20,9,25600000,5375,5390,3740,Northern_European,105,0,0,4999.0,Unknown,37076256,6000000.0,1.0,67,565,68,1,0,7,53,8,0.4634824027520507,0.3946524064171122,0.411764705882353,0.0048184301573859,0.0,0.0,0.0297574393598399,0.0497624406101525,0.0333064807355759,0.0,0.6279069767441858,0.125,176,12,19,8,0,4239,8,65,177,6000000,522727.2727272727,10000000.0,2000000.0,750000.0,9000000.0,1,1500000,0.0,-0.3333333333333333
594991,Mohamed,Bayo,2024,1082,France,Clermont-Ferrand,Guinea,04-06-98,Centre-Forward,Attack,Right,187.0,30-06-27,Soccermax,https://img.a.transfermarkt.technology/portrait/header/594991-1625740933.jpg?lm=1,FR1,Lille Olympique Sporting Club Lille MÃ©tropole,5000000.0,12000000.0,26,126,135,8,11,12,14,11,10,13,8,9,9,12,13,7,13,10,13,13,15,13,8,13,10,12,11,13,12,9,12,12,11,14,14,14,13,13,15,13,9,11,9,10,2,2,3,3,1,3,2,1,3,2,4,11,12,8,14,10,13,12,12,1,1,1,1,1,1,1,14,1,14,15,1,17,20,76,8,20,13588501,6300,6300,3501,African_Caribbean,124,21,3,12750.0,Unknown,49038311,14000000.0,1.0,34,368,44,0,1,1,128,3,0.5838846255623181,0.369090909090909,0.5514705882352942,0.0123029295862233,0.1381578947368421,0.0394736842105263,0.0247561890472618,0.0597649412353088,0.0777521597822161,0.0,0.5581395348837206,0.3333333333333332,201,74,25,14,1,3439,2,3,18,4000000,253333.33333333334,12000000.0,2000000.0,,200000.0,5,3100000,-0.2,-0.3333333333333333
595247,Shiloh,'T Zand,2024,1304,Netherlands,Rotterdam,Netherlands,14-05-03,Central Midfield,Midfield,Right,177.0,30-06-25,Unknown,https://img.a.transfermarkt.technology/portrait/header/595247-1707398186.jpg?lm=1,NL1,Heracles Almelo,1500000.0,1500000.0,21,105,-75,12,13,13,12,15,12,8,12,10,6,11,8,6,15,14,12,10,11,10,13,11,12,12,12,11,7,12,11,10,14,12,8,15,11,13,8,12,5,14,13,14,4,3,3,2,1,3,1,1,2,1,3,10,10,4,10,11,10,13,20,1,1,1,1,12,1,10,18,17,1,20,18,1,10,0,12,20,24240000,5047,5047,3249,African_Caribbean,111,0,0,1114.0,Unknown,37082902,9111392.0,2.0,67,1253,68,3,1,1,113,1,0.418100026462027,0.342139037433155,0.4558823529411764,0.0010670070789401,0.0,0.0,0.0072518129532383,0.0072518129532383,0.0505924720131114,0.1428571428571428,0.3255813953488373,0.125,118,35,16,12,0,4302,3,17,134,1200000,300000.0,1500000.0,300000.0,,300000.0,1,300000,-0.2,3.0
595650,Nikola,Stulic,2024,172,Yugoslavia (Republic),Sremska Mitrovica,Serbia,08-09-01,Centre-Forward,Attack,Right,188.0,30-06-26,Unknown,https://img.a.transfermarkt.technology/portrait/header/595650-1705056566.jpg?lm=1,BE1,Royal Charleroi Sporting Club,500000.0,1500000.0,23,112,137,8,8,11,13,9,9,12,12,5,7,11,10,7,11,13,11,11,13,10,11,12,13,13,9,12,8,12,12,13,12,13,14,10,13,13,13,11,11,13,10,11,2,2,1,2,3,3,1,3,1,3,1,11,12,13,13,10,11,11,9,1,1,1,1,1,1,1,1,1,1,1,1,1,20,80,9,20,1063999,5338,5338,3491,Northern_European,111,0,0,953.0,Unknown,62239624,750000.0,1.0,110,1410,85,0,1,7,174,3,0.4566022757343212,0.3680213903743315,0.4558823529411764,0.0009115426991126,0.0,0.0,0.0022505626406601,0.0072518129532383,0.0041390038612183,0.0,0.581395348837209,0.2083333333333332,144,47,7,15,1,4553,1,4,33,500000,23076.923076923078,1500000.0,400000.0,200000.0,250000.0,2,350000,-0.09090909090909091,-0.23076923076923078
595809,Unknown,Beto,2024,29,Portugal,Lisboa,Guinea-Bissau,31-01-98,Centre-Forward,Attack,Right,194.0,30-06-27,PR10,https://img.a.transfermarkt.technology/portrait/header/595809-1711746870.jpg?lm=1,GB1,Everton Football Club,20000000.0,25000000.0,26,142,151,5,7,12,15,13,6,15,12,6,6,12,11,6,12,15,14,12,14,13,10,12,16,11,8,15,8,12,16,16,13,14,16,14,16,13,16,15,11,10,3,10,1,3,1,1,2,3,3,2,2,1,3,15,15,14,5,15,13,17,10,1,1,1,1,1,1,1,1,1,1,1,12,1,20,78,8,20,10878914,7100,6550,5400,Mediterranean_Hispanic,142,0,0,7307.0,Unknown,83228124,20000000.0,2.0,76,843,45,0,1,3,65,3,0.6169621593014025,0.5721925133689839,0.6838235294117647,0.0070470748073352,0.0,0.0,0.0997749437359339,0.1247811952988247,0.1110864190671963,0.1428571428571428,0.7209302325581395,0.3333333333333332,195,62,9,21,0,3217,4,15,46,20000000,1414285.7142857143,25000000.0,3000000.0,,,2,4500000,0.0,-0.09090909090909091
595935,Sem,Westerveld,2024,1090,Spain,San SebastiÃ¡n,Netherlands,18-07-02,Goalkeeper,Goalkeeper,Right,191.0,30-06-26,World Soccer Consult,https://img.a.transfermarkt.technology/portrait/header/595935-1605555774.jpg?lm=1,NL1,Alkmaar Zaanstreek,400000.0,500000.0,22,107,-75,6,1,1,2,9,9,1,1,3,2,11,3,3,7,10,11,12,9,15,9,9,10,2,13,1,15,10,9,9,12,10,15,12,11,9,7,12,12,8,13,14,15,10,10,5,13,9,12,12,11,13,13,11,12,3,11,12,12,10,14,20,1,1,1,1,1,1,1,1,1,1,1,1,1,0,8,20,25440000,5250,5250,2768,Northern_European,102,0,0,1373.0,Unknown,37079077,9111392.0,2.0,89,1308,68,2,1,7,16,5,0.4449589838581635,0.2906951871657753,0.3897058823529412,0.0013171019508365,0.0,0.0,0.0017504376094023,0.0022505626406601,0.0505924720131114,0.1428571428571428,0.6511627906976742,0.1666666666666666,0,0,0,0,0,0,3,105,289,250000,20454.545454545456,500000.0,150000.0,25000.0,500000.0,1,0,-0.375,-0.5
595940,Zico,Buurmeester,2024,1090,Netherlands,Egmond aan den Hoef,Netherlands,07-06-02,Central Midfield,Midfield,Right,184.0,30-06-26,Joes Blakborn,https://img.a.transfermarkt.technology/portrait/header/595940-1723819805.jpg?lm=1,NL1,Alkmaar Zaanstreek,700000.0,700000.0,22,105,-75,5,8,10,7,13,10,6,11,4,7,13,9,6,13,5,12,6,13,11,14,14,12,12,6,13,7,12,9,9,12,13,10,12,10,12,10,12,5,9,6,11,2,4,1,2,3,3,3,2,1,3,2,8,11,6,9,10,11,9,20,1,1,1,1,1,1,18,1,20,1,1,16,1,1,65,14,20,64500000,5145,5145,2845,Northern_European,101,0,0,1242.0,Unknown,37079086,9111392.0,2.0,67,447,68,3,1,7,16,1,0.431066419687748,0.2989304812834224,0.3823529411764706,0.0011906060889893,0.0,0.0,0.0032508127031757,0.0032508127031757,0.0505924720131114,0.1428571428571428,0.4883720930232553,0.1666666666666666,176,20,17,7,1,3839,2,20,118,1200000,90384.61538461539,1200000.0,0.0,50000.0,550000.0,3,650000,0.7142857142857143,0.7142857142857143
596067,Unknown,Felippe Cardoso,2024,3725,Brazil,SÃ£o Paulo,Brazil,04-10-98,Centre-Forward,Attack,Right,186.0,30-06-28,firsteleven ISM,https://img.a.transfermarkt.technology/portrait/header/596067-1722258336.png?lm=1,RU1,RFK Akhmat Grozny,1000000.0,1000000.0,26,115,138,7,11,11,14,10,10,14,11,7,7,11,13,7,12,8,12,10,12,11,10,11,3,11,12,13,6,13,13,13,13,10,14,7,13,11,11,10,8,10,13,8,2,3,3,2,3,3,3,2,3,1,3,15,10,5,9,12,11,11,10,1,1,1,1,1,1,1,1,1,1,1,1,16,20,0,10,20,1352935,5750,5750,2500,Mixed_Race,114,0,0,3796.0,Sendai Lumiere FC,19341470,1500000.0,1.0,10,1456,11,0,1,4,157,3,0.5111140513363324,0.2620320855614972,0.4779411764705882,0.0036567925863768,0.0,0.0,0.0047511877969492,0.0047511877969492,0.0083057862718408,0.0,0.5348837209302322,0.3333333333333332,186,27,7,29,0,6201,2,16,61,900000,53333.333333333336,1000000.0,150000.0,,900000.0,6,1300000,0.125,1.25
596122,Pep,Chavarría,2024,367,Spain,Figueres,Spain,10-04-98,Left-Back,Defender,Left,174.0,30-06-27,Promoesport,https://img.a.transfermarkt.technology/portrait/header/596122-1659947697.jpg?lm=1,ES1,Rayo Vallecano de Madrid S.A.D.,2000000.0,2000000.0,26,126,136,11,13,13,5,13,8,8,7,9,12,12,7,13,13,12,10,13,13,11,11,13,6,9,10,13,11,13,13,15,15,12,11,14,15,14,9,13,8,11,7,10,3,2,3,2,3,2,1,2,2,3,3,12,13,7,11,11,13,12,12,1,20,1,1,18,1,1,17,1,1,10,1,1,1,72,20,7,2220334,6300,6300,4300,Mediterranean_Hispanic,121,0,0,7258.0,Unknown,67277695,1800000.0,1.0,89,491,89,1,0,3,163,8,0.5838846255623181,0.4545454545454545,0.5294117647058822,0.0069997595613007,0.0,0.0,0.0097524381095273,0.0097524381095273,0.0099724992360898,0.0,0.2558139534883721,0.3333333333333332,193,5,9,28,0,1366,1,2,10,2000000,114705.88235294117,2000000.0,500000.0,,100000.0,2,250000,0.0,1.0
596148,Djevencio,Van Der Kust,2024,468,Unknown,Unknown,Suriname,30-04-01,Left-Back,Defender,Left,178.0,30-06-26,HOA,https://img.a.transfermarkt.technology/portrait/header/596148-1723809755.jpg?lm=1,NL1,Sparta Rotterdam,1200000.0,1200000.0,23,117,137,7,8,11,7,11,10,8,7,12,12,10,9,13,12,15,12,15,10,11,12,10,12,11,7,11,13,12,14,14,14,14,8,15,14,14,10,12,11,4,9,14,3,3,1,1,2,3,3,3,4,1,3,11,10,6,10,14,10,10,15,1,20,1,12,19,12,13,14,10,1,6,1,1,1,0,20,8,6100000,5548,5548,3348,African_Caribbean,112,0,0,1816.0,Unknown,37071555,9111392.0,2.0,105,1549,90,1,0,1,187,8,0.4843874040751521,0.3527272727272726,0.463235294117647,0.0017448703996786,0.0,0.0,0.0057514378594648,0.0057514378594648,0.0505924720131114,0.1428571428571428,0.3488372093023257,0.2083333333333332,184,9,10,19,1,5344,0,0,0,750000,55769.230769230766,1200000.0,450000.0,,225000.0,1,350000,-0.375,-0.375
596446,Leif,Davis,2024,677,England,Newcastle,England,31-12-99,Left-Back,Defender,Left,182.0,30-06-25,Unknown,https://img.a.transfermarkt.technology/portrait/header/596446-1551183762.jpg?lm=1,GB1,Ipswich Town Football Club,15000000.0,15000000.0,24,118,136,10,12,13,6,12,11,10,6,9,11,12,6,13,11,9,12,13,11,12,11,12,12,10,5,12,13,14,14,13,13,12,8,13,14,15,10,10,5,10,5,13,1,1,1,2,2,1,2,3,3,3,3,14,9,6,12,12,12,12,10,1,20,15,1,13,1,1,12,1,1,11,1,1,1,55,20,10,3948359,5900,5900,3750,Northern_European,118,0,0,10439.0,Unknown,29175587,1200000.0,1.0,32,1036,33,1,0,7,115,8,0.530960571579783,0.3957219251336898,0.5073529411764706,0.010071388084476,0.0,0.0,0.0747686921730432,0.0747686921730432,0.0066390733075918,0.0,0.4418604651162785,0.25,157,6,40,15,0,2468,2,2,6,25000000,1556250.0,25000000.0,0.0,,400000.0,2,200000,1.7777777777777777,5.25
596884,Adrián,Butzke,2024,982,Spain,Monachil,Spain,30-03-99,Centre-Forward,Attack,Right,193.0,30-06-25,RGFOOTBALL,https://img.a.transfermarkt.technology/portrait/header/596884-1695207122.jpg?lm=1,PO1,Clube Desportivo Nacional,300000.0,400000.0,25,113,135,7,9,10,13,9,8,14,10,6,5,12,7,7,11,12,13,11,12,12,13,13,14,9,8,13,7,12,10,12,11,13,16,15,14,13,14,11,9,12,5,9,2,3,2,3,1,1,2,3,2,1,2,20,11,2,11,13,11,12,16,1,1,1,1,1,1,1,1,1,1,1,10,1,20,85,8,20,1339642,5647,5747,3647,Mediterranean_Hispanic,113,0,0,3153.0,Futebol Clube PaÃ§os de Ferreira,67277762,300000.0,1.0,89,967,89,0,1,3,56,3,0.5107171209314634,0.3847058823529411,0.4705882352941176,0.0030359006843329,0.0,0.0,0.0012503125781445,0.0017504376094023,0.0016389344148448,0.0,0.6976744186046511,0.2916666666666665,134,18,3,19,0,3595,0,0,0,300000,19230.76923076923,400000.0,100000.0,,50000.0,5,200000,0.0,-0.25
597087,Unknown,Lucas Áfrico,2024,4294,Brazil,SÃ£o Paulo,Brazil,05-02-95,Centre-Back,Defender,Left,188.0,30-06-26,Unknown,https://img.a.transfermarkt.technology/portrait/header/597087-1713408876.png?lm=1,PO1,Sporting Clube Farense,300000.0,500000.0,29,126,130,7,7,10,8,11,10,11,9,9,15,11,10,12,11,16,14,16,12,8,11,11,15,8,12,8,15,14,14,12,12,14,15,8,12,12,15,11,15,9,8,10,1,2,2,2,3,3,3,1,2,3,2,13,14,9,11,11,15,11,7,1,12,20,1,1,1,1,1,1,1,1,1,1,1,80,20,8,917998,6300,5534,4326,Mixed_Race,124,0,0,2500.0,Unknown,19191033,9111392.0,2.0,10,1456,11,1,0,4,191,2,0.4825350621857635,0.4573262032085561,0.5514705882352942,0.0024053526096289,0.0,0.0,0.0012503125781445,0.0022505626406601,0.0505924720131114,0.1428571428571428,0.581395348837209,0.4583333333333332,142,4,2,26,4,3300,2,44,300,500000,6250.0,500000.0,100000.0,,,5,375000,0.6666666666666666,0.25
597432,Leopold,Querfeld,2024,89,Austria,Wien,Austria,20-12-03,Centre-Back,Defender,Right,190.0,Unknown,ROGON,https://img.a.transfermarkt.technology/portrait/header/597432-1726351317.jpg?lm=1,L1,1. FC Union Berlin,5000000.0,5000000.0,21,114,-8,5,5,8,6,11,9,10,13,7,10,10,12,11,12,9,12,13,11,12,11,11,16,5,6,8,15,13,14,13,10,15,16,14,13,14,13,11,7,6,10,14,3,4,3,3,2,1,3,4,1,3,2,19,17,1,10,12,12,11,16,1,1,20,1,1,1,17,1,1,1,1,1,1,1,83,9,20,12895999,5680,5680,3780,Northern_European,112,0,0,500.0,Unknown,16337125,3000000.0,1.0,6,1663,7,1,1,7,0,2,0.5018523418893888,0.3989304812834224,0.463235294117647,0.0004741180776105,0.0,0.0,0.0247561890472618,0.0247561890472618,0.0166393510930859,0.0,0.6279069767441858,0.125,141,8,1,32,1,3215,3,17,76,5000000,400000.0,5000000.0,0.0,900000.0,5000000.0,2,50000,0.0,0.42857142857142855
597659,Charlie,Cresswell,2024,415,England,Preston,England,17-08-02,Centre-Back,Defender,Right,190.0,30-06-28,Unknown,https://img.a.transfermarkt.technology/portrait/header/597659-1641461698.jpg?lm=1,FR1,Toulouse Football Club,4000000.0,5000000.0,22,118,-8,2,5,11,8,10,2,13,4,6,12,11,4,12,12,14,12,15,13,12,9,11,13,9,12,7,13,11,13,12,11,13,15,13,13,13,16,10,12,11,4,12,2,1,3,1,3,2,3,3,3,3,1,15,12,4,10,14,14,12,13,1,1,20,1,1,1,1,1,1,1,1,1,1,1,0,11,20,37692674,5894,5894,3747,Northern_European,117,0,0,5800.0,Millwall,29217875,4500000.0,1.0,32,1183,33,1,1,7,203,2,0.530166710770045,0.3954010695187165,0.4999999999999999,0.0055918895874593,0.0,0.0,0.0197549387346836,0.0247561890472618,0.0249729159143309,0.0,0.6279069767441858,0.1666666666666666,110,11,3,14,0,2698,2,14,63,5000000,533333.3333333334,5000000.0,1000000.0,200000.0,5000000.0,4,3800000,0.25,0.25
597880,Dmytro,Riznyk,2024,660,Ukraine,Poltava,Ukraine,30-01-99,Goalkeeper,Goalkeeper,Right,191.0,31-12-27,ProStar,https://img.a.transfermarkt.technology/portrait/header/597880-1723486284.png?lm=1,UKR1,FC Shakhtar Donetsk,7000000.0,7000000.0,25,121,140,3,1,1,3,11,7,3,2,2,2,14,1,3,13,7,14,10,14,14,11,13,11,1,12,3,16,12,9,14,14,12,17,8,14,4,8,16,7,8,10,10,12,11,11,10,12,9,11,15,8,9,7,15,11,3,13,10,13,12,10,20,1,1,1,1,1,1,1,1,1,1,1,1,1,85,7,20,4467052,5728,5728,3483,Northern_European,121,2,0,4538.0,Unknown,71100666,3000000.0,1.0,103,1162,101,2,1,7,72,5,0.5082032283672929,0.3671657754010695,0.5294117647058822,0.0043732805977557,0.0131578947368421,0.0,0.0347586896724181,0.0347586896724181,0.0166393510930859,0.0,0.6511627906976742,0.2916666666666665,0,0,0,0,0,0,2,19,129,7000000,463333.3333333333,7000000.0,500000.0,,100000.0,2,550000,0.0,0.4
598577,Florian,Wirtz,2024,15,Germany,Pulheim,Germany,03-05-03,Attacking Midfield,Midfield,Right,177.0,30-06-27,Unknown,https://img.a.transfermarkt.technology/portrait/header/598577-1689710503.jpg?lm=1,L1,Bayer 04 Leverkusen FuÃŸball,130000000.0,130000000.0,21,143,-9,12,11,15,13,15,11,7,13,5,7,15,11,10,16,13,14,13,14,12,15,13,15,15,8,14,8,14,16,14,15,12,8,13,13,14,8,14,6,15,14,12,3,1,3,2,4,2,3,1,2,3,2,10,14,7,13,15,13,12,12,1,1,1,1,1,1,1,12,16,12,13,20,13,10,72,12,20,120096006,7250,7250,6250,Northern_European,143,4,0,86300.0,Unknown,91193048,200000.0,1.0,38,1193,40,3,1,7,36,0,0.7095792537708389,0.6631016042780749,0.6911764705882353,0.0833240795012007,0.0263157894736842,0.0,0.6499124781195299,0.6499124781195299,0.0010833634267618,0.0,0.3255813953488373,0.125,215,70,68,25,0,6562,17,74,266,140000000,9285714.285714285,140000000.0,0.0,70000000.0,110000000.0,0,0,0.07692307692307693,0.4
599203,Denis,Makarov,2024,121,Russia,Orenburg,Russia,18-02-98,Right Winger,Attack,Left,183.0,30-06-26,Unknown,https://img.a.transfermarkt.technology/portrait/header/599203-1721728027.png?lm=1,RU1,FK Dinamo Moskva,2000000.0,7000000.0,26,121,133,11,9,13,12,10,12,9,15,7,7,9,13,8,11,14,13,15,11,9,10,10,18,13,12,15,10,12,15,15,12,11,9,14,15,11,10,10,12,14,5,7,2,2,3,2,1,1,1,3,3,1,3,18,10,1,13,13,16,9,17,1,1,1,1,1,1,6,11,1,16,13,1,20,1,75,20,12,7147556,5900,5900,3409,Northern_European,118,0,0,27031.0,Unknown,58137149,2738000.0,3.0,78,1091,81,0,0,7,74,10,0.530960571579783,0.3592513368983956,0.5073529411764706,0.0260929097621008,0.0,0.0,0.0097524381095273,0.0347586896724181,0.0151837551043084,0.2857142857142857,0.4651162790697669,0.3333333333333332,220,57,19,52,1,3119,1,2,20,1800000,76190.47619047618,7000000.0,1000000.0,,250000.0,2,1075000,-0.28,-0.4
599231,Ferran,Jutglà,2024,2282,Spain,Sant JuliÃ  de Vilatorta,Spain,01-02-99,Centre-Forward,Attack,Right,175.0,30-06-26,YOU FIRST,https://img.a.transfermarkt.technology/portrait/header/599231-1666292299.jpg?lm=1,BE1,Club Brugge Koninklijke Voetbalvereniging,6000000.0,14000000.0,25,132,140,10,12,12,15,14,9,12,12,8,9,13,16,9,13,14,12,16,12,11,10,13,15,14,12,16,10,12,16,14,15,13,10,14,14,12,12,12,5,12,12,15,1,1,2,1,1,1,3,2,2,4,1,12,15,5,9,15,14,16,12,1,1,1,1,1,1,1,1,1,1,16,10,16,20,75,8,20,8905500,6493,6493,4493,Mediterranean_Hispanic,132,0,0,12499.0,Unknown,67272136,5000000.0,1.0,89,1321,89,0,1,3,53,3,0.6094204816088913,0.475187165775401,0.6102941176470589,0.012060559652455,0.0,0.0,0.0297574393598399,0.0697674418604651,0.0277507708547459,0.0,0.2790697674418605,0.2916666666666665,228,65,28,19,0,5307,4,17,107,5000000,275000.0,14000000.0,3000000.0,,50000.0,2,4150000,-0.3333333333333333,-0.23076923076923078
599879,Unknown,Marrony,2024,865,Brazil,Volta Redonda,Brazil,05-02-99,Right Winger,Attack,Left,186.0,30-06-26,VSR Assessoria,https://img.a.transfermarkt.technology/portrait/header/599879-1558040531.jpg?lm=1,DK1,Fodbold Club Midtjylland,1000000.0,4000000.0,25,126,134,8,9,13,12,10,8,13,11,6,6,10,12,5,13,11,11,11,11,8,11,9,13,15,9,11,6,13,13,13,13,12,14,15,13,15,11,10,10,9,11,12,3,2,2,2,2,4,1,3,2,2,2,8,13,12,12,11,12,11,10,1,1,1,1,1,1,1,12,1,12,17,9,18,20,75,20,18,4511506,6326,6326,3292,Mixed_Race,119,0,0,10082.0,FLU,19350830,3975000.0,2.0,10,1629,11,0,0,4,86,10,0.5873246890711828,0.3467379679144384,0.5147058823529411,0.0097266627205107,0.0,0.0,0.0047511877969492,0.0197549387346836,0.0220561682268951,0.1428571428571428,0.5348837209302322,0.2916666666666665,184,23,11,19,1,5630,2,57,412,1000000,5555.555555555556,4000000.0,1500000.0,,4000000.0,4,200000,0.0,-0.16666666666666666
601577,André,Anderson,2024,398,Brazil,Maracai,Italy,23-09-99,Attacking Midfield,Midfield,Right,180.0,30-06-25,Bertolucci Sports,https://img.a.transfermarkt.technology/portrait/header/601577-1557500332.jpg?lm=1,IT1,SocietÃ  Sportiva Lazio S.p.A.,400000.0,2000000.0,25,121,150,9,10,14,14,14,8,12,13,3,5,13,12,11,16,14,13,13,12,11,12,12,14,15,9,14,8,12,13,13,14,13,11,15,13,13,12,13,11,12,7,16,2,1,2,1,2,2,2,3,3,2,1,20,13,2,10,12,16,12,20,1,1,1,1,1,1,1,10,20,10,12,20,12,15,78,6,20,6995000,6010,6010,3727,Mediterranean_Hispanic,118,0,0,17787.0,SPO,19275421,9111392.0,2.0,10,910,54,3,1,3,185,0,0.5455146864249801,0.3932620320855614,0.5073529411764706,0.0171667437551117,0.0,0.0,0.0017504376094023,0.0097524381095273,0.0505924720131114,0.1428571428571428,0.3953488372093026,0.2916666666666665,73,8,4,15,0,2584,7,65,177,200000,8823.529411764706,2000000.0,500000.0,50000.0,800000.0,6,950000,-0.5,-0.75
601883,Matheus,Nunes,2024,281,Brazil,Rio de Janeiro,Portugal,27-08-98,Central Midfield,Midfield,Right,183.0,30-06-28,Gestifute,https://img.a.transfermarkt.technology/portrait/header/601883-1693561106.jpg?lm=1,GB1,Manchester City Football Club,40000000.0,55000000.0,26,150,162,13,13,15,12,14,11,10,14,8,9,14,11,11,15,15,13,16,13,17,14,13,15,15,8,14,14,16,16,14,13,13,12,17,14,16,14,15,13,17,3,14,1,1,3,1,2,2,2,3,1,2,1,14,16,5,13,17,18,13,15,1,1,1,1,1,1,14,5,20,13,10,16,13,1,78,12,20,85427913,7500,7500,6500,Mediterranean_Hispanic,149,8,1,115992.0,Unknown,83188780,36783333.33,3.0,10,1234,79,3,1,3,131,1,0.7426567875099233,0.6898395721925134,0.7352941176470587,0.1119951873635462,0.0526315789473684,0.0131578947368421,0.1997999499874969,0.274818704676169,0.2043297498819411,0.2857142857142857,0.4651162790697669,0.3333333333333332,0,0,0,0,0,0,3,6,13,40000000,2312500.0,55000000.0,10000000.0,,,2,20000000,-0.2,-0.2727272727272727
602105,Unknown,Antony,2024,985,Brazil,SÃ£o Paulo,Brazil,24-02-00,Right Winger,Attack,Left,172.0,30-06-27,4ComM,https://img.a.transfermarkt.technology/portrait/header/602105-1680698738.jpg?lm=1,GB1,Manchester United Football Club,20000000.0,75000000.0,24,148,165,11,14,16,12,16,12,12,13,10,6,14,11,5,16,12,13,15,14,12,13,12,14,16,9,14,6,12,12,15,16,13,7,15,14,13,11,11,15,10,7,11,3,3,1,1,3,2,1,1,1,1,3,15,15,8,12,13,12,5,9,1,1,1,1,1,1,1,10,10,18,14,15,20,15,63,20,10,132630741,7600,7250,5500,Mediterranean_Hispanic,143,9,2,173988.0,Unknown,19338230,55375000.0,2.0,10,1456,11,0,0,3,132,10,0.7095792537708389,0.5828877005347594,0.6911764705882353,0.1679971263230163,0.0592105263157894,0.0263157894736842,0.0997749437359339,0.3748437109277319,0.3076196561015583,0.1428571428571428,0.2093023255813952,0.25,234,45,34,28,0,6362,7,26,115,20000000,750000.0,75000000.0,15000000.0,5000000.0,25000000.0,2,40000000,-0.2,-0.42857142857142855
602124,Alessandro,Bianco,2024,2919,Italy,Torino,Italy,01-10-02,Central Midfield,Midfield,Right,173.0,30-06-25,Giuseppe Galli,https://img.a.transfermarkt.technology/portrait/header/602124-1725528350.jpg?lm=1,IT1,Associazione Calcio Monza,2500000.0,2500000.0,22,88,-75,8,8,10,7,11,8,7,7,6,7,12,8,7,10,9,12,12,8,13,12,12,10,8,9,10,11,12,13,13,12,9,8,11,12,12,10,12,8,11,9,12,4,2,1,1,2,4,2,1,1,2,2,12,11,9,12,13,11,12,10,1,1,1,1,1,1,16,1,20,1,1,1,1,1,0,7,20,11729999,4398,3998,364,Mediterranean_Hispanic,89,0,0,1027.0,Unknown,43458331,40000.0,1.0,52,1504,54,3,1,3,28,1,0.2793066948928288,0.0335828877005347,0.2941176470588235,0.0009829983767973,0.0,0.0,0.0122530632658164,0.0122530632658164,0.000194449845829,0.0,0.2325581395348837,0.1666666666666666,189,12,16,51,2,2200,1,1,3,5000000,487500.0,5000000.0,0.0,125000.0,800000.0,2,2900000,1.0,2.3333333333333335
603940,Marvin,Park,2024,472,Spain,Palma de Mallorca,Spain,03-07-00,Right-Back,Defender,Right,177.0,30-06-28,CAA Base Ltd,https://img.a.transfermarkt.technology/portrait/header/603940-1718888602.jpg?lm=1,ES1,UniÃ³n Deportiva Las Palmas S.A.D.,2000000.0,2000000.0,24,117,145,10,11,14,11,10,11,4,9,9,3,12,8,7,12,9,9,10,9,8,12,9,10,12,2,8,5,9,11,16,14,10,8,14,15,12,8,9,7,16,12,20,3,3,2,3,3,2,2,1,1,3,1,11,11,3,8,10,11,11,12,1,1,1,14,12,14,1,13,1,18,14,12,20,13,63,14,20,122983,5850,5850,3350,Mixed_Race,109,0,0,3898.0,Las Palmas,67277459,2000000.0,1.0,89,1112,89,1,1,4,207,11,0.5243450648319662,0.3529411764705882,0.4411764705882353,0.0037552855475098,0.0,0.0,0.0097524381095273,0.0097524381095273,0.0110836412122558,0.0,0.3255813953488373,0.25,146,7,11,27,0,3181,0,0,0,2000000,146153.84615384616,2000000.0,0.0,,500000.0,1,0,0.0,1.0
604327,Gabriel,Vidovic,2024,39,Germany,Augsburg,Croatia,01-12-03,Left Winger,Attack,Right,180.0,30-06-25,Unknown,https://img.a.transfermarkt.technology/portrait/header/604327-1693303272.jpg?lm=1,L1,1. FuÃŸball- und Sportverein Mainz 05,3500000.0,3500000.0,21,118,-85,13,9,14,13,14,13,7,13,2,8,13,13,9,15,9,11,9,12,9,13,10,15,17,7,13,8,11,12,12,13,11,8,14,13,12,8,15,3,12,6,13,2,2,2,2,4,2,3,1,4,3,1,14,16,4,14,13,15,14,12,1,1,1,1,1,1,1,10,15,10,15,18,12,20,71,12,20,53600001,5900,5125,4062,Northern_European,108,0,0,28766.0,Vitesse,2000065728,9111392.0,2.0,38,108,25,0,1,7,1,7,0.4284202169886213,0.429090909090909,0.4338235294117646,0.0277682557186268,0.0,0.0,0.0172543135783946,0.0172543135783946,0.0505924720131114,0.1428571428571428,0.3953488372093026,0.125,125,38,16,8,0,1973,2,10,66,3000000,311111.1111111111,3500000.0,500000.0,3000000.0,3500000.0,3,500000,-0.14285714285714285,0.2
605110,Eyüp,Ayd?N,2024,141,Germany,Heidenheim,Germany,02-08-04,Central Midfield,Midfield,Left,181.0,30-06-26,M-Soccermanagement,https://img.a.transfermarkt.technology/portrait/header/605110-1692858797.png?lm=1,TR1,Galatasaray Spor KulÃ¼bÃ¼,1100000.0,1300000.0,20,105,-8,14,10,11,7,13,14,7,12,4,11,14,7,13,14,14,11,12,13,11,14,10,16,13,10,8,12,12,12,11,11,12,9,13,11,13,8,15,7,12,8,10,2,2,2,3,2,3,1,1,3,3,1,12,14,8,14,14,12,14,12,1,1,1,1,1,1,20,1,18,1,1,10,1,1,72,20,8,32199999,5247,5247,3283,North_African__Middle_Eastern,104,0,0,4794.0,Unknown,2000111718,250000.0,1.0,38,606,40,3,0,6,102,1,0.4445620534532946,0.3457754010695186,0.4044117647058823,0.004620478617854,0.0,0.0,0.005251312828207,0.0062515628907226,0.0013611489208033,0.0,0.418604651162791,0.0833333333333332,77,5,12,14,0,849,3,14,104,1000000,18181.81818181818,1300000.0,200000.0,800000.0,1000000.0,1,0,-0.23076923076923078,0.3333333333333333
605184,Jean-Clair,Todibo,2024,379,French Guiana,Cayenne,France,30-12-99,Centre-Back,Defender,Right,190.0,30-06-25,Unknown,https://img.a.transfermarkt.technology/portrait/header/605184-1699439806.jpg?lm=1,GB1,West Ham United Football Club,35000000.0,35000000.0,24,140,162,3,5,14,8,13,4,14,8,7,15,14,5,16,14,14,14,14,15,11,13,12,16,14,9,8,12,14,12,13,14,13,16,16,16,13,15,16,8,16,8,12,1,2,1,2,1,1,2,2,1,3,1,14,15,10,14,16,15,13,12,1,1,20,1,1,1,1,1,1,1,1,1,1,1,88,10,20,48974267,6750,6750,5000,Mixed_Race,139,0,0,24051.0,Unknown,48044499,4750000.0,2.0,35,338,36,1,1,4,220,2,0.6434241862926701,0.5294117647058822,0.6617647058823528,0.0232153703093934,0.0,0.0,0.1747936984246061,0.1747936984246061,0.0263618433845384,0.1428571428571428,0.6279069767441858,0.25,180,3,4,27,3,4694,12,55,93,32000000,1666666.6666666667,35000000.0,3000000.0,8000000.0,14000000.0,6,11000000,-0.08571428571428572,-0.08571428571428572
606718,Unknown,Toti,2024,543,Guinea-Bissau,Bissau,Portugal,16-01-99,Centre-Back,Defender,Left,187.0,30-06-29,Element Twelve,https://img.a.transfermarkt.technology/portrait/header/606718-1630733935.jpg?lm=1,GB1,Wolverhampton Wanderers Football Club,20000000.0,20000000.0,25,122,138,10,10,10,6,9,10,13,4,10,13,11,5,14,11,13,12,13,12,9,10,12,12,5,8,10,14,14,12,12,11,13,14,14,12,14,15,11,10,10,5,10,3,2,3,2,1,2,1,1,1,1,2,19,13,5,11,13,14,13,13,1,15,20,1,13,1,1,1,1,1,1,1,1,1,83,20,12,7455404,6100,6100,3500,African_Caribbean,121,0,0,9279.0,Unknown,83228401,789000.0,1.0,44,202,79,1,0,1,222,2,0.5574225985710506,0.3689839572192513,0.5294117647058822,0.0089512720559053,0.0,0.0,0.0997749437359339,0.0997749437359339,0.0043556765465707,0.0,0.5581395348837206,0.2916666666666665,153,7,4,28,1,3648,1,4,23,20000000,1790909.0909090908,20000000.0,0.0,,,1,500000,0.0,0.42857142857142855
606752,Rodrigo,Zalazar,2024,1075,Spain,Albacete,Uruguay,12-08-99,Central Midfield,Midfield,Right,178.0,30-06-28,Unknown,https://img.a.transfermarkt.technology/portrait/header/606752-1657108824.jpg?lm=1,PO1,Sporting Clube de Braga,16000000.0,16000000.0,25,127,149,13,11,15,12,13,12,8,15,4,11,13,12,12,15,16,12,15,13,12,13,12,17,16,7,13,12,12,17,13,14,12,8,15,14,13,11,13,10,16,5,14,3,1,3,1,2,1,1,3,1,3,3,14,13,10,12,12,12,9,9,1,1,1,1,1,1,12,12,20,12,15,16,15,8,72,8,20,2700000,6399,5643,4966,Mediterranean_Hispanic,129,0,0,25889.0,Unknown,67271371,3250000.0,2.0,89,35,103,3,1,3,192,1,0.4969568668960042,0.5257754010695187,0.588235294117647,0.0249901748443183,0.0,0.0,0.0797699424856214,0.0797699424856214,0.0180282785632934,0.1428571428571428,0.3488372093023257,0.2916666666666665,179,32,41,27,1,3767,7,36,107,16000000,839473.6842105263,16000000.0,0.0,,250000.0,5,2950000,0.3333333333333333,1.6666666666666667
607223,Rayan,Cherki,2024,1041,France,Lyon,France,17-08-03,Attacking Midfield,Midfield,Right,177.0,30-06-26,Unknown,https://img.a.transfermarkt.technology/portrait/header/607223-1672831487.jpg?lm=1,FR1,Olympique Lyonnais,20000000.0,30000000.0,21,118,-9,12,10,16,12,15,13,4,9,3,3,11,9,3,16,6,8,8,13,7,12,9,13,16,8,11,5,8,7,13,14,11,7,12,13,8,12,10,6,4,7,16,2,3,1,2,1,3,1,3,1,2,2,15,14,6,14,11,12,11,14,1,1,1,1,1,1,1,12,12,1,19,20,17,15,71,18,20,51999675,6099,5899,3899,North_African__Middle_Eastern,108,0,0,34520.0,Unknown,49056279,9111392.0,2.0,34,884,36,3,1,6,143,0,0.5308282614448266,0.4116577540106951,0.4338235294117646,0.0333244174672438,0.0,0.0,0.0997749437359339,0.1497874468617154,0.0505924720131114,0.1428571428571428,0.3255813953488373,0.125,196,34,39,13,1,5435,2,20,90,30000000,1466666.6666666667,30000000.0,5000000.0,18000000.0,25000000.0,1,12000000,0.2,0.2
607226,Loum,Tchaouna,2024,398,Chad,N'Djamena,France,08-09-03,Right Winger,Attack,Left,180.0,30-06-29,BS Group - BS Law,https://img.a.transfermarkt.technology/portrait/header/607226-1695710683.jpg?lm=1,IT1,SocietÃ  Sportiva Lazio S.p.A.,8000000.0,8000000.0,21,96,-75,8,13,13,13,13,7,9,8,7,6,12,7,8,8,6,7,9,7,8,9,11,8,9,10,11,7,8,9,13,13,6,9,13,13,8,6,9,8,11,10,9,2,1,3,2,1,3,3,1,1,1,3,20,11,4,11,10,13,13,12,1,1,1,1,1,1,1,1,1,1,1,1,20,15,0,20,8,18720000,4797,4797,1747,African_Caribbean,84,0,0,948.0,Dijon FCO,2000006108,6500000.0,2.0,18,1008,36,0,0,1,185,10,0.3850224927229426,0.1814973262032085,0.2573529411764706,0.0009067146127826,0.0,0.0,0.0397599399849962,0.0397599399849962,0.0360843356759909,0.1428571428571428,0.3953488372093026,0.125,124,20,12,10,0,3026,1,1,12,10000000,881818.1818181818,10000000.0,200000.0,2000000.0,8000000.0,3,2600000,0.25,2.3333333333333335
608172,Ardon,Jashari,2024,2282,Switzerland,Cham,Switzerland,30-07-02,Defensive Midfield,Midfield,Left,181.0,30-06-28,Unknown,https://img.a.transfermarkt.technology/portrait/header/608172-1715938631.jpg?lm=1,BE1,Club Brugge Koninklijke Voetbalvereniging,6000000.0,7500000.0,22,121,-8,11,10,13,11,13,10,5,12,4,9,14,9,10,13,13,11,8,13,13,13,13,16,14,14,12,10,14,14,12,12,15,8,13,11,14,16,13,7,12,4,12,1,1,2,1,1,1,2,3,2,3,3,15,15,4,13,14,13,12,14,1,1,1,1,1,1,20,1,18,1,1,8,1,1,82,20,9,6037699,6016,6416,4228,Northern_European,118,0,0,7012.0,Unknown,84161856,6000000.0,1.0,92,344,92,3,0,7,53,4,0.5992326012172533,0.4468449197860962,0.5073529411764706,0.0067622177138624,0.0,0.0,0.0297574393598399,0.0372593148287071,0.0333064807355759,0.0,0.418604651162791,0.1666666666666666,198,29,15,28,0,3714,4,4,11,11000000,844230.7692307692,11000000.0,1000000.0,100000.0,7500000.0,2,5600000,0.8333333333333334,0.6923076923076923
608469,Adolfo,Gaich,2024,589,Argentina,CÃ³rdoba,Argentina,26-02-99,Centre-Forward,Attack,Right,190.0,30-06-25,Unknown,https://img.a.transfermarkt.technology/portrait/header/608469-1726736444.jpg?lm=1,TR1,Antalyaspor,1600000.0,12000000.0,25,122,134,4,7,12,14,14,7,14,9,5,7,11,12,6,13,13,13,13,12,8,12,10,9,10,10,14,9,15,15,10,10,14,14,15,12,15,15,12,13,12,6,10,2,3,1,3,3,1,2,3,2,2,4,8,11,7,10,10,13,13,7,1,1,1,1,1,1,1,1,1,1,1,1,1,20,94,10,20,7079958,6150,6250,4600,Mediterranean_Hispanic,119,1,0,21095.0,Unknown,14151843,8500000.0,1.0,4,400,4,0,1,3,19,3,0.5772691188145012,0.4866310160427807,0.5147058823529411,0.0203610056710702,0.006578947368421,0.0,0.0077519379844961,0.0597649412353088,0.047195755437651,0.0,0.6279069767441858,0.2916666666666665,186,31,10,18,0,6117,5,18,36,1600000,42500.0,12000000.0,2000000.0,,12000000.0,7,5600000,-0.058823529411764705,0.0
608832,Merlin,Röhl,2024,60,Germany,Berlin,Germany,05-07-02,Central Midfield,Midfield,Right,192.0,Unknown,sportlobby,https://img.a.transfermarkt.technology/portrait/header/608832-1726649794.jpg?lm=1,L1,Sport-Club Freiburg,12000000.0,12000000.0,22,122,-75,7,8,10,11,12,9,12,10,4,11,13,10,12,11,14,12,11,12,12,12,11,15,7,11,10,10,14,14,12,11,11,15,15,12,15,12,11,10,12,7,15,4,3,2,3,1,1,3,2,1,2,3,19,12,7,12,10,11,12,11,1,1,12,1,1,12,20,1,20,12,1,15,10,1,0,15,20,59540001,5850,5850,4000,Northern_European,115,0,0,767.0,Unknown,91204520,2900000.0,1.0,38,178,40,3,1,7,189,1,0.5243450648319662,0.4224598930481283,0.4852941176470588,0.0007319378876349,0.0,0.0,0.0597649412353088,0.0597649412353088,0.0160837801050029,0.0,0.6744186046511627,0.1666666666666666,165,10,13,23,1,3403,6,17,85,12000000,841071.4285714285,12000000.0,0.0,300000.0,2000000.0,1,1200000,0.0,1.0
609361,José,Fontán,2024,8024,Spain,VilagarcÃ­a de Arousa,Spain,11-02-00,Centre-Back,Defender,Left,182.0,30-06-26,YOU FIRST,https://img.a.transfermarkt.technology/portrait/header/609361-1643110309.jpg?lm=1,PO1,Futebol Clube de Arouca,1000000.0,1000000.0,24,125,150,8,11,13,10,10,8,11,8,10,14,14,10,14,12,15,14,11,12,11,12,12,7,12,9,12,13,13,15,13,14,12,10,14,13,13,11,12,8,9,6,13,1,2,3,2,1,2,1,2,2,4,2,11,10,8,8,10,11,13,10,1,20,20,1,16,1,1,1,1,1,1,1,1,1,76,20,10,9689999,6231,6231,3001,Mediterranean_Hispanic,122,0,0,7029.0,Go Ahead Eagles,67263767,9111392.0,2.0,89,1594,89,1,0,3,98,2,0.5747552262503308,0.315614973262032,0.536764705882353,0.0067786332073846,0.0,0.0,0.0047511877969492,0.0047511877969492,0.0505924720131114,0.1428571428571428,0.4418604651162785,0.25,143,8,4,34,0,2819,4,13,22,1000000,59375.0,1000000.0,200000.0,50000.0,100000.0,4,300000,0.0,0.25
609556,William,Osula,2024,762,Denmark,Aarhus,Denmark,04-08-03,Centre-Forward,Attack,Right,186.0,30-06-29,CAA Stellar,https://img.a.transfermarkt.technology/portrait/header/609556-1693217416.jpg?lm=1,GB1,Newcastle United Football Club,7000000.0,7000000.0,21,121,126,10,11,12,12,11,10,13,10,10,8,11,8,5,12,5,12,13,11,12,11,10,15,11,12,12,5,15,16,14,16,14,13,8,14,13,12,10,5,1,13,13,3,3,2,1,1,2,2,4,1,1,4,12,11,8,18,12,14,11,13,1,1,1,1,1,1,1,1,1,1,5,5,18,20,71,7,20,-1,5900,5850,4000,African_Caribbean,117,0,0,32655.0,Unknown,55022873,11600000.0,1.0,28,12,30,0,1,1,137,3,0.5243450648319662,0.4224598930481283,0.4999999999999999,0.0315235412661366,0.0,0.0,0.0347586896724181,0.0347586896724181,0.0644184560682241,0.0,0.5348837209302322,0.125,69,10,3,6,1,2240,0,0,0,7000000,978571.4285714285,7000000.0,0.0,,3000000.0,1,4000000,1.3333333333333333,1.3333333333333333
610190,Nediljko,Labrovic,2024,167,Croatia,Split,Croatia,10-10-99,Goalkeeper,Goalkeeper,Right,196.0,30-06-29,GreenField,https://img.a.transfermarkt.technology/portrait/header/610190-1722850680.jpg?lm=1,L1,FC Augsburg 1907,4500000.0,4500000.0,25,121,143,6,3,1,1,5,7,6,3,2,1,7,3,3,5,12,13,13,9,12,5,9,12,1,12,2,14,12,9,12,14,14,16,7,12,12,14,12,12,8,6,16,14,14,11,8,12,10,14,17,7,18,10,11,12,6,14,14,13,10,13,20,1,1,1,1,1,1,1,1,1,1,1,1,1,91,5,20,2534999,6100,6100,4400,Northern_European,119,0,0,1293.0,Unknown,24060250,2500000.0,1.0,24,1409,25,2,1,7,67,5,0.5574225985710506,0.4652406417112299,0.5147058823529411,0.0012398525695558,0.0,0.0,0.0222555638909727,0.0222555638909727,0.0138614961526709,0.0,0.7674418604651163,0.2916666666666665,0,0,0,0,0,0,0,0,0,4500000,433333.3333333333,4500000.0,0.0,,,2,0,0.0,0.2857142857142857
610238,Pedro,Ortiz,2024,368,Spain,Palma de Mallorca,Spain,19-08-00,Central Midfield,Midfield,Right,184.0,30-06-25,MagicPlayers,https://img.a.transfermarkt.technology/portrait/header/610238-1540334775.jpg?lm=1,ES1,Sevilla FÃºtbol Club S.A.D.,400000.0,400000.0,24,123,124,4,3,1,3,6,9,5,2,2,2,6,1,2,6,11,11,10,7,10,7,14,14,7,13,6,10,11,9,11,12,14,16,14,10,11,16,15,8,11,12,15,16,13,14,6,16,12,11,14,8,9,10,16,13,6,11,13,11,10,15,20,1,1,1,1,1,1,1,1,1,1,1,1,1,70,8,20,135230,5697,5697,3072,African_Caribbean,120,6,0,5483.0,Unknown,86050956,150000.0,1.0,89,1112,89,3,1,1,181,1,0.5041016141836465,0.3232085561497326,0.5220588235294117,0.0052857889141344,0.0394736842105263,0.0,0.0017504376094023,0.0017504376094023,0.0008055779327203,0.0,0.4883720930232553,0.25,108,6,6,39,2,4318,4,40,183,300000,12500.0,400000.0,100000.0,100000.0,150000.0,3,150000,-0.25,-0.25
610335,Unknown,Iván Jaime,2024,720,Spain,MÃ¡laga,Spain,26-09-00,Attacking Midfield,Midfield,Right,180.0,30-06-28,CAA Stellar,https://img.a.transfermarkt.technology/portrait/header/610335-1693590350.png?lm=1,PO1,Futebol Clube do Porto,8000000.0,10000000.0,24,123,141,13,14,15,10,15,12,7,10,8,7,14,9,9,16,7,8,8,15,11,15,14,11,13,8,12,9,11,9,12,14,11,9,13,11,12,10,13,9,13,10,15,2,2,3,3,2,2,1,1,3,1,2,10,11,8,13,12,10,14,15,1,1,1,1,1,1,12,14,18,8,19,20,10,5,72,11,20,4079998,6150,4907,4390,Mediterranean_Hispanic,121,0,0,2950.0,Unknown,67262227,6250000.0,2.0,89,997,89,3,1,3,100,0,0.3995766075681397,0.4641711229946523,0.5294117647058822,0.002839880379333,0.0,0.0,0.0397599399849962,0.0497624406101525,0.0346954082057834,0.1428571428571428,0.3953488372093026,0.25,0,0,0,0,0,0,2,24,252,7000000,402941.17647058825,10000000.0,2000000.0,200000.0,1000000.0,2,5300000,-0.125,-0.3
610417,Unknown,Andrew,2024,2424,Brazil,Duque de Caxias,Brazil,01-07-01,Goalkeeper,Goalkeeper,Right,188.0,30-06-26,Unknown,https://img.a.transfermarkt.technology/portrait/header/610417-1710238883.jpg?lm=1,PO1,Gil Vicente Futebol Clube,3000000.0,3000000.0,23,123,136,2,2,7,1,10,4,3,2,2,1,15,2,1,10,11,12,13,8,15,11,12,13,1,8,2,12,14,13,11,13,10,14,14,12,12,10,12,6,15,6,12,13,8,10,16,13,11,15,16,8,12,11,18,10,2,11,13,12,10,12,20,1,1,1,1,1,1,1,1,1,1,1,1,1,76,12,20,1529999,6150,5192,4238,African_Caribbean,122,0,0,1849.0,Unknown,19370048,9111392.0,2.0,10,438,11,2,1,1,106,5,0.4372849960306959,0.4479144385026737,0.536764705882353,0.0017767357694569,0.0,0.0,0.0147536884221055,0.0147536884221055,0.0505924720131114,0.1428571428571428,0.581395348837209,0.2083333333333332,0,0,0,0,0,0,1,6,33,4000000,359090.9090909091,4000000.0,0.0,,400000.0,1,200000,0.3333333333333333,0.6
610428,Oscar,Fraulo,2024,200,Denmark,Odense,Denmark,06-12-03,Central Midfield,Midfield,Right,180.0,30-06-25,Nine Group ,https://img.a.transfermarkt.technology/portrait/header/610428-1662965875.jpg?lm=1,NL1,Football Club Utrecht,3000000.0,3000000.0,21,103,-8,11,10,11,10,13,11,7,12,3,10,13,8,11,13,14,9,11,12,9,13,9,13,13,10,11,11,12,12,12,12,11,9,14,12,12,8,13,8,13,4,12,4,3,2,1,1,2,2,3,1,3,1,9,12,3,10,10,12,9,8,1,1,1,1,8,8,16,10,20,10,10,15,10,1,77,11,20,29840000,5149,4378,3768,Northern_European,103,0,0,15341.0,Unknown,27159740,2000000.0,1.0,28,1070,30,3,1,7,92,1,0.3295845461762371,0.3976470588235293,0.3970588235294117,0.0148048439224532,0.0,0.0,0.0147536884221055,0.0147536884221055,0.0110836412122558,0.0,0.3953488372093026,0.125,133,19,29,23,1,2716,1,1,4,3500000,313636.36363636365,3500000.0,0.0,2000000.0,3000000.0,2,2150000,0.16666666666666666,0.4
610429,Christian,Rasmussen,2024,610,Denmark,Lyngby,Denmark,19-01-03,Right Winger,Attack,Left,184.0,30-06-27,People In Sport,https://img.a.transfermarkt.technology/portrait/header/610429-1722415254.jpg?lm=1,NL1,AFC Ajax Amsterdam,2000000.0,2000000.0,21,110,-75,11,12,13,7,13,13,9,11,6,5,12,13,5,14,8,11,11,6,10,13,11,12,14,5,12,5,14,13,13,12,12,10,15,13,11,9,13,5,8,6,14,1,3,3,3,1,2,1,2,3,3,2,7,11,5,11,11,14,10,19,1,1,1,1,1,1,1,13,12,17,14,15,20,18,75,20,8,14940000,5499,4493,4393,Northern_European,104,0,0,3499.0,Unknown,27148085,3000000.0,1.0,28,882,30,0,0,7,6,10,0.344800211696216,0.4644919786096256,0.4044117647058823,0.0033700042583721,0.0,0.0,0.0097524381095273,0.0097524381095273,0.0166393510930859,0.0,0.4883720930232553,0.125,0,0,0,0,0,0,4,24,94,2000000,172727.27272727274,2000000.0,0.0,500000.0,2000000.0,3,1350000,0.0,0.0
610431,Wahid,Faghir,2024,79,Denmark,Vejle,Denmark,29-07-03,Centre-Forward,Attack,Right,186.0,30-06-26,Boutique Transfers,https://img.a.transfermarkt.technology/portrait/header/610431-1689927868.jpg?lm=1,L1,Verein fÃ¼r Bewegungsspiele Stuttgart 1893,1000000.0,4500000.0,21,110,-8,5,8,11,15,12,7,11,11,5,5,11,12,6,12,11,12,12,14,11,11,12,11,12,4,13,5,10,9,11,11,11,13,12,12,10,13,10,11,12,6,8,4,2,2,3,2,3,1,1,2,3,2,12,11,8,12,14,11,8,12,1,1,1,1,1,1,1,1,1,1,11,1,11,20,74,12,20,67100000,5495,5495,3245,North_African__Middle_Eastern,109,0,0,3845.0,Football Club NordsjÃ¦lland,27156353,3500000.0,1.0,28,1567,30,0,1,6,211,3,0.4773749669224663,0.341711229946524,0.4411764705882353,0.0037041078324113,0.0,0.0,0.0047511877969492,0.0222555638909727,0.0194172060335009,0.0,0.5348837209302322,0.125,128,37,11,10,1,5409,11,43,90,1000000,64285.71428571428,4500000.0,1500000.0,3000000.0,2000000.0,4,3000000,-0.5,-0.6
610442,Rasmus,Højlund,2024,985,Denmark,KÃ¸benhavn,Denmark,04-02-03,Centre-Forward,Attack,Left,191.0,30-06-28,SEG,https://img.a.transfermarkt.technology/portrait/header/610442-1699471458.jpg?lm=1,GB1,Manchester United Football Club,65000000.0,65000000.0,21,132,-85,7,10,12,15,13,7,13,9,7,7,12,9,7,13,14,14,14,12,11,10,12,15,11,8,13,8,14,14,13,11,13,15,13,15,14,14,13,10,12,7,9,2,2,2,3,1,2,3,2,1,1,2,16,15,5,15,15,16,14,10,1,1,1,1,1,1,1,1,1,1,1,16,1,20,79,20,12,66000000,6600,6400,3000,Northern_European,131,0,0,12308.0,Unknown,27160181,31950000.0,3.0,28,778,30,0,0,7,132,3,0.5971156390579518,0.3155080213903743,0.6029411764705883,0.0118761267546472,0.0,0.0,0.3248312078019504,0.3248312078019504,0.177477152143115,0.2857142857142857,0.6511627906976742,0.125,191,67,15,14,0,3618,6,20,49,60000000,4275000.0,65000000.0,5000000.0,1000000.0,65000000.0,4,33000000,-0.07692307692307693,-0.07692307692307693
610849,Liam,Delap,2024,677,England,Winchester,England,08-02-03,Centre-Forward,Attack,Right,186.0,30-06-29,CAA Stellar,https://img.a.transfermarkt.technology/portrait/header/610849-1601282009.jpg?lm=1,GB1,Ipswich Town Football Club,15000000.0,15000000.0,21,115,-85,3,7,12,13,12,7,9,10,9,5,12,11,7,12,16,12,14,12,12,8,8,16,13,7,12,6,11,14,13,12,9,13,14,14,13,13,10,16,5,11,8,2,3,1,2,3,2,3,2,1,3,4,9,13,11,12,14,12,13,6,1,1,1,1,1,1,1,1,1,1,12,1,1,20,0,12,20,62821124,5746,5746,4246,Northern_European,110,0,0,9279.0,Stoke City,28126247,9111392.0,2.0,32,1669,33,0,1,7,115,3,0.510584810796507,0.4487700534759358,0.4485294117647059,0.0089512720559053,0.0,0.0,0.0747686921730432,0.0747686921730432,0.0505924720131114,0.1428571428571428,0.5348837209302322,0.125,165,70,20,37,1,3606,1,16,92,25000000,2400000.0,25000000.0,2000000.0,,8000000.0,4,16500000,2.125,2.125
611195,Oliver,Zandén,2024,5724,Sweden,AlingsÃ¥s,Sweden,14-08-01,Left-Back,Defender,Left,183.0,31-12-24,JS Management AB,https://img.a.transfermarkt.technology/portrait/header/611195-1658247914.png?lm=1,DK1,Randers Fodbold Club,800000.0,1200000.0,23,113,138,9,12,11,8,12,9,9,11,10,12,12,8,13,12,10,13,11,12,12,12,12,14,8,6,13,13,12,12,13,11,10,10,12,13,13,10,13,6,10,5,9,2,2,3,1,1,2,3,2,1,3,2,13,13,2,14,14,14,18,18,1,20,1,1,19,1,1,12,1,1,8,1,1,1,75,20,9,2460799,5650,5650,2018,Northern_European,111,0,0,4198.0,Unknown,93104384,1500000.0,1.0,91,44,91,1,0,7,160,8,0.4978830378406986,0.2104812834224599,0.4558823529411764,0.0040449707273125,0.0,0.0,0.0037509377344336,0.0057514378594648,0.0083057862718408,0.0,0.4651162790697669,0.2083333333333332,64,3,10,8,0,4059,2,9,123,700000,84375.0,1200000.0,200000.0,,1000000.0,2,200000,-0.125,-0.125
611793,James,Hill,2024,989,England,Bristol,England,10-01-02,Centre-Back,Defender,Left,184.0,30-06-26,Unknown,https://img.a.transfermarkt.technology/portrait/header/611793-1633426138.png?lm=1,GB1,Association Football Club Bournemouth,2000000.0,2000000.0,22,110,140,8,6,6,7,9,7,14,8,17,10,8,6,12,10,4,10,12,10,11,7,11,14,5,13,11,12,13,12,12,12,10,14,14,12,14,13,12,4,11,5,11,2,1,1,2,2,2,3,1,3,2,1,12,13,4,12,13,15,15,12,1,17,20,1,14,1,1,1,1,1,1,1,1,1,0,20,12,14522165,5500,5500,2758,Mixed_Race,107,0,0,9279.0,Unknown,29217706,1200000.0,1.0,32,259,33,1,0,4,22,2,0.4780365175972479,0.2896256684491978,0.4264705882352941,0.0089512720559053,0.0,0.0,0.0097524381095273,0.0097524381095273,0.0066390733075918,0.0,0.4883720930232553,0.1666666666666666,0,0,0,0,0,0,4,53,174,2000000,166666.66666666666,2000000.0,0.0,,1000000.0,3,1000000,0.0,0.0
613393,Gaetano,Oristanio,2024,607,Italy,Vallo della Lucania,Italy,28-09-02,Attacking Midfield,Midfield,Left,174.0,30-06-29,GR Sports,https://img.a.transfermarkt.technology/portrait/header/613393-1692963581.jpg?lm=1,IT1,Venezia Football Club,4000000.0,4000000.0,22,95,-75,8,10,11,11,13,13,6,14,2,3,13,10,6,15,5,11,7,12,8,12,11,13,13,5,11,4,10,8,13,12,8,4,12,12,8,6,10,4,15,6,12,2,3,3,1,3,2,1,2,2,3,3,19,13,6,13,14,16,12,19,1,1,1,1,1,1,1,1,13,1,13,20,13,18,0,20,7,35000000,4250,4500,2000,Mediterranean_Hispanic,87,0,0,1214.0,FC Volendam,43425611,4000000.0,1.0,52,1559,54,3,0,3,210,0,0.3457263826409102,0.2085561497326203,0.2794117647058823,0.001163568805541,0.0,0.0,0.0197549387346836,0.0197549387346836,0.0221950609739159,0.0,0.2558139534883721,0.1666666666666666,172,27,14,16,1,2004,7,31,50,6500000,590000.0,6500000.0,50000.0,600000.0,1000000.0,3,3050000,0.625,0.8571428571428571
613781,Vasilios,Zagaritis,2024,723,Greece,Thiva,Greece,04-05-01,Left-Back,Defender,Left,178.0,30-06-26,Unknown,https://img.a.transfermarkt.technology/portrait/header/613781-1725528285.jpg?lm=1,NL1,Almere City Football Club,400000.0,500000.0,23,105,135,8,11,11,6,11,6,9,8,12,11,10,10,12,12,13,11,12,11,10,8,11,15,9,6,12,11,13,15,14,13,11,9,14,13,14,10,12,8,12,7,14,1,2,1,3,1,3,1,1,2,1,1,9,16,6,9,11,15,14,15,1,20,1,1,19,1,1,11,1,1,1,1,1,1,68,20,5,1602000,5250,5250,2000,Mediterranean_Hispanic,102,0,0,3836.0,Unknown,36151881,380000.0,1.0,40,1488,42,1,0,3,17,8,0.4449589838581635,0.2085561497326203,0.3897058823529412,0.0036954172770172,0.0,0.0,0.0017504376094023,0.0022505626406601,0.0020833912053112,0.0,0.3488372093023257,0.2083333333333332,121,7,2,25,0,3032,4,11,21,600000,42307.692307692305,600000.0,100000.0,50000.0,500000.0,2,500000,0.5,0.5
613964,Stelios,Andreou,2024,172,Cyprus,Geri,Cyprus,24-07-02,Centre-Back,Defender,Right,187.0,30-06-26,Mylogram Ltd,https://img.a.transfermarkt.technology/portrait/header/613964-1672563576.jpg?lm=1,BE1,Royal Charleroi Sporting Club,2500000.0,2500000.0,22,115,-75,4,7,8,4,11,8,11,8,6,14,10,8,11,9,12,12,13,11,11,8,13,14,8,11,10,12,13,12,12,13,12,13,15,13,14,13,15,8,7,4,6,1,3,3,3,2,1,3,1,3,4,3,8,13,4,12,12,11,14,13,1,1,20,1,1,1,1,1,1,1,1,1,1,1,78,9,20,17500000,5741,5741,1991,Mediterranean_Hispanic,113,5,0,3499.0,Unknown,2000098756,200000.0,1.0,25,534,27,1,1,3,174,2,0.5099232601217253,0.2075935828877005,0.4705882352941176,0.0033700042583721,0.0328947368421052,0.0,0.0122530632658164,0.0122530632658164,0.0010833634267618,0.0,0.5581395348837206,0.1666666666666666,154,5,2,22,0,2648,1,2,10,3000000,280000.0,3000000.0,0.0,600000.0,2000000.0,1,200000,0.2,0.5
614258,Levi,Colwill,2024,631,England,Southampton,England,26-02-03,Centre-Back,Defender,Left,187.0,30-06-29,FA Sport,https://img.a.transfermarkt.technology/portrait/header/614258-1694614507.jpg?lm=1,GB1,Chelsea Football Club,50000000.0,55000000.0,21,126,-8,6,7,11,5,10,2,12,2,8,13,12,6,13,10,10,11,8,13,11,8,13,1,5,13,11,13,10,11,15,12,15,15,14,15,13,12,11,6,11,7,15,4,4,1,2,1,2,1,4,3,1,3,19,12,5,10,13,11,14,20,1,16,20,1,14,1,1,1,1,1,1,1,1,1,88,20,10,67507190,6285,6285,3235,African_Caribbean,120,0,0,17399.0,Brighton & Hove Albion,28124573,9111392.0,2.0,32,1403,33,1,0,1,50,2,0.5818999735379731,0.3406417112299464,0.5220588235294117,0.0167920842559001,0.0,0.0,0.2498124531132783,0.274818704676169,0.0505924720131114,0.1428571428571428,0.5581395348837206,0.125,158,4,7,21,0,3719,7,43,60,55000000,4375000.0,55000000.0,5000000.0,2500000.0,55000000.0,2,19000000,0.1,0.0
614742,Drissa,Camara,2024,130,Cote d'Ivoire,Abobo,Cote d'Ivoire,18-02-02,Central Midfield,Midfield,Right,179.0,30-06-25,GR Sports,https://img.a.transfermarkt.technology/portrait/header/614742-1714503149.jpg?lm=1,IT1,Parma Calcio 1913,1200000.0,1200000.0,22,95,-75,8,9,11,7,12,8,8,11,7,9,13,10,12,11,10,12,10,10,11,9,12,11,7,8,12,12,13,11,11,14,15,9,9,12,13,10,16,9,4,12,14,1,3,2,3,3,3,1,2,1,1,2,12,10,4,14,11,11,12,18,1,1,1,1,1,1,17,1,20,1,1,13,1,1,69,4,20,7479000,4749,2594,3443,North_African__Middle_Eastern,97,0,0,1406.0,Unknown,43424748,9111392.0,2.0,23,16,24,3,1,6,155,1,0.0935432654141307,0.3628877005347593,0.3529411764705882,0.0013489673206148,0.0,0.0,0.0057514378594648,0.0057514378594648,0.0505924720131114,0.1428571428571428,0.3720930232558141,0.1666666666666666,99,22,9,21,2,4145,5,23,121,1000000,93750.0,1200000.0,200000.0,,1000000.0,1,150000,-0.16666666666666666,-0.16666666666666666
615300,Nikola,Stajic,2024,6418,Yugoslavia (Republic),Para?in,Serbia,08-09-01,Centre-Back,Defender,Left,182.0,30-06-25,Joseba Diaz,https://img.a.transfermarkt.technology/portrait/header/default.jpg?lm=1,GR1,Panetolikos Agrinio,250000.0,250000.0,23,99,135,10,11,7,6,10,6,11,6,5,12,10,8,12,11,11,12,12,10,12,10,11,12,9,12,9,11,12,12,12,13,11,11,10,10,10,10,11,6,10,6,6,2,3,2,2,3,2,3,2,3,2,1,9,10,6,11,12,11,12,12,1,19,20,1,12,1,1,1,1,1,1,1,1,1,74,20,8,927198,4500,4500,1578,Northern_European,96,0,0,303.0,Unknown,2000038045,9111392.0,2.0,110,1117,85,1,0,7,151,2,0.3457263826409102,0.1634224598930481,0.3455882352941176,0.0002838914762067,0.0,0.0,0.0010002500625156,0.0010002500625156,0.0505924720131114,0.1428571428571428,0.4418604651162785,0.2083333333333332,100,3,4,15,0,4448,1,3,46,300000,22727.272727272728,300000.0,0.0,,150000.0,4,75000,0.2,0.5
615302,Mirko,Topi?,2024,3329,Yugoslavia (Republic),Novi Sad,Serbia,05-02-01,Defensive Midfield,Midfield,Right,190.0,30-06-27,Unknown,https://img.a.transfermarkt.technology/portrait/header/615302-1596787780.jpg?lm=1,PO1,Futebol Clube de FamalicÃ£o,5000000.0,5000000.0,23,111,140,7,9,13,8,11,7,11,12,8,12,12,9,11,12,12,13,10,11,11,13,12,13,11,9,12,13,13,12,13,12,12,14,12,13,11,12,12,12,12,11,9,2,1,2,2,4,3,3,1,2,3,2,11,13,9,11,9,11,13,12,1,1,1,1,1,1,20,1,19,1,1,1,1,1,80,14,20,1687999,5500,5500,2750,Northern_European,117,0,0,1450.0,Unknown,62238926,1000000.0,1.0,110,1058,85,3,1,7,99,4,0.4780365175972479,0.2887700534759358,0.4999999999999999,0.0013914544803192,0.0,0.0,0.0247561890472618,0.0247561890472618,0.0055279313314258,0.0,0.6279069767441858,0.2083333333333332,177,5,3,18,0,3477,1,7,63,5000000,350000.0,5000000.0,300000.0,400000.0,1500000.0,2,300000,0.42857142857142855,1.0
615350,Cenk,ÃÂZkacar,2024,366,TÃ¼rkiye,Izmir,TÃ¼rkiye,06-10-00,Centre-Back,Defender,Left,190.0,30-06-25,SEG,https://img.a.transfermarkt.technology/portrait/header/615350-1641457298.jpg?lm=1,ES1,Real Valladolid Club de FÃºtbol S.A.D.,4000000.0,5000000.0,24,105,135,5,5,8,5,12,5,13,5,6,12,11,8,13,11,10,10,14,12,11,9,10,11,7,5,6,10,10,10,13,10,12,16,12,13,13,14,12,10,10,7,15,1,3,2,1,3,2,2,3,3,1,3,8,11,6,11,12,10,11,19,1,12,20,1,1,1,1,1,1,1,1,1,1,1,90,20,10,1638749,5250,5250,2000,Mediterranean_Hispanic,103,1,0,11506.0,Valencia,70118933,3425000.0,2.0,100,682,100,1,0,3,169,2,0.4449589838581635,0.2085561497326203,0.3970588235294117,0.0111017017073078,0.006578947368421,0.0,0.0197549387346836,0.0247561890472618,0.0190005277924386,0.1428571428571428,0.6279069767441858,0.25,128,3,2,13,0,2337,4,14,31,1800000,121428.57142857143,5000000.0,2500000.0,100000.0,1200000.0,4,3225000,-0.55,-0.28
616341,Nuno,Mendes,2024,583,Portugal,Lisboa,Portugal,19-06-02,Left-Back,Defender,Left,183.0,30-06-26,MRP.POSITIONUMBER,https://img.a.transfermarkt.technology/portrait/header/616341-1672304855.jpg?lm=1,FR1,Paris Saint-Germain Football Club,55000000.0,65000000.0,22,149,-9,13,14,14,10,14,7,9,10,11,11,13,9,14,14,12,15,12,13,14,13,13,14,12,8,11,11,12,13,15,14,13,10,16,16,15,13,13,6,15,11,14,2,2,2,1,1,4,2,2,4,1,3,16,15,6,15,17,14,14,15,1,20,13,1,20,1,1,14,1,1,1,1,1,1,70,20,12,98592975,7447,7747,5497,African_Caribbean,141,15,0,40102.0,Unknown,83261910,38000000.0,1.0,76,843,79,1,0,1,154,8,0.7753373908441386,0.582566844919786,0.6764705882352942,0.0387144930461072,0.0986842105263157,0.0,0.274818704676169,0.3248312078019504,0.2110891969221367,0.0,0.4651162790697669,0.1666666666666666,173,6,21,24,0,4640,10,70,288,55000000,3428571.4285714286,65000000.0,5000000.0,40000000.0,65000000.0,1,0,0.0,-0.08333333333333333
616344,Tiago,Tomás,2024,82,Portugal,Cascais,Portugal,16-06-02,Centre-Forward,Attack,Right,180.0,30-06-27,Proeleven S.A.,https://img.a.transfermarkt.technology/portrait/header/616344-1695623995.jpg?lm=1,L1,Verein fÃ¼r LeibesÃ¼bungen Wolfsburg,6000000.0,8000000.0,22,126,-8,7,9,13,13,12,6,11,12,8,6,10,11,6,12,15,12,16,11,10,12,9,16,16,6,13,7,13,14,15,15,12,10,15,15,14,12,10,5,10,5,14,3,1,2,1,1,1,4,3,2,3,1,12,14,11,14,15,16,12,11,1,1,1,5,1,10,1,1,1,14,12,1,15,20,72,13,20,28687501,6296,6146,4596,African_Caribbean,123,0,0,10102.0,VfB Stuttgart,83261927,8000000.0,1.0,76,324,79,0,1,1,213,3,0.563508864779042,0.4862032085561497,0.5441176470588236,0.0097459750658309,0.0,0.0,0.0297574393598399,0.0397599399849962,0.044417900497236,0.0,0.3953488372093026,0.1666666666666666,172,29,14,25,0,2303,9,23,32,9000000,615384.6153846154,9000000.0,2000000.0,6000000.0,7000000.0,2,3000000,0.5,0.125
616369,Ander,Barrenetxea,2024,681,Spain,Donostia-San SebastiÃ¡n,Spain,27-12-01,Left Winger,Attack,Right,175.0,30-06-30,Wasserman,https://img.a.transfermarkt.technology/portrait/header/616369-1699472801.jpg?lm=1,ES1,Real Sociedad de FÃºtbol S.A.D.,20000000.0,20000000.0,22,141,154,12,14,15,12,12,8,8,11,7,8,13,14,8,15,9,12,10,12,14,15,13,12,14,10,15,8,14,12,14,14,15,9,14,15,11,16,12,7,11,11,15,2,3,2,1,3,3,3,2,2,1,3,15,14,3,16,13,14,13,9,1,11,1,10,12,11,1,16,1,16,20,11,18,12,74,12,20,36877501,7050,7050,4600,Mediterranean_Hispanic,139,0,0,24633.0,Unknown,67276482,9111392.0,2.0,89,423,89,0,1,3,168,7,0.6831172267795713,0.4866310160427807,0.6617647058823528,0.0237773595582107,0.0,0.0,0.0997749437359339,0.0997749437359339,0.0505924720131114,0.1428571428571428,0.2790697674418605,0.1666666666666666,192,24,12,23,0,5728,14,92,169,20000000,1187500.0,20000000.0,3000000.0,11000000.0,6000000.0,1,0,0.0,0.0
616631,Matteo,Ruggeri,2024,800,Italy,San Giovanni Bianco,Italy,11-07-02,Left Midfield,Midfield,Left,187.0,30-06-28,TMP SOCCER srl ,https://img.a.transfermarkt.technology/portrait/header/616631-1695028258.jpg?lm=1,IT1,Atalanta Bergamasca Calcio S.p.a.,20000000.0,20000000.0,22,120,-75,13,14,11,6,12,13,8,11,8,9,12,5,12,13,11,12,11,13,13,12,12,15,8,8,12,12,14,14,13,13,12,10,16,13,14,12,13,8,13,6,9,2,2,1,1,2,1,2,3,3,3,3,12,15,8,15,13,15,14,12,1,20,13,1,20,1,1,11,1,1,1,1,1,1,79,20,8,34500002,5995,5995,3745,Mediterranean_Hispanic,117,0,0,1346.0,Unknown,43425834,9111392.0,2.0,52,1299,54,3,0,3,31,6,0.5435300344006351,0.395187165775401,0.4999999999999999,0.0012910302846543,0.0,0.0,0.0997749437359339,0.0997749437359339,0.0505924720131114,0.1428571428571428,0.5581395348837206,0.1666666666666666,167,4,21,14,0,6017,9,61,126,20000000,1772727.2727272727,20000000.0,0.0,2000000.0,4000000.0,2,0,0.0,0.3333333333333333
616894,Eren,Elmal?,2024,449,TÃ¼rkiye,Istanbul,TÃ¼rkiye,07-07-00,Left-Back,Defender,Left,181.0,30-06-27,GROW,https://img.a.transfermarkt.technology/portrait/header/616894-1723801363.jpg?lm=1,TR1,Trabzonspor KulÃ¼bÃ¼,4000000.0,4200000.0,24,120,130,11,13,11,5,11,3,10,8,10,11,12,8,10,12,12,12,14,12,13,8,11,13,12,8,10,10,14,14,15,13,14,10,15,16,15,13,12,11,14,4,13,3,4,1,2,1,3,3,3,4,2,3,18,14,3,9,13,13,12,13,1,20,1,12,16,1,1,1,1,1,1,1,1,1,0,20,5,3511415,6041,6041,4041,North_African__Middle_Eastern,116,2,0,13027.0,Unknown,70123223,3600000.0,1.0,100,667,100,1,0,6,204,8,0.5496163006086267,0.4268449197860962,0.4926470588235294,0.0125704055689078,0.0131578947368421,0.0,0.0197549387346836,0.0207551887971993,0.0199727770215839,0.0,0.418604651162791,0.25,208,3,10,38,0,2792,6,15,21,4000000,219444.44444444444,4200000.0,400000.0,50000.0,125000.0,2,300000,0.0,0.14285714285714285
617018,Marko,Stamenic,2024,683,New Zealand,Wellington,New Zealand,19-02-02,Defensive Midfield,Midfield,Right,188.0,30-06-25,Stars & Friends,https://img.a.transfermarkt.technology/portrait/header/617018-1728417778.png?lm=1,GR1,Olympiakos Syndesmos Filathlon Peiraios,5000000.0,5000000.0,22,110,-75,8,8,12,9,13,10,10,8,4,11,13,10,11,14,12,12,13,12,11,11,11,14,13,8,12,11,13,14,11,12,14,15,13,11,13,10,10,13,9,7,15,2,2,1,2,1,3,4,2,3,1,3,16,15,5,13,13,14,12,12,1,1,12,1,1,1,17,1,20,1,1,12,1,1,78,11,20,9098744,5496,5496,2246,Northern_European,110,11,0,1344.0,Unknown,88026183,5500000.0,1.0,68,1652,69,3,1,7,141,4,0.4775072770574226,0.2348663101604278,0.4485294117647059,0.0012890990501222,0.0723684210526315,0.0,0.0247561890472618,0.0247561890472618,0.0305286257951609,0.0,0.581395348837209,0.1666666666666666,125,7,6,28,0,3922,5,10,21,4500000,442500.0,5000000.0,500000.0,100000.0,400000.0,5,1275000,-0.1,3.5
617060,Mika,Mármol,2024,472,Spain,Terrassa,Spain,01-07-01,Centre-Back,Defender,Left,181.0,30-06-26,Unknown,https://img.a.transfermarkt.technology/portrait/header/617060-1638453788.jpg?lm=1,ES1,UniÃ³n Deportiva Las Palmas S.A.D.,15000000.0,15000000.0,23,120,150,6,11,8,7,12,6,13,7,9,13,11,7,14,11,14,13,13,9,11,11,12,15,8,6,9,14,11,12,13,14,14,13,15,14,12,13,12,5,12,5,15,1,1,1,3,2,3,3,3,2,1,3,13,14,5,12,13,14,13,15,1,19,20,1,14,1,1,9,1,1,1,1,1,1,71,20,8,2664000,6000,6000,3500,Mediterranean_Hispanic,121,0,0,6344.0,Unknown,67295761,1900000.0,1.0,89,1485,89,1,0,3,207,2,0.5441915850754168,0.3689839572192513,0.5294117647058822,0.0061171853801683,0.0,0.0,0.0747686921730432,0.0747686921730432,0.0105280702241728,0.0,0.418604651162791,0.2083333333333332,168,4,5,27,0,1632,2,0,33,12000000,786666.6666666666,15000000.0,3000000.0,,800000.0,2,1300000,-0.2,1.4
617074,Ilaix,Moriba,2024,940,Guinea,Conakry,Guinea,19-01-03,Central Midfield,Midfield,Right,185.0,30-06-25,Promoesport,https://img.a.transfermarkt.technology/portrait/header/617074-1695158882.jpg?lm=1,ES1,Real Club Celta de Vigo S. A. D.,3000000.0,25000000.0,21,133,-9,8,9,14,13,15,10,11,14,3,9,14,11,11,16,13,12,15,12,12,14,13,16,17,11,12,11,11,12,13,14,14,13,15,14,13,12,10,10,15,5,12,4,2,1,1,2,3,1,3,1,3,2,10,18,12,9,15,13,14,9,1,1,1,1,1,1,15,10,20,5,10,15,5,10,73,12,20,78784001,6650,6650,4650,African_Caribbean,135,8,0,27999.0,Valencia,67279753,16000000.0,1.0,43,378,44,3,1,1,165,1,0.6301931727970362,0.4919786096256684,0.6323529411764706,0.0270276272755977,0.0526315789473684,0.0,0.0147536884221055,0.1247811952988247,0.0888635795438762,0.0,0.5116279069767438,0.125,136,5,12,29,1,4737,5,18,43,4000000,205882.35294117648,25000000.0,10000000.0,20000000.0,3000000.0,6,21550000,0.3333333333333333,0.3333333333333333
617081,Diego,López,2024,1049,Spain,TurÃ³n,Spain,13-05-02,Right Winger,Attack,Right,172.0,30-06-27,Unknown,https://img.a.transfermarkt.technology/portrait/header/617081-1683211924.jpg?lm=1,ES1,Valencia Club de FÃºtbol S. A. D.,14000000.0,14000000.0,22,136,157,1,1,1,1,8,1,8,1,7,1,10,2,1,9,6,14,15,15,15,8,15,13,5,13,2,14,9,9,9,10,11,17,15,9,11,13,16,8,14,9,1,16,14,13,10,14,15,13,14,15,9,12,13,14,14,15,15,16,14,13,20,1,1,1,1,1,1,1,1,1,1,1,1,1,87,8,20,468738,6800,6800,5800,Mediterranean_Hispanic,137,1,0,15558.0,Unknown,6701938,9111392.0,2.0,89,1536,89,0,1,3,208,10,0.6500396930404869,0.6149732620320855,0.6470588235294117,0.0150143828691772,0.006578947368421,0.0,0.0697674418604651,0.0697674418604651,0.0505924720131114,0.1428571428571428,0.2093023255813952,0.1666666666666666,99,16,13,9,0,757,1,3,26,10000000,1108333.3333333333,14000000.0,2000000.0,,50000.0,1,8500000,-0.2857142857142857,0.0
617267,Henrique,Araújo,2024,8024,Portugal,Funchal,Portugal,19-01-02,Centre-Forward,Attack,Right,182.0,30-06-25,Gestifute,https://img.a.transfermarkt.technology/portrait/header/617267-1653476712.jpg?lm=1,PO1,Futebol Clube de Arouca,2500000.0,5000000.0,22,126,-85,11,10,12,14,13,7,13,10,8,5,12,14,7,13,14,14,13,14,13,12,13,15,13,10,14,5,12,14,13,13,13,12,12,12,12,12,15,12,12,7,10,2,4,2,1,3,3,1,2,3,1,2,12,14,13,16,13,16,12,9,1,1,1,1,1,1,1,1,1,1,1,8,1,20,74,10,20,36450000,6300,6300,4800,Mediterranean_Hispanic,125,0,0,6250.0,Unknown,83261904,9111392.0,2.0,76,518,79,0,1,3,98,3,0.5838846255623181,0.5080213903743315,0.5588235294117647,0.0060264173571634,0.0,0.0,0.0122530632658164,0.0247561890472618,0.0505924720131114,0.1428571428571428,0.4418604651162785,0.1666666666666666,148,52,12,14,0,4109,3,13,35,2000000,166666.66666666666,5000000.0,1000000.0,,5000000.0,4,2000000,-0.2,-0.42857142857142855
617520,Stanislav,Agkatsev,2024,16704,Russia,Vladikavkaz,Russia,09-01-02,Goalkeeper,Goalkeeper,Right,189.0,30-06-29,Glory Group Ltd.,https://img.a.transfermarkt.technology/portrait/header/617520-1721724260.png?lm=1,RU1,FK Krasnodar,2000000.0,2000000.0,22,104,-75,4,2,3,3,5,9,2,2,2,1,10,6,1,6,7,12,14,13,12,10,15,5,2,8,1,11,10,11,8,10,11,14,9,9,9,11,15,9,17,10,14,12,9,8,10,9,9,11,11,10,10,9,13,11,3,12,11,10,11,13,20,1,1,1,1,1,1,1,1,1,1,1,1,1,82,10,20,15055946,5000,5000,2500,Northern_European,91,0,0,10337.0,Unknown,58152092,9111392.0,2.0,78,1621,81,2,1,7,78,5,0.4118814501190792,0.2620320855614972,0.3088235294117646,0.0099728951233431,0.0,0.0,0.0097524381095273,0.0097524381095273,0.0505924720131114,0.1428571428571428,0.6046511627906974,0.1666666666666666,0,0,0,0,0,0,0,0,0,3500000,215625.0,3500000.0,0.0,275000.0,600000.0,2,100000,2.5,2.5
617679,Unknown,Zé Carlos,2024,2424,Portugal,Porto,Portugal,31-07-98,Right-Back,Defender,Right,178.0,30-06-26,PromoSport,https://img.a.transfermarkt.technology/portrait/header/617679-1710239662.jpg?lm=1,PO1,Gil Vicente Futebol Clube,700000.0,1500000.0,26,114,-75,9,9,10,8,11,10,6,7,11,11,11,6,14,12,14,13,15,11,13,12,11,17,12,8,8,11,14,15,13,12,12,5,14,13,14,10,14,6,12,8,14,2,2,2,1,2,1,2,3,1,1,1,14,16,6,14,15,18,15,18,1,10,1,19,10,19,20,1,20,1,1,1,1,1,66,8,20,1620000,5669,5669,3875,Mediterranean_Hispanic,108,0,0,1349.0,VitÃ³ria Sport Clube,2000057964,220000.0,1.0,76,1170,79,1,1,3,106,11,0.500396930404869,0.409090909090909,0.4338235294117646,0.0012939271364523,0.0,0.0,0.0032508127031757,0.0072518129532383,0.0011944776243784,0.0,0.3488372093023257,0.3333333333333332,119,2,8,23,0,2840,1,7,46,800000,27272.727272727272,1500000.0,700000.0,,,3,1100000,0.14285714285714285,0.14285714285714285
618341,Mario,Gila,2024,398,Spain,Barcelona,Spain,29-08-00,Centre-Back,Defender,Right,185.0,30-06-27,Footfeel ISM  ,https://img.a.transfermarkt.technology/portrait/header/618341-1667406185.jpg?lm=1,IT1,SocietÃ  Sportiva Lazio S.p.A.,13000000.0,13000000.0,24,127,157,5,5,5,6,11,6,15,10,13,12,11,8,15,10,16,15,17,15,12,11,11,18,13,16,10,12,14,14,10,11,12,15,12,10,14,16,13,12,12,5,11,2,1,1,4,1,1,1,1,1,1,3,14,15,5,13,12,15,12,12,1,1,20,1,1,1,11,1,8,1,1,1,1,1,76,11,20,12519999,6350,5543,2519,Mediterranean_Hispanic,125,0,0,12308.0,Unknown,67277455,6000000.0,1.0,89,141,89,1,1,3,185,2,0.4837258534003704,0.2640641711229946,0.5588235294117647,0.0118761267546472,0.0,0.0,0.0647661915478869,0.0647661915478869,0.0333064807355759,0.0,0.5116279069767438,0.25,147,8,3,22,1,2347,5,13,27,28000000,1743750.0,28000000.0,0.0,,200000.0,1,2500000,1.1538461538461537,8.333333333333334
618425,Tanguy,Coulibaly,2024,969,France,SÃ¨vres,France,18-02-01,Right Winger,Attack,Left,179.0,30-06-26,Unknown,https://img.a.transfermarkt.technology/portrait/header/618425-1657182257.jpg?lm=1,FR1,Montpellier HÃ©rault Sport Club,2000000.0,5000000.0,23,121,142,10,9,14,9,11,9,10,10,6,7,11,12,9,12,11,10,12,9,9,11,10,12,16,6,11,7,11,13,15,15,11,8,14,15,12,11,8,7,10,6,14,1,4,1,3,1,3,1,2,2,1,2,15,14,6,10,10,12,12,14,1,7,1,1,16,10,1,16,1,12,20,1,16,14,72,20,8,3739999,6047,5747,4247,African_Caribbean,111,0,0,8630.0,Unknown,49039276,9111392.0,2.0,34,1460,36,0,0,1,133,10,0.5107171209314634,0.4488770053475935,0.4558823529411764,0.0083245864502654,0.0,0.0,0.0097524381095273,0.0247561890472618,0.0505924720131114,0.1428571428571428,0.3720930232558141,0.2083333333333332,141,17,9,21,1,2803,12,24,57,1800000,84615.38461538461,5000000.0,2000000.0,500000.0,4500000.0,2,500000,-0.1,-0.1
618472,Castello,Lukeba,2024,23826,France,Lyon,France,17-12-02,Centre-Back,Defender,Left,184.0,30-06-28,BS Group - BS Law,https://img.a.transfermarkt.technology/portrait/header/618472-1713897532.jpg?lm=1,L1,RasenBallsport Leipzig,40000000.0,40000000.0,22,124,-85,7,7,10,7,12,7,13,7,7,14,13,7,13,13,10,15,14,16,11,13,12,13,11,11,11,14,14,14,12,12,12,11,13,12,14,13,12,7,11,8,10,1,2,2,4,1,2,1,3,1,3,3,14,12,7,10,10,11,11,15,1,13,20,1,1,1,1,1,1,1,1,1,1,1,73,20,8,63210856,6700,6200,2012,African_Caribbean,124,0,0,7671.0,Unknown,49056273,30000000.0,1.0,34,884,36,1,0,1,162,2,0.5706536120666843,0.2098395721925133,0.5514705882352942,0.0073985594921625,0.0,0.0,0.1997999499874969,0.1997999499874969,0.1666435178754965,0.0,0.4883720930232553,0.1666666666666666,146,5,0,21,1,4403,4,17,58,50000000,4509090.909090909,50000000.0,0.0,2500000.0,40000000.0,1,10000000,0.25,0.25
618494,Tyler,Morton,2024,31,England,Wallasey,England,31-10-02,Defensive Midfield,Midfield,Right,185.0,Unknown,SEG,https://img.a.transfermarkt.technology/portrait/header/618494-1719220555.jpg?lm=1,GB1,Liverpool Football Club,8000000.0,8000000.0,22,114,-8,12,11,11,9,14,12,8,11,5,11,14,11,10,15,9,13,9,13,13,15,12,13,12,11,12,12,14,13,12,11,12,9,12,12,11,7,12,7,12,6,10,2,2,2,2,2,3,3,1,1,2,3,8,13,5,17,17,17,10,12,1,1,14,1,1,1,20,1,20,1,1,14,1,1,0,8,20,51129157,5700,5700,3026,Northern_European,110,0,0,2900.0,Blackburn Rovers,28127164,9111392.0,2.0,32,1641,33,3,1,7,129,4,0.5044985445885155,0.3182887700534759,0.4485294117647059,0.0027915995160326,0.0,0.0,0.0397599399849962,0.0397599399849962,0.0505924720131114,0.1428571428571428,0.5116279069767438,0.1666666666666666,171,19,27,27,1,4030,1,4,15,8000000,855555.5555555555,8000000.0,0.0,300000.0,7000000.0,4,2000000,0.0,0.0
618809,Manu,Sánchez,2024,1108,Spain,Madrid,Spain,24-08-00,Left-Back,Defender,Left,171.0,30-06-25,Unknown,https://img.a.transfermarkt.technology/portrait/header/618809-1673281847.jpg?lm=1,ES1,Deportivo AlavÃ©s S.A.D.,8000000.0,10000000.0,24,124,149,8,13,12,8,12,7,7,9,12,12,14,11,12,14,11,13,13,13,13,13,14,9,13,9,13,11,13,14,14,12,12,8,11,14,14,11,13,11,11,7,12,1,2,1,2,1,2,1,1,3,1,3,9,14,3,10,9,11,9,13,1,20,1,1,16,1,1,1,1,1,1,1,1,1,70,20,8,7875000,6050,6050,3500,Mediterranean_Hispanic,123,0,0,5216.0,AtlÃ©tico Pamplona,67284340,9111392.0,2.0,89,892,89,1,0,3,59,8,0.5508070918232336,0.3689839572192513,0.5441176470588236,0.0050279691041099,0.0,0.0,0.0397599399849962,0.0497624406101525,0.0505924720131114,0.1428571428571428,0.1860465116279068,0.25,177,1,19,29,0,2980,1,4,13,6000000,323529.4117647059,10000000.0,2000000.0,,8000000.0,3,6000000,-0.25,-0.25
619279,Veldin,Hodza,2024,2698,Croatia,Rijeka,Croatia,15-10-02,Defensive Midfield,Midfield,Right,183.0,30-06-28,Lautus Football,https://img.a.transfermarkt.technology/portrait/header/619279-1726223524.png?lm=1,RU1,FC Rubin Kazan,3500000.0,3500000.0,22,103,-75,10,8,8,7,11,10,10,10,8,13,12,8,10,12,12,13,12,11,9,11,11,13,8,9,9,12,13,12,11,10,11,12,15,12,14,12,8,9,16,6,15,2,1,1,2,3,1,3,3,2,3,2,15,12,6,12,10,12,9,11,1,1,1,1,1,1,20,1,17,1,1,12,1,1,74,12,20,3330000,5649,5399,3649,Northern_European,102,0,0,574.0,Unknown,2000078300,2000000.0,1.0,24,1231,25,3,1,7,71,4,0.4646731939666578,0.3849197860962566,0.3897058823529412,0.0005455737552952,0.0,0.0,0.0172543135783946,0.0172543135783946,0.0110836412122558,0.0,0.4651162790697669,0.1666666666666666,156,13,4,20,0,3445,0,0,0,3000000,305555.55555555556,3500000.0,500000.0,250000.0,3000000.0,4,1200000,-0.14285714285714285,0.0
620318,Rocco,Ascone,2024,2778,France,Villeneuve-d'Ascq,France,12-09-03,Central Midfield,Midfield,Left,180.0,30-06-28,SBE Management AG,https://img.a.transfermarkt.technology/portrait/header/620318-1697191931.jpg?lm=1,DK1,Fodbold Club NordsjÃ¦lland,400000.0,400000.0,21,95,-75,11,8,9,7,12,13,11,10,7,13,13,11,13,13,12,13,12,13,13,13,6,14,5,11,13,13,14,14,11,12,9,11,15,12,11,7,9,5,14,5,18,3,1,3,1,3,1,1,3,2,1,3,12,12,6,12,9,14,12,13,1,1,16,1,1,1,20,1,20,1,1,14,1,1,67,20,5,12810000,4099,4158,4131,Mediterranean_Hispanic,98,0,0,645.0,Football Club NordsjÃ¦lland,2000025176,9111392.0,2.0,34,1605,36,3,0,3,87,1,0.3004763164858428,0.436470588235294,0.3602941176470588,0.0006141325811818,0.0,0.0,0.0017504376094023,0.0017504376094023,0.0505924720131114,0.1428571428571428,0.3953488372093026,0.125,54,5,4,10,1,2732,0,0,0,350000,14285.714285714286,400000.0,50000.0,200000.0,400000.0,1,50000,-0.125,-0.125
620322,Malo,Gusto,2024,631,France,DÃ©cines-Charpieu,France,19-05-03,Right-Back,Defender,Right,178.0,30-06-30,E CASTAGNINO,https://img.a.transfermarkt.technology/portrait/header/620322-1672831209.jpg?lm=1,GB1,Chelsea Football Club,35000000.0,35000000.0,21,124,-85,5,12,10,5,12,5,10,9,10,12,12,5,13,13,12,12,13,11,9,11,10,14,12,8,14,11,13,15,15,14,11,10,15,15,15,12,11,12,14,7,17,3,1,2,3,1,3,3,2,2,3,2,19,12,8,10,10,11,13,18,1,1,1,20,1,20,14,1,15,1,1,11,1,1,67,6,20,63331488,6600,6200,2000,Mixed_Race,114,0,0,7671.0,Unknown,49056280,30000000.0,1.0,34,441,36,1,1,4,50,11,0.5706536120666843,0.2085561497326203,0.4779411764705882,0.0073985594921625,0.0,0.0,0.1747936984246061,0.1747936984246061,0.1666435178754965,0.0,0.3488372093023257,0.125,141,1,18,18,1,2581,12,44,68,35000000,2464285.714285714,35000000.0,0.0,9000000.0,32000000.0,2,2500000,0.0,0.4
621436,Daniil,Khlusevich,2024,232,Ukraine,Simferopol,Russia,26-02-01,Right-Back,Defender,Right,186.0,30-06-26,SIMF,https://img.a.transfermarkt.technology/portrait/header/621436-1642180172.png?lm=1,RU1,FK Spartak Moskva,5000000.0,5000000.0,23,122,-75,9,8,12,11,11,11,9,12,1,9,11,11,10,12,11,12,13,11,10,9,11,14,15,6,11,11,13,15,13,11,13,12,12,14,15,11,13,6,4,15,14,4,1,1,2,3,1,1,3,3,1,2,9,13,5,11,14,12,13,20,1,13,9,16,1,18,1,13,8,20,14,1,16,1,77,13,20,26847550,5750,5750,3513,Northern_European,111,0,0,24311.0,Unknown,58147636,3000000.0,1.0,103,1371,81,1,1,7,82,11,0.5111140513363324,0.370374331550802,0.4558823529411764,0.0234664307985558,0.0,0.0,0.0247561890472618,0.0247561890472618,0.0166393510930859,0.0,0.5348837209302322,0.2083333333333332,195,30,32,43,1,4209,6,20,80,4000000,218055.55555555556,5000000.0,1000000.0,275000.0,3500000.0,2,150000,-0.2,-0.2
621993,Andrew,Omobamidele,2024,703,Ireland,Leixlip,Ireland,23-06-02,Centre-Back,Defender,Right,188.0,30-06-28,Unknown,https://img.a.transfermarkt.technology/portrait/header/621993-1700738756.jpg?lm=1,GB1,Nottingham Forest Football Club,11000000.0,11000000.0,22,127,150,2,4,7,4,9,4,14,4,3,14,10,3,15,11,10,13,14,16,13,11,12,16,3,13,6,14,14,12,15,13,13,14,10,15,13,13,14,7,12,4,4,1,2,1,3,3,2,1,2,3,2,2,12,14,6,15,14,14,11,14,1,1,20,1,1,1,1,1,1,1,1,1,1,1,0,8,20,20934188,6350,6350,4005,Mixed_Race,127,5,0,20879.0,Unknown,29218111,12850000.0,1.0,49,818,52,1,1,4,140,2,0.590500132310135,0.4229946524064171,0.5735294117647058,0.0201524323416122,0.0328947368421052,0.0,0.0547636909227306,0.0547636909227306,0.0713630934192616,0.0,0.581395348837209,0.1666666666666666,125,7,1,16,0,4933,2,19,69,11000000,904166.6666666666,11000000.0,0.0,150000.0,6000000.0,1,5000000,0.0,0.0
622380,Cesare,Casadei,2024,631,Italy,Ravenna,Italy,10-01-03,Central Midfield,Midfield,Right,185.0,30-06-28,Unknown,https://img.a.transfermarkt.technology/portrait/header/622380-1692967622.jpg?lm=1,GB1,Chelsea Football Club,10000000.0,12000000.0,21,115,-9,6,8,10,14,13,12,15,10,5,7,13,12,9,13,10,14,12,13,12,12,13,14,12,10,15,10,13,12,11,12,14,15,13,13,11,12,14,7,15,5,12,2,1,2,3,1,1,1,3,2,1,2,19,13,1,11,11,18,10,16,1,1,1,1,1,1,15,1,20,1,1,16,1,1,72,10,20,40968281,5750,5750,3500,Mediterranean_Hispanic,115,0,0,14652.0,Unknown,43500064,14860000.0,1.0,52,1206,54,3,1,3,50,1,0.5111140513363324,0.3689839572192513,0.4852941176470588,0.0141395336261728,0.0,0.0,0.0497624406101525,0.0597649412353088,0.0825300702797299,0.0,0.5116279069767438,0.125,177,50,11,21,0,4841,0,0,0,10000000,1500000.0,12000000.0,2000000.0,,10000000.0,4,13000000,0.0,0.0
622461,Sergey,Babkin,2024,2696,Russia,Volgograd,Russia,25-09-02,Central Midfield,Midfield,Right,176.0,30-06-27,Shpinev Vadim,https://img.a.transfermarkt.technology/portrait/header/622461-1722144564.png?lm=1,RU1,PFK Krylya Sovetov Samara,1500000.0,1500000.0,22,98,-75,10,9,10,10,12,8,9,9,7,12,12,10,10,10,11,10,10,11,13,11,11,3,10,14,12,10,11,13,12,15,12,8,8,13,13,4,13,10,12,9,12,2,4,2,3,2,1,1,3,3,2,3,14,10,1,11,12,10,13,16,1,1,1,1,1,1,17,1,20,1,1,1,1,1,62,8,20,17454238,4775,4775,2102,Northern_European,99,0,0,7231.0,Krylja Sovetov Samara,58142349,500000.0,1.0,78,1626,81,3,1,7,149,1,0.3821116697539032,0.2194652406417112,0.3676470588235294,0.0069736878951185,0.0,0.0,0.0072518129532383,0.0072518129532383,0.0027500763910108,0.0,0.3023255813953489,0.1666666666666666,141,8,3,12,1,4028,2,14,61,1800000,147916.66666666666,1800000.0,100000.0,150000.0,1000000.0,3,350000,0.8,0.8
622988,Fran,Pérez,2024,1049,Spain,Valencia,Spain,09-09-02,Right Winger,Attack,Right,176.0,30-06-26,Wasserman,https://img.a.transfermarkt.technology/portrait/header/622988-1683212780.jpg?lm=1,ES1,Valencia Club de FÃºtbol S. A. D.,8000000.0,8000000.0,22,100,-8,10,12,14,10,10,8,5,9,5,8,9,3,7,14,12,13,6,7,6,10,14,13,13,3,10,8,9,10,14,14,5,11,15,14,10,7,7,5,10,11,10,1,2,1,1,1,3,3,2,3,2,2,8,10,6,11,10,13,12,13,1,1,1,1,1,1,1,14,1,18,18,1,20,11,77,8,20,11887497,4500,4500,500,Mediterranean_Hispanic,96,0,0,462.0,Unknown,95078306,9111392.0,2.0,89,1556,89,0,1,3,208,10,0.3457263826409102,0.0481283422459893,0.3455882352941176,0.0004374246215021,0.0,0.0,0.0397599399849962,0.0397599399849962,0.0505924720131114,0.1428571428571428,0.3023255813953489,0.1666666666666666,96,4,4,11,0,2562,1,4,23,4000000,354545.45454545453,8000000.0,2000000.0,100000.0,500000.0,1,4500000,-0.5,-0.5
623024,Jesús,Vázquez,2024,1049,Spain,MÃ©rida,Spain,02-01-03,Left-Back,Defender,Left,182.0,30-06-26,LEADERBROCK,https://img.a.transfermarkt.technology/portrait/header/623024-1644238446.jpg?lm=1,ES1,Valencia Club de FÃºtbol S. A. D.,3000000.0,5000000.0,21,127,-85,12,13,12,9,10,11,8,9,12,13,11,8,13,13,11,13,12,13,14,11,12,4,11,13,13,14,12,14,14,13,13,11,12,14,13,13,13,13,16,5,11,2,3,3,3,2,1,1,1,3,4,2,14,10,8,11,12,10,12,13,1,20,1,1,19,1,1,15,1,1,14,1,1,1,79,20,6,57000000,6350,6350,3250,Mediterranean_Hispanic,125,0,0,9182.0,Unknown,95078288,9111392.0,2.0,89,999,89,1,0,3,208,8,0.590500132310135,0.3422459893048128,0.5588235294117647,0.0088576071811024,0.0,0.0,0.0147536884221055,0.0247561890472618,0.0505924720131114,0.1428571428571428,0.4418604651162785,0.125,100,2,2,9,0,4507,2,9,32,4000000,300000.0,5000000.0,2000000.0,500000.0,2000000.0,1,500000,0.3333333333333333,1.0
623274,Maksim,Mukhin,2024,2410,Russia,"Togliatti, Samara Oblast",Russia,04-11-01,Defensive Midfield,Midfield,Right,183.0,30-06-26,Shpinev Vadim,https://img.a.transfermarkt.technology/portrait/header/623274-1690030980.png?lm=1,RU1,PFK CSKA Moskva,2500000.0,4000000.0,23,117,-8,10,9,10,6,13,9,11,7,7,13,11,8,11,12,18,14,15,10,14,8,11,14,9,10,8,11,18,18,13,15,13,10,15,13,16,6,13,12,11,10,9,3,1,4,3,1,3,4,2,2,1,2,14,14,3,5,12,14,11,10,1,1,1,1,1,1,20,1,16,1,1,10,1,1,67,14,20,20785201,5701,5701,3614,Northern_European,117,5,0,11506.0,Unknown,58152224,170000.0,1.0,78,1498,81,3,1,7,148,4,0.5046308547234718,0.3811764705882352,0.4999999999999999,0.0111017017073078,0.0328947368421052,0.0,0.0122530632658164,0.0197549387346836,0.0009166921303369,0.0,0.4651162790697669,0.2083333333333332,143,9,4,29,1,4517,7,40,233,2000000,108333.33333333333,4000000.0,500000.0,175000.0,3500000.0,3,2800000,-0.2857142857142857,-0.3333333333333333
623570,Iliman,Ndiaye,2024,29,France,Rouen,Senegal,06-03-00,Centre-Forward,Attack,Right,180.0,30-06-29,Classico,https://img.a.transfermarkt.technology/portrait/header/623570-1651653048.png?lm=1,GB1,Everton Football Club,15000000.0,18000000.0,24,125,148,8,10,14,13,14,10,12,12,6,5,12,10,7,13,6,11,4,12,12,11,12,5,15,13,14,8,10,12,14,15,13,8,12,14,11,7,12,15,11,11,10,1,1,2,3,3,3,1,3,2,1,1,8,12,1,11,10,11,10,16,1,1,1,1,1,1,1,1,1,1,15,20,15,20,69,12,20,11900752,6249,6249,3500,African_Caribbean,119,1,0,4640.0,Unknown,89063107,17500000.0,2.0,34,1256,84,0,1,1,65,3,0.5771368086795449,0.3689839572192513,0.5147058823529411,0.0044717735588886,0.006578947368421,0.0,0.0747686921730432,0.0897724431107777,0.0971971443651212,0.1428571428571428,0.3953488372093026,0.25,162,34,19,15,1,1904,1,2,10,18000000,1618181.8181818181,18000000.0,3000000.0,,,3,3500000,0.2,0.0
624037,Joris,Chotard,2024,969,France,Orange,France,24-09-01,Defensive Midfield,Midfield,Right,179.0,30-06-26,FAIR SPORT MNG,https://img.a.transfermarkt.technology/portrait/header/624037-1702663463.JPG?lm=1,FR1,Montpellier HÃ©rault Sport Club,10000000.0,10000000.0,23,123,147,8,8,12,8,13,9,10,8,5,11,14,6,13,14,13,13,14,12,13,13,13,13,13,9,12,13,14,14,13,14,14,12,14,12,13,14,14,13,13,8,10,2,2,1,2,3,1,2,3,2,2,3,19,13,8,12,13,15,12,12,1,1,1,1,1,1,20,1,19,1,1,1,1,1,70,8,20,9824000,6149,6149,3907,Northern_European,125,0,0,9500.0,Unknown,49048599,9111392.0,2.0,34,1088,36,3,1,7,133,4,0.5639057951839112,0.4125133689839572,0.5588235294117647,0.0091646734716934,0.0,0.0,0.0497624406101525,0.0497624406101525,0.0505924720131114,0.1428571428571428,0.3720930232558141,0.2083333333333332,195,3,11,29,0,2078,3,6,29,9000000,566666.6666666666,10000000.0,1000000.0,7000000.0,10000000.0,0,0,-0.1,-0.1
624258,Conor,Bradley,2024,31,Northern Ireland,Castlederg,Northern Ireland,09-07-03,Right-Back,Defender,Right,181.0,30-06-27,Unknown,https://img.a.transfermarkt.technology/portrait/header/624258-1708933100.jpg?lm=1,GB1,Liverpool Football Club,15000000.0,15000000.0,21,118,-8,8,12,12,11,13,8,8,9,8,11,12,8,10,13,12,11,12,12,12,12,11,13,12,8,12,10,14,13,15,14,12,9,15,14,13,9,13,7,13,7,12,3,3,1,2,2,1,1,1,1,3,3,14,15,4,13,13,12,10,12,1,1,1,19,1,20,1,1,1,16,1,1,13,1,0,7,20,49180496,5900,6100,4255,Northern_European,115,8,0,2900.0,Bolton Wanderers,28127166,9111392.0,2.0,70,332,72,1,1,7,129,11,0.5574225985710506,0.4497326203208556,0.4852941176470588,0.0027915995160326,0.0526315789473684,0.0,0.0747686921730432,0.0747686921730432,0.0505924720131114,0.1428571428571428,0.418604651162791,0.125,0,0,0,0,0,0,3,40,128,20000000,2800000.0,20000000.0,0.0,1000000.0,15000000.0,2,1000000,0.3333333333333333,9.0
624690,Manu,Koné,2024,12,France,Colombes,France,17-05-01,Central Midfield,Midfield,Right,185.0,30-06-29,ESN,https://img.a.transfermarkt.technology/portrait/header/624690-1691248968.jpg?lm=1,IT1,Associazione Sportiva Roma,20000000.0,40000000.0,23,134,162,4,8,16,11,13,5,11,11,4,12,14,7,15,15,16,13,16,13,12,13,13,16,16,6,13,12,13,15,14,13,13,11,15,13,15,16,13,14,14,7,12,2,1,1,1,2,3,1,3,2,4,4,17,16,8,10,15,14,8,8,1,1,1,1,1,1,18,1,20,1,1,14,1,1,80,8,20,27060002,6800,5886,6036,African_Caribbean,133,0,0,44490.0,Unknown,49047182,13500000.0,2.0,34,375,36,3,1,1,29,1,0.5291082296903943,0.6402139037433154,0.6176470588235294,0.0429516216093556,0.0,0.0,0.0997749437359339,0.1997999499874969,0.0749743048418011,0.1428571428571428,0.5116279069767438,0.2083333333333332,196,15,7,47,1,4275,13,31,69,26000000,1520588.2352941176,40000000.0,10000000.0,5400000.0,15000000.0,2,14000000,0.3,-0.2571428571428571
624913,Parfait,Guiagon,2024,172,Unknown,Unknown,Cote d'Ivoire,22-02-01,Attacking Midfield,Midfield,Right,169.0,30-06-26,Unknown,https://img.a.transfermarkt.technology/portrait/header/624913-1653328365.png?lm=1,BE1,Royal Charleroi Sporting Club,1800000.0,2000000.0,23,115,145,11,12,14,10,13,11,7,10,4,7,13,8,10,14,11,10,13,11,11,14,10,15,13,11,11,7,13,13,12,14,8,5,14,13,12,9,11,11,13,9,11,2,3,2,1,3,1,1,1,2,2,1,14,16,12,5,8,11,11,8,1,1,1,1,10,10,1,12,18,12,17,20,15,12,0,12,20,1721998,5748,5083,3235,African_Caribbean,112,0,0,4487.0,Unknown,12078200,9111392.0,2.0,105,1549,24,3,1,1,174,0,0.4228631913204551,0.3406417112299464,0.463235294117647,0.0043240341171892,0.0,0.0,0.0087521880470117,0.0097524381095273,0.0505924720131114,0.1428571428571428,0.13953488372093,0.2083333333333332,157,26,19,17,2,2643,4,8,20,2000000,159090.9090909091,2000000.0,200000.0,,600000.0,3,1250000,0.1111111111111111,0.1111111111111111
624920,Béni,Makouana,2024,53646,Congo,Brazzaville,Congo,28-09-02,Left Winger,Attack,Right,182.0,30-06-28,Unknown,https://img.a.transfermarkt.technology/portrait/header/624920-1708966249.png?lm=1,UKR1,FK Polissya Zhytomyr,1200000.0,1200000.0,22,108,135,4,10,12,11,12,6,7,8,4,6,9,7,5,12,8,11,10,10,8,8,11,14,12,8,12,5,13,13,15,11,11,10,12,17,11,12,12,9,9,11,10,1,1,3,3,3,1,4,1,1,1,2,13,12,8,9,13,14,14,12,1,1,1,1,1,1,1,1,1,1,17,1,15,20,73,5,20,3503999,5400,5400,2504,African_Caribbean,93,10,0,2888.0,Unknown,2000059092,525000.0,2.0,21,247,22,0,1,1,80,7,0.4648055041016142,0.2624598930481283,0.3235294117647059,0.0027800121088405,0.0657894736842105,0.0,0.0057514378594648,0.0057514378594648,0.0028889691380316,0.1428571428571428,0.4418604651162785,0.1666666666666666,66,5,4,9,0,1320,2,26,155,800000,59090.90909090909,1200000.0,400000.0,150000.0,600000.0,1,600000,-0.3333333333333333,-0.3333333333333333
624942,Raúl,Moro,2024,366,Spain,Abrera,Spain,05-12-02,Left Winger,Attack,Right,169.0,30-06-28,YOU FIRST,https://img.a.transfermarkt.technology/portrait/header/624942-1632729036.jpg?lm=1,ES1,Real Valladolid Club de FÃºtbol S.A.D.,2500000.0,3000000.0,22,111,-75,12,11,13,12,13,11,7,9,3,4,12,11,5,13,12,10,11,9,8,12,10,14,14,10,14,5,11,10,14,15,12,6,15,14,10,8,12,11,13,8,17,1,1,3,1,3,3,1,1,4,3,3,13,14,8,14,12,14,16,16,1,1,1,1,6,8,1,11,1,13,20,15,18,14,65,11,20,32700000,5550,5150,3500,Mediterranean_Hispanic,107,0,0,17787.0,Ternana Calcio,43612084,9111392.0,2.0,89,17,89,0,1,3,169,7,0.4317279703625297,0.3689839572192513,0.4264705882352941,0.0171667437551117,0.0,0.0,0.0122530632658164,0.0147536884221055,0.0505924720131114,0.1428571428571428,0.13953488372093,0.1666666666666666,141,29,18,14,0,2853,2,16,72,5000000,420000.0,5000000.0,300000.0,3000000.0,2500000.0,4,2500000,1.0,1.0
625014,Julen,Agirrezabala,2024,621,Spain,Donostia-San SebastiÃ¡n,Spain,26-12-00,Goalkeeper,Goalkeeper,Left,187.0,30-06-27,YOU FIRST,https://img.a.transfermarkt.technology/portrait/header/625014-1709674945.png?lm=1,ES1,Athletic Club Bilbao,5000000.0,5000000.0,23,124,151,7,3,3,1,9,9,2,3,1,3,9,1,1,9,7,13,15,10,12,9,14,13,1,3,2,14,11,10,13,13,7,15,10,13,5,13,14,14,11,9,12,14,12,12,5,12,10,13,15,8,9,12,12,11,4,11,9,11,12,14,20,1,1,1,1,1,1,1,1,1,1,1,1,1,0,20,8,11309999,6200,6200,4700,Mediterranean_Hispanic,123,0,0,6932.0,Unknown,67277830,9111392.0,2.0,89,423,89,2,0,3,33,5,0.5706536120666843,0.4973262032085561,0.5441176470588236,0.0066849683325817,0.0,0.0,0.0247561890472618,0.0247561890472618,0.0505924720131114,0.1428571428571428,0.5581395348837206,0.2083333333333332,0,0,0,0,0,0,4,14,40,15000000,1067857.142857143,15000000.0,0.0,,5000000.0,1,0,2.0,2.0
625047,Beñat,Prados,2024,621,Spain,Pamplona,Spain,08-02-01,Central Midfield,Midfield,Right,180.0,30-06-31,CAA Stellar,https://img.a.transfermarkt.technology/portrait/header/625047-1709675858.png?lm=1,ES1,Athletic Club Bilbao,15000000.0,15000000.0,23,105,139,6,9,9,4,12,9,10,8,9,9,15,4,8,13,9,10,10,15,6,13,15,15,5,2,10,9,14,11,11,11,15,8,16,11,11,5,11,12,6,5,15,2,2,2,4,3,2,2,2,2,2,2,8,10,5,11,12,10,13,16,1,1,15,1,1,1,20,1,19,1,1,1,1,1,67,11,20,2239999,5250,5250,2754,Mediterranean_Hispanic,88,0,0,1789.0,MirandÃ©s,67277835,9111392.0,2.0,89,1115,89,3,1,3,33,1,0.4449589838581635,0.2891978609625668,0.286764705882353,0.0017187987334963,0.0,0.0,0.0747686921730432,0.0747686921730432,0.0505924720131114,0.1428571428571428,0.3953488372093026,0.2083333333333332,174,6,3,40,1,2232,2,4,16,20000000,1534615.3846153845,20000000.0,0.0,,500000.0,2,900000,0.3333333333333333,5.666666666666667
625202,Lautaro,Valenti,2024,130,Argentina,Rosario,Argentina,14-01-99,Centre-Back,Defender,Left,188.0,30-06-27,Unknown,https://img.a.transfermarkt.technology/portrait/header/625202-1725530168.jpg?lm=1,IT1,Parma Calcio 1913,1800000.0,5000000.0,25,113,135,7,7,11,8,10,10,13,12,5,12,12,10,13,10,16,13,10,13,8,9,9,15,13,10,7,11,13,13,13,11,11,15,16,13,14,16,13,12,10,15,5,2,2,1,2,4,1,3,3,2,1,2,9,14,14,12,10,15,10,8,1,1,20,1,1,1,1,1,1,1,1,1,1,1,76,20,11,5684337,5650,6237,4246,Mediterranean_Hispanic,113,0,0,14615.0,Unknown,14185196,10500000.0,1.0,4,1248,4,1,0,3,155,2,0.5755490870600688,0.4487700534759358,0.4705882352941176,0.0141038057873305,0.0,0.0,0.0087521880470117,0.0247561890472618,0.058307175199311,0.0,0.581395348837209,0.2916666666666665,86,5,5,18,1,2778,10,66,273,1500000,96153.84615384616,5000000.0,1200000.0,,3000000.0,1,2300000,-0.16666666666666666,-0.5
625651,Urko,González De Zarate,2024,681,Spain,Vitoria-Gasteiz,Spain,20-03-01,Defensive Midfield,Midfield,Right,189.0,30-06-28,IDUB GLOBAL,https://img.a.transfermarkt.technology/portrait/header/625651-1694171507.jpg?lm=1,ES1,Real Sociedad de FÃºtbol S.A.D.,1200000.0,1500000.0,23,110,-8,7,8,7,10,15,10,12,11,8,12,15,8,15,15,12,12,11,13,10,9,12,16,10,11,10,15,10,12,12,12,11,14,14,12,9,7,13,10,17,9,16,4,1,1,3,3,1,3,3,2,3,1,8,11,3,12,10,13,11,13,1,1,20,1,1,1,20,1,1,1,1,1,1,1,83,10,20,53250001,5450,5450,2250,Mediterranean_Hispanic,114,0,0,2466.0,Unknown,2000058330,9111392.0,2.0,89,1617,89,3,1,3,168,4,0.4714210108494311,0.2352941176470588,0.4779411764705882,0.0023725216225846,0.0,0.0,0.0057514378594648,0.0072518129532383,0.0505924720131114,0.1428571428571428,0.6046511627906974,0.2083333333333332,0,0,0,0,0,0,3,10,24,1200000,95833.33333333333,1500000.0,300000.0,,1000000.0,1,800000,0.0,-0.2
626724,Unknown,João Pedro,2024,1237,Brazil,RibeirÃ£o Preto,Brazil,26-09-01,Centre-Forward,Attack,Right,188.0,30-06-28,Promanager,https://img.a.transfermarkt.technology/portrait/header/626724-1724792744.jpg?lm=1,GB1,Brighton and Hove Albion Football Club,50000000.0,50000000.0,23,135,148,11,12,11,13,14,11,13,11,3,4,14,15,5,15,13,13,13,14,13,13,14,15,14,14,16,5,13,14,14,13,14,13,17,13,14,12,15,13,12,9,13,2,3,1,2,1,2,2,1,2,4,3,8,15,10,10,12,15,10,11,1,1,1,1,1,1,1,9,10,9,12,17,12,20,75,10,20,10295772,6800,6750,6700,Mixed_Race,135,0,0,80127.0,Unknown,19069586,22850000.0,2.0,10,1227,11,0,1,4,44,3,0.6434241862926701,0.7112299465240641,0.6323529411764706,0.0773633241181259,0.0,0.0,0.2498124531132783,0.2498124531132783,0.1269201922275618,0.1428571428571428,0.581395348837209,0.2083333333333332,205,59,18,20,0,1503,5,28,57,50000000,1578947.3684210526,50000000.0,3000000.0,15000000.0,20000000.0,2,5000000,0.1111111111111111,0.42857142857142855
626913,Boulaye,Dia,2024,398,France,Oyonnax,Senegal,16-11-96,Centre-Forward,Attack,Left,180.0,30-06-26,VV Consulting,https://img.a.transfermarkt.technology/portrait/header/626913-1662127119.jpg?lm=1,IT1,SocietÃ  Sportiva Lazio S.p.A.,10000000.0,25000000.0,28,137,145,8,11,14,14,12,8,13,11,6,5,12,13,6,13,8,13,13,12,12,10,11,14,13,10,14,9,12,13,17,14,14,13,14,17,15,14,14,9,13,9,9,2,3,2,4,2,1,1,3,2,3,2,12,14,3,12,10,10,11,17,1,1,1,1,1,1,1,1,1,1,10,1,15,20,75,20,7,9060929,6845,6495,4249,African_Caribbean,137,17,2,19911.0,U.S. Salernitana 1919,50065334,13200000.0,2.0,34,1105,84,0,0,1,185,3,0.6096851018788039,0.449090909090909,0.6470588235294117,0.0192177148281153,0.1118421052631578,0.0263157894736842,0.0497624406101525,0.1247811952988247,0.0733075918775521,0.1428571428571428,0.3953488372093026,0.4166666666666665,232,83,20,17,0,2719,10,95,299,15000000,650000.0,25000000.0,5000000.0,,,3,5000000,0.5,-0.16666666666666666
627068,Ezequiel,Bullaude,2024,385,Argentina,MaipÃº,Argentina,26-10-00,Attacking Midfield,Midfield,Right,184.0,30-06-25,MVP Group,https://img.a.transfermarkt.technology/portrait/header/627068-1662984188.jpg?lm=1,NL1,Fortuna Sittardia Combinatie,2200000.0,4500000.0,24,127,142,11,9,14,13,14,11,6,12,5,6,13,11,10,14,14,13,7,13,11,13,12,14,14,12,13,11,9,15,13,14,11,11,13,13,14,8,11,7,10,6,12,3,2,3,1,2,1,3,3,3,2,1,15,13,5,15,11,14,17,6,1,1,1,1,1,1,1,12,15,10,15,20,13,12,77,11,20,9158499,6450,6450,3600,Mediterranean_Hispanic,125,0,0,10000.0,Unknown,14207820,2000000.0,1.0,4,895,4,3,1,3,94,0,0.6037311458057687,0.3796791443850267,0.5588235294117647,0.009647482104698,0.0,0.0,0.010752688172043,0.0222555638909727,0.0110836412122558,0.0,0.4883720930232553,0.25,152,31,14,14,0,4114,0,0,0,2500000,202083.33333333334,4500000.0,1500000.0,75000.0,3800000.0,4,775000,0.13636363636363635,-0.10714285714285714
627207,Ricardo,Pepi,2024,383,United States,"El Paso, Texas",United States,09-01-03,Centre-Forward,Attack,Right,185.0,30-06-28,SXI,https://img.a.transfermarkt.technology/portrait/header/627207-1658600752.jpg?lm=1,NL1,Eindhovense Voetbalvereniging Philips Sport Vereniging,12000000.0,12000000.0,21,112,-8,6,9,11,12,11,8,13,10,8,6,10,13,6,10,11,13,12,11,11,10,11,12,10,7,13,6,10,11,12,11,11,13,13,14,13,9,12,7,2,3,10,1,1,2,1,2,2,2,2,3,1,3,11,13,8,12,12,11,13,20,1,1,1,1,1,1,1,1,1,1,1,12,1,20,78,12,20,68416000,5850,6211,3733,Mediterranean_Hispanic,106,11,3,6904.0,FC Groningen,20048604,13680000.0,2.0,104,453,102,0,1,3,62,3,0.5721090235512041,0.393903743315508,0.4191176470588235,0.0066579310491335,0.0723684210526315,0.0394736842105263,0.0597649412353088,0.0597649412353088,0.0759743326203505,0.1428571428571428,0.5116279069767438,0.125,190,67,14,8,0,3536,4,25,154,18000000,1353846.1538461538,18000000.0,1000000.0,8000000.0,11000000.0,3,4000000,0.5,0.6363636363636364
627222,Unknown,Talles Costa,2024,53646,Brazil,SÃ£o Paulo,Brazil,02-08-02,Central Midfield,Midfield,Right,176.0,31-12-27,ROGON,https://img.a.transfermarkt.technology/portrait/header/627222-1707054877.png?lm=1,UKR1,FK Polissya Zhytomyr,1800000.0,2000000.0,22,115,135,11,12,13,8,13,11,9,9,9,10,13,7,11,12,9,12,9,12,11,14,12,12,11,9,11,12,14,10,13,14,9,8,13,12,11,8,20,15,5,9,10,2,1,2,2,3,3,1,2,2,1,1,13,11,1,10,13,10,11,12,1,1,1,1,1,1,13,12,20,14,1,16,1,1,65,12,20,6157081,5686,5686,2244,African_Caribbean,112,0,0,3851.0,Unknown,19375654,1000000.0,1.0,10,1456,11,3,1,1,80,1,0.5026462026991267,0.2346524064171123,0.463235294117647,0.0037099015360073,0.0,0.0,0.0087521880470117,0.0097524381095273,0.0055279313314258,0.0,0.3023255813953489,0.1666666666666666,82,1,7,17,0,3800,2,37,126,1500000,30000.0,2000000.0,300000.0,1200000.0,2000000.0,1,200000,-0.16666666666666666,-0.25
627224,Unknown,Gabriel Silva,2024,2423,Brazil,RibeirÃ£o Preto,Brazil,22-03-02,Right Winger,Attack,Right,177.0,30-06-25,Unknown,https://img.a.transfermarkt.technology/portrait/header/627224-1598272630.jpg?lm=1,PO1,Clube Desportivo Santa Clara,1700000.0,2500000.0,22,114,-75,12,13,13,12,12,12,10,11,6,5,11,13,7,13,10,9,10,11,9,11,9,13,14,7,12,5,9,10,13,13,12,8,12,13,13,7,8,11,12,8,12,3,2,3,3,1,2,2,1,3,3,3,10,15,12,11,8,9,10,8,1,1,1,1,1,1,1,8,12,11,17,19,20,19,71,11,20,16623124,5700,5700,3700,Mediterranean_Hispanic,106,0,0,3596.0,Santa Clara AÃ§ores Futebol,19360961,1500000.0,1.0,10,1227,11,0,1,3,57,10,0.5044985445885155,0.3903743315508021,0.4191176470588235,0.003463669133175,0.0,0.0,0.0082520630157539,0.0122530632658164,0.0083057862718408,0.0,0.3255813953488373,0.1666666666666666,127,24,15,14,1,3134,2,5,52,2500000,194444.44444444444,2500000.0,500000.0,900000.0,2500000.0,1,0,0.47058823529411764,0.25
627228,Yan,Couto,2024,16,Brazil,Curitiba,Brazil,03-06-02,Right-Back,Defender,Right,168.0,30-06-25,CAA Stellar,https://img.a.transfermarkt.technology/portrait/header/627228-1723922216.jpg?lm=1,L1,Borussia Dortmund,25000000.0,25000000.0,22,132,-8,12,14,14,10,13,10,10,10,12,12,14,11,9,14,10,13,11,14,13,14,14,12,13,9,14,11,14,12,13,14,15,5,13,13,13,10,13,7,7,6,12,1,2,3,1,1,2,2,2,1,3,2,14,13,6,12,11,12,8,12,1,10,1,19,1,20,1,1,1,14,1,1,13,1,65,11,20,71914876,6550,6150,4158,Mixed_Race,130,0,0,5800.0,Girona,19383257,6000000.0,1.0,10,398,11,1,1,4,41,11,0.5640381053188674,0.4393582887700534,0.5955882352941175,0.0055918895874593,0.0,0.0,0.1247811952988247,0.1247811952988247,0.0333064807355759,0.0,0.1162790697674416,0.1666666666666666,159,6,22,26,0,2867,4,10,24,25000000,1411764.705882353,25000000.0,2000000.0,3000000.0,4000000.0,5,5000000,0.0,1.0833333333333333
627442,Benjamin,Sesko,2024,23826,Slovenia,Rade?e,Slovenia,31-05-03,Centre-Forward,Attack,Right,195.0,30-06-29,Pro transfer,https://img.a.transfermarkt.technology/portrait/header/627442-1713897956.jpg?lm=1,L1,RasenBallsport Leipzig,50000000.0,50000000.0,21,133,-9,7,8,13,14,13,8,14,9,5,6,12,11,8,13,13,12,13,13,12,11,12,14,12,7,16,4,12,14,16,12,13,17,14,14,13,14,12,8,11,7,8,2,1,2,2,1,2,1,3,1,1,1,10,12,1,11,10,12,9,11,1,1,1,1,1,1,1,1,1,1,1,1,1,20,77,8,20,24000001,7005,6652,5005,Northern_European,133,13,2,11988.0,Unknown,62246208,13250000.0,2.0,87,1201,87,0,1,7,162,3,0.6304577930669489,0.5299465240641711,0.6176470588235294,0.0115671292295243,0.0855263157894736,0.0263157894736842,0.2498124531132783,0.2498124531132783,0.0735853773715936,0.1428571428571428,0.7441860465116279,0.125,210,94,24,10,2,4455,3,13,30,50000000,2867647.0588235296,50000000.0,150000.0,10000000.0,50000000.0,2,9000000,0.0,0.6666666666666666
628366,Lucas,Beltrán,2024,430,Argentina,CÃ³rdoba,Argentina,29-03-01,Centre-Forward,Attack,Right,176.0,30-06-28,Leduar Football,https://img.a.transfermarkt.technology/portrait/header/628366-1692881138.jpg?lm=1,IT1,Associazione Calcio Fiorentina,16000000.0,16000000.0,23,124,135,7,7,12,13,10,7,14,12,10,5,11,6,9,13,15,12,12,13,13,9,12,12,8,10,14,11,12,15,13,12,14,10,14,13,14,16,11,8,2,7,6,2,1,2,1,3,3,3,1,1,2,1,13,10,7,8,13,14,7,10,1,1,1,1,1,1,1,1,1,1,12,1,14,20,75,10,20,3979862,6059,6059,3475,Northern_European,122,0,0,10743.0,Unknown,14217414,12600000.0,1.0,4,400,4,0,1,7,26,3,0.5519978830378407,0.3663101604278074,0.536764705882353,0.0103649357333428,0.0,0.0,0.0797699424856214,0.0797699424856214,0.0699741659490541,0.0,0.3023255813953489,0.2083333333333332,199,43,19,15,0,5433,4,8,16,18000000,1590909.0909090908,18000000.0,0.0,,500000.0,3,500000,0.125,0.5
628451,Roméo,Lavia,2024,631,Belgium,Brussels,Belgium,06-01-04,Defensive Midfield,Midfield,Right,181.0,30-06-30,Unknown,https://img.a.transfermarkt.technology/portrait/header/628451-1683898478.jpg?lm=1,GB1,Chelsea Football Club,35000000.0,50000000.0,20,124,-9,5,7,12,8,14,11,7,11,5,10,14,5,13,14,15,15,12,9,11,12,13,16,14,12,13,13,14,14,15,14,12,9,14,14,13,13,12,6,11,7,8,2,2,3,1,1,3,1,1,1,2,1,10,18,6,8,10,10,12,15,1,1,1,1,1,1,20,1,18,14,1,12,12,1,0,7,20,79523934,6194,6194,3744,African_Caribbean,125,0,0,46397.0,Unknown,18115012,42180000.0,2.0,7,266,8,3,1,1,50,4,0.5698597512569463,0.3950802139037432,0.5588235294117647,0.0447930537356352,0.0,0.0,0.1747936984246061,0.2498124531132783,0.2343120642240062,0.1428571428571428,0.418604651162791,0.0833333333333332,0,0,0,0,0,0,8,74,186,40000000,3900000.0,50000000.0,10000000.0,25000000.0,40000000.0,2,41000000,0.14285714285714285,-0.2
628487,Ángel,Fortuño,2024,714,Spain,Barcelona,Spain,05-10-01,Goalkeeper,Goalkeeper,Right,183.0,30-06-25,MagicPlayers,https://img.a.transfermarkt.technology/portrait/header/default.jpg?lm=1,ES1,Reial Club Deportiu Espanyol de Barcelona S.A.D.,300000.0,400000.0,23,100,136,4,1,3,2,7,7,1,2,1,1,12,3,3,3,5,14,12,8,8,9,14,15,1,10,1,14,8,9,11,8,9,6,16,10,4,8,9,12,8,14,12,10,10,9,5,15,14,12,14,6,5,10,9,13,2,10,11,12,12,18,20,1,1,1,1,1,1,1,1,1,1,1,1,1,0,10,20,1949999,5000,5000,1500,Mediterranean_Hispanic,99,0,0,1294.0,Unknown,67295931,9111392.0,2.0,89,141,89,2,1,3,170,5,0.4118814501190792,0.1550802139037433,0.3676470588235294,0.0012408181868218,0.0,0.0,0.0012503125781445,0.0017504376094023,0.0505924720131114,0.1428571428571428,0.4651162790697669,0.2083333333333332,0,0,0,0,0,0,0,0,0,300000,20000.0,400000.0,100000.0,,400000.0,1,0,0.0,0.0
628498,Jofre,Carreras,2024,714,Spain,Girona,Spain,17-06-01,Right Winger,Attack,Right,175.0,30-06-26,MSSports,https://img.a.transfermarkt.technology/portrait/header/628498-1701787554.jpg?lm=1,ES1,Reial Club Deportiu Espanyol de Barcelona S.A.D.,1800000.0,1800000.0,23,114,139,14,13,12,11,9,11,7,9,7,6,11,8,5,11,9,12,9,11,12,12,12,11,13,7,13,7,11,11,14,13,12,8,11,13,12,9,11,14,7,13,9,2,2,3,1,2,1,2,1,2,3,1,9,9,2,11,11,11,10,20,1,1,1,1,1,1,1,1,14,16,14,1,20,1,68,14,20,3029999,5700,5700,1700,Mediterranean_Hispanic,111,0,0,3339.0,MirandÃ©s,67277677,9111392.0,2.0,89,540,89,0,1,3,170,10,0.5044985445885155,0.1764705882352941,0.4558823529411764,0.0032155054958106,0.0,0.0,0.0087521880470117,0.0087521880470117,0.0505924720131114,0.1428571428571428,0.2790697674418605,0.2083333333333332,133,13,9,15,1,2053,2,15,113,4000000,303846.1538461539,4000000.0,0.0,,50000.0,2,400000,1.2222222222222223,3.0
629588,Nathan,Ngoumou,2024,18,France,Toulouse,France,14-03-00,Right Winger,Attack,Right,185.0,30-06-27,NexSt11,https://img.a.transfermarkt.technology/portrait/header/629588-1662966435.jpg?lm=1,L1,Borussia Verein fÃ¼r LeibesÃ¼bungen 1900 MÃ¶nchengladbach,5000000.0,7000000.0,24,123,148,4,12,14,11,12,7,12,9,4,6,12,8,8,13,11,12,12,11,10,11,11,13,13,4,13,7,12,12,16,13,12,12,13,16,11,10,12,4,12,6,14,1,4,1,3,1,1,2,1,3,4,3,11,13,6,12,11,13,12,11,1,1,1,1,1,12,1,15,10,18,15,14,20,12,72,8,20,7981200,6250,5850,4500,African_Caribbean,118,0,0,19177.0,Unknown,49037694,8000000.0,1.0,34,1512,36,0,1,1,42,10,0.5243450648319662,0.4759358288770053,0.5073529411764706,0.0185089517548645,0.0,0.0,0.0247561890472618,0.0347586896724181,0.044417900497236,0.0,0.5116279069767438,0.25,165,27,9,4,2,2629,4,9,36,3500000,200000.0,7000000.0,2000000.0,,450000.0,1,4500000,-0.3,-0.3
631002,Raúl,García,2024,331,Spain,Olesa de Montserrat,Spain,03-11-00,Centre-Forward,Attack,Right,192.0,30-06-28,Unknown,https://img.a.transfermarkt.technology/portrait/header/631002-1614090749.jpg?lm=1,ES1,Club AtlÃ©tico Osasuna,4000000.0,4000000.0,24,147,175,10,11,11,14,14,11,16,17,10,11,14,15,12,13,15,14,15,16,14,13,15,14,13,13,15,15,16,15,11,12,12,12,16,12,14,15,14,15,13,11,14,3,1,3,1,3,3,3,2,2,3,4,15,14,9,15,9,15,7,8,1,1,1,1,1,1,1,10,16,13,6,20,13,18,84,13,20,6073476,7350,7350,6600,Mediterranean_Hispanic,146,2,0,159999.0,Unknown,1502117,9111392.0,2.0,89,1078,89,0,1,3,51,3,0.7228102672664726,0.7005347593582887,0.713235294117647,0.1544891063888135,0.0131578947368421,0.0,0.0197549387346836,0.0197549387346836,0.0505924720131114,0.1428571428571428,0.6744186046511627,0.25,167,52,13,12,0,1374,0,0,0,3500000,246428.57142857142,4000000.0,1000000.0,,500000.0,2,1300000,-0.125,0.16666666666666666
631007,Filippo,Terracciano,2024,5,Italy,Verona,Italy,08-02-03,Right-Back,Defender,Right,186.0,30-06-28,Unknown,https://img.a.transfermarkt.technology/portrait/header/631007-1663671440.jpg?lm=1,IT1,Associazione Calcio Milan,4500000.0,4500000.0,21,122,-8,5,12,12,8,9,5,10,8,11,12,12,5,12,12,13,11,13,10,11,10,12,13,7,7,13,12,12,13,14,13,13,13,12,14,15,12,12,8,10,7,12,3,4,3,3,2,1,3,3,2,3,1,12,13,12,13,13,15,12,12,1,1,1,20,1,20,1,1,14,18,1,1,1,1,0,9,20,19500802,6100,6100,1000,Mediterranean_Hispanic,115,0,0,13815.0,Unknown,43500821,4500000.0,1.0,52,1577,54,1,1,3,27,11,0.5574225985710506,0.1016042780748663,0.4852941176470588,0.0133313119745231,0.0,0.0,0.0222555638909727,0.0222555638909727,0.0249729159143309,0.0,0.5348837209302322,0.125,130,4,7,14,0,3302,1,1,8,4500000,472222.22222222225,4500000.0,0.0,,3500000.0,2,1750000,0.0,0.2857142857142857
631821,Vladyslav,Vanat,2024,338,Ukraine,"Kamyanets-Podilskyi, Khmelnytskyi Oblast",Ukraine,04-01-02,Centre-Forward,Attack,Left,182.0,30-06-27,ProStar,https://img.a.transfermarkt.technology/portrait/header/631821-1726135390.png?lm=1,UKR1,Futbolniy Klub Dynamo Kyiv,10000000.0,10000000.0,22,108,-75,7,8,12,14,12,5,10,5,6,4,10,11,5,12,13,13,11,13,8,7,11,17,13,6,13,6,12,12,14,12,11,11,12,12,11,11,11,8,10,8,8,3,1,2,3,2,1,3,3,1,3,2,5,8,2,15,12,12,11,11,1,1,1,1,1,1,1,8,1,3,15,4,9,20,69,20,12,22630493,4991,4991,1607,Northern_European,106,0,0,2320.0,Unknown,71113671,9111392.0,2.0,103,706,101,0,0,7,97,3,0.4106906589044721,0.166524064171123,0.4191176470588235,0.0022315415017472,0.0,0.0,0.0497624406101525,0.0497624406101525,0.0505924720131114,0.1428571428571428,0.4418604651162785,0.1666666666666666,119,46,19,16,0,1956,3,2,14,11000000,990909.0909090909,11000000.0,0.0,,800000.0,2,100000,0.1,2.6666666666666665
631904,Anselmo,García Macnulty,2024,1269,Spain,Sevilla,Ireland,19-02-03,Centre-Back,Defender,Left,190.0,30-06-26,LEADERBROCK,https://img.a.transfermarkt.technology/portrait/header/631904-1724751208.jpg?lm=1,NL1,Prins Hendrik Ende Desespereert Nimmer Combinatie Zwolle,1000000.0,1000000.0,21,106,-75,3,8,12,8,12,5,12,10,6,12,13,9,12,13,17,10,12,15,10,13,9,16,12,13,8,12,12,15,13,12,14,14,14,13,11,12,14,12,13,5,10,2,1,2,2,2,3,1,2,3,1,1,16,15,7,8,13,15,16,14,1,10,20,1,1,1,14,1,1,1,1,1,1,1,80,20,8,18989999,5250,5250,2778,Northern_European,108,0,0,9588.0,NAC Breda,2000065864,9111392.0,2.0,89,1364,52,1,0,7,156,2,0.4449589838581635,0.2917647058823529,0.4338235294117646,0.0092496477911022,0.0,0.0,0.0047511877969492,0.0047511877969492,0.0505924720131114,0.1428571428571428,0.6279069767441858,0.125,131,7,4,34,0,2216,0,0,0,1000000,70000.0,1000000.0,0.0,300000.0,750000.0,3,400000,0.0,0.3333333333333333
631927,Saud,Abdulhamid,2024,12,Saudi Arabia,Jeddah,Saudi Arabia,18-07-99,Right-Back,Defender,Right,175.0,30-06-28,TKS,https://img.a.transfermarkt.technology/portrait/header/631927-1697052549.png?lm=1,IT1,Associazione Sportiva Roma,4000000.0,4000000.0,25,117,135,12,12,11,10,12,12,10,10,10,13,11,7,12,11,7,11,10,11,12,12,13,14,8,8,12,13,11,13,13,11,12,11,12,12,12,14,12,8,11,10,6,1,1,3,3,3,2,2,2,1,3,3,12,13,7,13,13,11,12,11,1,1,10,20,1,15,1,1,1,11,1,1,8,1,69,11,20,3315067,5901,5901,1906,North_African__Middle_Eastern,116,15,0,23204.0,Unknown,2000042460,2500000.0,1.0,81,687,82,1,1,6,29,11,0.5310928817147393,0.1985026737967914,0.4926470588235294,0.0223974924850836,0.0986842105263157,0.0,0.0197549387346836,0.0197549387346836,0.0138614961526709,0.0,0.2790697674418605,0.2916666666666665,0,0,0,0,0,0,0,0,0,4000000,303846.1538461539,4000000.0,0.0,,250000.0,2,350000,0.0,0.42857142857142855
631996,Brandon,Aguilera,2024,2425,Costa Rica,Grecia,Costa Rica,28-06-03,Attacking Midfield,Midfield,Right,179.0,30-06-27,KMR SG,https://img.a.transfermarkt.technology/portrait/header/631996-1669971243.jpg?lm=1,PO1,Rio Ave Futebol Clube,300000.0,325000.0,21,84,-85,13,11,15,11,13,12,6,11,13,6,14,11,6,14,10,9,10,11,10,13,10,15,10,11,7,11,11,11,9,13,9,9,10,8,9,7,10,10,9,6,10,2,1,3,1,2,3,1,3,3,2,3,7,11,5,9,11,13,1,10,1,1,1,1,1,1,1,1,18,1,1,20,18,1,0,10,20,31030109,5000,4962,2977,Mediterranean_Hispanic,91,3,0,2320.0,AD Guanacasteca,80034792,950000.0,1.0,22,558,23,3,1,3,171,0,0.4068536649907383,0.3130481283422459,0.3088235294117646,0.0022315415017472,0.0197368421052631,0.0,0.0012503125781445,0.0013753438359589,0.0052501458373843,0.0,0.3720930232558141,0.125,128,14,12,17,0,5783,2,10,33,400000,32500.0,400000.0,50000.0,125000.0,300000.0,4,325000,0.3333333333333333,0.3333333333333333
632741,Iker,Losada,2024,150,Spain,Catoira,Spain,01-08-01,Second Striker,Attack,Right,175.0,30-06-29,IGdreamsfootball,https://img.a.transfermarkt.technology/portrait/header/632741-1569337955.jpg?lm=1,ES1,Real Betis BalompiÃ© S.A.D.,1800000.0,1800000.0,23,110,-75,7,6,14,14,14,9,10,8,7,10,12,4,10,11,10,14,7,9,10,14,14,5,10,8,13,11,10,11,14,14,10,9,10,14,9,8,14,5,15,8,18,3,1,4,1,1,1,1,3,1,3,1,8,12,5,11,12,9,10,17,1,1,1,1,1,1,1,1,16,1,1,20,1,14,70,5,20,51000000,5150,5150,2650,Mediterranean_Hispanic,106,0,0,1587.0,Unknown,67278254,1800000.0,1.0,89,335,89,0,1,3,164,12,0.4317279703625297,0.2780748663101604,0.4191176470588235,0.0015237440457625,0.0,0.0,0.0087521880470117,0.0087521880470117,0.0099724992360898,0.0,0.2790697674418605,0.2083333333333332,172,26,20,9,0,2909,0,0,0,1800000,107142.85714285714,1800000.0,0.0,300000.0,300000.0,2,150000,0.0,1.25
632896,Alejandro,Francés,2024,12321,Spain,Zaragoza,Spain,01-08-02,Centre-Back,Defender,Right,182.0,30-06-29,LA PLAYERS,https://img.a.transfermarkt.technology/portrait/header/632896-1697808516.jpg?lm=1,ES1,Girona FÃºtbol Club S. A. D.,4000000.0,5000000.0,22,120,-8,5,10,8,6,11,6,11,8,10,12,11,4,14,11,11,13,12,13,13,12,12,14,9,12,9,13,13,14,13,12,12,12,13,13,13,12,12,8,8,6,12,3,3,3,1,3,2,3,3,3,2,3,10,12,4,11,14,11,13,15,1,15,20,19,1,1,1,1,1,1,1,1,1,1,70,13,20,9562500,6000,6000,3500,Mediterranean_Hispanic,119,0,0,4177.0,Unknown,67281886,3500000.0,1.0,89,1699,89,1,1,3,107,2,0.5441915850754168,0.3689839572192513,0.5147058823529411,0.0040246927647263,0.0,0.0,0.0197549387346836,0.0247561890472618,0.0194172060335009,0.0,0.4418604651162785,0.1666666666666666,148,4,3,29,1,1965,1,4,23,3500000,283333.3333333333,5000000.0,1500000.0,3000000.0,4000000.0,1,1000000,-0.125,-0.125
633530,Jordan,Zemura,2024,410,England,London,Zimbabwe,14-11-99,Left-Back,Defender,Left,173.0,30-06-27,Unknown,https://img.a.transfermarkt.technology/portrait/header/633530-1644920816.jpg?lm=1,IT1,Udinese Calcio,5000000.0,6000000.0,25,125,147,7,11,14,9,11,6,8,6,7,11,11,6,13,12,9,11,9,12,11,11,11,14,11,8,12,11,14,17,15,14,12,7,16,15,17,9,14,6,10,4,8,1,3,3,3,1,3,2,1,3,1,3,10,12,4,15,10,15,13,14,1,20,1,1,19,1,1,7,1,1,1,1,1,1,0,20,8,15171719,6250,6250,3255,African_Caribbean,115,6,0,28998.0,Unknown,29164969,9111392.0,2.0,32,858,108,1,0,1,205,8,0.5772691188145012,0.3427807486631015,0.4852941176470588,0.0279922789243409,0.0394736842105263,0.0,0.0247561890472618,0.0297574393598399,0.0505924720131114,0.1428571428571428,0.2325581395348837,0.2916666666666665,113,5,5,12,0,924,3,17,44,5000000,485000.0,6000000.0,1000000.0,,,1,0,0.0,-0.16666666666666666
633650,Leon,King,2024,124,Scotland,Glasgow,Scotland,14-01-04,Centre-Back,Defender,Right,183.0,31-05-26,CAA Base Ltd,https://img.a.transfermarkt.technology/portrait/header/633650-1663162092.jpg?lm=1,SC1,Rangers Football Club,800000.0,1000000.0,20,111,-8,6,4,3,6,11,5,12,6,10,9,11,7,13,6,12,14,15,12,10,10,10,14,3,11,10,12,11,9,11,12,11,15,15,13,12,14,14,5,16,12,12,1,4,2,1,3,2,1,3,3,3,3,13,11,6,16,12,13,8,13,1,14,20,17,1,1,14,1,1,1,1,1,1,1,82,10,20,18338293,5550,5550,3500,Northern_European,104,0,0,4640.0,Unknown,61094097,9111392.0,2.0,82,545,83,1,1,7,161,2,0.4846520243450648,0.3689839572192513,0.4044117647058823,0.0044717735588886,0.0,0.0,0.0037509377344336,0.0047511877969492,0.0505924720131114,0.1428571428571428,0.4651162790697669,0.0833333333333332,0,0,0,0,0,0,1,3,36,800000,116666.66666666667,1000000.0,200000.0,1000000.0,800000.0,1,900000,0.0,0.0
633668,Giovanni,Fabbian,2024,1025,Italy,Camposampiero,Italy,14-01-03,Attacking Midfield,Midfield,Right,186.0,30-06-28,MM-Management,https://img.a.transfermarkt.technology/portrait/header/633668-1695027735.jpg?lm=1,IT1,Bologna Football Club 1909,14000000.0,14000000.0,21,110,-8,3,5,9,8,11,5,14,7,8,12,11,6,14,11,16,15,12,12,13,10,12,13,11,7,14,14,16,15,11,13,14,14,12,11,14,13,15,7,15,5,8,2,1,2,1,2,1,3,2,1,1,2,13,14,6,12,12,12,11,14,1,1,1,1,1,1,18,1,20,1,1,3,1,1,0,5,20,40600001,5497,5497,998,Mediterranean_Hispanic,106,0,0,4857.0,Reggina 1914,43500245,2595000.0,2.0,52,310,54,3,1,3,40,0,0.477639587192379,0.1013903743315508,0.4191176470588235,0.0046813125056126,0.0,0.0,0.0697674418604651,0.0697674418604651,0.0143892885913497,0.1428571428571428,0.5348837209302322,0.125,165,34,8,30,0,4431,2,4,18,13000000,1388888.888888889,14000000.0,1000000.0,,7000000.0,2,1800000,-0.07142857142857142,0.8571428571428571
633753,Alex,Lowry,2024,124,Scotland,Uddingston,Scotland,23-06-03,Attacking Midfield,Midfield,Right,183.0,31-05-25,Wasserman,https://img.a.transfermarkt.technology/portrait/header/633753-1663162208.jpg?lm=1,SC1,Rangers Football Club,350000.0,350000.0,21,107,-8,11,9,13,15,12,15,7,13,4,7,12,5,8,14,4,9,5,13,11,14,6,10,12,3,12,6,7,6,16,15,13,13,17,16,15,5,11,5,4,8,7,2,3,2,1,2,1,4,1,3,2,2,18,12,5,11,15,12,10,11,1,1,1,1,1,1,12,1,17,1,1,20,1,1,0,8,20,18338293,5350,5350,3300,Northern_European,111,0,0,6960.0,Unknown,61094101,9111392.0,2.0,82,1542,83,3,1,7,161,0,0.4581899973537973,0.3475935828877005,0.4558823529411764,0.00671200561603,0.0,0.0,0.0015003750937734,0.0015003750937734,0.0505924720131114,0.1428571428571428,0.4651162790697669,0.125,56,18,9,5,0,3153,2,23,60,350000,16666.666666666668,350000.0,0.0,,350000.0,3,100000,0.0,0.0
633992,Enzo,Le Fée,2024,12,France,Lorient,France,03-02-00,Central Midfield,Midfield,Right,173.0,30-06-29,Cracksman,https://img.a.transfermarkt.technology/portrait/header/633992-1725529188.jpg?lm=1,IT1,Associazione Sportiva Roma,18000000.0,20000000.0,24,126,150,13,13,14,9,14,13,6,11,5,11,14,12,9,15,7,13,8,13,12,15,13,14,14,11,12,10,14,13,13,15,13,5,13,14,14,7,12,8,12,7,12,2,1,3,2,2,3,2,2,3,3,3,18,12,7,15,12,13,14,12,1,1,1,1,1,1,12,12,20,14,12,19,14,1,58,8,20,7375999,6300,6300,3756,Northern_European,126,0,0,11234.0,Unknown,49040114,21500000.0,2.0,34,863,36,3,1,7,29,1,0.5838846255623181,0.3963636363636363,0.5661764705882353,0.0108390538109533,0.0,0.0,0.0897724431107777,0.0997749437359339,0.1194199838884413,0.1428571428571428,0.2325581395348837,0.25,215,10,25,21,0,2547,4,19,48,18000000,1023529.4117647059,20000000.0,2000000.0,,5000000.0,2,2000000,0.0,-0.1
634427,Miguel,Rodríguez,2024,200,Spain,Redondela,Spain,29-04-03,Right Winger,Attack,Right,179.0,30-06-25,LEADERBROCK,https://img.a.transfermarkt.technology/portrait/header/634427-1723460737.jpg?lm=1,NL1,Football Club Utrecht,800000.0,1000000.0,21,128,136,13,13,13,15,15,13,7,14,11,6,13,16,6,16,11,14,15,16,14,14,15,15,18,14,15,6,14,8,13,11,13,5,14,9,12,12,14,15,13,12,12,2,1,4,1,1,2,2,2,1,2,3,3,13,13,6,18,14,7,7,1,1,1,1,1,1,1,1,6,1,8,18,13,20,71,10,20,347975206,6405,6405,4181,Native_American,124,1,0,14115.0,Unknown,14011131,9111392.0,2.0,89,1213,89,0,1,5,92,10,0.5977771897327335,0.4418181818181818,0.5514705882352942,0.0136209971543259,0.006578947368421,0.0,0.0037509377344336,0.0047511877969492,0.0505924720131114,0.1428571428571428,0.3720930232558141,0.125,122,27,9,18,1,2501,1,5,42,2000000,140000.0,2000000.0,100000.0,1000000.0,900000.0,2,1200000,1.5,1.2222222222222223
634431,Beñat,Turrientes,2024,681,Spain,Beasain,Spain,31-01-02,Central Midfield,Midfield,Right,181.0,30-06-27,IDUB GLOBAL,https://img.a.transfermarkt.technology/portrait/header/634431-1702416501.jpg?lm=1,ES1,Real Sociedad de FÃºtbol S.A.D.,20000000.0,20000000.0,22,125,152,9,5,11,12,13,10,10,10,7,12,14,9,15,14,15,14,10,12,12,12,12,10,5,10,15,13,14,14,15,12,8,5,13,14,15,10,13,13,14,8,12,2,3,3,3,2,1,3,3,3,2,2,18,12,1,10,12,11,9,13,1,1,1,1,1,1,20,1,16,1,1,1,1,1,73,14,20,19424997,6250,6250,3900,Mediterranean_Hispanic,130,0,0,7742.0,Unknown,67276474,9111392.0,2.0,89,158,89,3,1,3,168,1,0.5772691188145012,0.4117647058823529,0.5955882352941175,0.0074671183180492,0.0,0.0,0.0997749437359339,0.0997749437359339,0.0505924720131114,0.1428571428571428,0.418604651162791,0.1666666666666666,123,1,4,16,0,3236,2,8,40,18000000,1376923.076923077,20000000.0,2000000.0,,2000000.0,2,3700000,-0.1,0.8
634460,Álex,Balboa,2024,723,Spain,Vitoria-Gasteiz,Equatorial Guinea,06-03-01,Central Midfield,Midfield,Right,181.0,30-06-26,Footfeel ISM  ,https://img.a.transfermarkt.technology/portrait/header/634460-1725529273.jpg?lm=1,NL1,Almere City Football Club,200000.0,200000.0,23,80,-75,4,4,7,4,8,2,14,7,3,6,8,3,12,7,9,8,9,8,8,5,14,6,5,8,4,14,7,8,14,12,8,11,14,14,6,6,15,8,19,7,11,2,1,4,3,2,1,2,2,2,1,1,7,13,8,10,12,11,14,20,1,1,20,1,1,1,1,1,1,1,1,1,1,1,0,1,20,8555999,4005,4005,1508,Mediterranean_Hispanic,70,0,0,277.0,Unknown,2000125132,9111392.0,2.0,89,1617,34,3,1,3,17,1,0.2802328658375231,0.1559358288770053,0.1544117647058823,0.0002587854272904,0.0,0.0,0.0007501875468867,0.0007501875468867,0.0505924720131114,0.1428571428571428,0.418604651162791,0.2083333333333332,57,2,3,17,1,2607,1,5,37,300000,22727.272727272728,300000.0,0.0,,100000.0,2,150000,0.5,0.5
635645,Aurèle,Amenda,2024,24,Switzerland,Biel/Bienne,Switzerland,31-07-03,Centre-Back,Defender,Right,197.0,30-06-29,Signature - ISCM AG,https://img.a.transfermarkt.technology/portrait/header/635645-1724772426.jpg?lm=1,L1,Eintracht Frankfurt FuÃŸball AG,9500000.0,9500000.0,21,101,-75,3,4,8,5,10,4,12,5,6,12,10,8,13,9,11,12,11,11,10,8,10,10,7,8,6,12,12,12,12,10,13,16,14,13,11,15,5,9,14,9,18,3,3,2,3,2,4,3,1,4,3,2,16,12,6,12,9,13,10,13,1,1,20,1,1,1,1,1,1,1,1,1,1,1,90,5,20,10463292,5050,5050,3450,Northern_European,100,0,0,1837.0,Unknown,84161623,9500000.0,1.0,92,187,92,1,1,7,63,2,0.418496956866896,0.3636363636363636,0.3749999999999999,0.0017651483622648,0.0,0.0,0.0472618154538634,0.0472618154538634,0.052751465318481,0.0,0.7906976744186047,0.125,144,13,2,26,0,4455,2,14,75,9500000,861363.6363636364,9500000.0,0.0,100000.0,9500000.0,2,0,0.0,0.9
636093,Carlos,Domínguez,2024,940,Spain,Vigo,Spain,11-02-01,Centre-Back,Defender,Left,187.0,30-06-26,InterStarDeporte,https://img.a.transfermarkt.technology/portrait/header/636093-1629886975.jpg?lm=1,ES1,Real Club Celta de Vigo S. A. D.,3000000.0,3000000.0,23,116,152,8,7,4,9,12,3,14,8,6,14,11,9,15,11,16,14,14,13,15,9,12,4,5,7,12,15,12,13,13,11,11,13,8,13,11,13,11,7,6,6,3,3,3,2,1,1,3,1,2,3,2,2,13,12,8,12,9,10,9,15,1,12,20,1,1,1,1,1,1,1,1,1,1,1,0,20,6,11309999,5600,5600,3600,Mediterranean_Hispanic,123,0,0,2797.0,Unknown,67279603,9111392.0,2.0,89,1587,89,1,0,3,165,2,0.4912675310928817,0.3796791443850267,0.5441176470588236,0.0026921409376336,0.0,0.0,0.0147536884221055,0.0147536884221055,0.0505924720131114,0.1428571428571428,0.5581395348837206,0.2083333333333332,108,2,1,13,0,3402,1,1,13,2500000,175000.0,3000000.0,500000.0,,1000000.0,1,200000,-0.16666666666666666,2.5714285714285716
636237,Kostyantyn,Vivcharenko,2024,338,Ukraine,Odesa,Ukraine,10-06-02,Left-Back,Defender,Left,178.0,31-12-25,Unknown,https://img.a.transfermarkt.technology/portrait/header/636237-1726134872.png?lm=1,UKR1,Futbolniy Klub Dynamo Kyiv,1500000.0,2000000.0,22,107,-75,8,11,10,6,10,9,12,7,8,12,11,5,12,11,12,11,14,9,9,10,9,14,9,12,10,12,12,15,13,13,13,11,6,13,14,13,9,7,12,6,14,1,1,1,1,2,2,2,3,1,3,1,14,12,7,12,9,12,10,16,1,20,14,4,15,4,7,4,4,1,4,1,1,1,76,20,10,22630493,4941,4941,1491,Northern_European,107,0,0,1429.0,Unknown,71113673,9111392.0,2.0,103,1071,101,1,0,7,97,8,0.4040751521566552,0.1541176470588235,0.4264705882352941,0.001371176517733,0.0,0.0,0.0072518129532383,0.0097524381095273,0.0505924720131114,0.1428571428571428,0.3488372093023257,0.1666666666666666,79,3,7,14,0,3092,3,6,36,1800000,159090.9090909091,2000000.0,500000.0,75000.0,1000000.0,2,425000,0.2,0.2
636688,Alejandro,Balde,2024,131,Spain,Barcelona,Spain,18-10-03,Left-Back,Defender,Left,175.0,30-06-28,Gestifute,https://img.a.transfermarkt.technology/portrait/header/636688-1662836200.jpg?lm=1,ES1,Futbol Club Barcelona,40000000.0,50000000.0,21,127,-9,8,13,12,8,12,9,8,9,10,10,12,8,11,13,12,11,12,10,10,11,12,14,13,7,13,9,11,12,16,17,12,8,15,16,13,8,15,10,14,8,15,2,2,2,3,1,2,1,2,1,3,1,12,13,5,14,15,14,13,15,1,20,1,13,19,12,1,17,1,13,15,1,14,1,69,20,5,33000000,6350,6350,4350,African_Caribbean,111,0,0,3989.0,Unknown,67296654,9111392.0,2.0,89,141,89,1,0,1,96,8,0.590500132310135,0.4598930481283422,0.4558823529411764,0.0038431567187166,0.0,0.0,0.1997999499874969,0.2498124531132783,0.0505924720131114,0.1428571428571428,0.2790697674418605,0.125,0,0,0,0,0,0,9,58,182,50000000,3320000.0,50000000.0,10000000.0,8000000.0,40000000.0,2,4300000,0.25,0.0
636695,Marc,Casadó,2024,131,Spain,Sant Pere de Vilamajor,Spain,14-09-03,Defensive Midfield,Midfield,Right,172.0,30-06-28,Wasserman,https://img.a.transfermarkt.technology/portrait/header/636695-1699383437.jpg?lm=1,ES1,Futbol Club Barcelona,2500000.0,2500000.0,21,95,-75,7,7,7,6,12,7,8,8,6,9,13,6,11,12,13,11,12,9,11,11,12,14,12,11,9,12,12,12,12,13,12,8,14,12,11,11,15,8,15,14,12,2,1,3,2,1,3,1,1,2,1,1,11,12,5,14,12,13,14,15,1,1,12,12,1,12,20,1,19,12,1,1,1,1,0,8,20,14460000,4749,4749,2249,Mediterranean_Hispanic,95,0,0,1825.0,Unknown,2000058198,9111392.0,2.0,89,1322,89,3,1,3,96,4,0.3786716062450384,0.235187165775401,0.338235294117647,0.0017535609550727,0.0,0.0,0.0122530632658164,0.0122530632658164,0.0505924720131114,0.1428571428571428,0.2093023255813952,0.125,111,0,8,25,0,2127,0,0,0,30000000,3731250.0,30000000.0,-50000.0,,2500000.0,1,12500000,11.0,49.0
638793,Tajon,Buchanan,2024,46,Canada,"Brampton, Ontario",Canada,08-02-99,Right Midfield,Midfield,Right,183.0,30-06-28,Octagon,https://img.a.transfermarkt.technology/portrait/header/638793-1673727337.jpg?lm=1,IT1,Football Club Internazionale Milano S.p.A.,8000000.0,12000000.0,25,120,131,10,12,12,11,10,9,9,10,11,11,11,6,11,11,6,7,11,8,8,11,10,11,12,5,12,9,12,14,16,12,10,10,15,16,12,7,9,12,4,11,15,3,3,1,2,1,2,3,3,1,1,1,16,15,7,12,9,11,14,19,1,1,1,1,1,12,1,13,1,16,17,1,20,11,69,10,20,3708830,6196,6198,3548,African_Caribbean,111,24,3,7499.0,Unknown,72052880,6865000.0,2.0,16,240,16,3,1,1,89,9,0.5703889917967716,0.3741176470588235,0.4558823529411764,0.0072324733224089,0.1578947368421052,0.0394736842105263,0.0397599399849962,0.0597649412353088,0.0381121697824939,0.1428571428571428,0.4651162790697669,0.2916666666666665,153,18,23,17,0,5869,6,43,116,8000000,496875.0,12000000.0,2000000.0,,350000.0,2,1000000,0.0,0.0
639733,Peque,Fernández,2024,368,Spain,L'Hospitalet de Llobregat,Spain,04-10-02,Second Striker,Attack,Left,172.0,30-06-28,JV SPORTS ,https://img.a.transfermarkt.technology/portrait/header/639733-1615192753.jpg?lm=1,ES1,Sevilla FÃºtbol Club S.A.D.,3000000.0,3000000.0,22,122,-75,10,10,12,11,14,10,10,12,4,12,15,9,15,13,9,11,11,12,9,11,15,11,5,10,11,15,11,14,13,10,11,6,6,11,10,8,20,9,5,11,14,3,1,2,3,1,1,1,2,2,2,1,19,11,3,13,10,11,10,20,1,1,1,1,1,1,20,12,19,1,1,1,1,1,76,20,12,5778337,6086,6086,3102,Mediterranean_Hispanic,119,0,0,1261.0,Club AtlÃ©tico Tigre,14247304,4000000.0,1.0,89,779,89,0,0,3,181,12,0.5555702566816618,0.3264171122994652,0.5147058823529411,0.0012089528170435,0.0,0.0,0.0147536884221055,0.0147536884221055,0.0221950609739159,0.0,0.2093023255813952,0.1666666666666666,137,28,8,16,0,4007,4,25,75,5000000,350000.0,5000000.0,0.0,200000.0,300000.0,2,2000000,0.6666666666666666,1.5
640026,Shola,Shoretire,2024,1091,England,Newcastle,England,02-02-04,Right Winger,Attack,Right,171.0,30-06-28,CAA Stellar,https://img.a.transfermarkt.technology/portrait/header/640026-1727967599.png?lm=1,GR1,Panthessalonikios Athlitikos Omilos Konstantinoupoliton,3500000.0,4000000.0,20,113,-8,8,10,13,13,15,8,2,8,3,4,14,10,3,14,10,12,9,13,10,13,9,15,18,4,13,2,11,12,15,15,10,5,7,14,9,6,10,11,18,4,10,3,4,1,1,3,4,3,2,3,4,1,8,10,7,10,11,11,13,5,1,1,1,1,1,1,1,14,12,10,20,18,15,8,66,13,20,54144942,5650,5650,4026,African_Caribbean,110,0,0,11599.0,Unknown,2000017587,9111392.0,2.0,32,1036,33,0,1,1,153,10,0.4978830378406986,0.4252406417112299,0.4485294117647059,0.0111915041130467,0.0,0.0,0.0172543135783946,0.0197549387346836,0.0505924720131114,0.1428571428571428,0.1860465116279068,0.0833333333333332,141,40,22,31,1,5587,1,1,8,3000000,0.0,4000000.0,500000.0,4000000.0,3000000.0,3,500000,-0.25,-0.25
640109,Martín,Satriano,2024,826,Uruguay,Montevideo,Uruguay,20-02-01,Centre-Forward,Attack,Right,187.0,30-06-25,All Iron Sports,https://img.a.transfermarkt.technology/portrait/header/640109-1626685122.jpg?lm=1,FR1,Racing Club de Lens,7000000.0,8000000.0,23,126,152,7,8,11,14,12,8,15,11,5,5,11,12,7,13,12,14,13,12,12,11,12,15,13,11,13,8,12,13,13,13,14,14,14,12,15,13,14,8,10,6,11,1,3,1,1,1,2,1,3,1,3,2,13,15,7,8,13,15,12,18,1,1,1,1,1,1,1,1,1,1,1,12,1,20,75,10,20,7943999,6300,6250,4500,Mediterranean_Hispanic,126,1,0,23085.0,Empoli Football Club,78097218,2400000.0,1.0,106,975,103,0,1,3,158,3,0.5772691188145012,0.4759358288770053,0.5661764705882353,0.0222825840304285,0.006578947368421,0.0,0.0347586896724181,0.0397599399849962,0.0133059251645879,0.0,0.5581395348837206,0.2083333333333332,131,28,15,18,1,2254,4,30,192,7000000,516666.6666666667,8000000.0,2000000.0,,2500000.0,4,4500000,0.0,0.4
640428,Eduardo,Camavinga,2024,418,Angola,Cabinda,France,10-11-02,Central Midfield,Midfield,Left,182.0,30-06-29,CAA Stellar,https://img.a.transfermarkt.technology/portrait/header/640428-1668500874.jpg?lm=1,ES1,Real Madrid Club de FÃºtbol,100000000.0,100000000.0,22,147,180,6,8,12,10,14,6,11,9,4,14,14,7,15,15,15,15,14,14,13,13,14,15,12,12,13,15,14,16,14,14,14,11,14,14,15,16,15,9,15,5,11,1,3,2,2,3,1,2,2,1,1,3,13,13,5,14,16,15,13,17,1,1,1,1,1,1,18,1,20,1,1,1,1,1,68,20,10,78600001,7350,6800,7000,African_Caribbean,145,3,1,148675.0,Unknown,49056243,31000000.0,1.0,3,292,36,3,0,1,167,1,0.6500396930404869,0.7433155080213903,0.7058823529411764,0.1435544564685252,0.0197368421052631,0.0131578947368421,0.4998749687421855,0.4998749687421855,0.1721992277563265,0.0,0.4418604651162785,0.1666666666666666,266,9,14,58,1,5800,10,46,51,80000000,4470588.235294118,100000000.0,20000000.0,55000000.0,90000000.0,1,0,-0.2,-0.1111111111111111
641537,Tommaso,Baldanzi,2024,12,Italy,Poggibonsi,Italy,23-03-03,Attacking Midfield,Midfield,Left,170.0,30-06-28,GR Sports,https://img.a.transfermarkt.technology/portrait/header/641537-1661764089.jpg?lm=1,IT1,Associazione Sportiva Roma,15000000.0,15000000.0,21,110,-8,12,9,14,12,13,12,8,11,4,5,12,10,7,14,10,12,9,10,9,14,13,16,14,7,13,5,13,13,13,14,13,5,12,12,11,7,12,5,14,6,8,3,3,2,3,1,4,1,1,2,2,1,13,16,6,13,12,16,14,9,1,1,1,1,1,1,1,1,10,1,1,20,12,18,68,20,9,24080000,5500,5500,2250,Mediterranean_Hispanic,110,0,0,4381.0,Unknown,43591641,10000000.0,1.0,52,1158,54,3,0,3,29,0,0.4780365175972479,0.2352941176470588,0.4485294117647059,0.0042216786869922,0.0,0.0,0.0747686921730432,0.0747686921730432,0.055529320258896,0.0,0.1627906976744184,0.125,165,44,18,17,0,3138,8,31,67,14000000,1340000.0,15000000.0,1000000.0,800000.0,15000000.0,1,0,-0.06666666666666667,-0.06666666666666667
644244,Enis,Cokaj,2024,2672,Albania,Koplik,Albania,23-02-99,Defensive Midfield,Midfield,Right,182.0,30-06-25,Unknown,https://img.a.transfermarkt.technology/portrait/header/644244-1663313188.jpg?lm=1,GR1,APO Levadiakos Football Club,850000.0,1200000.0,25,120,135,13,11,9,8,10,12,10,13,8,13,14,11,13,11,17,11,15,9,13,11,11,15,8,13,9,13,13,18,11,12,13,8,15,11,17,12,13,10,11,6,4,2,4,4,1,3,1,1,2,2,1,2,11,12,8,13,13,12,9,10,1,1,1,1,1,1,20,6,19,1,1,10,1,1,0,9,20,2366780,5750,6050,4750,Northern_European,118,3,0,3634.0,Unknown,24065180,1000000.0,1.0,0,747,0,3,1,7,8,4,0.5508070918232336,0.5026737967914437,0.5073529411764706,0.0035003625892833,0.0197368421052631,0.0,0.0040010002500625,0.0057514378594648,0.0055279313314258,0.0,0.4418604651162785,0.2916666666666665,187,6,13,50,1,3304,0,0,0,800000,50000.0,1200000.0,200000.0,,600000.0,3,200000,-0.058823529411764705,-0.2
644401,Keane,Lewis-Potter,2024,1148,England,Hull,England,22-02-01,Left Winger,Attack,Right,170.0,30-06-28,Unknown,https://img.a.transfermarkt.technology/portrait/header/644401-1642684319.jpg?lm=1,GB1,Brentford Football Club,18000000.0,18000000.0,23,128,151,11,13,14,14,13,12,13,14,9,7,13,13,7,12,11,13,10,14,11,13,12,17,13,6,12,7,10,14,14,14,13,10,14,14,13,9,12,6,14,4,14,2,3,1,1,1,3,2,2,3,4,3,13,14,4,13,13,16,14,13,1,1,1,1,10,10,1,16,1,15,20,18,19,14,0,7,20,34519140,6400,6400,4250,Northern_European,126,0,0,40597.0,Unknown,28113414,19000000.0,1.0,32,641,33,0,1,7,43,7,0.5971156390579518,0.4491978609625668,0.5661764705882353,0.0391924735927818,0.0,0.0,0.0897724431107777,0.0897724431107777,0.1055307091863662,0.0,0.1627906976744184,0.2083333333333332,0,0,0,0,0,0,3,20,59,20000000,1763636.3636363635,20000000.0,3000000.0,,1000000.0,1,5000000,0.3333333333333333,0.6666666666666666
644771,Odilon,Kossounou,2024,800,Cote d'Ivoire,Abidjan,Cote d'Ivoire,04-01-01,Centre-Back,Defender,Right,191.0,30-06-25,Unique Sports Group,https://img.a.transfermarkt.technology/portrait/header/644771-1695368062.jpg?lm=1,IT1,Atalanta Bergamasca Calcio S.p.a.,35000000.0,35000000.0,23,127,-85,6,8,5,4,11,7,13,9,11,13,10,5,15,10,8,13,14,14,12,8,10,14,9,9,11,13,12,12,13,12,15,17,14,14,12,14,11,9,10,4,6,2,2,2,1,2,3,3,3,1,2,1,13,13,3,7,11,11,13,13,1,1,20,18,1,17,16,1,14,1,1,1,1,1,81,8,20,68416000,6500,6500,4750,African_Caribbean,122,15,0,28766.0,Unknown,93127195,13425000.0,2.0,23,14,24,1,1,1,31,2,0.6103466525535857,0.5026737967914437,0.536764705882353,0.0277682557186268,0.0986842105263157,0.0,0.1747936984246061,0.1747936984246061,0.0745576266007389,0.1428571428571428,0.6511627906976742,0.2083333333333332,185,2,7,25,1,5581,4,28,80,30000000,1431578.9473684211,35000000.0,5000000.0,3000000.0,23000000.0,3,15200000,-0.14285714285714285,-0.14285714285714285
645173,Manfred,Ugalde,2024,232,Costa Rica,Heredia,Costa Rica,25-05-02,Centre-Forward,Attack,Right,173.0,30-06-28,KMR SG,https://img.a.transfermarkt.technology/portrait/header/645173-1721915197.png?lm=1,RU1,FK Spartak Moskva,9000000.0,9000000.0,22,111,-75,10,10,13,12,12,9,8,9,8,7,11,14,7,13,18,11,14,11,10,12,11,15,14,8,14,6,12,13,14,13,10,8,13,15,9,11,12,14,13,5,10,3,1,2,4,2,3,1,2,2,3,3,14,13,1,13,11,16,8,13,1,1,1,1,1,1,1,1,1,1,16,18,16,20,0,6,20,1875001,5397,5397,2999,Mediterranean_Hispanic,102,1,0,2000.0,FC Twente,80034923,5958333.333,3.0,22,614,23,0,1,3,82,3,0.4644085736967451,0.3154010695187165,0.3897058823529412,0.0019225439766243,0.006578947368421,0.0,0.0447611902975743,0.0447611902975743,0.0330749928220228,0.2857142857142857,0.2325581395348837,0.1666666666666666,197,67,31,30,1,6009,4,9,28,15000000,925000.0,15000000.0,500000.0,1100000.0,800000.0,3,3250000,1.0,2.0
645588,Tomás,Händel,2024,2420,Portugal,GuimarÃ£es,Portugal,27-11-00,Defensive Midfield,Midfield,Left,180.0,30-06-26,MRP.POSITIONUMBER,https://img.a.transfermarkt.technology/portrait/header/645588-1728373966.jpg?lm=1,PO1,VitÃ³ria Sport Clube,10000000.0,10000000.0,24,120,142,12,12,13,10,13,11,5,10,5,6,15,12,10,14,13,12,9,16,12,15,14,14,10,5,11,12,14,12,12,13,15,10,8,13,14,11,14,12,12,11,10,1,1,1,1,3,1,1,3,3,1,1,8,10,6,9,14,15,13,16,1,1,1,1,1,1,20,1,19,1,1,12,1,1,69,20,7,2719998,6000,6000,4000,Northern_European,117,0,0,2149.0,Unknown,83223951,9111392.0,2.0,76,579,79,3,0,7,217,4,0.5441915850754168,0.4224598930481283,0.4999999999999999,0.0020664209492597,0.0,0.0,0.0497624406101525,0.0497624406101525,0.0505924720131114,0.1428571428571428,0.3953488372093026,0.25,122,7,5,20,1,2497,3,44,357,13000000,1250000.0,13000000.0,500000.0,,500000.0,0,0,0.8571428571428571,2.25
645686,Lamare,Bogarde,2024,405,Netherlands,Rotterdam,Netherlands,05-01-04,Centre-Back,Defender,Right,185.0,Unknown,Wasserman,https://img.a.transfermarkt.technology/portrait/header/645686-1724484880.jpg?lm=1,GB1,Aston Villa Football Club,450000.0,450000.0,20,77,-75,5,4,10,6,11,5,9,5,5,11,11,3,12,11,12,12,10,10,9,10,8,15,8,12,9,13,12,13,11,12,10,7,10,11,9,9,8,9,11,6,12,4,1,1,4,2,2,2,3,2,2,2,14,9,3,10,12,11,14,16,1,17,20,1,1,1,10,1,12,1,1,1,1,1,76,8,20,25193405,3840,3841,1991,African_Caribbean,77,0,0,1160.0,Unknown,37085322,9111392.0,2.0,67,1253,68,1,1,1,30,2,0.2585340037046838,0.2075935828877005,0.2058823529411764,0.0011114254731766,0.0,0.0,0.0020005001250312,0.0020005001250312,0.0505924720131114,0.1428571428571428,0.5116279069767438,0.0833333333333332,125,4,9,19,0,6910,0,0,0,450000,50000.0,450000.0,0.0,300000.0,450000.0,2,150000,0.0,0.0
645774,Eren,Dinkçi,2024,60,Germany,Bremen,TÃ¼rkiye,13-12-01,Right Winger,Attack,Right,188.0,Unknown,EMG Mundial,https://img.a.transfermarkt.technology/portrait/header/645774-1690186275.jpg?lm=1,L1,Sport-Club Freiburg,12000000.0,12000000.0,23,106,-75,9,11,15,11,14,9,11,13,6,9,10,9,6,15,10,14,4,12,10,10,11,11,13,10,15,8,10,11,15,11,15,14,15,10,6,6,10,11,12,13,13,3,4,1,3,2,1,2,3,2,3,1,15,10,3,11,11,11,12,17,1,1,1,1,1,1,1,1,1,14,15,10,16,20,0,8,20,35999999,5299,4999,2249,Mediterranean_Hispanic,105,0,0,4178.0,Unknown,91204663,5000000.0,1.0,38,253,100,0,1,3,189,10,0.4117491399841227,0.235187165775401,0.411764705882353,0.0040256583819923,0.0,0.0,0.0597649412353088,0.0597649412353088,0.0277507708547459,0.0,0.581395348837209,0.2083333333333332,137,45,25,11,1,2446,11,16,22,12000000,911538.4615384615,12000000.0,0.0,150000.0,700000.0,3,2350000,0.0,1.0
646478,Elias,Jelert,2024,141,Denmark,Virum,Denmark,12-06-03,Right-Back,Defender,Right,178.0,30-06-29,People In Sport,https://img.a.transfermarkt.technology/portrait/header/646478-1662491413.jpg?lm=1,TR1,Galatasaray Spor KulÃ¼bÃ¼,8000000.0,8000000.0,21,113,-75,11,12,12,9,12,2,8,9,4,9,11,6,10,12,15,12,15,9,11,11,12,15,12,4,13,11,13,14,15,12,11,7,12,16,12,5,11,12,19,11,20,1,4,3,1,3,2,2,1,1,3,3,9,15,12,14,14,13,11,12,1,15,1,20,15,19,1,1,1,1,1,1,1,1,56,11,20,9098744,5750,5750,1950,Northern_European,103,0,0,3400.0,Unknown,27161401,9000000.0,1.0,28,1614,30,1,1,7,102,11,0.5111140513363324,0.2032085561497326,0.3970588235294117,0.0032744081490372,0.0,0.0,0.0397599399849962,0.0397599399849962,0.049973610378066,0.0,0.3488372093023257,0.125,169,4,13,23,0,6566,2,3,12,7500000,887500.0,8000000.0,500000.0,400000.0,5500000.0,2,2500000,0.36363636363636365,0.5
646698,Gabriel,Misehouy,2024,12321,Netherlands,Amsterdam,Netherlands,18-07-05,Attacking Midfield,Midfield,Right,173.0,30-06-28,Gol International,https://img.a.transfermarkt.technology/portrait/header/646698-1683294176.jpg?lm=1,ES1,Girona FÃºtbol Club S. A. D.,1000000.0,1000000.0,19,101,-85,10,8,12,11,13,10,7,10,7,10,13,10,8,13,11,8,7,8,11,13,12,13,12,12,9,8,12,13,11,13,11,9,11,11,9,12,12,9,10,10,12,3,1,4,1,2,1,2,1,1,4,3,18,12,8,11,11,11,11,10,1,1,1,1,1,1,12,12,20,1,12,18,1,1,0,12,20,27000001,4899,4899,3035,African_Caribbean,100,0,0,7499.0,Unknown,2000046143,9111392.0,2.0,67,64,68,3,1,1,107,0,0.398518126488489,0.3192513368983957,0.3749999999999999,0.0072324733224089,0.0,0.0,0.0047511877969492,0.0047511877969492,0.0505924720131114,0.1428571428571428,0.2325581395348837,0.0416666666666666,85,23,10,3,0,2479,4,29,67,1000000,80000.0,1000000.0,0.0,1000000.0,,1,0,0.0,0.0
646704,Maxim,Dekker,2024,1090,Netherlands,Rijsenhout,Netherlands,21-04-04,Centre-Back,Defender,Left,192.0,30-06-26,Unknown,https://img.a.transfermarkt.technology/portrait/header/646704-1656945899.jpg?lm=1,NL1,Alkmaar Zaanstreek,800000.0,1500000.0,20,113,-8,9,6,6,9,9,9,11,5,9,14,11,9,13,9,7,12,12,13,10,9,14,10,6,10,7,13,14,14,11,13,13,14,13,11,12,8,13,8,10,5,15,1,3,1,2,2,2,1,1,3,3,2,16,13,1,12,11,8,11,20,1,14,20,1,1,1,1,1,1,1,1,1,1,1,0,20,10,64200000,5550,5550,3158,Northern_European,112,0,0,1848.0,Unknown,2000014084,9111392.0,2.0,67,1232,68,1,0,7,16,2,0.4846520243450648,0.3324064171122994,0.463235294117647,0.0017757701521909,0.0,0.0,0.0037509377344336,0.0072518129532383,0.0505924720131114,0.1428571428571428,0.6744186046511627,0.0833333333333332,123,7,3,6,1,5005,1,21,79,1000000,108333.33333333333,1500000.0,500000.0,1500000.0,1000000.0,1,300000,0.25,0.0
646738,Juan,Larios,2024,180,Spain,Tomares,Spain,12-01-04,Left-Back,Defender,Left,170.0,30-06-27,Unknown,https://img.a.transfermarkt.technology/portrait/header/646738-1662067003.jpg?lm=1,GB1,Southampton Football Club,4500000.0,7000000.0,20,115,-8,10,12,13,7,12,8,8,7,9,11,13,7,12,14,12,7,12,12,10,8,9,15,10,9,9,9,14,14,16,15,13,7,12,14,14,8,12,10,13,8,16,1,1,1,2,2,3,4,2,2,1,1,8,9,1,13,9,10,12,18,1,20,1,12,17,12,1,1,1,1,1,1,1,1,0,20,8,32709669,6150,5750,4250,Mediterranean_Hispanic,106,0,0,6960.0,Unknown,2000030287,7000000.0,1.0,89,1500,89,1,0,3,186,8,0.5111140513363324,0.4491978609625668,0.4191176470588235,0.00671200561603,0.0,0.0,0.0222555638909727,0.0347586896724181,0.038862190616406,0.0,0.1627906976744184,0.0833333333333332,49,0,5,8,1,2029,2,86,491,4500000,-71428.57142857143,7000000.0,1000000.0,7000000.0,4500000.0,0,0,0.0,-0.25
646740,Unknown,Gavi,2024,131,Spain,Los Palacios y Villafranca,Spain,05-08-04,Central Midfield,Midfield,Right,173.0,30-06-26,Unknown,https://img.a.transfermarkt.technology/portrait/header/646740-1682685701.jpg?lm=1,ES1,Futbol Club Barcelona,90000000.0,90000000.0,20,148,-95,12,14,15,10,15,11,6,11,8,11,14,9,10,16,14,15,14,14,14,16,16,16,15,12,15,12,14,15,14,15,15,6,14,12,14,8,15,5,15,7,16,1,2,1,4,1,3,3,1,3,3,1,15,15,5,12,14,15,14,13,1,1,1,1,1,1,15,10,20,14,10,17,12,5,68,12,20,74100001,7598,7598,6248,Mediterranean_Hispanic,147,10,1,144230.0,Unknown,2000049413,10000.0,1.0,89,864,89,3,1,3,96,1,0.7556231807356444,0.6628877005347593,0.7205882352941175,0.1392622877211143,0.0657894736842105,0.0131578947368421,0.4498624656164041,0.4498624656164041,2.7778549404150115e-05,0.0,0.2325581395348837,0.0833333333333332,137,9,17,42,0,3923,6,53,316,80000000,5500000.0,90000000.0,10000000.0,90000000.0,80000000.0,0,0,-0.1111111111111111,-0.1111111111111111
646750,Cristhian,Mosquera,2024,1049,Spain,Alicante,Spain,27-06-04,Centre-Back,Defender,Right,191.0,30-06-26,Unknown,https://img.a.transfermarkt.technology/portrait/header/646750-1644238478.jpg?lm=1,ES1,Valencia Club de FÃºtbol S. A. D.,30000000.0,30000000.0,20,100,-85,5,7,9,9,10,7,12,5,3,12,11,8,12,5,8,11,11,13,11,8,12,3,5,10,10,12,10,11,11,11,12,12,15,10,12,12,14,14,15,5,13,3,3,3,1,3,1,3,3,2,3,3,18,13,6,10,10,11,11,11,1,1,20,15,1,1,1,1,1,1,1,1,1,1,0,6,20,27630000,5000,5000,2500,African_Caribbean,96,0,0,2900.0,Unknown,2000030816,9111392.0,2.0,89,43,89,1,1,1,208,2,0.4118814501190792,0.2620320855614972,0.3455882352941176,0.0027915995160326,0.0,0.0,0.1497874468617154,0.1497874468617154,0.0505924720131114,0.1428571428571428,0.6511627906976742,0.0833333333333332,86,1,0,9,0,1824,0,0,0,30000000,3222222.222222222,30000000.0,0.0,1000000.0,30000000.0,2,0,0.0,2.0
647280,Kieron,Bowie,2024,903,Scotland,Kirkcaldy,Scotland,21-09-02,Centre-Forward,Attack,Left,190.0,31-05-28,Deluxe Sports Group,https://img.a.transfermarkt.technology/portrait/header/default.jpg?lm=1,SC1,Hibernian Football Club,500000.0,500000.0,22,90,-75,5,9,12,12,9,5,11,9,4,5,10,13,5,15,5,10,15,5,8,12,10,9,15,5,11,7,11,15,10,6,7,14,12,14,12,15,13,5,7,7,14,2,2,2,3,3,3,1,2,3,2,4,13,8,5,7,11,12,11,10,1,1,1,1,1,1,1,10,1,15,13,19,18,20,0,20,7,37998893,4500,4500,2250,Northern_European,85,0,0,986.0,Northampton Town,61095510,440000.0,2.0,82,732,83,0,0,7,114,3,0.3457263826409102,0.2352941176470588,0.2647058823529412,0.0009434080688909,0.0,0.0,0.0022505626406601,0.0022505626406601,0.002416733798161,0.1428571428571428,0.6279069767441858,0.1666666666666666,173,45,20,17,1,1299,2,18,92,500000,62500.0,500000.0,0.0,,250000.0,1,250000,1.0,1.0
648020,Unknown,Alexsandro,2024,1082,Brazil,Rio de Janeiro,Brazil,09-08-99,Centre-Back,Defender,Left,191.0,30-06-28,Focus Soccer Agency,https://img.a.transfermarkt.technology/portrait/header/648020-1666689768.jpg?lm=1,FR1,Lille Olympique Sporting Club Lille MÃ©tropole,8000000.0,8000000.0,25,143,168,11,14,13,10,15,8,14,11,13,13,14,9,15,14,11,15,14,14,10,12,13,13,14,7,12,15,14,15,13,13,14,12,16,14,14,14,13,14,11,10,12,3,2,2,3,1,1,3,3,2,2,2,13,13,6,14,13,15,15,17,1,20,12,1,20,1,1,17,5,1,9,1,1,1,80,20,10,11677504,7200,7933,6985,African_Caribbean,142,37,2,231653.0,Unknown,19067093,2000000.0,1.0,10,1234,11,1,0,1,128,2,0.7999470759460174,0.741711229946524,0.6838235294117647,0.2236794459674374,0.2434210526315789,0.0263157894736842,0.0397599399849962,0.0397599399849962,0.0110836412122558,0.0,0.6511627906976742,0.2916666666666665,139,7,2,28,2,3097,0,0,0,12000000,1305555.5555555555,12000000.0,-250000.0,,,1,1200000,0.5,0.7142857142857143
648046,Evan,Ferguson,2024,1237,Ireland,"Bettystown, Meath",Ireland,19-10-04,Centre-Forward,Attack,Right,188.0,30-06-29,YMU Management Ltd.,https://img.a.transfermarkt.technology/portrait/header/648046-1681739980.jpg?lm=1,GB1,Brighton and Hove Albion Football Club,45000000.0,65000000.0,20,106,-8,10,7,6,14,10,7,12,11,8,7,11,4,6,9,11,10,13,10,9,11,11,6,7,8,9,6,11,14,15,7,13,12,6,13,14,13,18,7,17,5,10,3,3,2,1,1,1,2,2,1,1,3,14,11,2,11,10,11,12,12,1,1,1,1,1,1,1,1,1,1,1,1,1,20,0,14,20,49180496,5296,5296,3000,Northern_European,102,0,0,6960.0,Unknown,2000120742,9111392.0,2.0,49,183,52,0,1,7,44,3,0.451045250066155,0.3155080213903743,0.3897058823529412,0.00671200561603,0.0,0.0,0.2248062015503876,0.3248312078019504,0.0505924720131114,0.1428571428571428,0.581395348837209,0.0833333333333332,129,36,8,6,0,4125,4,29,147,40000000,3300000.0,65000000.0,10000000.0,65000000.0,40000000.0,1,400000,-0.2,-0.38461538461538464
648195,Enzo,Fernández,2024,631,Argentina,San MartÃ­n,Argentina,17-01-01,Central Midfield,Midfield,Right,178.0,30-06-32,DE 9 FÃšTBOL,https://img.a.transfermarkt.technology/portrait/header/648195-1669894717.jpg?lm=1,GB1,Chelsea Football Club,75000000.0,85000000.0,23,150,164,10,10,13,12,14,9,7,16,8,10,16,13,13,15,15,13,10,11,13,16,13,14,14,11,17,14,15,13,12,14,15,10,15,12,16,13,15,7,13,4,9,3,2,3,2,3,2,3,1,3,3,2,18,13,5,10,17,15,13,12,1,1,1,1,1,1,18,1,20,1,1,15,1,1,70,13,20,36600000,7500,6800,6500,Mediterranean_Hispanic,148,2,0,27510.0,Unknown,14229525,82625000.0,2.0,4,1303,4,3,1,3,50,1,0.6500396930404869,0.6898395721925134,0.7279411764705881,0.0265554404325192,0.0131578947368421,0.0,0.3748437109277319,0.4248562140535133,0.4590127503541764,0.1428571428571428,0.3488372093023257,0.2083333333333332,208,28,32,40,0,6702,5,12,37,75000000,5461538.461538462,85000000.0,5000000.0,,5000000.0,3,35000000,0.0,-0.0625
648779,Wilfried,Singo,2024,162,Cote d'Ivoire,Grand-BÃ©rÃ©by,Cote d'Ivoire,25-12-00,Centre-Back,Defender,Right,190.0,30-06-28,Maxime Nana,https://img.a.transfermarkt.technology/portrait/header/648779-1661511097.jpg?lm=1,FR1,Association sportive de Monaco Football Club,25000000.0,25000000.0,24,135,159,6,12,14,8,11,5,12,7,12,10,13,8,12,12,14,11,11,12,12,11,11,17,11,6,13,12,12,15,16,14,12,13,14,16,14,14,12,12,11,4,13,3,3,3,3,1,2,2,3,2,2,1,12,15,6,12,13,14,13,10,1,1,12,20,1,20,1,1,1,19,1,1,1,1,79,9,20,19288499,6700,5615,5359,African_Caribbean,125,2,0,4999.0,Unknown,12078947,4650000.0,2.0,23,553,24,1,1,1,24,2,0.4932521831172267,0.567807486631016,0.5588235294117647,0.0048184301573859,0.0131578947368421,0.0,0.1247811952988247,0.1247811952988247,0.0258062723964554,0.1428571428571428,0.6279069767441858,0.25,188,14,17,29,2,2447,7,27,77,25000000,1658333.3333333333,25000000.0,2000000.0,150000.0,7000000.0,2,3025000,0.0,0.3888888888888889
649016,El Bilal,Touré,2024,79,Cote d'Ivoire,AdjamÃ©,Mali,03-10-01,Centre-Forward,Attack,Right,185.0,30-06-25,Unknown,https://img.a.transfermarkt.technology/portrait/header/649016-1690782316.jpg?lm=1,L1,Verein fÃ¼r Bewegungsspiele Stuttgart 1893,20000000.0,20000000.0,23,122,147,8,7,12,12,14,9,12,11,10,6,12,13,6,14,8,12,10,12,11,11,11,11,12,8,12,9,9,10,16,11,11,11,11,14,14,13,11,7,10,8,6,2,1,2,3,1,3,2,3,3,3,4,15,14,12,7,10,8,14,10,1,1,1,1,1,1,1,1,1,1,1,1,10,20,72,10,20,7992601,6100,6100,4200,African_Caribbean,120,13,4,4814.0,Unknown,12081007,9111392.0,2.0,23,23,61,0,1,1,211,3,0.5574225985710506,0.4438502673796791,0.5220588235294117,0.0046397909631742,0.0855263157894736,0.0526315789473684,0.0997749437359339,0.0997749437359339,0.0505924720131114,0.1428571428571428,0.5116279069767438,0.2083333333333332,122,24,9,11,1,1910,4,74,148,20000000,1240625.0,20000000.0,2500000.0,3500000.0,6500000.0,4,13850000,0.0,0.0
649020,Boubacar,Traoré,2024,543,Mali,Bamako,Mali,20-08-01,Defensive Midfield,Midfield,Right,183.0,30-06-27,Unknown,https://img.a.transfermarkt.technology/portrait/header/649020-1693477837.jpg?lm=1,GB1,Wolverhampton Wanderers Football Club,6000000.0,6000000.0,23,118,-75,8,6,12,8,13,8,11,13,9,9,13,12,11,12,13,14,14,13,12,13,13,13,10,9,14,10,12,15,12,14,13,13,13,10,12,12,12,12,11,8,14,1,2,1,1,3,3,3,1,2,2,2,9,13,3,12,12,11,11,20,1,1,1,1,1,1,18,1,20,1,1,10,1,1,67,9,20,11837999,5900,5900,3550,African_Caribbean,118,0,0,6784.0,Wolverhampton Wanderers,12083693,5675000.0,2.0,61,133,61,3,1,1,222,4,0.530960571579783,0.374331550802139,0.5073529411764706,0.0065420569772123,0.0,0.0,0.0297574393598399,0.0297574393598399,0.0315008750243062,0.1428571428571428,0.4651162790697669,0.2083333333333332,82,4,2,15,0,2510,3,54,153,6000000,453846.1538461539,6000000.0,0.0,150000.0,1800000.0,2,2250000,0.0,0.0
649022,Moussa,N'Diaye,2024,58,Senegal,Dakar,Senegal,18-06-02,Left-Back,Defender,Left,181.0,30-06-27,LGT Football,https://img.a.transfermarkt.technology/portrait/header/649022-1693899513.jpg?lm=1,BE1,Royal Sporting Club Anderlecht,1800000.0,2500000.0,22,150,160,10,12,16,12,13,8,7,11,6,5,13,10,5,14,10,12,10,13,11,12,11,12,15,6,14,6,12,12,18,16,13,6,13,18,14,11,14,4,13,5,10,1,1,4,3,2,1,2,1,3,1,1,11,15,4,13,11,15,13,7,1,1,1,1,1,1,1,20,1,17,20,12,17,1,67,20,10,51627374,7500,7250,6000,African_Caribbean,135,8,0,57533.0,Unknown,48044574,500000.0,1.0,83,402,84,1,0,1,175,8,0.7095792537708389,0.6363636363636364,0.6323529411764706,0.0555461676099138,0.0526315789473684,0.0,0.0087521880470117,0.0122530632658164,0.0027500763910108,0.0,0.418604651162791,0.1666666666666666,0,0,0,0,0,0,4,18,92,3000000,237500.0,3000000.0,400000.0,500000.0,1500000.0,3,950000,0.6666666666666666,0.36363636363636365
649035,Youssouph,Badji,2024,678,Senegal,Ziguinchor,Senegal,20-12-01,Centre-Forward,Attack,Right,192.0,30-06-29,Wasserman,https://img.a.transfermarkt.technology/portrait/header/649035-1704451094.jpg?lm=1,DK1,Aarhus Gymnastik Forening,750000.0,5000000.0,23,105,135,10,12,11,12,11,10,10,10,5,7,11,7,9,12,13,10,13,11,10,8,12,5,11,1,11,5,10,10,13,12,12,17,12,15,11,11,11,6,3,7,12,1,1,3,1,2,3,2,2,2,3,2,17,12,6,10,11,14,11,11,1,1,1,1,1,1,1,1,1,1,14,14,14,20,78,9,20,3624999,5750,5750,1518,African_Caribbean,104,3,0,3000.0,Royal Charleroi Sporting Club,12079019,1050000.0,2.0,83,1707,84,0,1,1,11,3,0.5111140513363324,0.1570053475935829,0.4044117647058823,0.0028881612426335,0.0197368421052631,0.0,0.0035008752188047,0.0247561890472618,0.0058057168254673,0.1428571428571428,0.6744186046511627,0.2083333333333332,125,17,6,6,0,4127,2,5,29,1000000,70833.33333333333,5000000.0,1500000.0,5000000.0,1500000.0,4,3100000,0.3333333333333333,0.0
649087,Amadou,Dante,2024,8024,Unknown,Unknown,Mali,07-10-00,Left-Back,Defender,Left,178.0,30-06-25,GROW,https://img.a.transfermarkt.technology/portrait/header/649087-1694035145.jpg?lm=1,PO1,Futebol Clube de Arouca,1500000.0,2500000.0,24,123,141,6,8,11,8,11,6,8,8,7,11,10,6,11,12,8,12,12,11,12,11,10,15,7,7,13,15,13,13,16,13,12,10,13,16,14,12,11,5,7,5,6,3,2,1,1,2,1,2,1,3,1,2,13,15,6,13,14,12,12,14,1,20,1,1,17,1,1,15,1,1,1,1,1,1,70,20,11,4899999,6133,6133,3983,African_Caribbean,117,2,0,3900.0,Unknown,12078989,9111392.0,2.0,105,1549,61,1,0,1,98,8,0.5617888330246097,0.4206417112299465,0.4999999999999999,0.0037572167820418,0.0131578947368421,0.0,0.0072518129532383,0.0122530632658164,0.0505924720131114,0.1428571428571428,0.3488372093023257,0.25,164,4,9,14,1,4807,0,0,0,1500000,93333.33333333333,2500000.0,500000.0,100000.0,2500000.0,3,700000,0.0,-0.25
649303,Daniil,Denisov,2024,232,Russia,St.Petersburg,Russia,21-10-02,Right-Back,Defender,Right,185.0,30-06-26,FM Sports Agency,https://img.a.transfermarkt.technology/portrait/header/649303-1632579421.png?lm=1,RU1,FK Spartak Moskva,3500000.0,4000000.0,22,112,-75,8,8,8,7,10,9,11,11,11,10,12,7,12,10,16,11,16,14,13,7,13,16,9,6,9,11,16,16,10,10,12,11,12,12,14,10,14,10,13,13,13,4,3,2,2,3,1,2,3,2,3,1,11,10,3,10,12,12,11,15,1,1,15,20,1,13,19,1,13,1,1,1,1,1,76,12,20,18120431,5256,5256,2830,Northern_European,106,0,0,14927.0,Unknown,58159001,9111392.0,2.0,78,1414,81,1,1,7,82,11,0.4457528446679015,0.2973262032085561,0.4191176470588235,0.0144050783743253,0.0,0.0,0.0172543135783946,0.0197549387346836,0.0505924720131114,0.1428571428571428,0.5116279069767438,0.1666666666666666,183,1,10,22,0,2543,0,0,0,4500000,316071.4285714286,4500000.0,500000.0,300000.0,4000000.0,2,800000,0.2857142857142857,0.125
649317,Jhon,Durán,2024,405,Colombia,MedellÃ­n,Colombia,13-12-03,Centre-Forward,Attack,Left,185.0,30-06-30,Unknown,https://img.a.transfermarkt.technology/portrait/header/649317-1645958151.jpg?lm=1,GB1,Aston Villa Football Club,35000000.0,35000000.0,21,108,-85,10,11,12,13,12,10,11,11,4,10,11,7,8,12,13,12,10,10,11,11,11,11,12,12,13,10,12,13,13,13,11,14,13,14,12,14,8,10,11,12,14,1,2,2,3,2,2,1,1,1,2,2,11,10,16,8,12,10,8,12,1,1,1,1,1,1,1,1,1,1,12,1,10,20,73,20,8,5911475,5464,5040,3290,African_Caribbean,115,2,0,3238.0,Unknown,76063258,9170000.0,2.0,20,937,20,0,0,1,30,3,0.4171738555173326,0.3465240641711229,0.4852941176470588,0.0031179781519437,0.0131578947368421,0.0,0.1747936984246061,0.1747936984246061,0.0509180810578071,0.1428571428571428,0.5116279069767438,0.125,158,41,10,41,1,5556,4,13,44,40000000,3308333.3333333335,40000000.0,0.0,6000000.0,35000000.0,2,7150000,1.0,1.3529411764705883
649343,Dmitriy,Vasiljev,2024,964,Russia,St. Petersburg,Russia,16-06-04,Defensive Midfield,Midfield,Right,184.0,30-06-28,ATS,https://img.a.transfermarkt.technology/portrait/header/649343-1721723612.png?lm=1,RU1,AO FK Zenit Sankt-Peterburg,700000.0,700000.0,20,83,-75,8,8,9,6,12,8,4,13,7,10,9,6,10,15,8,15,9,10,10,11,9,12,5,6,9,9,9,14,8,8,9,10,8,8,13,11,20,9,10,5,14,1,2,3,3,3,4,3,1,2,1,3,14,13,8,10,11,8,11,15,1,1,10,1,1,1,20,1,17,1,1,13,1,1,79,9,20,8517268,3250,3341,1178,Northern_European,80,0,0,699.0,FC Orenburg,2000158930,9111392.0,2.0,78,1413,81,3,1,7,7,4,0.1923789362265149,0.1206417112299465,0.2279411764705882,0.0006662759135463,0.0,0.0,0.0032508127031757,0.0032508127031757,0.0505924720131114,0.1428571428571428,0.4883720930232553,0.0833333333333332,77,15,8,13,0,3411,3,32,96,700000,72222.22222222222,700000.0,0.0,125000.0,700000.0,2,50000,0.4,0.4
649452,Issa,Kaboré,2024,294,Burkina Faso,Bobo-Dioulasso,Burkina Faso,12-05-01,Right-Back,Defender,Right,180.0,30-06-25,CAA Stellar,https://img.a.transfermarkt.technology/portrait/header/649452-1724407648.jpg?lm=1,PO1,Sport Lisboa e Benfica,10000000.0,10000000.0,23,118,143,10,11,12,10,12,7,8,8,8,11,12,10,11,12,14,12,12,12,12,9,12,14,13,8,14,11,10,10,16,13,8,8,12,16,12,12,11,5,11,5,1,2,3,4,2,1,2,1,2,1,3,1,14,18,5,12,9,11,13,12,1,1,1,20,1,15,1,1,1,1,1,1,1,1,70,10,20,16192446,5892,5892,3992,African_Caribbean,114,26,1,11599.0,Olympique de Marseille,13196665,4500000.0,1.0,12,209,13,1,1,1,188,11,0.5299020905001324,0.4216042780748663,0.4779411764705882,0.0111915041130467,0.1710526315789473,0.0131578947368421,0.0497624406101525,0.0497624406101525,0.0249729159143309,0.0,0.3953488372093026,0.2083333333333332,135,1,12,23,1,1452,2,6,31,6000000,393333.3333333333,10000000.0,4000000.0,1300000.0,3000000.0,4,8000000,-0.4,-0.4
650568,António,Silva,2024,294,Portugal,Viseu,Portugal,30-10-03,Centre-Back,Defender,Right,187.0,30-06-27,Gestifute,https://img.a.transfermarkt.technology/portrait/header/650568-1700235534.jpg?lm=1,PO1,Sport Lisboa e Benfica,40000000.0,45000000.0,21,132,-9,7,7,12,8,13,6,13,6,6,13,14,10,14,13,11,14,12,15,13,14,14,15,12,10,7,12,14,13,12,13,12,14,14,14,13,12,15,10,14,5,8,1,3,1,2,1,2,2,3,2,3,2,16,14,6,18,13,14,15,17,1,1,20,1,1,1,1,1,1,1,1,1,1,1,80,12,20,44100002,7000,6600,5000,Mediterranean_Hispanic,131,0,0,8500.0,Unknown,83320135,9111392.0,2.0,76,1615,79,1,1,3,188,2,0.6235776660492194,0.5294117647058822,0.6029411764705883,0.0081990562056842,0.0,0.0,0.1997999499874969,0.2248062015503876,0.0505924720131114,0.1428571428571428,0.5581395348837206,0.125,170,13,2,25,2,7434,0,0,0,38000000,3790000.0,45000000.0,5000000.0,4000000.0,40000000.0,1,3700000,-0.15555555555555556,-0.15555555555555556
650966,Samuele,Vignato,2024,2919,Italy,Fumane,Italy,24-02-04,Attacking Midfield,Midfield,Right,172.0,30-06-25,TMP SOCCER srl ,https://img.a.transfermarkt.technology/portrait/header/650966-1707129316.jpg?lm=1,IT1,Associazione Calcio Monza,3500000.0,4000000.0,20,108,-85,11,10,11,13,12,7,7,10,7,4,11,11,10,13,7,8,11,12,12,12,10,12,11,9,12,8,12,10,14,13,12,7,12,12,12,10,11,8,12,7,12,1,2,2,1,1,1,2,1,2,3,2,12,12,8,11,12,12,12,12,1,1,1,1,1,1,1,1,1,1,10,20,17,15,63,11,20,13385601,5398,5598,2998,Mixed_Race,106,0,0,768.0,Unknown,2000021407,9111392.0,2.0,52,517,54,3,1,4,28,0,0.4910029108229691,0.3152941176470588,0.4191176470588235,0.0007329035049009,0.0,0.0,0.0172543135783946,0.0197549387346836,0.0505924720131114,0.1428571428571428,0.2093023255813952,0.0833333333333332,84,22,15,2,1,1631,4,24,84,3500000,344444.44444444444,4000000.0,500000.0,600000.0,3500000.0,0,0,0.0,-0.125
651005,Cher,Ndour,2024,114,Italy,Brescia,Italy,27-07-04,Central Midfield,Midfield,Right,190.0,30-06-25,MRP.POSITIONUMBER,https://img.a.transfermarkt.technology/portrait/header/651005-1727356126.png?lm=1,TR1,Be?ikta? Jimnastik KulÃ¼bÃ¼,4000000.0,4000000.0,20,107,-8,11,11,12,10,13,10,11,10,5,10,13,8,11,13,10,11,8,14,12,13,12,12,15,6,8,12,12,9,12,11,12,13,13,12,13,13,13,8,10,4,12,3,3,3,1,1,2,1,3,1,1,1,12,14,11,7,13,13,12,10,1,1,1,1,1,1,12,8,20,8,10,20,10,1,84,8,20,32920000,5350,5350,3863,African_Caribbean,108,0,0,3749.0,Unknown,2000022887,9111392.0,2.0,52,257,54,3,1,1,37,1,0.4581899973537973,0.407807486631016,0.4338235294117646,0.0036114085748744,0.0,0.0,0.0197549387346836,0.0197549387346836,0.0505924720131114,0.1428571428571428,0.6279069767441858,0.0833333333333332,134,12,4,25,0,3559,2,3,13,4000000,370000.0,4000000.0,0.0,1500000.0,4000000.0,3,2500000,0.0,0.0
651269,Armin,Gigovic,2024,269,Sweden,Lund,Bosnia-Herzegovina,06-04-02,Central Midfield,Midfield,Right,187.0,Unknown,CLS Mundial,https://img.a.transfermarkt.technology/portrait/header/651269-1606809695.png?lm=1,L1,Kieler Sportvereinigung Holstein von 1900,2500000.0,2500000.0,22,113,-75,8,11,12,7,12,8,10,10,7,11,13,8,13,13,9,12,11,12,12,11,11,13,8,7,12,12,12,13,12,11,11,14,13,13,14,13,12,7,14,6,6,3,2,3,1,3,2,4,3,1,2,3,12,13,4,12,12,12,12,11,1,1,1,1,1,1,20,10,18,10,1,13,1,1,78,11,20,12664315,5698,5148,2498,Mediterranean_Hispanic,113,0,0,21794.0,Odense Boldklub,93122308,2150000.0,2.0,91,875,10,3,1,3,119,1,0.4314633500926171,0.2618181818181818,0.4705882352941176,0.0210359721400106,0.0,0.0,0.0122530632658164,0.0122530632658164,0.0119169976943803,0.1428571428571428,0.5581395348837206,0.1666666666666666,166,10,7,29,0,5494,3,15,58,3000000,166666.66666666666,3000000.0,50000.0,1500000.0,2000000.0,5,700000,0.5,0.5
652275,Hákon Arnar,Haraldsson,2024,1082,Iceland,Akranes,Iceland,10-04-03,Left Winger,Attack,Right,178.0,30-06-28,CAA Stellar,https://img.a.transfermarkt.technology/portrait/header/652275-1662491592.jpg?lm=1,FR1,Lille Olympique Sporting Club Lille MÃ©tropole,9000000.0,10000000.0,21,114,-8,13,10,13,11,13,12,7,12,3,4,13,5,8,13,14,13,14,11,10,13,9,15,15,10,13,6,14,14,13,14,13,10,13,14,13,7,9,12,13,8,15,2,1,1,1,1,1,3,2,1,2,3,15,14,4,14,15,16,15,16,1,1,1,1,1,1,1,1,15,1,15,20,15,1,0,10,20,9098744,5700,5034,1256,Northern_European,114,3,0,1344.0,Unknown,39060464,15000000.0,1.0,46,31,48,0,1,7,128,7,0.4163799947075945,0.1289839572192513,0.4779411764705882,0.0012890990501222,0.0197368421052631,0.0,0.0447611902975743,0.0497624406101525,0.0833078696630462,0.0,0.3488372093023257,0.125,158,28,26,23,1,5504,1,12,74,9000000,890000.0,10000000.0,2000000.0,600000.0,8000000.0,2,4500000,0.0,0.125
652332,ÃÂScar,Aranda,2024,3329,Spain,Granada,Spain,29-04-02,Left Winger,Attack,Right,181.0,30-06-26,CAA Stellar,https://img.a.transfermarkt.technology/portrait/header/default.jpg?lm=1,PO1,Futebol Clube de FamalicÃ£o,1500000.0,1500000.0,22,107,152,10,10,14,12,13,10,8,14,9,4,12,7,6,12,9,10,8,11,9,13,10,9,15,8,9,5,12,11,13,13,12,10,9,13,11,10,8,10,11,5,12,2,2,3,1,3,3,2,1,2,3,3,14,12,7,13,10,12,13,15,1,1,1,1,1,1,1,10,1,1,20,1,14,15,77,10,20,5743999,5350,5350,2850,Mediterranean_Hispanic,105,0,0,2205.0,Unknown,2000052060,300000.0,1.0,89,552,89,0,1,3,99,7,0.4581899973537973,0.2994652406417112,0.411764705882353,0.0021204955161562,0.0,0.0,0.0072518129532383,0.0072518129532383,0.0016389344148448,0.0,0.418604651162791,0.1666666666666666,114,18,6,17,0,2087,0,0,0,3000000,290000.0,3000000.0,100000.0,,400000.0,1,100000,5.0,5.0
653266,Mauro,Luna Diale,2024,3725,Argentina,Buenos Aires,Argentina,26-04-99,Attacking Midfield,Midfield,Right,173.0,30-06-28,SP,https://img.a.transfermarkt.technology/portrait/header/653266-1722083205.png?lm=1,RU1,RFK Akhmat Grozny,2000000.0,2500000.0,25,124,136,11,12,15,11,14,11,8,9,7,8,13,11,8,15,7,11,11,12,13,13,11,12,14,11,14,9,15,11,13,15,14,7,10,14,12,7,12,12,14,10,14,1,3,2,2,2,2,3,3,2,2,2,11,13,15,10,10,10,11,12,1,1,1,1,1,1,1,1,10,1,12,20,14,18,0,10,20,3477991,5972,5972,3481,Mediterranean_Hispanic,122,0,0,5445.0,Unknown,14160030,1135000.0,2.0,4,275,4,3,1,3,157,0,0.5404869012966393,0.3669518716577539,0.536764705882353,0.005249095458026,0.0,0.0,0.0097524381095273,0.0122530632658164,0.0062779521653379,0.1428571428571428,0.2325581395348837,0.2916666666666665,180,25,21,17,2,5707,3,28,190,1800000,141666.66666666666,2500000.0,500000.0,,75000.0,2,525000,-0.28,-0.1
653348,Unknown,Khellven,2024,2410,Brazil,Alexandria,Brazil,25-02-01,Right-Back,Defender,Right,176.0,30-06-28,Bertolucci Sports,https://img.a.transfermarkt.technology/portrait/header/653348-1693593972.png?lm=1,RU1,PFK CSKA Moskva,5000000.0,7000000.0,23,129,143,12,13,13,11,14,11,11,13,13,12,13,12,12,14,11,13,12,12,13,13,13,13,13,11,13,11,14,13,15,13,12,11,13,13,14,11,12,14,11,14,12,1,3,1,2,2,1,1,3,3,2,1,14,12,8,8,11,13,9,12,1,1,1,20,1,17,1,1,1,11,1,1,10,1,73,5,20,11098492,6420,6420,3257,Northern_European,128,0,0,11560.0,Unknown,19369351,4500000.0,1.0,10,40,11,1,1,7,148,11,0.5997618417570786,0.3429946524064171,0.5808823529411764,0.0111538450396723,0.0,0.0,0.0247561890472618,0.0347586896724181,0.0249729159143309,0.0,0.3023255813953489,0.2083333333333332,217,12,34,15,1,7460,0,0,0,5000000,291176.4705882353,7000000.0,1000000.0,4000000.0,4700000.0,2,50000,-0.16666666666666666,-0.2857142857142857
653610,Igor,Paixão,2024,234,Brazil,MacapÃ¡,Brazil,28-06-00,Left Winger,Attack,Right,168.0,30-06-27,Head Soccer,https://img.a.transfermarkt.technology/portrait/header/653610-1723200804.jpg?lm=1,NL1,Feyenoord Rotterdam,14000000.0,15000000.0,24,125,143,9,11,13,11,12,8,8,11,8,8,12,11,8,13,9,12,8,12,12,9,12,13,13,7,14,7,12,12,15,14,12,6,13,15,13,7,12,4,12,4,7,3,3,2,4,1,3,1,2,2,2,1,15,12,2,10,12,13,9,12,1,1,1,1,1,1,1,1,1,1,17,12,15,20,63,11,20,7044999,6250,6250,3900,African_Caribbean,110,0,0,14999.0,Unknown,19383256,4500000.0,1.0,10,889,11,0,1,1,85,7,0.5772691188145012,0.4117647058823529,0.4485294117647059,0.014474602817478,0.0,0.0,0.0697674418604651,0.0747686921730432,0.0249729159143309,0.0,0.1162790697674416,0.25,235,54,37,21,0,4097,2,5,12,17000000,1495454.5454545454,17000000.0,3000000.0,,,1,5200000,0.21428571428571427,0.13333333333333333
654253,Toby,Collyer,2024,985,England,Worthing,England,03-01-04,Defensive Midfield,Midfield,Right,180.0,30-06-27,CAA Base Ltd,https://img.a.transfermarkt.technology/portrait/header/654253-1709159230.jpg?lm=1,GB1,Manchester United Football Club,2000000.0,2000000.0,20,78,-75,10,9,10,8,12,7,5,8,6,6,13,4,8,13,11,10,8,11,12,9,9,18,5,6,10,5,13,13,11,10,10,9,15,12,11,7,20,5,10,7,10,1,1,3,1,1,4,1,2,2,2,2,7,14,6,12,10,10,12,12,1,1,13,1,1,1,20,1,19,1,1,1,1,1,0,9,20,25193405,3897,3897,1747,Northern_European,71,0,0,2320.0,Unknown,2000010840,9111392.0,2.0,32,1675,33,3,1,7,132,4,0.2659433712622386,0.1814973262032085,0.1617647058823529,0.0022315415017472,0.0,0.0,0.0097524381095273,0.0097524381095273,0.0505924720131114,0.1428571428571428,0.3953488372093026,0.0833333333333332,71,0,3,9,0,2808,1,1,8,3000000,933333.3333333334,3000000.0,-1000000.0,,3000000.0,1,1800000,14.0,0.0
654539,Adrien,Truffert,2024,273,Belgium,LiÃ¨ge,France,20-11-01,Left-Back,Defender,Left,176.0,30-06-26,CAA Stellar,https://img.a.transfermarkt.technology/portrait/header/654539-1616684807.jpg?lm=1,FR1,Stade Rennais Football Club,18000000.0,18000000.0,23,122,-8,7,14,11,12,13,5,7,12,6,12,14,5,13,13,13,12,13,12,12,13,13,12,13,7,14,13,14,13,14,13,12,7,12,14,14,12,13,12,12,5,12,2,3,3,1,1,1,1,2,3,2,2,15,8,5,11,12,13,9,18,1,20,1,1,13,1,1,15,1,1,12,1,1,1,63,20,8,63331488,6093,6093,4993,Northern_European,123,0,0,9270.0,Unknown,49050736,9111392.0,2.0,7,849,36,1,0,7,195,8,0.5564964276263562,0.528663101604278,0.5441176470588236,0.0089425815005112,0.0,0.0,0.0897724431107777,0.0897724431107777,0.0505924720131114,0.1428571428571428,0.3023255813953489,0.2083333333333332,200,9,21,21,1,4173,2,14,88,15000000,1138461.5384615385,18000000.0,3000000.0,1000000.0,15000000.0,0,0,-0.16666666666666666,-0.16666666666666666
654982,Bilal,El Khannouss,2024,1003,Belgium,Strombeek-Bever,Morocco,10-05-04,Attacking Midfield,Midfield,Right,180.0,30-06-28,Stirr Associates,https://img.a.transfermarkt.technology/portrait/header/654982-1714038053.png?lm=1,GB1,Leicester City Football Club,30000000.0,30000000.0,20,110,-75,11,11,13,9,14,9,8,9,6,4,14,8,6,13,11,10,15,13,12,14,14,14,14,6,13,6,10,11,13,12,5,10,12,14,11,8,9,9,18,5,11,3,3,3,3,3,1,1,2,1,3,2,8,11,8,12,12,10,8,7,1,1,1,1,1,1,1,1,1,1,12,20,1,14,70,12,20,22560000,6248,5748,2540,North_African__Middle_Eastern,112,0,0,1249.0,Unknown,2000055184,9111392.0,2.0,7,1431,67,3,1,6,127,0,0.5108494310664197,0.2663101604278075,0.463235294117647,0.0011973654098514,0.0,0.0,0.1497874468617154,0.1497874468617154,0.0505924720131114,0.1428571428571428,0.3953488372093026,0.0833333333333332,124,7,17,16,0,2930,0,0,0,30000000,2990000.0,30000000.0,0.0,11000000.0,30000000.0,2,3400000,0.0,0.36363636363636365
655006,Diego,Moreira,2024,667,Belgium,LiÃ¨ge,Portugal,06-08-04,Left Winger,Attack,Left,179.0,30-06-29,Gestifute,https://img.a.transfermarkt.technology/portrait/header/655006-1702991199.jpg?lm=1,FR1,Racing Club de Strasbourg Alsace,3000000.0,3000000.0,20,100,-85,10,13,14,10,13,8,6,9,4,6,12,8,5,14,10,9,9,10,11,12,9,12,17,6,12,9,8,11,13,12,11,7,14,13,11,9,12,8,14,6,10,1,3,3,2,2,1,3,3,3,1,1,10,14,14,10,14,12,12,10,1,1,1,1,1,1,1,14,1,12,20,1,18,10,73,20,8,22200000,5000,5000,2252,Mixed_Race,99,0,0,4250.0,Unknown,2000027719,2000000.0,1.0,7,849,79,0,0,4,159,7,0.4118814501190792,0.2355080213903743,0.3676470588235294,0.004095182825145,0.0,0.0,0.0147536884221055,0.0147536884221055,0.0110836412122558,0.0,0.3720930232558141,0.0833333333333332,106,16,16,17,1,4250,0,0,0,6000000,583333.3333333334,6000000.0,0.0,2000000.0,6000000.0,4,4250000,1.0,1.0
655456,Saba,Sazonov,2024,749,Russia,St. Petersburg,Georgia,01-02-02,Centre-Back,Defender,Right,194.0,30-06-25,Unknown,https://img.a.transfermarkt.technology/portrait/header/655456-1695386095.jpg?lm=1,IT1,Empoli Football Club S.r.l.,2800000.0,3000000.0,22,110,-75,2,2,5,7,7,5,14,9,8,12,7,7,14,8,12,13,14,12,13,7,10,4,11,14,8,11,13,12,12,9,12,15,15,14,12,15,13,16,9,13,7,3,1,3,2,1,1,2,3,2,2,3,17,14,16,13,11,12,10,20,1,1,20,1,1,1,8,1,1,1,1,1,1,1,87,7,20,17454238,4990,5490,2590,North_African__Middle_Eastern,107,0,0,10337.0,Unknown,58154551,1425000.0,2.0,78,1413,39,1,1,6,64,2,0.4767134162476846,0.2716577540106951,0.4264705882352941,0.0099728951233431,0.0,0.0,0.0137534383595899,0.0147536884221055,0.0078891080307786,0.1428571428571428,0.7209302325581395,0.1666666666666666,108,9,2,25,1,3567,4,35,198,2500000,165000.0,3000000.0,300000.0,125000.0,2000000.0,5,575000,-0.10714285714285714,-0.16666666666666666
655488,Gabriel,Martinelli,2024,11,Brazil,Guarulhos,Brazil,18-06-01,Left Winger,Attack,Right,178.0,30-06-27,Roc Nation Sports,https://img.a.transfermarkt.technology/portrait/header/655488-1682689091.jpg?lm=1,GB1,Arsenal Football Club,60000000.0,85000000.0,23,148,174,14,10,14,14,14,10,13,8,3,5,12,11,5,14,12,13,13,13,12,13,12,16,15,6,15,6,16,16,17,16,14,11,13,16,13,10,13,6,14,10,12,2,2,4,4,3,2,2,2,3,2,1,16,14,5,12,14,15,13,13,1,1,1,1,1,1,1,12,1,10,20,13,16,19,72,10,20,100274855,7400,7250,6000,Mediterranean_Hispanic,141,3,0,63795.0,Unknown,19351309,7100000.0,1.0,10,575,11,0,1,3,21,7,0.7095792537708389,0.6363636363636364,0.6764705882352942,0.0615928629296634,0.0197368421052631,0.0,0.2998249562390597,0.4248562140535133,0.039417761604489,0.0,0.3488372093023257,0.2083333333333332,227,54,28,16,0,6058,9,56,170,55000000,2631578.947368421,85000000.0,10000000.0,25000000.0,40000000.0,0,0,-0.21428571428571427,-0.35294117647058826
655895,Bartu?,Elmaz,2024,36,TÃ¼rkiye,Tekirdag,TÃ¼rkiye,19-02-03,Defensive Midfield,Midfield,Right,179.0,30-06-26,FutureBall,https://img.a.transfermarkt.technology/portrait/header/655895-1728392470.JPG?lm=1,TR1,FenerbahÃ§e Spor KulÃ¼bÃ¼,1500000.0,1500000.0,21,85,-75,11,11,6,10,13,12,6,13,7,8,14,6,5,13,6,9,6,13,5,14,11,16,5,13,7,7,13,8,8,10,8,8,14,8,8,8,20,12,14,11,7,2,1,3,2,2,1,2,3,1,1,3,10,13,6,12,10,13,13,14,1,1,1,1,1,1,20,1,18,1,1,1,1,1,65,15,20,19230001,4698,4684,2690,North_African__Middle_Eastern,72,0,0,858.0,Unknown,70137157,1400000.0,1.0,100,1480,100,3,1,6,84,4,0.3700714474728764,0.2823529411764705,0.1691176470588235,0.0008198090588418,0.0,0.0,0.0072518129532383,0.0072518129532383,0.0077502152837578,0.0,0.3720930232558141,0.125,70,13,4,9,0,2767,3,7,15,1500000,120833.33333333333,1500000.0,0.0,100000.0,800000.0,5,800000,0.0,0.875
655902,Emin,Bayram,2024,968,TÃ¼rkiye,Istanbul,TÃ¼rkiye,02-04-03,Centre-Back,Defender,Right,192.0,30-06-28,DW Sports Management,https://img.a.transfermarkt.technology/portrait/header/655902-1671037417.png?lm=1,BE1,Koninklijke Voetbal Club Westerlo,4000000.0,4000000.0,21,95,-75,4,5,7,5,10,7,11,5,5,13,12,7,12,10,10,9,13,12,12,10,10,4,4,8,5,11,12,13,11,10,12,13,13,12,9,12,13,6,18,5,5,1,1,2,3,2,2,1,1,3,1,3,17,10,8,11,13,8,10,15,1,1,20,1,1,1,1,1,1,1,1,1,1,1,78,8,20,10059683,5150,5150,3012,North_African__Middle_Eastern,92,0,0,552.0,Unknown,70137158,9111392.0,2.0,100,667,100,1,1,6,123,2,0.4317279703625297,0.3167914438502673,0.3161764705882353,0.000524330175443,0.0,0.0,0.0197549387346836,0.0197549387346836,0.0505924720131114,0.1428571428571428,0.6744186046511627,0.125,112,5,2,17,0,2791,2,15,71,5000000,380769.23076923075,5000000.0,200000.0,550000.0,1500000.0,3,525000,0.25,2.3333333333333335
656681,Victor,Boniface,2024,15,Nigeria,Akure,Nigeria,23-12-00,Centre-Forward,Attack,Right,190.0,30-06-28,Aneke/PMG ,https://img.a.transfermarkt.technology/portrait/header/656681-1727378262.jpg?lm=1,L1,Bayer 04 Leverkusen FuÃŸball,45000000.0,45000000.0,24,125,145,7,10,13,13,15,10,13,13,10,10,9,14,9,15,13,12,12,11,10,9,7,15,15,9,11,9,12,12,13,13,17,14,10,14,11,18,11,10,10,16,10,1,2,2,2,3,2,1,1,2,2,2,14,13,5,10,10,13,12,19,1,1,1,1,1,1,1,1,1,1,12,1,12,20,88,10,20,31199998,6000,6250,5200,African_Caribbean,125,0,0,5499.0,Unknown,53174131,13900000.0,2.0,69,33,70,0,1,1,36,3,0.5772691188145012,0.5508021390374331,0.5588235294117647,0.0053012387903905,0.0,0.0,0.2248062015503876,0.2248062015503876,0.0771965887941331,0.1428571428571428,0.6279069767441858,0.25,170,71,31,15,0,5799,6,125,358,45000000,2996666.6666666665,45000000.0,100000.0,50000.0,500000.0,2,29300000,0.125,0.125
657435,Pedro,Santos,2024,8024,Portugal,Porto,Portugal,12-10-00,Central Midfield,Midfield,Left,183.0,30-06-28,Proeleven S.A.,https://img.a.transfermarkt.technology/portrait/header/657435-1680781798.png?lm=1,PO1,Futebol Clube de Arouca,1500000.0,1500000.0,24,122,140,13,13,15,10,15,14,6,13,6,8,15,14,12,15,15,12,14,12,12,13,12,13,15,9,14,12,12,10,13,13,12,6,13,12,10,7,12,12,13,9,13,2,2,2,3,2,3,2,1,1,3,2,13,13,7,13,11,12,11,11,1,19,1,1,19,1,1,15,1,11,20,10,13,8,64,20,12,188350,6063,6220,4170,Mediterranean_Hispanic,123,0,0,13330.0,Unknown,55028168,9111392.0,2.0,76,1170,79,3,0,3,98,1,0.573299814765811,0.4406417112299465,0.5441176470588236,0.0128629876005086,0.0,0.0,0.0072518129532383,0.0072518129532383,0.0505924720131114,0.1428571428571428,0.4651162790697669,0.25,143,10,3,33,1,4836,0,0,0,1000000,170000.0,1500000.0,500000.0,,,1,100000,-0.3333333333333333,3.0
658269,Víctor,Meseguer,2024,366,Spain,Murcia,Spain,09-06-99,Central Midfield,Midfield,Right,184.0,30-06-29,JV SPORTS ,https://img.a.transfermarkt.technology/portrait/header/658269-1660121083.jpg?lm=1,ES1,Real Valladolid Club de FÃºtbol S.A.D.,2200000.0,2200000.0,25,123,137,7,8,12,11,13,11,12,12,7,10,13,12,10,13,13,12,11,13,13,12,13,15,7,11,13,12,13,15,13,12,9,11,13,13,14,12,13,6,6,5,16,2,2,3,2,1,3,3,3,3,1,1,13,9,7,12,12,9,11,15,1,1,1,1,1,1,11,1,20,1,1,13,1,1,81,11,20,3058972,6150,6150,4150,Mediterranean_Hispanic,123,0,0,6485.0,Unknown,67278046,1543333.333,3.0,89,993,89,3,1,3,169,1,0.5640381053188674,0.4385026737967914,0.5441176470588236,0.0062533374146756,0.0,0.0,0.010752688172043,0.010752688172043,0.0085465336981582,0.2857142857142857,0.4883720930232553,0.2916666666666665,181,19,7,37,0,1575,0,0,0,2000000,135714.2857142857,3000000.0,1000000.0,,100000.0,3,100000,-0.09090909090909091,0.6666666666666666
658531,Mohamed,Diomandé,2024,124,Cote d'Ivoire,Yopougon,Cote d'Ivoire,30-10-01,Central Midfield,Midfield,Left,183.0,30-06-28,Unknown,https://img.a.transfermarkt.technology/portrait/header/658531-1718179984.jpg?lm=1,SC1,Rangers Football Club,5000000.0,5000000.0,23,120,-8,12,12,15,12,14,12,12,9,2,4,14,12,4,15,10,13,11,12,12,13,12,14,15,9,14,5,13,13,14,14,12,11,13,14,12,8,11,11,9,5,5,3,1,3,3,4,3,3,1,3,2,1,12,14,6,12,12,14,13,12,1,1,1,1,1,1,1,1,20,1,16,20,1,12,75,20,7,3878527,6250,4481,1340,African_Caribbean,111,0,0,1680.0,Unknown,13183075,5000000.0,1.0,23,1687,24,3,0,1,161,1,0.3432124900767399,0.1379679144385026,0.4558823529411764,0.0016135464515013,0.0,0.0,0.0247561890472618,0.0247561890472618,0.0277507708547459,0.0,0.4651162790697669,0.2083333333333332,0,0,0,0,0,0,3,27,117,6000000,426785.71428571426,6000000.0,500000.0,1000000.0,1300000.0,2,575000,0.5,1.0
658536,Simon,Adingra,2024,1237,Cote d'Ivoire,Abobo,Cote d'Ivoire,01-01-02,Right Winger,Attack,Right,175.0,30-06-26,Fidus Sports,https://img.a.transfermarkt.technology/portrait/header/658536-1666292606.jpg?lm=1,GB1,Brighton and Hove Albion Football Club,30000000.0,30000000.0,22,121,-8,7,11,16,12,14,7,9,8,5,4,8,11,3,14,10,15,10,11,11,8,7,11,16,8,15,4,11,13,16,15,7,8,13,16,11,9,6,8,9,12,13,2,2,4,2,1,1,1,1,2,3,3,12,13,7,12,8,13,12,11,1,1,1,1,1,1,1,14,1,1,20,1,11,16,68,9,20,67971157,6057,6053,1601,African_Caribbean,116,0,0,17399.0,Royale Union Saint-Gilloise,2000018781,8000000.0,1.0,23,16,24,0,1,1,44,10,0.5512040222281027,0.1658823529411764,0.4926470588235294,0.0167920842559001,0.0,0.0,0.1497874468617154,0.1497874468617154,0.044417900497236,0.0,0.2790697674418605,0.1666666666666666,168,51,30,13,1,5060,3,11,25,30000000,2305769.230769231,30000000.0,25000.0,0.0,6000000.0,4,8525000,0.0,0.2
658848,Jesús,Castillo,2024,2424,Peru,Callao,Peru,11-06-01,Defensive Midfield,Midfield,Right,185.0,30-06-27,Unknown,https://img.a.transfermarkt.technology/portrait/header/658848-1710239832.jpg?lm=1,PO1,Gil Vicente Futebol Clube,700000.0,1000000.0,23,106,138,10,13,9,7,13,8,13,9,9,13,14,11,13,13,13,12,12,10,9,12,12,9,8,8,9,13,13,13,12,10,11,13,10,13,12,12,13,8,12,7,12,4,3,1,3,3,2,2,2,1,1,1,11,11,5,14,8,10,12,14,1,1,1,1,1,1,20,1,17,1,1,1,1,1,80,6,20,375679,5279,5279,2266,African_Caribbean,108,2,0,1529.0,Unknown,77062603,1000000.0,1.0,74,304,76,3,1,1,106,4,0.4487959777718974,0.2370053475935828,0.4338235294117646,0.0014677382443339,0.0131578947368421,0.0,0.0032508127031757,0.0047511877969492,0.0055279313314258,0.0,0.5116279069767438,0.2083333333333332,145,3,2,23,1,7215,4,14,42,700000,50000.0,1000000.0,200000.0,175000.0,700000.0,1,250000,0.0,-0.3
659089,Ilya,Zabarnyi,2024,989,Ukraine,Kyiv,Ukraine,01-09-02,Centre-Back,Defender,Right,189.0,30-06-29,Unknown,https://img.a.transfermarkt.technology/portrait/header/659089-1715881375.jpg?lm=1,GB1,Association Football Club Bournemouth,32000000.0,32000000.0,22,130,-85,3,3,9,5,10,4,13,5,5,13,11,6,15,10,10,14,13,14,14,9,14,14,5,9,8,14,16,13,13,12,15,15,15,14,14,14,15,2,18,3,13,1,1,3,2,1,2,1,3,1,1,3,7,15,3,15,16,14,14,16,1,1,20,5,1,2,1,1,1,1,1,1,1,1,81,8,20,29419640,6500,6500,5000,Northern_European,130,22,0,6918.0,Unknown,71113679,22700000.0,1.0,103,774,101,1,1,7,22,2,0.6103466525535857,0.5294117647058822,0.5955882352941175,0.0066714496908576,0.1447368421052631,0.0,0.1597899474868717,0.1597899474868717,0.1260868357454374,0.0,0.6046511627906974,0.1666666666666666,163,2,3,21,2,4414,3,7,50,38000000,2710714.285714286,38000000.0,0.0,11000000.0,20000000.0,1,3000000,0.1875,0.52
659459,Carney,Chukwuemeka,2024,631,Austria,Eisenstadt,England,20-10-03,Central Midfield,Midfield,Right,187.0,30-06-28,Unknown,https://img.a.transfermarkt.technology/portrait/header/659459-1677687144.jpg?lm=1,GB1,Chelsea Football Club,15000000.0,15000000.0,21,120,-85,5,6,13,11,14,5,11,11,6,8,13,7,10,14,10,12,14,15,10,11,12,17,14,9,9,10,9,12,13,13,12,11,12,14,13,13,11,9,10,8,11,3,1,1,1,3,2,4,1,1,1,3,12,18,6,10,10,10,10,14,1,1,1,1,1,1,1,1,20,1,1,18,1,1,70,13,20,66718446,6000,6000,4750,African_Caribbean,117,0,0,115992.0,Unknown,28127875,18000000.0,1.0,6,451,33,3,1,1,50,1,0.5441915850754168,0.5026737967914437,0.4999999999999999,0.1119951873635462,0.0,0.0,0.0747686921730432,0.0747686921730432,0.0999749993055362,0.0,0.5581395348837206,0.125,106,15,14,5,0,3066,12,49,84,15000000,1400000.0,15000000.0,0.0,15000000.0,15000000.0,1,9000000,0.0,0.0
659513,Soumaïla,Coulibaly,2024,3911,France,Montfermeil,France,14-10-03,Centre-Back,Defender,Right,191.0,30-06-25,Epic Coulibaly,https://img.a.transfermarkt.technology/portrait/header/659513-1657285323.jpg?lm=1,FR1,Stade brestois 29,6000000.0,8000000.0,21,116,145,8,9,13,11,12,7,8,11,4,6,11,9,6,13,7,13,7,12,10,9,11,4,11,5,13,11,14,13,15,13,12,11,10,14,12,11,9,6,5,8,12,3,2,2,1,1,2,2,2,1,1,2,19,12,2,13,9,14,12,14,1,1,1,1,1,1,1,1,20,1,15,16,15,15,68,13,20,9715468,5500,5250,4000,African_Caribbean,107,0,0,2900.0,Unknown,53173177,9111392.0,2.0,34,976,36,1,1,1,196,2,0.4449589838581635,0.4224598930481283,0.4264705882352941,0.0027915995160326,0.0,0.0,0.0297574393598399,0.0397599399849962,0.0505924720131114,0.1428571428571428,0.6511627906976742,0.125,97,0,1,11,0,4487,8,46,243,9000000,687500.0,9000000.0,2000000.0,900000.0,6000000.0,2,8000000,0.5,0.125
659516,Warren,Bondo,2024,2919,France,Ã‰vry,France,15-09-03,Central Midfield,Midfield,Right,177.0,30-06-27,Unknown,https://img.a.transfermarkt.technology/portrait/header/659516-1663659034.jpg?lm=1,IT1,Associazione Calcio Monza,6000000.0,6000000.0,21,101,-8,8,10,13,11,14,8,11,8,8,12,13,6,12,12,13,8,4,13,7,14,14,8,15,3,10,9,9,10,12,8,9,8,12,9,13,12,11,5,7,11,12,2,2,2,2,1,3,2,2,3,3,2,15,13,7,9,11,12,13,11,1,1,1,1,1,1,10,13,20,13,13,15,13,1,0,6,20,14259200,5000,5000,2500,African_Caribbean,94,0,0,2022.0,Unknown,2000006107,9111392.0,2.0,34,1724,36,3,1,1,28,1,0.4118814501190792,0.2620320855614972,0.3308823529411764,0.0019437875564765,0.0,0.0,0.0297574393598399,0.0297574393598399,0.0505924720131114,0.1428571428571428,0.3255813953488373,0.125,110,4,5,20,1,3210,1,5,25,7000000,622727.2727272727,7000000.0,100000.0,700000.0,6000000.0,3,300000,0.16666666666666666,6.0
659542,Elye,Wahi,2024,244,France,Courcouronnes,France,02-01-03,Centre-Forward,Attack,Right,181.0,30-06-29,DW Sports Management,https://img.a.transfermarkt.technology/portrait/header/659542-1692791720.jpg?lm=1,FR1,Olympique de Marseille,30000000.0,40000000.0,21,122,-85,8,9,13,14,13,11,13,12,6,6,11,12,6,14,11,12,11,12,12,8,12,13,13,8,13,8,13,13,15,13,12,8,12,15,13,13,13,9,12,8,12,1,1,2,2,2,1,1,2,3,3,2,12,14,13,14,15,13,9,10,1,1,1,1,1,1,1,1,1,1,15,1,12,20,74,8,20,52836555,6097,6097,3801,African_Caribbean,122,0,0,9279.0,Unknown,49061868,27500000.0,2.0,34,390,36,0,1,1,144,3,0.5570256681661815,0.4011764705882352,0.536764705882353,0.0089512720559053,0.0,0.0,0.1497874468617154,0.1997999499874969,0.1527542431734214,0.1428571428571428,0.418604651162791,0.125,157,50,14,20,2,2796,3,7,18,25000000,1466666.6666666667,40000000.0,5000000.0,6000000.0,40000000.0,2,10000000,-0.2857142857142857,-0.375
659543,Matthis,Abline,2024,995,France,Angers,France,28-03-03,Centre-Forward,Attack,Right,182.0,30-06-28,Wasserman,https://img.a.transfermarkt.technology/portrait/header/659543-1704213657.jpg?lm=1,FR1,Football Club de Nantes,9000000.0,9000000.0,21,102,-8,10,7,12,12,13,10,8,9,6,7,12,11,6,13,7,12,12,11,11,12,10,13,12,10,8,7,10,11,13,13,11,8,12,14,11,13,11,12,10,5,8,2,2,3,2,3,4,1,3,3,2,1,20,14,2,12,12,13,12,11,1,1,1,1,1,1,1,1,1,1,1,1,1,20,0,10,20,55860140,5100,5100,2500,Northern_European,100,0,0,1711.0,Unknown,49056366,10000000.0,1.0,34,70,36,0,1,7,93,3,0.4251124636147129,0.2620320855614972,0.3749999999999999,0.0016434805867476,0.0,0.0,0.0447611902975743,0.0447611902975743,0.055529320258896,0.0,0.4418604651162785,0.125,125,30,10,7,0,2525,0,0,0,9000000,716666.6666666666,9000000.0,500000.0,2000000.0,4000000.0,4,2000000,0.5,1.0
659813,Piero,Hincapié,2024,15,Ecuador,Esmeraldas,Ecuador,09-01-02,Centre-Back,Defender,Left,184.0,30-06-27,Unknown,https://img.a.transfermarkt.technology/portrait/header/659813-1727377918.jpg?lm=1,L1,Bayer 04 Leverkusen FuÃŸball,40000000.0,40000000.0,22,132,-85,4,8,12,6,12,6,12,6,11,14,14,10,14,13,12,14,13,13,13,12,12,13,9,10,10,15,13,13,14,13,12,12,12,13,15,13,13,11,12,5,15,2,1,3,2,2,2,2,2,3,1,1,12,12,6,11,13,15,11,12,1,15,20,1,12,1,1,1,1,1,1,1,1,1,76,20,10,97308000,6740,6490,4740,Mixed_Race,132,21,1,19177.0,Unknown,86066853,4950000.0,2.0,30,471,31,1,0,4,36,2,0.6090235512040222,0.5016042780748663,0.6102941176470589,0.0185089517548645,0.1381578947368421,0.0131578947368421,0.1997999499874969,0.1997999499874969,0.0274729853607044,0.1428571428571428,0.4883720930232553,0.1666666666666666,181,6,4,32,1,5101,3,2,31,40000000,2493750.0,40000000.0,0.0,600000.0,25000000.0,2,5100000,0.0,0.14285714285714285
660860,Diego,Coppola,2024,276,Italy,Bussolengo,Italy,28-12-03,Centre-Back,Defender,Right,193.0,30-06-27,CAA Base Ltd,https://img.a.transfermarkt.technology/portrait/header/660860-1663671800.jpg?lm=1,IT1,Verona Hellas Football Club,6000000.0,6000000.0,20,125,-85,5,5,10,5,11,4,14,5,11,13,11,6,15,11,15,13,14,12,14,7,12,13,4,8,5,13,11,14,13,12,12,14,11,13,14,15,13,10,13,6,12,2,3,3,3,2,3,1,1,1,2,3,15,15,8,13,15,14,12,13,1,1,20,1,1,1,1,1,1,1,1,1,1,1,0,10,20,47176001,6250,6250,1010,Mediterranean_Hispanic,125,0,0,17799.0,Unknown,43500130,9111392.0,2.0,52,283,54,1,1,3,214,2,0.5772691188145012,0.1026737967914438,0.5588235294117647,0.0171783311623038,0.0,0.0,0.0297574393598399,0.0297574393598399,0.0505924720131114,0.1428571428571428,0.6976744186046511,0.0833333333333332,0,0,0,0,0,0,4,22,84,7500000,744444.4444444445,7500000.0,0.0,3000000.0,7500000.0,0,0,0.25,0.875
660867,Julio,Enciso,2024,1237,Paraguay,CaaguazÃº,Paraguay,23-01-04,Attacking Midfield,Midfield,Right,173.0,30-06-26,Pedro Aldave Ortuzar,https://img.a.transfermarkt.technology/portrait/header/660867-1669388786.jpg?lm=1,GB1,Brighton and Hove Albion Football Club,22000000.0,22000000.0,20,115,-8,9,12,16,11,12,9,7,13,10,6,12,12,6,12,7,6,9,11,9,9,8,11,14,6,11,7,6,13,16,15,10,7,12,13,11,9,8,8,12,5,11,1,2,1,1,3,1,2,3,3,1,1,13,12,8,11,12,11,6,12,1,1,1,1,1,1,1,7,5,7,20,11,15,14,72,12,20,69502248,5744,5344,3257,Mediterranean_Hispanic,110,5,0,17399.0,Unknown,79034187,11600000.0,1.0,73,291,75,3,1,3,44,0,0.4573961365440593,0.3429946524064171,0.4485294117647059,0.0167920842559001,0.0328947368421052,0.0,0.1097774443610902,0.1097774443610902,0.0644184560682241,0.0,0.2325581395348837,0.0833333333333332,133,29,16,9,0,4652,4,61,184,22000000,1977272.7272727273,22000000.0,0.0,11000000.0,22000000.0,2,300000,0.0,0.0
661053,Jarrad,Branthwaite,2024,29,England,Carlisle,England,27-06-02,Centre-Back,Defender,Left,195.0,30-06-27,Unknown,https://img.a.transfermarkt.technology/portrait/header/661053-1687975679.jpg?lm=1,GB1,Everton Football Club,42000000.0,42000000.0,22,127,-8,3,6,10,7,12,7,13,5,9,11,10,6,12,12,14,12,17,12,12,12,11,13,13,10,11,12,13,13,13,12,13,18,13,12,13,13,11,11,11,11,12,2,1,1,3,1,2,2,2,2,2,3,11,15,4,10,13,11,9,12,1,16,20,16,1,1,10,1,7,1,1,1,1,1,0,20,17,91053512,6400,6150,4900,Northern_European,124,0,0,17399.0,PSV Eindhoven,29226000,1100000.0,1.0,32,318,33,1,0,7,65,2,0.5640381053188674,0.5187165775401069,0.5514705882352942,0.0167920842559001,0.0,0.0,0.2098024506126531,0.2098024506126531,0.0060835023195088,0.0,0.7441860465116279,0.1666666666666666,145,10,3,16,1,5239,9,50,61,42000000,2857142.8571428573,42000000.0,0.0,3000000.0,10000000.0,4,9000000,0.0,0.68
661140,Franco,Orozco,2024,2696,Argentina,Canning,Argentina,09-01-02,Left Winger,Attack,Right,168.0,31-12-24,Hernan Berman,https://img.a.transfermarkt.technology/portrait/header/661140-1722144698.png?lm=1,RU1,PFK Krylya Sovetov Samara,2500000.0,3000000.0,22,114,-75,11,13,15,8,14,10,12,11,10,10,15,7,8,14,8,9,6,12,11,12,12,8,11,13,15,8,11,12,11,13,11,5,10,14,13,6,14,5,17,9,14,2,2,2,3,2,1,3,3,1,2,1,9,10,1,13,11,12,10,14,1,1,1,1,1,1,1,1,1,1,20,1,1,16,61,11,20,5958894,5882,5882,2618,Mediterranean_Hispanic,117,0,0,679.0,Unknown,14221877,9111392.0,2.0,4,311,4,0,1,3,149,7,0.528578989150569,0.2746524064171122,0.4999999999999999,0.0006469635682261,0.0,0.0,0.0122530632658164,0.0147536884221055,0.0505924720131114,0.1428571428571428,0.1162790697674416,0.1666666666666666,125,18,11,10,0,4129,0,0,0,2000000,159090.9090909091,3000000.0,800000.0,675000.0,1800000.0,3,2900000,-0.2,0.0
661145,Jon,Aramburu,2024,681,Venezuela,Caracas,Venezuela,23-07-02,Right-Back,Defender,Right,176.0,30-06-27,BY AND FOR,https://img.a.transfermarkt.technology/portrait/header/661145-1719915615.jpg?lm=1,ES1,Real Sociedad de FÃºtbol S.A.D.,5000000.0,5000000.0,22,109,-75,6,9,9,5,11,7,12,6,8,13,9,5,13,11,14,13,13,12,13,9,12,8,8,13,8,13,13,13,13,12,12,8,14,12,13,11,20,7,12,7,18,2,2,3,2,3,3,3,2,2,2,3,17,12,1,12,11,12,13,15,1,19,16,20,16,16,1,1,1,1,1,1,1,1,71,5,20,350700,5450,5450,2000,Mediterranean_Hispanic,105,0,0,2099.0,Unknown,86080170,9111392.0,2.0,108,315,105,1,1,3,168,11,0.4714210108494311,0.2085561497326203,0.411764705882353,0.0020181400859592,0.0,0.0,0.0247561890472618,0.0247561890472618,0.0505924720131114,0.1428571428571428,0.3023255813953489,0.1666666666666666,169,4,2,43,0,3159,0,0,0,12000000,853571.4285714285,12000000.0,0.0,200000.0,300000.0,4,2525000,1.4,39.0
661171,Willian,Pacho,2024,583,Ecuador,QuinindÃ©,Ecuador,16-10-01,Centre-Back,Defender,Left,187.0,30-06-29,Kancha Agency,https://img.a.transfermarkt.technology/portrait/header/661171-1696508666.jpg?lm=1,FR1,Paris Saint-Germain Football Club,40000000.0,40000000.0,23,120,-75,6,6,9,7,10,6,13,7,6,14,13,8,12,12,12,13,13,13,11,8,12,14,9,7,9,13,14,14,11,13,16,13,13,12,15,15,12,8,14,7,11,3,3,2,3,2,3,1,3,1,2,2,19,11,6,13,12,10,12,19,1,1,20,1,1,1,12,1,1,1,1,1,1,1,81,20,8,23100000,6390,6090,2155,African_Caribbean,120,0,0,21109.0,Unknown,86075795,19740000.0,3.0,30,1199,31,1,0,1,154,2,0.5560994972214872,0.2251336898395722,0.5220588235294117,0.0203745243127943,0.0,0.0,0.1997999499874969,0.1997999499874969,0.1096419344981805,0.2857142857142857,0.5581395348837206,0.2083333333333332,174,0,4,20,0,6124,2,12,124,40000000,2660000.0,40000000.0,300000.0,100000.0,3000000.0,3,11300000,0.14285714285714285,0.6666666666666666
661205,Daniel,Karlsbakk,2024,306,Norway,Kristiansand,Norway,07-04-03,Centre-Forward,Attack,Right,186.0,30-06-26,Unknown,https://img.a.transfermarkt.technology/portrait/header/661205-1723714552.jpg?lm=1,NL1,Sportclub Heerenveen,900000.0,2500000.0,21,102,-75,8,11,12,12,12,10,9,11,5,6,8,11,6,11,11,11,11,12,9,8,9,15,14,7,11,7,12,12,11,8,13,15,10,12,11,13,15,11,16,7,11,4,1,2,1,3,2,1,3,2,3,3,11,15,9,13,13,15,12,12,1,1,1,1,1,1,1,16,1,14,20,1,16,18,80,11,20,2900985,4753,4753,2610,Northern_European,92,0,0,806.0,Unknown,29240362,2000000.0,1.0,71,761,73,0,1,7,190,3,0.3792008467848637,0.2737967914438502,0.3161764705882353,0.0007695969610093,0.0,0.0,0.0042510627656914,0.0122530632658164,0.0110836412122558,0.0,0.5348837209302322,0.125,107,10,2,10,0,2937,1,1,8,800000,66666.66666666667,2500000.0,500000.0,500000.0,1000000.0,2,2000000,-0.1111111111111111,-0.2
661207,Oscar,Bobb,2024,281,Norway,Oslo,Norway,12-07-03,Right Winger,Attack,Left,175.0,30-06-29,CAA Stellar,https://img.a.transfermarkt.technology/portrait/header/661207-1709018293.jpg?lm=1,GB1,Manchester City Football Club,25000000.0,25000000.0,21,105,-75,12,13,14,11,13,8,8,8,6,7,13,4,10,13,8,10,9,7,9,13,11,7,13,9,11,8,4,9,15,14,12,1,9,14,12,6,11,7,16,6,10,4,3,2,2,3,3,2,3,3,1,2,15,9,7,12,9,9,12,17,1,1,1,1,1,1,1,13,15,15,16,1,20,13,0,20,10,42916942,5247,5247,3002,Mixed_Race,108,0,0,8119.0,Unknown,28126241,9111392.0,2.0,71,1096,73,0,0,4,131,10,0.4445620534532946,0.3157219251336898,0.4338235294117646,0.0078311560273346,0.0,0.0,0.1247811952988247,0.1247811952988247,0.0505924720131114,0.1428571428571428,0.2790697674418605,0.125,141,33,35,1,0,3945,1,42,200,25000000,3000000.0,25000000.0,0.0,,25000000.0,0,0,0.0,0.6666666666666666
662131,Ahmetcan,Kaplan,2024,610,TÃ¼rkiye,Trabzon,TÃ¼rkiye,16-01-03,Centre-Back,Defender,Left,189.0,30-06-27,Unknown,https://img.a.transfermarkt.technology/portrait/header/662131-1660912608.jpg?lm=1,NL1,AFC Ajax Amsterdam,10000000.0,10000000.0,21,110,-8,4,6,9,6,9,5,15,4,8,13,9,7,13,9,5,9,16,16,13,9,12,16,6,5,5,13,12,13,12,9,14,14,13,11,12,13,16,5,11,4,9,1,4,2,1,2,1,2,2,4,2,1,15,15,5,18,12,14,16,11,1,1,20,1,1,1,1,1,1,1,1,1,1,1,0,20,10,37700000,5250,4410,2382,Northern_European,109,0,0,18999.0,Unknown,2000038244,9500000.0,1.0,100,1515,100,1,0,7,6,2,0.3338184704948399,0.2494117647058823,0.4411764705882353,0.0183370718815149,0.0,0.0,0.0497624406101525,0.0497624406101525,0.052751465318481,0.0,0.6046511627906974,0.125,71,4,6,13,2,4213,10,68,347,6000000,371875.0,10000000.0,2000000.0,300000.0,4000000.0,2,2200000,-0.4,0.5
662261,Rafa,Marín,2024,6195,Spain,Guadajoz,Spain,19-05-02,Centre-Back,Defender,Right,191.0,30-06-29,LEADERBROCK,https://img.a.transfermarkt.technology/portrait/header/662261-1725529332.jpg?lm=1,IT1,SocietÃ  Sportiva Calcio Napoli,7500000.0,7500000.0,22,108,147,6,3,5,5,9,9,14,7,13,12,8,7,13,9,12,12,14,14,12,5,11,4,4,15,6,12,12,13,11,9,12,16,14,9,15,15,14,9,9,7,7,3,3,2,2,1,3,3,2,3,2,2,8,12,4,11,9,11,12,14,1,1,20,1,1,1,1,1,1,1,1,1,1,1,78,4,20,4687999,5400,5400,3000,Mediterranean_Hispanic,106,0,0,2335.0,Unknown,2000051886,12000000.0,1.0,89,570,89,1,1,3,184,2,0.4648055041016142,0.3155080213903743,0.4191176470588235,0.0022460257607374,0.0,0.0,0.0372593148287071,0.0372593148287071,0.0666407400205561,0.0,0.6511627906976742,0.1666666666666666,107,4,1,25,0,698,2,2,9,9000000,809090.9090909091,9000000.0,0.0,,500000.0,2,4000000,0.2,2.0
662328,Unknown,Daniel Cabral,2024,2431,Brazil,Mesquita,Brazil,14-05-02,Defensive Midfield,Midfield,Right,174.0,30-06-28,Unknown,https://img.a.transfermarkt.technology/portrait/header/662328-1572442916.png?lm=1,PO1,Club Football Estrela da Amadora,100000.0,150000.0,22,100,138,9,8,5,7,13,9,9,11,3,11,13,9,13,15,11,14,10,14,11,9,15,7,5,12,4,13,14,11,9,13,15,8,15,11,6,5,14,12,16,13,15,3,1,1,1,1,1,3,3,2,3,1,16,10,7,10,12,11,10,17,1,1,1,1,1,1,20,1,15,1,1,1,1,1,72,8,20,2600434,4915,4915,2048,Mediterranean_Hispanic,99,0,0,1022.0,Unknown,19363341,9111392.0,2.0,10,944,11,3,1,3,55,4,0.4006350886477904,0.2136898395721925,0.3676470588235294,0.0009781702904673,0.0,0.0,0.0002500625156289,0.0005001250312578,0.0505924720131114,0.1428571428571428,0.2558139534883721,0.1666666666666666,20,0,0,5,0,996,0,0,0,100000,-10000.0,150000.0,150000.0,,0.0,1,100000,0.0,0.0
666539,Unknown,Beni,2024,3268,Angola,Luanda,Angola,21-05-02,Central Midfield,Midfield,Left,180.0,30-06-27,Liderfute,https://img.a.transfermarkt.technology/portrait/header/default.jpg?lm=1,PO1,Casa Pia AtlÃ©tico Clube,700000.0,700000.0,22,121,127,14,13,12,13,13,13,11,11,3,4,13,15,6,14,9,15,11,13,12,13,11,13,13,6,17,6,16,13,10,11,13,10,12,10,11,11,13,10,13,8,12,1,3,4,3,2,2,3,1,3,1,3,15,16,4,13,12,14,12,13,1,1,1,1,1,1,1,11,1,11,15,16,20,17,74,20,11,327644,6100,6731,4786,African_Caribbean,110,35,17,11249.0,Unknown,34002594,9111392.0,2.0,3,868,3,3,0,1,48,1,0.6409102937284996,0.506524064171123,0.4485294117647059,0.0108535380699435,0.2302631578947368,0.2236842105263157,0.0032508127031757,0.0032508127031757,0.0505924720131114,0.1428571428571428,0.3953488372093026,0.1666666666666666,103,0,7,28,0,2973,2,7,36,600000,38888.88888888889,700000.0,100000.0,,525000.0,1,75000,-0.14285714285714285,0.0
666616,Olakunle,Olusegun,2024,16704,Nigeria,"llorin, Kwara",Nigeria,23-04-02,Left Winger,Attack,Right,167.0,30-06-28,DW Sports Management,https://img.a.transfermarkt.technology/portrait/header/666616-1652945115.png?lm=1,RU1,FK Krasnodar,2500000.0,2800000.0,22,123,-8,7,7,13,11,12,6,6,10,3,3,10,9,6,12,11,6,5,16,12,8,8,10,12,9,11,6,8,12,17,15,11,4,13,20,12,7,12,13,19,7,10,2,1,3,3,3,3,1,1,1,1,2,15,12,7,12,10,9,9,11,1,1,1,1,1,1,1,1,1,1,19,14,17,20,67,7,20,17454238,5745,4475,2892,African_Caribbean,96,0,0,24132.0,Unknown,13224511,1200000.0,1.0,69,1712,70,0,1,1,78,7,0.3424186292670018,0.3039572192513368,0.3455882352941176,0.0232935853079401,0.0,0.0,0.0122530632658164,0.0137534383595899,0.0066390733075918,0.0,0.0930232558139532,0.1666666666666666,0,0,0,0,0,0,1,6,93,2500000,204545.45454545456,2800000.0,300000.0,250000.0,1700000.0,2,1050000,-0.10714285714285714,0.25
666977,Aliou,Baldé,2024,80,Senegal,Baghagha,Guinea,12-12-02,Left Winger,Attack,Right,170.0,30-06-25, EB SPORTS ,https://img.a.transfermarkt.technology/portrait/header/666977-1723302616.jpg?lm=1,L1,Verein fÃ¼r LeibesÃ¼bungen Bochum 1848 FuÃŸballgemeinschaft,800000.0,1200000.0,22,103,-75,7,10,13,12,12,10,5,9,3,2,11,3,4,12,11,10,10,8,10,9,10,12,13,6,11,3,11,11,14,14,8,3,14,15,11,8,10,9,11,11,11,3,1,1,2,2,3,2,2,3,3,1,17,15,7,9,14,10,6,11,1,1,1,1,1,1,1,17,1,17,19,1,20,12,0,9,20,28170001,5250,4545,3270,African_Caribbean,95,0,0,1373.0,FC Dordrecht,2000047650,1180000.0,3.0,83,126,44,0,1,1,212,7,0.3516803387139455,0.3443850267379679,0.338235294117647,0.0013171019508365,0.0,0.0,0.0037509377344336,0.0057514378594648,0.0065279591099752,0.2857142857142857,0.1627906976744184,0.1666666666666666,75,16,8,11,0,2698,2,33,122,650000,18750.0,1200000.0,200000.0,500000.0,1200000.0,4,1050000,-0.1875,-0.35
667121,Rodrigo,Gomes,2024,543,Portugal,PÃ³voa de Varzim,Portugal,07-07-03,Right Midfield,Midfield,Right,175.0,30-06-29,MC Striker,https://img.a.transfermarkt.technology/portrait/header/667121-1658746770.jpg?lm=1,GB1,Wolverhampton Wanderers Football Club,15000000.0,15000000.0,21,105,-8,9,9,13,10,11,10,4,8,5,3,9,6,5,12,13,13,12,8,11,11,8,14,14,8,13,5,10,13,15,14,8,5,12,15,10,6,10,12,19,5,12,3,1,1,2,2,3,1,1,1,3,1,9,14,9,14,12,12,8,12,1,1,1,1,1,1,1,1,1,12,14,15,20,15,66,8,20,19769998,5250,5250,3255,Mediterranean_Hispanic,96,0,0,2149.0,Unknown,83333463,15000000.0,1.0,76,1197,79,3,1,3,222,9,0.4449589838581635,0.3427807486631015,0.3455882352941176,0.0020664209492597,0.0,0.0,0.0747686921730432,0.0747686921730432,0.0833078696630462,0.0,0.2790697674418605,0.125,127,23,10,8,1,5184,0,0,0,15000000,1300000.0,15000000.0,0.0,3000000.0,12000000.0,3,5000000,0.25,2.0
667287,Yasin,Ayari,2024,1237,Sweden,Solna,Sweden,06-10-03,Central Midfield,Midfield,Right,172.0,30-06-27,Universal Twenty Two,https://img.a.transfermarkt.technology/portrait/header/667287-1662115248.jpg?lm=1,GB1,Brighton and Hove Albion Football Club,4500000.0,6000000.0,21,111,-75,8,10,12,9,13,9,8,11,5,9,12,8,13,13,11,13,12,11,11,12,11,13,11,7,13,11,11,11,13,13,10,7,11,12,12,10,13,7,12,5,13,2,2,1,1,1,3,3,3,3,4,1,14,12,7,14,12,12,12,12,1,7,1,10,10,12,12,15,20,15,15,18,15,7,0,10,20,1882430,5550,5550,1250,North_African__Middle_Eastern,107,0,0,1118.0,Unknown,93142470,4000000.0,1.0,91,1393,91,3,1,6,44,1,0.4846520243450648,0.1283422459893048,0.4264705882352941,0.0010708695480042,0.0,0.0,0.0222555638909727,0.0297574393598399,0.0221950609739159,0.0,0.2093023255813952,0.125,105,7,4,15,0,2468,3,5,15,12000000,1195000.0,12000000.0,1000000.0,3000000.0,4500000.0,5,11000000,1.6666666666666667,1.4
667517,Jordan,James,2024,273,England,Hereford,Wales,02-07-04,Central Midfield,Midfield,Right,182.0,30-06-28,Unique Sports Group,https://img.a.transfermarkt.technology/portrait/header/667517-1675157129.png?lm=1,FR1,Stade Rennais Football Club,4500000.0,4500000.0,20,107,-75,7,10,10,9,11,8,11,10,7,9,14,5,8,13,12,11,13,11,12,13,14,12,9,8,11,11,13,14,11,10,12,10,11,12,12,10,12,8,10,5,11,3,4,1,3,3,1,2,2,3,1,1,10,11,6,10,12,14,13,14,1,1,1,1,1,1,14,1,20,14,1,14,1,1,63,12,20,23912856,5350,5350,2504,Northern_European,107,0,0,2030.0,Unknown,2000045039,5000000.0,1.0,32,615,106,3,1,7,195,1,0.4581899973537973,0.2624598930481283,0.4264705882352941,0.0019515124946046,0.0,0.0,0.0222555638909727,0.0222555638909727,0.0277507708547459,0.0,0.4418604651162785,0.0833333333333332,133,12,2,27,1,2649,0,0,0,5000000,571428.5714285715,5000000.0,0.0,3000000.0,5000000.0,1,500000,0.1111111111111111,0.3157894736842105
668183,Nico,Serrano,2024,621,Spain,Pamplona,Spain,05-03-03,Left Winger,Attack,Left,176.0,30-06-26,Unknown,https://img.a.transfermarkt.technology/portrait/header/668183-1635170361.jpg?lm=1,ES1,Athletic Club Bilbao,1400000.0,2500000.0,21,115,-85,7,11,13,12,13,8,9,9,7,8,12,13,8,15,12,13,12,9,11,13,11,14,13,10,12,12,13,14,12,13,13,9,12,13,10,10,12,6,10,5,13,2,2,1,2,2,1,1,2,1,3,2,11,11,7,10,9,13,12,11,1,1,1,1,1,1,1,19,14,16,20,16,16,14,0,20,9,30000000,5750,5750,4250,Mediterranean_Hispanic,111,0,0,3247.0,MirandÃ©s,67295206,9111392.0,2.0,89,1115,89,0,0,3,33,7,0.5111140513363324,0.4491978609625668,0.4558823529411764,0.0031266687073378,0.0,0.0,0.0067516879219804,0.0122530632658164,0.0505924720131114,0.1428571428571428,0.3023255813953489,0.125,112,12,12,8,0,3187,7,26,78,1200000,82142.85714285714,2500000.0,1000000.0,1000000.0,1000000.0,4,1100000,-0.14285714285714285,0.2
668235,Unknown,Marlon Gomes,2024,660,Brazil,Rio de Janeiro,Brazil,14-12-03,Central Midfield,Midfield,Right,184.0,31-12-28,Unknown,https://img.a.transfermarkt.technology/portrait/header/668235-1723486644.png?lm=1,UKR1,FC Shakhtar Donetsk,12000000.0,12000000.0,21,108,-75,9,12,13,10,14,11,10,11,7,10,14,12,10,14,11,10,12,11,9,12,12,12,11,12,10,9,12,10,12,12,11,9,11,12,10,10,10,9,13,7,11,2,1,3,3,1,2,2,2,3,3,1,12,11,3,10,14,9,9,17,1,1,1,1,1,1,1,1,12,1,18,20,18,1,70,10,20,6101111,5394,5394,1658,Mediterranean_Hispanic,107,0,0,1514.0,Unknown,2000136301,12000000.0,1.0,10,1234,11,3,1,3,72,1,0.4640116432918761,0.1719786096256684,0.4264705882352941,0.0014532539853438,0.0,0.0,0.0597649412353088,0.0597649412353088,0.0666407400205561,0.0,0.4883720930232553,0.125,89,10,8,9,0,3260,2,8,43,10000000,1285714.2857142857,12000000.0,2000000.0,,12000000.0,1,4000000,-0.16666666666666666,0.6666666666666666
668265,Unknown,Kayky,2024,468,Brazil,Rio de Janeiro,Brazil,11-06-03,Right Winger,Attack,Left,172.0,30-06-25,Promanager,https://img.a.transfermarkt.technology/portrait/header/668265-1618220631.jpg?lm=1,NL1,Sparta Rotterdam,7000000.0,14000000.0,21,112,-9,10,14,15,11,13,8,9,11,7,8,12,9,10,15,12,13,4,13,12,11,13,2,15,5,10,9,10,10,14,14,10,8,13,13,11,11,11,5,4,8,13,2,2,3,3,2,3,1,3,3,3,1,15,11,8,10,12,12,6,19,1,1,1,1,1,1,1,1,10,13,1,12,20,12,67,20,7,75533818,5600,5600,4255,African_Caribbean,116,0,0,28998.0,Futebol Clube PaÃ§os de Ferreira,19408255,9111392.0,2.0,10,1234,11,0,0,1,187,10,0.4912675310928817,0.4497326203208556,0.4926470588235294,0.0279922789243409,0.0,0.0,0.0347586896724181,0.0697674418604651,0.0505924720131114,0.1428571428571428,0.2093023255813952,0.125,100,13,11,9,0,3337,3,7,456,6000000,444444.44444444444,14000000.0,2000000.0,14000000.0,7000000.0,5,16000000,-0.14285714285714285,-0.14285714285714285
668276,Hugo,Novoa,2024,1108,Spain,BertamirÃ¡ns,Spain,24-01-03,Right-Back,Defender,Right,182.0,30-06-29,ROOF,https://img.a.transfermarkt.technology/portrait/header/668276-1606146927.jpg?lm=1,ES1,Deportivo AlavÃ©s S.A.D.,2500000.0,5000000.0,21,117,-8,11,10,13,12,12,12,8,9,8,9,12,12,8,13,7,11,13,11,9,12,10,13,13,4,12,8,12,14,13,13,12,11,14,15,12,9,11,2,11,5,17,3,1,3,2,3,1,3,1,3,1,2,16,14,4,9,11,16,15,16,1,1,1,10,1,15,1,10,1,15,12,10,18,20,68,8,20,48600001,5845,5145,4573,Mediterranean_Hispanic,105,0,0,4999.0,Unknown,2000013687,1500000.0,1.0,89,180,89,1,1,3,59,11,0.431066419687748,0.4837433155080213,0.411764705882353,0.0048184301573859,0.0,0.0,0.0122530632658164,0.0247561890472618,0.0083057862718408,0.0,0.4418604651162785,0.125,95,16,15,2,0,3435,5,7,56,2000000,150000.0,5000000.0,1000000.0,1500000.0,3500000.0,5,4100000,-0.2,-0.42857142857142855
668529,Rodrigo,Huescas,2024,190,Mexico,Naucalpan de JuÃ¡rez,Mexico,18-09-03,Right-Back,Defender,Right,172.0,30-06-29,AmEro Sports,https://img.a.transfermarkt.technology/portrait/header/668529-1720617288.jpg?lm=1,DK1,Football Club KÃ¸benhavn,6000000.0,6000000.0,21,83,-75,8,9,11,10,11,4,10,10,10,7,11,10,6,12,10,11,7,11,10,9,11,2,9,12,11,10,11,12,12,12,11,9,8,8,9,7,8,8,5,12,12,2,3,1,3,1,3,2,3,3,2,1,18,13,8,10,11,11,11,19,1,1,1,1,1,1,1,1,1,1,1,1,1,20,69,10,20,5388184,4250,4400,1016,Mediterranean_Hispanic,82,0,0,307.0,Unknown,2000131671,1850000.0,1.0,63,1019,64,1,1,3,90,11,0.3324953691452765,0.1033155080213903,0.2426470588235293,0.0002877539452707,0.0,0.0,0.0297574393598399,0.0297574393598399,0.0102502847301313,0.0,0.2093023255813952,0.125,129,12,15,9,0,6534,1,8,38,5000000,587500.0,6000000.0,1000000.0,300000.0,6000000.0,1,1000000,-0.16666666666666666,0.42857142857142855
668547,Máximo,Perrone,2024,1047,Argentina,Buenos Aires,Argentina,07-01-03,Defensive Midfield,Midfield,Left,177.0,30-06-25,DCGLOBALSL,https://img.a.transfermarkt.technology/portrait/header/668547-1681246573.jpg?lm=1,IT1,Calcio Como,9000000.0,10000000.0,21,118,-8,6,7,12,9,13,10,11,12,10,12,14,11,12,13,12,13,13,13,13,13,13,12,13,12,12,12,13,12,12,13,13,10,13,12,13,9,12,13,14,6,13,1,3,1,3,1,1,3,2,2,1,3,16,14,6,14,12,12,13,13,1,1,1,1,1,1,20,1,18,1,1,10,1,1,67,20,8,5101247,6000,6000,3250,Mediterranean_Hispanic,118,0,0,2097.0,Unknown,14227360,11000000.0,1.0,4,275,4,3,0,3,47,4,0.5441915850754168,0.3422459893048128,0.5073529411764706,0.0020162088514272,0.0,0.0,0.0447611902975743,0.0497624406101525,0.0610850301397261,0.0,0.3255813953488373,0.125,79,3,3,22,0,3544,2,29,76,9000000,875000.0,10000000.0,2500000.0,,7500000.0,3,4000000,0.0,0.2
668951,Matías,Soulé,2024,12,Argentina,Mar del Plata,Argentina,15-04-03,Right Winger,Attack,Left,182.0,30-06-29,Guastadisegno,https://img.a.transfermarkt.technology/portrait/header/668951-1725529266.jpg?lm=1,IT1,Associazione Sportiva Roma,25000000.0,25000000.0,21,110,-8,12,13,14,9,13,14,8,11,6,3,11,12,8,14,9,10,12,10,11,13,10,10,12,9,13,8,11,11,14,14,13,9,14,12,11,7,12,10,8,3,10,2,4,1,2,3,2,2,3,3,3,2,10,12,5,13,10,13,14,11,1,1,1,1,1,1,1,9,1,11,10,16,20,12,71,20,8,49900000,5500,5400,3252,Mediterranean_Hispanic,109,0,0,5476.0,Unknown,14222108,25600000.0,1.0,4,908,4,0,0,3,29,10,0.4648055041016142,0.3424598930481283,0.4411764705882353,0.0052790295932723,0.0,0.0,0.1247811952988247,0.1247811952988247,0.1421983943998444,0.0,0.4418604651162785,0.125,159,26,16,13,0,3606,3,16,50,22000000,2437500.0,25000000.0,3000000.0,2500000.0,25000000.0,3,8500000,-0.12,-0.12
669380,Konstantinos,Koulierakis,2024,82,Greece,Chania,Greece,28-11-03,Centre-Back,Defender,Left,188.0,30-06-29,Unknown,https://img.a.transfermarkt.technology/portrait/header/669380-1694780769.png?lm=1,L1,Verein fÃ¼r LeibesÃ¼bungen Wolfsburg,12000000.0,12000000.0,21,105,-75,8,8,7,8,10,9,14,10,8,11,11,8,12,10,11,11,12,11,11,10,10,15,4,11,8,11,12,13,12,12,12,14,15,12,13,13,13,7,12,4,6,2,2,2,2,2,2,1,3,3,2,2,14,10,2,11,16,12,11,13,1,6,20,1,1,1,10,1,1,1,1,1,1,1,78,20,8,10740000,5494,5494,3766,Mediterranean_Hispanic,105,0,0,2424.0,Unknown,36159445,11750000.0,1.0,40,346,42,1,0,3,213,2,0.47724265678751,0.3974331550802139,0.411764705882353,0.0023319656974122,0.0,0.0,0.0597649412353088,0.0597649412353088,0.0652518125503486,0.0,0.581395348837209,0.125,0,0,0,0,0,0,5,7,16,15000000,1235416.6666666667,15000000.0,-50000.0,1500000.0,12000000.0,2,5200000,0.875,2.3333333333333335
669632,Nikolas,Sattlberger,2024,1184,Austria,Wien,Austria,18-01-04,Defensive Midfield,Midfield,Right,191.0,30-06-29,Skylar,https://img.a.transfermarkt.technology/portrait/header/669632-1726050733.jpg?lm=1,BE1,Koninklijke Racing Club Genk,3000000.0,3000000.0,20,105,-75,7,9,9,7,10,11,12,13,6,11,9,10,10,11,10,10,12,10,11,10,12,14,5,6,9,14,13,14,14,12,13,17,13,14,13,14,11,5,6,13,12,1,4,2,2,1,1,2,2,4,1,1,16,14,8,12,12,11,9,16,1,1,1,1,1,1,20,1,17,1,1,1,1,1,73,13,20,12895999,5250,5250,2456,Northern_European,112,0,0,749.0,Unknown,16337140,2500000.0,1.0,6,1663,7,3,1,7,122,4,0.4449589838581635,0.2573262032085561,0.463235294117647,0.0007145567768468,0.0,0.0,0.0147536884221055,0.0147536884221055,0.0138614961526709,0.0,0.6511627906976742,0.0833333333333332,113,5,2,24,0,3219,6,66,295,4000000,300000.0,4000000.0,50000.0,400000.0,4000000.0,4,2150000,1.6666666666666667,3.0
669956,Leonardo,Lelo,2024,3268,Portugal,OlhÃ£o,Portugal,30-03-00,Left-Back,Defender,Left,175.0,30-06-25,Unknown,https://img.a.transfermarkt.technology/portrait/header/669956-1663603059.png?lm=1,PO1,Casa Pia AtlÃ©tico Clube,3500000.0,3500000.0,24,126,144,12,12,12,10,12,10,8,9,12,10,12,13,14,13,14,13,15,12,14,12,12,16,13,6,13,10,13,15,15,13,12,8,16,14,14,9,13,5,10,5,14,3,1,2,3,3,1,1,1,3,1,3,14,13,5,10,13,15,14,12,1,20,1,1,20,1,1,18,1,1,14,1,1,1,70,20,6,1459998,6300,6300,4300,Mediterranean_Hispanic,121,0,0,1950.0,Unknown,83257795,9111392.0,2.0,76,1079,79,1,0,3,48,8,0.5838846255623181,0.4545454545454545,0.5294117647058822,0.0018742631133238,0.0,0.0,0.0172543135783946,0.0172543135783946,0.0505924720131114,0.1428571428571428,0.2790697674418605,0.25,157,11,15,14,0,1658,2,9,274,3500000,400000.0,3500000.0,0.0,,,0,0,0.0,0.0
670096,Tanner,Tessmann,2024,1041,United States,"Birmingham, Alabama",United States,24-09-01,Defensive Midfield,Midfield,Right,188.0,30-06-29,PROSPORT Management,https://img.a.transfermarkt.technology/portrait/header/670096-1722196121.jpg?lm=1,FR1,Olympique Lyonnais,7000000.0,7000000.0,23,111,148,7,7,9,7,9,9,12,9,8,12,12,9,11,12,12,13,14,11,12,9,12,13,9,9,12,12,12,10,12,13,14,12,12,12,15,15,10,12,10,10,12,3,3,2,1,1,2,1,1,3,2,2,11,11,12,9,11,12,12,13,1,1,1,1,1,1,16,1,20,1,1,1,1,1,84,13,20,6995000,5550,5750,4000,Northern_European,111,1,0,4570.0,Unknown,2000015818,9111392.0,2.0,104,200,102,3,1,7,143,4,0.5111140513363324,0.4224598930481283,0.4558823529411764,0.004404180350268,0.006578947368421,0.0,0.0347586896724181,0.0347586896724181,0.0505924720131114,0.1428571428571428,0.581395348837209,0.2083333333333332,163,11,6,19,1,3886,0,0,0,6000000,453846.1538461539,7000000.0,1000000.0,600000.0,2500000.0,3,2500000,-0.14285714285714285,0.875
670103,Andreas,Schjelderup,2024,294,Norway,BodÃ¸,Norway,01-06-04,Left Winger,Attack,Right,176.0,30-06-28,Rafaela Pimenta,https://img.a.transfermarkt.technology/portrait/header/670103-1725535697.jpg?lm=1,PO1,Sport Lisboa e Benfica,10000000.0,10000000.0,20,134,160,12,13,16,13,16,12,6,14,3,4,16,14,4,16,9,16,10,15,13,16,13,15,15,7,16,6,14,14,14,14,8,8,13,14,9,6,11,8,9,6,12,2,1,4,3,2,3,3,1,2,1,3,12,15,5,14,12,16,13,13,1,1,1,1,1,1,1,14,10,1,20,12,1,15,73,13,20,8670909,6996,6246,3597,Northern_European,137,0,0,4839.0,Unknown,2000020287,9000000.0,1.0,71,214,73,0,1,7,188,7,0.5767398782746759,0.3793582887700534,0.6470588235294117,0.0046639313948244,0.0,0.0,0.0497624406101525,0.0497624406101525,0.049973610378066,0.0,0.3023255813953489,0.0833333333333332,134,39,21,9,0,4437,1,1,3,10000000,990000.0,10000000.0,1000000.0,9000000.0,10000000.0,3,0,0.0,0.1111111111111111
670116,Isak,Hansen-Aarøen,2024,86,Norway,TromsÃ¸,Norway,22-08-04,Attacking Midfield,Midfield,Right,173.0,30-06-27,Unknown,https://img.a.transfermarkt.technology/portrait/header/670116-1722887545.jpg?lm=1,L1,Sportverein Werder Bremen von 1899,1500000.0,1500000.0,20,98,-8,9,10,14,10,14,9,3,8,2,4,14,6,5,15,12,12,7,12,9,12,9,18,10,4,13,4,12,13,13,13,14,6,13,13,10,5,13,7,6,4,16,2,2,1,2,4,2,2,2,1,3,1,15,16,4,10,12,15,15,6,1,1,1,1,1,1,14,1,20,1,12,18,10,1,60,8,20,55026479,4898,4220,2545,Northern_European,89,0,0,1624.0,Unknown,2000010819,250000.0,1.0,71,1527,73,3,1,7,194,0,0.3086795448531357,0.2668449197860962,0.2941176470588235,0.0015594718846048,0.0,0.0,0.0072518129532383,0.0072518129532383,0.0013611489208033,0.0,0.2325581395348837,0.0833333333333332,100,9,10,5,0,3806,4,6,16,1000000,-166666.66666666666,1500000.0,500000.0,,1000000.0,0,0,-0.3333333333333333,-0.3333333333333333
670681,João,Neves,2024,583,Portugal,Tavira,Portugal,27-09-04,Defensive Midfield,Midfield,Right,174.0,30-06-29,Gestifute,https://img.a.transfermarkt.technology/portrait/header/670681-1701295511.jpg?lm=1,FR1,Paris Saint-Germain Football Club,60000000.0,60000000.0,20,100,-85,9,10,12,10,14,10,6,10,6,7,12,10,10,14,10,10,14,12,12,13,11,16,14,8,12,9,12,13,11,13,13,6,13,11,12,8,13,5,12,8,12,3,2,1,3,3,2,3,2,3,3,2,12,15,6,15,12,16,17,15,1,1,1,1,1,1,8,1,20,1,1,18,1,1,67,7,20,22200000,4999,4999,3003,Mediterranean_Hispanic,100,0,0,2749.0,Unknown,2000030130,59920000.0,1.0,76,1474,79,3,1,3,154,4,0.4117491399841227,0.3158288770053475,0.3749999999999999,0.0026457913088652,0.0,0.0,0.2998249562390597,0.2998249562390597,0.3328703575099307,0.0,0.2558139534883721,0.0833333333333332,0,0,0,0,0,0,0,0,0,60000000,6622222.222222222,60000000.0,0.0,10000000.0,60000000.0,3,7100000,0.09090909090909091,0.3333333333333333
670682,Marco,Cruz,2024,2420,Portugal,PÃ³voa de Varzim,Portugal,23-02-04,Attacking Midfield,Midfield,Left,181.0,30-06-28,Nomi Sports,https://img.a.transfermarkt.technology/portrait/header/670682-1658732707.jpg?lm=1,PO1,VitÃ³ria Sport Clube,200000.0,200000.0,20,84,-8,6,10,11,7,12,6,7,7,4,10,13,11,9,11,10,11,8,9,8,12,12,11,9,8,12,10,11,10,13,11,8,7,9,12,10,9,11,7,13,5,10,2,2,3,1,1,2,3,1,1,2,2,8,14,8,9,11,12,12,18,1,16,1,1,12,1,1,10,20,1,10,12,1,1,71,20,6,10732500,4199,4199,1499,Mediterranean_Hispanic,85,0,0,1849.0,Unknown,83320100,9111392.0,2.0,76,1197,79,3,0,3,217,0,0.3059010320190527,0.1549732620320855,0.2647058823529412,0.0017767357694569,0.0,0.0,0.0007501875468867,0.0007501875468867,0.0505924720131114,0.1428571428571428,0.418604651162791,0.0833333333333332,59,6,3,9,0,2876,0,0,0,200000,0.0,200000.0,0.0,,200000.0,0,0,0.0,0.0
670711,Diogo,Pinto,2024,336,Portugal,Felgueiras,Portugal,18-06-04,Goalkeeper,Goalkeeper,Right,194.0,30-06-26,MRP.POSITIONUMBER,https://img.a.transfermarkt.technology/portrait/header/670711-1689275244.jpg?lm=1,PO1,Sporting Clube de Portugal,500000.0,500000.0,20,112,135,13,11,13,13,14,12,7,13,5,5,12,10,4,14,12,13,13,9,10,13,11,12,13,14,12,7,12,13,13,13,10,6,12,13,11,8,8,8,11,5,10,3,3,3,3,3,1,1,1,2,3,3,12,13,9,11,11,12,10,9,1,1,1,1,1,1,1,10,12,1,18,20,5,1,68,10,20,515750,5598,5598,3598,Mediterranean_Hispanic,111,0,0,1649.0,Unknown,83111352,9111392.0,2.0,76,487,79,2,1,3,193,5,0.4910029108229691,0.3794652406417111,0.4558823529411764,0.0015836123162551,0.0,0.0,0.0022505626406601,0.0022505626406601,0.0505924720131114,0.1428571428571428,0.7209302325581395,0.0833333333333332,0,0,0,0,0,0,0,0,0,500000,0.0,500000.0,0.0,,500000.0,0,0,0.0,0.0
670717,Dário,Essugo,2024,472,Portugal,Lisboa,Portugal,14-03-05,Defensive Midfield,Midfield,Right,178.0,30-06-25,Promoesport,https://img.a.transfermarkt.technology/portrait/header/670717-1616406134.jpg?lm=1,ES1,UniÃ³n Deportiva Las Palmas S.A.D.,3500000.0,3500000.0,19,101,-85,5,4,12,6,11,6,7,9,8,11,12,10,11,12,11,12,11,12,11,10,11,13,12,8,9,12,13,12,12,11,14,11,15,12,13,14,10,5,10,8,10,1,2,3,2,1,4,1,1,2,2,1,16,10,6,11,13,14,12,10,1,1,1,1,1,1,20,1,18,1,1,1,1,1,75,9,20,20024999,5050,5050,3050,African_Caribbean,101,0,0,3149.0,Unknown,2000087400,9111392.0,2.0,76,843,79,3,1,1,207,4,0.418496956866896,0.320855614973262,0.3823529411764706,0.0030320382152689,0.0,0.0,0.0172543135783946,0.0172543135783946,0.0505924720131114,0.1428571428571428,0.3488372093023257,0.0416666666666666,77,1,2,19,1,2562,1,6,39,8000000,1000000.0,8000000.0,0.0,3000000.0,,3,5500000,1.2857142857142858,3.0
670845,Omari,Forson,2024,2919,England,London,England,20-07-04,Right Winger,Attack,Left,179.0,30-06-28,Sports Invest UK ltd,https://img.a.transfermarkt.technology/portrait/header/670845-1722327564.jpg?lm=1,IT1,Associazione Calcio Monza,2000000.0,2000000.0,20,90,-75,7,7,12,11,14,8,3,10,1,2,13,8,4,13,8,11,7,12,8,11,8,10,15,3,11,4,8,11,14,13,10,6,9,13,10,6,10,8,14,13,18,3,2,1,2,2,1,2,3,2,3,3,14,11,3,11,11,12,11,12,1,1,1,1,1,1,1,12,15,13,14,20,15,1,68,20,9,33753595,4500,4500,2000,African_Caribbean,87,0,0,1392.0,Unknown,2000017597,9111392.0,2.0,32,858,33,0,0,1,28,10,0.3457263826409102,0.2085561497326203,0.2794117647058823,0.0013354486788907,0.0,0.0,0.0097524381095273,0.0097524381095273,0.0505924720131114,0.1428571428571428,0.3720930232558141,0.0833333333333332,101,27,19,2,0,3082,3,17,58,2000000,250000.0,2000000.0,0.0,,2000000.0,2,1000000,0.0,1.0
670847,Mohamed-Ali,Cho,2024,417,France,Stains,France,19-01-04,Right Winger,Attack,Left,182.0,30-06-28,Sparka Management,https://img.a.transfermarkt.technology/portrait/header/670847-1655064069.jpg?lm=1,FR1,Olympique Gymnaste Club Nice CÃ´te d'Azur,12000000.0,15000000.0,20,120,-9,8,9,13,11,14,9,11,9,4,7,11,10,7,13,9,10,12,12,11,11,11,14,11,8,10,9,9,9,15,14,11,11,12,14,13,10,10,8,10,4,12,2,3,2,2,1,3,2,1,3,1,3,13,12,6,11,10,12,12,15,1,1,1,1,1,1,1,12,1,12,17,1,17,20,66,20,10,61840001,6000,6000,2500,African_Caribbean,110,0,0,4158.0,Unknown,2000006280,11500000.0,2.0,34,1417,36,0,0,1,142,10,0.5441915850754168,0.2620320855614972,0.4485294117647059,0.0040063460366722,0.0,0.0,0.0597649412353088,0.0747686921730432,0.0638628850801411,0.1428571428571428,0.4418604651162785,0.0833333333333332,142,13,11,8,0,3077,9,35,62,12000000,700000.0,15000000.0,3000000.0,15000000.0,12000000.0,2,2000000,0.2,0.5
670858,Lewis,Hall,2024,762,England,Slough,England,08-09-04,Left-Back,Defender,Left,179.0,Unknown,Wasserman,https://img.a.transfermarkt.technology/portrait/header/670858-1699385942.jpg?lm=1,GB1,Newcastle United Football Club,22000000.0,22000000.0,20,103,-8,10,11,8,9,11,13,11,11,7,8,12,16,12,10,10,9,14,12,10,12,12,7,9,10,8,8,13,15,13,7,10,8,15,12,10,9,16,8,12,11,13,1,3,3,3,3,3,1,3,4,3,1,19,12,4,10,9,11,12,20,1,15,15,1,17,1,18,13,20,1,13,15,1,1,0,20,10,43148926,5149,5149,4256,Northern_European,93,0,0,11599.0,Unknown,2000108691,33000000.0,1.0,32,1384,33,1,0,7,137,8,0.4315956602275734,0.4498395721925133,0.3235294117647059,0.0111915041130467,0.0,0.0,0.1097774443610902,0.1097774443610902,0.1833106475179866,0.0,0.3720930232558141,0.0833333333333332,140,15,23,20,0,5415,0,0,0,25000000,2500000.0,25000000.0,0.0,10000000.0,25000000.0,1,8000000,0.3888888888888889,0.3888888888888889
670987,Tawanda,Maswanhise,2024,987,Zimbabwe,Harare,Zimbabwe,20-11-02,Left Winger,Attack,Right,180.0,06-01-25,Unknown,https://img.a.transfermarkt.technology/portrait/header/default.jpg?lm=1,SC1,Motherwell Football Club,100000.0,100000.0,22,98,-8,7,11,12,9,8,8,10,7,7,8,10,8,9,11,6,6,3,10,6,10,10,5,12,1,10,8,9,12,16,9,6,9,15,14,12,7,11,6,10,10,11,4,4,2,3,1,3,2,1,3,2,2,10,11,5,12,12,13,13,18,1,1,1,1,1,1,1,12,8,12,19,10,20,17,0,12,20,55026479,4897,4897,2497,African_Caribbean,90,0,0,3480.0,Unknown,28127131,9111392.0,2.0,113,597,108,0,1,1,135,7,0.3982535062185763,0.261711229946524,0.3014705882352941,0.0033516575303179,0.0,0.0,0.0002500625156289,0.0002500625156289,0.0505924720131114,0.1428571428571428,0.3953488372093026,0.1666666666666666,126,29,16,8,0,2013,0,0,0,300000,100000.0,300000.0,-200000.0,,,0,0,0.0,0.0
671594,Kamory,Doumbia,2024,3911,Mali,Bamako,Mali,18-02-03,Attacking Midfield,Midfield,Right,170.0,30-06-29,BLACKSKILL,https://img.a.transfermarkt.technology/portrait/header/671594-1639672362.png?lm=1,FR1,Stade brestois 29,5000000.0,5000000.0,21,102,-75,9,9,11,12,13,7,10,10,6,6,12,10,5,12,11,12,13,11,11,12,9,13,12,8,12,7,11,11,12,14,11,10,13,12,12,11,10,8,10,5,11,2,1,1,2,3,3,3,1,1,2,2,11,11,7,13,12,12,14,18,1,1,1,1,1,1,1,1,20,1,1,18,1,15,0,10,20,12448000,5099,5099,2261,African_Caribbean,97,0,0,1511.0,Unknown,12088460,4000000.0,1.0,61,133,61,3,1,1,196,0,0.4249801534797566,0.2364705882352941,0.3529411764705882,0.0014503571335458,0.0,0.0,0.0247561890472618,0.0247561890472618,0.0221950609739159,0.0,0.1627906976744184,0.125,110,19,13,3,0,3153,1,3,21,5000000,522222.22222222225,5000000.0,500000.0,,2000000.0,2,1500000,0.0,1.5
672243,Niko,Rak,2024,2293,Croatia,Å ibenik,Croatia,26-07-03,Defensive Midfield,Midfield,Right,173.0,30-06-26,Unknown,https://img.a.transfermarkt.technology/portrait/header/672243-1727458116.png?lm=1,TR1,Konyaspor,700000.0,1500000.0,21,99,-75,8,8,12,6,11,9,9,11,7,10,13,8,11,12,11,12,11,12,9,12,9,13,12,12,9,12,13,13,12,13,9,7,14,12,13,8,9,7,11,6,11,3,3,1,1,3,1,1,3,3,1,2,18,14,6,12,11,11,10,10,1,12,1,17,1,1,20,1,17,1,1,1,1,1,0,9,20,760499,4900,4750,2400,Northern_European,96,0,0,180.0,Unknown,24066200,200000.0,1.0,24,1726,25,3,1,7,125,4,0.3788039163799948,0.2513368983957219,0.3455882352941176,0.0001651205524875,0.0,0.0,0.0032508127031757,0.0072518129532383,0.0010833634267618,0.0,0.2325581395348837,0.125,56,0,3,5,0,1252,0,0,0,550000,37500.0,1500000.0,500000.0,1500000.0,750000.0,2,1900000,-0.26666666666666666,-0.45
672381,Jonathan,Rowe,2024,244,England,London,England,30-04-03,Left Winger,Attack,Right,173.0,30-06-25,Unique Sports Group,https://img.a.transfermarkt.technology/portrait/header/672381-1708003554.jpg?lm=1,FR1,Olympique de Marseille,10000000.0,10000000.0,21,112,-75,11,11,14,11,12,11,5,10,3,3,10,7,3,12,8,10,6,12,8,9,9,14,13,5,9,2,10,12,16,13,11,8,10,16,11,7,7,5,8,8,7,3,3,1,1,1,1,3,4,3,2,1,11,13,4,14,11,16,12,18,1,1,1,1,1,1,1,1,1,1,20,1,20,12,0,10,20,20934188,5600,5600,3000,African_Caribbean,104,0,0,2320.0,Unknown,28127273,9111392.0,2.0,32,858,33,0,1,1,144,7,0.4912675310928817,0.3155080213903743,0.4044117647058823,0.0022315415017472,0.0,0.0,0.0497624406101525,0.0497624406101525,0.0505924720131114,0.1428571428571428,0.2325581395348837,0.125,0,0,0,0,0,0,1,13,59,12000000,1400000.0,12000000.0,300000.0,,7000000.0,1,1000000,0.3333333333333333,1.4
673492,Unknown,Morato,2024,703,Brazil,Francisco Morato,Brazil,30-06-01,Centre-Back,Defender,Left,192.0,30-06-29,Bertolucci Sports,https://img.a.transfermarkt.technology/portrait/header/673492-1701295349.jpg?lm=1,GB1,Nottingham Forest Football Club,15000000.0,15000000.0,23,135,158,6,8,9,8,9,6,14,8,10,15,13,10,14,9,14,14,15,13,11,13,12,12,8,13,11,14,15,13,12,11,14,16,15,13,14,15,14,11,11,12,6,1,1,1,1,3,1,4,3,2,3,3,11,13,11,10,12,16,15,14,1,1,20,1,1,1,14,1,1,1,1,1,1,1,84,20,10,19000000,6750,5627,5426,Mediterranean_Hispanic,135,0,0,19149.0,Unknown,19347264,9300000.0,2.0,10,505,11,1,0,3,140,2,0.4948399047367028,0.5749732620320855,0.6323529411764706,0.0184819144714162,0.0,0.0,0.0747686921730432,0.0747686921730432,0.051640323342315,0.1428571428571428,0.6744186046511627,0.2083333333333332,0,0,0,0,0,0,2,13,53,15000000,996666.6666666666,15000000.0,2000000.0,1800000.0,10000000.0,3,4950000,0.0,0.0
673514,Abdoulaye,Ndiaye,2024,3911,Senegal,Boune,Senegal,10-04-02,Centre-Back,Defender,Left,195.0,30-06-25,Unknown,https://img.a.transfermarkt.technology/portrait/header/673514-1684140965.jpg?lm=1,FR1,Stade brestois 29,3000000.0,3000000.0,22,125,135,10,10,14,11,13,10,8,10,5,5,10,14,7,14,10,12,14,12,10,9,9,13,14,8,13,8,12,12,16,15,11,5,12,16,10,8,10,10,13,10,10,4,1,3,1,2,2,2,3,2,1,1,8,15,8,11,10,7,13,13,1,1,1,1,1,1,1,12,1,10,15,10,19,20,70,20,8,6790921,6250,6350,5000,African_Caribbean,105,25,7,29112.0,Unknown,85054417,3500000.0,1.0,83,232,84,1,0,1,196,2,0.590500132310135,0.5294117647058822,0.411764705882353,0.028102359292666,0.1644736842105263,0.0921052631578947,0.0147536884221055,0.0147536884221055,0.0194172060335009,0.0,0.7441860465116279,0.1666666666666666,94,2,5,21,3,1609,0,0,0,3000000,327777.77777777775,3000000.0,500000.0,,1000000.0,3,3000000,0.2,0.0
674501,Jonathan,Gómez,2024,1091,United States,"North Richland Hills, Texas",United States,01-09-03,Left-Back,Defender,Right,178.0,30-06-27,Wasserman,https://img.a.transfermarkt.technology/portrait/header/674501-1727967170.png?lm=1,GR1,Panthessalonikios Athlitikos Omilos Konstantinoupoliton,1200000.0,1200000.0,21,122,135,13,13,13,11,13,13,6,12,8,10,15,11,12,13,13,12,11,11,11,14,14,13,14,7,14,12,12,13,12,13,11,8,12,11,12,10,11,10,11,7,15,3,2,2,3,1,1,3,3,3,1,2,13,15,13,12,11,12,14,9,1,1,1,1,1,1,12,6,20,10,4,14,8,1,71,10,20,1294019,6000,6000,3400,Mediterranean_Hispanic,122,0,0,5633.0,Racing Club de Avellaneda,14011211,400000.0,2.0,104,1054,102,1,1,3,153,8,0.5441915850754168,0.3582887700534758,0.536764705882353,0.0054306315040357,0.0,0.0,0.0057514378594648,0.0057514378594648,0.0021945054029278,0.1428571428571428,0.3488372093023257,0.125,134,4,17,24,0,2837,1,10,43,1000000,81818.18181818182,1200000.0,200000.0,500000.0,1200000.0,4,750000,-0.16666666666666666,0.25
674612,Youssouf,Ndayishimiye,2024,417,Burundi,Bujumbura,Burundi,27-10-98,Defensive Midfield,Midfield,Right,183.0,30-06-27,FutureBall,https://img.a.transfermarkt.technology/portrait/header/674612-1667045688.png?lm=1,FR1,Olympique Gymnaste Club Nice CÃ´te d'Azur,15000000.0,18000000.0,26,120,135,8,9,11,6,13,7,11,5,8,12,13,8,12,12,15,12,16,13,13,11,12,16,6,9,9,13,15,16,12,12,15,12,16,12,15,14,14,11,16,5,14,3,3,1,1,2,1,4,1,2,2,2,15,13,7,9,9,10,8,10,1,1,20,1,1,1,18,1,14,9,1,10,9,1,75,8,20,3035541,6099,5185,4427,African_Caribbean,119,17,1,4999.0,Unknown,70138807,9111392.0,2.0,13,276,14,3,1,1,142,4,0.4363588250860016,0.4681283422459892,0.5147058823529411,0.0048184301573859,0.1118421052631578,0.0131578947368421,0.0747686921730432,0.0897724431107777,0.0505924720131114,0.1428571428571428,0.4651162790697669,0.3333333333333332,163,14,8,28,1,3944,11,43,62,12000000,746875.0,18000000.0,3000000.0,,50000.0,3,6050000,-0.2,-0.3333333333333333
674806,Santiago,Pierotti,2024,1005,Argentina,Pilar,Argentina,03-04-01,Right Winger,Attack,Right,189.0,30-06-27,Unknown,https://img.a.transfermarkt.technology/portrait/header/674806-1709016512.jpg?lm=1,IT1,Unione Sportiva Lecce,2500000.0,2500000.0,23,120,133,11,11,13,9,13,10,8,12,8,7,12,11,8,13,10,13,13,15,12,12,11,16,12,11,14,11,15,13,12,11,14,12,12,10,14,13,13,7,12,6,14,1,1,2,2,1,1,3,1,1,1,3,13,15,6,12,13,12,12,14,1,1,1,1,1,1,10,8,20,15,1,12,10,1,79,9,20,4042078,5909,5909,3277,Mediterranean_Hispanic,113,0,0,1942.0,Unknown,14230113,1200000.0,1.0,4,1146,4,0,1,3,206,10,0.53215136279439,0.3451336898395721,0.4705882352941176,0.0018665381751958,0.0,0.0,0.0122530632658164,0.0122530632658164,0.0066390733075918,0.0,0.6046511627906974,0.2083333333333332,154,14,7,19,1,2259,1,1,6,2500000,204166.66666666666,2500000.0,300000.0,750000.0,1700000.0,1,0,0.0,0.0
675278,Eric,Kahl,2024,678,Sweden,Solna,Sweden,27-09-01,Left-Back,Defender,Left,181.0,30-06-26,Unknown,https://img.a.transfermarkt.technology/portrait/header/675278-1596613733.jpg?lm=1,DK1,Aarhus Gymnastik Forening,1500000.0,1500000.0,23,111,135,10,12,11,5,12,11,6,7,10,11,13,7,11,12,12,12,13,12,12,11,12,14,10,5,12,11,13,12,14,13,10,12,13,14,13,9,12,9,16,5,8,2,3,2,4,2,2,2,1,1,1,4,14,12,5,13,14,14,14,14,1,20,1,1,18,1,1,14,1,1,8,1,1,1,69,20,7,2009843,5546,5696,1496,Asian,109,0,0,2689.0,Unknown,93142833,1500000.0,1.0,91,1393,91,1,0,2,11,8,0.5039693040486901,0.1546524064171123,0.4411764705882353,0.0025878542729046,0.0,0.0,0.0072518129532383,0.0072518129532383,0.0083057862718408,0.0,0.418604651162791,0.2083333333333332,165,5,9,28,0,4130,1,8,79,1800000,109090.90909090909,1800000.0,300000.0,600000.0,1300000.0,1,500000,0.2,0.5
675341,Gabriel,Florentín,2024,14589,Argentina,Gregorio de Laferrere,Argentina,13-03-99,Attacking Midfield,Midfield,Right,173.0,30-06-25,Lucio Corporation,https://img.a.transfermarkt.technology/portrait/header/675341-1690113335.png?lm=1,RU1,FC Orenburg,2300000.0,2500000.0,25,121,136,12,12,14,11,12,12,6,14,6,12,14,8,10,14,8,11,11,9,9,14,11,11,14,8,14,12,14,12,14,13,11,6,14,13,13,8,12,5,11,14,14,3,2,1,2,3,1,3,3,2,4,1,17,12,8,14,10,12,12,12,1,1,1,1,1,1,14,1,20,1,11,18,13,11,70,11,20,4009944,6050,6050,3250,Mediterranean_Hispanic,119,0,0,24598.0,Unknown,14207318,2200000.0,1.0,4,561,4,3,1,3,70,0,0.5508070918232336,0.3422459893048128,0.5147058823529411,0.0237435629539004,0.0,0.0,0.0112528132033008,0.0122530632658164,0.0121947831884219,0.0,0.2325581395348837,0.2916666666666665,139,10,20,32,1,4005,2,26,196,2000000,190000.0,2500000.0,300000.0,,100000.0,1,500000,-0.13043478260869565,-0.2
675565,Thomas,Kastanaras,2024,79,Germany,Stuttgart,Germany,09-01-03,Centre-Forward,Attack,Right,186.0,30-06-26,AKA Global GmbH,https://img.a.transfermarkt.technology/portrait/header/675565-1691999148.jpg?lm=1,L1,Verein fÃ¼r Bewegungsspiele Stuttgart 1893,500000.0,700000.0,21,109,-75,4,7,11,13,12,12,13,9,4,4,11,14,5,12,11,13,12,12,11,11,10,13,13,5,13,5,11,12,12,12,12,12,13,12,12,12,13,6,14,7,7,2,1,1,1,3,4,2,1,3,3,3,11,14,4,15,12,15,14,15,1,1,1,1,1,1,1,5,1,1,12,14,12,20,80,12,20,40699999,5249,5249,3253,Mediterranean_Hispanic,109,0,0,6711.0,Unknown,2000051522,9111392.0,2.0,38,1432,40,0,1,3,211,3,0.4448266737232071,0.342566844919786,0.4411764705882353,0.0064715669167937,0.0,0.0,0.0022505626406601,0.0032508127031757,0.0505924720131114,0.1428571428571428,0.5348837209302322,0.125,131,67,16,4,0,2131,3,13,137,500000,46875.0,700000.0,200000.0,125000.0,700000.0,3,475000,0.0,-0.2857142857142857
676318,Facundo,Pellistri,2024,265,Uruguay,Montevideo,Uruguay,20-12-01,Right Winger,Attack,Right,175.0,30-06-28,CAA Stellar,https://img.a.transfermarkt.technology/portrait/header/676318-1668156308.jpg?lm=1,GR1,Panathinaikos Athlitikos Omilos,10000000.0,10000000.0,23,122,-8,8,11,14,11,14,8,4,7,3,5,11,10,7,15,14,10,11,10,10,10,9,14,14,5,14,7,13,15,17,14,10,7,11,14,13,6,12,6,15,11,13,2,3,1,2,3,3,1,1,1,2,3,11,11,5,11,13,10,10,12,1,1,1,1,1,1,1,5,1,8,14,12,20,15,65,11,20,80266281,6250,6000,4250,Mediterranean_Hispanic,117,6,0,28998.0,Unknown,78095389,7325000.0,2.0,106,975,103,0,1,3,150,10,0.5441915850754168,0.4491978609625668,0.4999999999999999,0.0279922789243409,0.0394736842105263,0.0,0.0497624406101525,0.0497624406101525,0.0406677963276757,0.1428571428571428,0.2790697674418605,0.2083333333333332,150,11,13,6,0,5397,10,25,33,10000000,571428.5714285715,10000000.0,2000000.0,7000000.0,3000000.0,6,10700000,0.0,0.0
678100,Aziz,Ouattara,2024,354,Cote d'Ivoire,Abidjan,Cote d'Ivoire,04-01-01,Defensive Midfield,Midfield,Right,188.0,30-06-25,Unknown,https://img.a.transfermarkt.technology/portrait/header/678100-1714037869.png?lm=1,BE1,Yellow-Red Koninklijke Voetbalclub Mechelen,1500000.0,2000000.0,23,110,145,5,11,8,8,11,6,14,8,9,11,11,8,12,11,13,11,13,11,11,11,11,13,8,8,12,11,12,11,12,10,12,15,14,13,12,12,12,12,2,6,14,4,3,1,3,2,2,1,3,3,3,1,14,13,5,8,12,12,10,8,1,1,17,14,1,12,20,1,15,1,1,1,1,1,78,8,20,8349999,5489,3954,5243,African_Caribbean,96,0,0,4155.0,Unknown,12090188,1050000.0,2.0,23,14,24,3,1,1,223,4,0.27348504895475,0.5554010695187165,0.3455882352941176,0.0040034491848741,0.0,0.0,0.0072518129532383,0.0097524381095273,0.0058057168254673,0.1428571428571428,0.581395348837209,0.2083333333333332,138,9,1,32,2,2914,1,28,238,2000000,158333.33333333334,2000000.0,500000.0,100000.0,1500000.0,2,1000000,1.0,0.3333333333333333
678406,Sergi,Cardona,2024,1050,Spain,Lloret de Mar,Spain,08-07-99,Left-Back,Defender,Left,186.0,30-06-27,EMG Mundial,https://img.a.transfermarkt.technology/portrait/header/678406-1697540707.jpg?lm=1,ES1,Villarreal Club de FÃºtbol S.A.D.,6000000.0,6000000.0,25,116,140,9,12,12,9,12,10,6,9,10,10,12,9,11,13,11,10,11,12,12,12,13,9,12,8,12,10,13,13,13,12,10,12,14,14,14,11,12,9,11,8,14,1,1,1,2,1,1,2,3,2,2,2,17,11,2,11,8,12,8,14,1,19,1,1,20,1,1,17,1,1,14,1,1,1,0,20,8,1592715,5788,5788,3188,Mediterranean_Hispanic,114,0,0,3479.0,Unknown,67294055,9111392.0,2.0,89,853,89,1,0,3,216,8,0.5161418364646732,0.335614973262032,0.4779411764705882,0.0033506919130519,0.0,0.0,0.0297574393598399,0.0297574393598399,0.0505924720131114,0.1428571428571428,0.5348837209302322,0.2916666666666665,166,4,13,42,0,1177,0,0,0,7000000,496428.5714285714,7000000.0,0.0,,,2,1400000,0.16666666666666666,1.3333333333333333
680806,Samuel,Edozie,2024,58,England,London,England,28-01-03,Left Winger,Attack,Right,181.0,30-06-25,Unique Sports Group,https://img.a.transfermarkt.technology/portrait/header/680806-1726822183.jpg?lm=1,BE1,Royal Sporting Club Anderlecht,8000000.0,8000000.0,21,115,-8,9,10,15,11,9,11,6,8,4,7,12,7,10,13,5,6,7,7,12,10,12,8,16,6,12,9,12,15,15,14,13,11,13,16,15,9,11,8,8,11,19,3,2,2,2,3,3,2,4,2,4,3,10,9,3,10,9,14,11,13,1,1,1,1,1,1,1,13,1,13,20,1,15,13,0,10,20,44192851,5750,5750,4250,Mixed_Race,118,0,0,5800.0,Unknown,28126246,4300000.0,2.0,32,858,33,0,1,4,175,7,0.5111140513363324,0.4491978609625668,0.5073529411764706,0.0055918895874593,0.0,0.0,0.0397599399849962,0.0397599399849962,0.0238617739381649,0.1428571428571428,0.418604651162791,0.125,148,23,17,6,0,5939,3,15,27,8000000,937500.0,8000000.0,0.0,500000.0,8000000.0,2,6200000,0.0,0.0
683620,Antoni,Milambo,2024,234,Netherlands,Rotterdam,Netherlands,03-04-05,Central Midfield,Midfield,Right,179.0,30-06-27,22Eleven,https://img.a.transfermarkt.technology/portrait/header/683620-1691146656.jpg?lm=1,NL1,Feyenoord Rotterdam,6000000.0,6000000.0,19,105,-85,8,9,13,10,14,8,8,10,7,4,14,4,10,13,13,13,7,10,8,10,14,13,15,9,10,7,9,13,12,14,12,7,14,13,12,7,11,9,16,6,11,2,2,3,1,2,3,1,4,4,2,2,15,11,4,9,12,11,11,14,1,1,1,1,1,1,1,12,15,1,13,20,1,1,0,8,20,29399999,4900,4900,2354,African_Caribbean,102,0,0,4999.0,Unknown,2000054475,9111392.0,2.0,67,1253,68,3,1,1,85,1,0.3986504366234453,0.2464171122994652,0.3897058823529412,0.0048184301573859,0.0,0.0,0.0297574393598399,0.0297574393598399,0.0505924720131114,0.1428571428571428,0.3720930232558141,0.0416666666666666,0,0,0,0,0,0,9,25,43,16000000,1666666.6666666667,16000000.0,0.0,6000000.0,,0,0,1.6666666666666667,3.0
683828,Emrecan,Uzunhan,2024,589,TÃ¼rkiye,Istanbul,TÃ¼rkiye,26-02-01,Centre-Back,Defender,Left,189.0,30-06-25,F-F SPORT,https://img.a.transfermarkt.technology/portrait/header/683828-1726736787.jpg?lm=1,TR1,Antalyaspor,550000.0,2000000.0,23,110,140,4,5,12,6,12,7,12,7,9,13,12,4,13,12,11,12,13,13,12,10,12,14,9,9,8,12,13,12,12,12,10,13,14,12,12,11,12,10,10,7,12,4,2,1,2,3,4,3,3,2,1,3,7,9,4,11,9,11,10,18,1,1,20,1,1,1,1,1,1,1,1,1,1,1,80,20,10,3594123,5700,5700,3700,Mediterranean_Hispanic,110,0,0,2764.0,Unknown,70131673,2000000.0,1.0,100,667,100,1,0,3,19,2,0.5044985445885155,0.3903743315508021,0.4485294117647059,0.0026602755678553,0.0,0.0,0.002500625156289,0.0097524381095273,0.0110836412122558,0.0,0.6046511627906974,0.2083333333333332,51,1,4,7,0,1988,10,75,165,500000,31666.666666666668,2000000.0,500000.0,,125000.0,4,1975000,-0.09090909090909091,-0.5833333333333334
683840,Unknown,Pedri,2024,131,Spain,Tegueste,Spain,25-11-02,Central Midfield,Midfield,Right,174.0,30-06-26,LEADERBROCK,https://img.a.transfermarkt.technology/portrait/header/683840-1620304992.jpg?lm=1,ES1,Futbol Club Barcelona,80000000.0,100000000.0,22,159,176,9,14,17,11,18,9,7,11,6,6,17,11,9,17,11,17,11,16,15,18,16,14,18,9,13,9,13,15,14,15,13,8,16,13,16,9,15,5,13,5,15,1,1,2,1,2,3,2,2,4,2,3,12,14,3,14,13,15,15,17,1,1,1,1,1,1,1,12,20,14,15,20,16,5,65,10,20,96009385,7950,7950,6950,Mediterranean_Hispanic,153,12,0,172603.0,Unknown,67293495,23000000.0,1.0,89,1478,89,3,1,3,96,1,0.8021963482402752,0.7379679144385026,0.7647058823529411,0.1666597464095936,0.0789473684210526,0.0,0.3998499624906226,0.4998749687421855,0.1277535487096864,0.0,0.2558139534883721,0.1666666666666666,216,28,26,16,0,5120,11,88,103,100000000,5277777.777777778,100000000.0,10000000.0,80000000.0,100000000.0,1,7800000,0.25,0.1111111111111111
684315,Nnamdi,Collins,2024,24,Germany,DÃ¼sseldorf,Germany,10-01-04,Centre-Back,Defender,Right,191.0,30-06-28,11WINS,https://img.a.transfermarkt.technology/portrait/header/684315-1724772257.jpg?lm=1,L1,Eintracht Frankfurt FuÃŸball AG,1000000.0,1000000.0,20,103,-8,2,3,8,1,10,1,12,1,4,14,9,5,12,14,15,9,12,6,7,7,14,10,5,3,8,8,13,13,17,12,9,11,15,16,7,9,7,8,20,10,17,1,3,3,3,1,3,1,1,2,1,2,19,17,7,8,11,11,14,12,1,13,20,13,1,1,1,1,1,1,1,1,1,1,84,13,20,31480000,5150,5150,3365,African_Caribbean,94,0,0,7560.0,Unknown,2000045854,1000000.0,1.0,38,443,40,1,1,1,63,2,0.4317279703625297,0.3545454545454545,0.3308823529411764,0.0072913759756355,0.0,0.0,0.0047511877969492,0.0047511877969492,0.0055279313314258,0.0,0.6511627906976742,0.0833333333333332,124,9,5,20,0,4698,2,22,84,4000000,700000.0,4000000.0,0.0,500000.0,4000000.0,1,0,3.0,4.333333333333333
685145,Filip,Bundgaard,2024,206,Denmark,Randers,Denmark,03-07-04,Centre-Forward,Attack,Left,176.0,30-06-28,Elite Consulting,https://img.a.transfermarkt.technology/portrait/header/685145-1694548385.jpg?lm=1,DK1,BrÃ¸ndby IdrÃ¦tsforening,2000000.0,2000000.0,20,109,-75,14,12,13,13,12,12,5,11,4,9,13,13,3,13,15,11,12,11,12,11,13,15,14,10,13,4,12,13,13,13,13,7,12,13,11,5,12,10,14,3,10,3,2,3,3,2,3,2,4,2,3,4,20,11,7,15,12,13,9,10,1,1,1,1,1,1,1,1,1,1,1,19,15,20,62,20,11,3022159,5500,5000,1000,Northern_European,101,0,0,1010.0,Unknown,2000018980,3000000.0,1.0,28,1204,30,0,0,7,45,3,0.4118814501190792,0.1016042780748663,0.3823529411764706,0.0009665828832752,0.0,0.0,0.0097524381095273,0.0097524381095273,0.0166393510930859,0.0,0.3023255813953489,0.0833333333333332,155,32,13,7,0,6417,1,3,8,2000000,162500.0,2000000.0,0.0,1000000.0,2000000.0,2,550000,0.0,0.3333333333333333
685657,Silas,Andersen,2024,200,Unknown,Unknown,Denmark,13-06-04,Defensive Midfield,Midfield,Right,190.0,30-06-26,Nordic Sky,https://img.a.transfermarkt.technology/portrait/header/685657-1723460472.jpg?lm=1,NL1,Football Club Utrecht,400000.0,400000.0,20,125,145,14,13,16,12,16,15,7,12,11,4,14,13,6,16,10,14,7,12,9,14,11,10,16,14,13,6,12,11,11,15,10,9,10,11,11,7,8,8,11,16,15,3,3,2,1,2,2,1,3,3,4,2,10,12,5,17,8,13,13,13,1,1,1,1,1,1,1,15,18,12,20,19,14,14,72,13,20,2540872,6250,6250,5050,Northern_European,121,7,0,10755.0,Unknown,27039538,450000.0,1.0,105,1549,30,3,1,7,92,4,0.5772691188145012,0.53475935828877,0.5294117647058822,0.0103765231405349,0.0460526315789473,0.0,0.0017504376094023,0.0017504376094023,0.0024722908969693,0.0,0.6279069767441858,0.0833333333333332,117,10,11,20,2,2308,0,0,0,400000,75000.0,400000.0,0.0,,400000.0,2,200000,0.0,0.3333333333333333
685887,Matchoi,Djaló,2024,6890,Guinea-Bissau,Bissau,Portugal,10-04-03,Attacking Midfield,Midfield,Right,180.0,30-06-27,MadeinFootball,https://img.a.transfermarkt.technology/portrait/header/685887-1728309980.jpg?lm=1,TR1,?stanbul Ba?ak?ehir Futbol KulÃ¼bÃ¼,1300000.0,2000000.0,21,120,-8,12,12,14,10,12,12,7,13,5,3,12,10,6,14,11,9,11,11,9,14,11,13,14,6,12,8,9,10,14,14,15,4,14,14,13,7,11,8,10,4,12,3,1,3,1,3,3,3,3,3,1,3,12,11,6,13,13,11,11,12,1,1,1,1,1,1,1,1,18,14,16,20,19,10,68,12,20,26720002,5997,5997,3997,African_Caribbean,114,0,0,1749.0,Unknown,83297506,9111392.0,2.0,44,202,79,3,1,1,4,0,0.5437946546705478,0.422139037433155,0.4779411764705882,0.001680174042856,0.0,0.0,0.0062515628907226,0.0097524381095273,0.0505924720131114,0.1428571428571428,0.3953488372093026,0.125,105,10,4,28,2,1749,2,14,53,1100000,64285.71428571428,2000000.0,500000.0,2000000.0,1300000.0,1,200000,-0.26666666666666666,-0.15384615384615385
686597,Unknown,Calegari,2024,3329,Brazil,CuiabÃ¡,Brazil,27-02-02,Right-Back,Defender,Right,171.0,30-06-25,Roc Nation Sports,https://img.a.transfermarkt.technology/portrait/header/686597-1688635197.jpg?lm=1,PO1,Futebol Clube de FamalicÃ£o,4000000.0,5000000.0,22,124,138,12,13,14,11,14,7,10,13,8,11,13,10,13,13,8,13,11,13,13,12,13,12,14,11,12,11,12,13,14,14,12,5,14,14,14,12,11,9,11,7,15,2,1,1,3,2,1,1,3,2,1,3,12,12,1,10,11,13,13,12,1,1,1,20,1,15,16,1,14,1,1,14,1,1,65,6,20,7171603,6126,6126,2883,Mediterranean_Hispanic,124,0,0,8637.0,Unknown,19392884,9111392.0,2.0,10,396,11,1,1,3,99,11,0.5608626620799153,0.3029946524064171,0.5514705882352942,0.0083313457711274,0.0,0.0,0.0197549387346836,0.0247561890472618,0.0505924720131114,0.1428571428571428,0.1860465116279068,0.1666666666666666,132,1,5,16,1,4160,4,41,226,4000000,263333.3333333333,5000000.0,1000000.0,2500000.0,5000000.0,4,850000,0.0,0.0
686845,Zidane,Iqbal,2024,200,England,Manchester,Iraq,27-04-03,Central Midfield,Midfield,Right,181.0,30-06-27,SEG,https://img.a.transfermarkt.technology/portrait/header/686845-1723460350.jpg?lm=1,NL1,Football Club Utrecht,1000000.0,1000000.0,21,112,-75,9,7,13,10,14,7,3,11,2,5,14,9,7,14,13,12,8,13,11,13,11,11,12,3,12,8,14,14,13,13,10,9,12,13,14,8,12,11,12,12,12,3,3,1,2,2,1,1,4,3,4,1,12,10,8,10,11,9,9,20,1,1,1,1,1,1,17,1,20,1,10,15,10,1,64,13,20,45839934,5597,6198,3274,Asian,110,2,0,2320.0,Unknown,28127217,1000000.0,1.0,32,905,51,3,1,2,92,1,0.5703889917967716,0.3448128342245989,0.4485294117647059,0.0022315415017472,0.0131578947368421,0.0,0.0047511877969492,0.0047511877969492,0.0055279313314258,0.0,0.418604651162791,0.125,92,12,3,13,0,3315,4,17,49,1000000,66666.66666666667,1000000.0,0.0,600000.0,1000000.0,2,200000,0.0,0.0
687626,Moisés,Caicedo,2024,631,Ecuador,Santo Domingo,Ecuador,02-11-01,Defensive Midfield,Midfield,Right,178.0,30-06-31,Unknown,https://img.a.transfermarkt.technology/portrait/header/687626-1660729724.jpg?lm=1,GB1,Chelsea Football Club,75000000.0,90000000.0,23,143,-9,5,8,14,10,13,8,9,12,4,12,15,8,17,14,13,13,13,14,13,14,14,15,14,9,13,14,14,15,16,16,12,9,18,14,16,9,13,8,11,6,10,3,3,3,1,1,1,1,2,3,2,2,4,14,8,13,10,12,13,10,1,1,1,1,1,1,19,1,20,1,1,1,1,1,73,8,20,94034500,7143,7143,4243,African_Caribbean,141,25,2,28998.0,Unknown,86078360,72100000.0,2.0,30,1338,31,3,1,1,50,4,0.6954220693305108,0.4484491978609625,0.6764705882352942,0.0279922789243409,0.1644736842105263,0.0263157894736842,0.3748437109277319,0.4498624656164041,0.4005389038584405,0.1428571428571428,0.3488372093023257,0.2083333333333332,182,13,12,46,0,6234,4,10,22,80000000,4996875.0,90000000.0,10000000.0,1200000.0,25000000.0,4,17000000,0.06666666666666667,-0.1111111111111111
690429,Robert,Wagner,2024,35,Germany,Lahr,Germany,14-07-03,Central Midfield,Midfield,Right,181.0,30-06-25,VIDA 11,https://img.a.transfermarkt.technology/portrait/header/690429-1723632023.jpeg?lm=1,L1,FuÃŸball-Club St. Pauli von 1910,3000000.0,3000000.0,21,109,-8,9,10,12,10,13,8,9,12,9,7,13,9,10,13,15,10,11,9,12,12,11,12,6,10,9,10,14,14,12,10,9,12,15,11,14,11,12,16,12,3,12,3,1,3,3,2,1,3,1,1,1,3,13,14,10,13,11,10,12,10,1,1,1,1,1,1,1,17,20,15,15,18,15,10,0,10,20,53600001,5290,5290,3056,Northern_European,103,0,0,2000.0,Unknown,2000068513,9111392.0,2.0,38,792,40,3,1,7,101,1,0.450251389256417,0.3214973262032085,0.3970588235294117,0.0019225439766243,0.0,0.0,0.0147536884221055,0.0147536884221055,0.0505924720131114,0.1428571428571428,0.418604651162791,0.125,123,12,9,22,0,1496,6,15,96,3000000,241666.66666666666,3000000.0,0.0,500000.0,3000000.0,3,700000,0.0,0.5
690799,Anthony,Rouault,2024,79,France,Villeneuve-sur-Lot,France,29-05-01,Centre-Back,Defender,Right,186.0,30-06-27,One Team Football ,https://img.a.transfermarkt.technology/portrait/header/690799-1723707069.jpg?lm=1,L1,Verein fÃ¼r Bewegungsspiele Stuttgart 1893,10000000.0,10000000.0,23,120,156,4,6,10,5,12,4,14,5,4,13,13,12,13,13,11,13,12,11,12,11,12,15,12,12,12,13,13,12,12,13,12,15,14,13,13,12,13,4,14,6,10,3,3,1,1,3,1,2,4,1,4,1,13,15,3,14,11,15,14,20,1,1,20,1,1,1,1,1,1,1,1,1,1,1,77,8,20,7987999,6000,6000,3018,Northern_European,120,0,0,2749.0,Unknown,49047179,3000000.0,1.0,34,1606,36,1,1,7,211,2,0.5441915850754168,0.3174331550802138,0.5220588235294117,0.0026457913088652,0.0,0.0,0.0497624406101525,0.0497624406101525,0.0166393510930859,0.0,0.5348837209302322,0.2083333333333332,156,8,5,16,1,3052,5,21,79,10000000,579411.7647058824,10000000.0,3000000.0,150000.0,3000000.0,1,3000000,0.42857142857142855,0.42857142857142855
691316,Unknown,Luis Henrique,2024,244,Brazil,JoÃ£o Pessoa,Brazil,14-12-01,Left Winger,Attack,Left,181.0,30-06-28,Roc Nation Sports,https://img.a.transfermarkt.technology/portrait/header/691316-1632769083.jpg?lm=1,FR1,Olympique de Marseille,12000000.0,12000000.0,23,130,150,7,12,15,11,13,8,10,11,7,6,13,11,7,15,8,12,11,12,11,12,12,13,15,8,12,7,11,13,15,14,11,11,10,15,12,11,12,5,10,4,12,1,3,2,2,3,1,2,3,2,2,3,15,11,6,12,11,12,7,11,1,1,1,1,1,1,1,12,1,12,18,1,20,16,0,20,7,10500000,6350,6350,2000,African_Caribbean,124,0,0,8759.0,Unknown,19377206,8000000.0,1.0,10,692,11,0,0,1,144,7,0.590500132310135,0.2085561497326203,0.5514705882352942,0.0084491510775805,0.0,0.0,0.0597649412353088,0.0597649412353088,0.044417900497236,0.0,0.418604651162791,0.2083333333333332,187,19,21,3,0,6239,2,5,14,15000000,656250.0,15000000.0,1000000.0,8000000.0,6000000.0,3,5000000,0.875,1.5
691920,Artem,Karpukas,2024,932,Russia,"Biysk, Altai Region",Russia,13-06-02,Defensive Midfield,Midfield,Right,184.0,30-06-27,Unknown,https://img.a.transfermarkt.technology/portrait/header/691920-1721715789.png?lm=1,RU1,"?????????? ???? ""?????????"" ??????",6000000.0,6000000.0,22,108,-75,8,6,10,8,10,8,9,9,7,13,10,8,14,10,12,13,13,11,13,10,10,15,9,8,10,12,14,14,11,12,12,11,11,12,14,10,14,10,7,9,7,2,2,1,1,3,2,4,2,3,1,3,14,13,2,11,13,15,10,17,1,1,1,1,1,1,20,1,14,1,1,1,1,1,75,10,20,17454238,5250,5250,2854,Northern_European,103,0,0,862.0,Unknown,2000082337,9111392.0,2.0,78,203,81,3,1,7,3,4,0.4449589838581635,0.2998930481283422,0.3970588235294117,0.0008236715279058,0.0,0.0,0.0297574393598399,0.0297574393598399,0.0505924720131114,0.1428571428571428,0.4883720930232553,0.1666666666666666,0,0,0,0,0,0,2,8,38,6000000,497916.6666666667,6000000.0,0.0,100000.0,3000000.0,2,300000,0.0,0.0
692209,Joan,González,2024,1005,Spain,Barcelona,Spain,01-02-02,Central Midfield,Midfield,Right,190.0,30-06-27,YOU FIRST,https://img.a.transfermarkt.technology/portrait/header/692209-1681309894.jpg?lm=1,IT1,Unione Sportiva Lecce,4500000.0,6000000.0,22,127,137,10,11,13,13,11,11,12,11,10,7,12,10,7,13,13,11,13,12,12,12,11,12,12,11,13,7,11,14,15,14,12,12,14,14,12,12,12,6,11,15,12,2,2,3,2,1,3,2,3,1,2,1,19,11,10,13,12,13,12,10,1,1,1,1,1,1,1,12,1,12,20,10,18,10,75,11,20,1316699,6332,6332,4511,African_Caribbean,124,0,0,2697.0,AsociaciÃ³n Deportivo Cali,76037203,9111392.0,2.0,89,141,89,3,1,1,206,1,0.5881185498809209,0.4771122994652406,0.5514705882352942,0.0025955792110327,0.0,0.0,0.0222555638909727,0.0297574393598399,0.0505924720131114,0.1428571428571428,0.6279069767441858,0.1666666666666666,98,10,7,18,0,238,1,28,224,2000000,194444.44444444444,6000000.0,2500000.0,,3000000.0,1,1150000,-0.5555555555555556,-0.6666666666666666
693095,Jacob,Greaves,2024,677,England,Cottingham,England,12-09-00,Centre-Back,Defender,Left,193.0,30-06-29,CAA Stellar,https://img.a.transfermarkt.technology/portrait/header/693095-1727786112.jpg?lm=1,GB1,Ipswich Town Football Club,20000000.0,20000000.0,24,118,148,5,7,10,6,12,5,12,6,7,13,14,5,14,11,11,13,13,12,10,13,11,12,5,13,11,14,14,14,11,11,12,16,14,11,15,12,12,5,13,2,8,1,1,2,2,3,2,2,1,3,1,1,11,10,8,11,14,15,8,10,1,14,20,1,1,1,10,1,1,1,1,1,1,1,0,20,8,10961219,5900,5900,3255,Northern_European,117,0,0,16935.0,Unknown,28113416,21500000.0,1.0,32,389,33,1,0,7,115,2,0.530960571579783,0.3427807486631015,0.4999999999999999,0.0163440378444718,0.0,0.0,0.0997749437359339,0.0997749437359339,0.1194199838884413,0.0,0.6976744186046511,0.25,229,8,8,40,0,1072,1,9,65,20000000,1940000.0,20000000.0,0.0,,600000.0,1,5000000,0.3333333333333333,0.42857142857142855
694928,Samuel,Lino,2024,13,Brazil,Santo AndrÃ©,Brazil,23-12-99,Left Midfield,Midfield,Right,170.0,30-06-27,ADM Esporte,https://img.a.transfermarkt.technology/portrait/header/694928-1695982815.jpg?lm=1,ES1,Club AtlÃ©tico de Madrid S.A.D.,30000000.0,30000000.0,25,139,152,8,9,14,14,14,9,6,13,7,5,13,11,10,14,12,11,13,12,11,13,11,15,14,7,13,8,10,15,15,13,15,12,17,15,14,14,10,10,16,5,13,1,3,2,1,2,3,2,1,3,1,3,16,13,6,12,15,14,11,10,1,1,1,1,1,1,1,13,1,10,20,1,18,18,72,12,20,13740001,6950,5331,5226,Mixed_Race,134,0,0,23099.0,Valencia,19320258,6500000.0,1.0,10,1337,11,3,1,4,52,6,0.4556761047896269,0.5535828877005347,0.625,0.0222961026721526,0.0,0.0,0.1497874468617154,0.1497874468617154,0.0360843356759909,0.0,0.1627906976744184,0.2916666666666665,218,47,21,18,0,2960,2,4,15,25000000,1543750.0,30000000.0,5000000.0,,800000.0,2,9000000,-0.16666666666666666,0.0
696164,Tim,Oermann,2024,80,Germany,Bochum,Germany,06-10-03,Centre-Back,Defender,Right,189.0,30-06-26,CN Sports,https://img.a.transfermarkt.technology/portrait/header/696164-1657283257.jpg?lm=1,L1,Verein fÃ¼r LeibesÃ¼bungen Bochum 1848 FuÃŸballgemeinschaft,4000000.0,4000000.0,21,102,-75,3,7,10,6,10,3,12,6,6,12,13,6,11,12,10,10,12,11,11,11,10,15,11,10,8,13,12,12,13,11,13,12,13,13,12,12,11,4,12,6,9,3,3,3,2,2,1,1,4,3,3,3,9,13,4,17,14,15,13,14,1,1,20,10,1,1,16,1,12,1,1,1,1,1,76,8,20,13376000,5093,5093,3053,Northern_European,100,0,0,5273.0,Unknown,2000070513,9111392.0,2.0,38,212,40,1,1,7,212,2,0.4241862926700185,0.3211764705882352,0.3749999999999999,0.0050830092882724,0.0,0.0,0.0197549387346836,0.0197549387346836,0.0505924720131114,0.1428571428571428,0.6046511627906974,0.125,94,2,1,6,0,1512,6,14,31,4000000,542857.1428571428,4000000.0,0.0,200000.0,4000000.0,2,200000,0.0,4.0
696324,Billy,Koumetio,2024,511,France,Villeurbanne,France,14-11-02,Centre-Back,Defender,Left,195.0,31-05-26,ROOF,https://img.a.transfermarkt.technology/portrait/header/696324-1659424199.png?lm=1,SC1,Dundee Football Club,500000.0,800000.0,22,110,-8,5,7,11,7,13,8,13,7,11,12,14,6,13,12,9,12,12,13,10,13,10,14,11,7,8,9,12,10,13,11,11,13,12,13,12,15,11,9,11,7,6,3,3,2,3,1,2,3,1,2,3,1,12,13,8,11,11,11,10,11,1,1,20,1,1,1,1,1,1,1,1,1,1,1,0,20,14,56975140,5482,4618,2322,African_Caribbean,110,0,0,2900.0,Fussballklub Austria Vienna,28127159,9111392.0,2.0,34,1607,36,1,0,1,61,2,0.3613389785657581,0.2429946524064171,0.4485294117647059,0.0027915995160326,0.0,0.0,0.0022505626406601,0.0037509377344336,0.0505924720131114,0.1428571428571428,0.7441860465116279,0.1666666666666666,125,4,3,10,0,5602,0,0,0,500000,0.0,800000.0,200000.0,500000.0,,4,300000,0.0,0.0
696589,Tim,Iroegbunam,2024,29,England,Birmingham,England,30-06-03,Central Midfield,Midfield,Right,183.0,30-06-27,S Palmer Sports,https://img.a.transfermarkt.technology/portrait/header/696589-1650877564.jpg?lm=1,GB1,Everton Football Club,10000000.0,10000000.0,21,112,-75,10,9,13,8,13,9,10,13,7,10,13,7,12,14,14,9,13,12,11,12,10,16,13,6,12,10,10,13,14,13,12,13,15,14,13,12,9,13,12,6,10,2,1,3,3,1,2,3,3,1,1,2,15,11,4,11,9,9,13,11,1,1,1,1,1,1,15,1,20,1,1,10,1,1,0,8,20,43891273,5595,5595,2255,African_Caribbean,113,0,0,17399.0,Queens Park Rangers,292380027,10700000.0,1.0,32,199,33,3,1,1,65,1,0.4906059804181,0.2358288770053475,0.4705882352941176,0.0167920842559001,0.0,0.0,0.0497624406101525,0.0497624406101525,0.059418317175477,0.0,0.4651162790697669,0.125,125,7,7,30,0,3116,1,16,106,10000000,937500.0,10000000.0,1000000.0,2500000.0,4000000.0,3,7500000,1.5,1.5
697149,Kaz?Mcan,Karata?,2024,14589,TÃ¼rkiye,Izmir,TÃ¼rkiye,16-01-03,Left-Back,Defender,Left,182.0,30-06-25,Hamle Menajerlik,https://img.a.transfermarkt.technology/portrait/header/697149-1671038344.png?lm=1,RU1,FC Orenburg,1500000.0,2500000.0,21,95,-75,10,10,12,8,10,9,8,9,14,8,9,9,11,11,6,7,8,8,11,8,8,11,12,6,8,7,12,14,14,13,12,11,14,14,13,11,14,9,8,11,14,3,3,1,3,3,1,2,3,3,1,2,9,11,1,13,12,11,13,10,1,18,1,1,20,1,1,14,1,1,14,1,10,5,0,20,5,8865506,4897,4897,3225,Mediterranean_Hispanic,91,0,0,9482.0,Unknown,70131625,9111392.0,2.0,100,682,100,1,0,3,70,8,0.3982535062185763,0.3395721925133689,0.3088235294117646,0.0091472923609052,0.0,0.0,0.0072518129532383,0.0122530632658164,0.0505924720131114,0.1428571428571428,0.4418604651162785,0.125,80,1,2,5,0,3426,7,18,25,1500000,86764.70588235294,2500000.0,400000.0,225000.0,2500000.0,3,950000,-0.21052631578947367,-0.4
697716,Unknown,Serginho,2024,1063,Portugal,Lisboa,Cape Verde,29-01-01,Left Winger,Attack,Right,183.0,30-06-26,FMA Sports,https://img.a.transfermarkt.technology/portrait/header/697716-1567621292.jpg?lm=1,DK1,Viborg Fodsports Forening,1000000.0,1000000.0,23,120,130,9,12,14,11,10,6,4,7,2,9,13,10,6,13,14,12,11,13,10,13,13,9,13,5,10,7,11,13,15,14,10,7,13,14,12,12,14,8,10,9,11,3,2,4,3,1,1,1,1,4,3,3,13,11,5,10,12,13,9,14,1,1,1,1,1,1,1,12,5,10,20,10,19,5,0,12,20,1734453,6000,4440,5504,Mixed_Race,118,0,0,7499.0,Unknown,11027761,500000.0,1.0,76,843,17,0,1,4,215,7,0.33778777454353,0.5833155080213903,0.5073529411764706,0.0072324733224089,0.0,0.0,0.0047511877969492,0.0047511877969492,0.0027500763910108,0.0,0.4651162790697669,0.2083333333333332,139,18,33,15,0,7730,1,7,58,1700000,228571.42857142858,1700000.0,-50000.0,,,2,350000,0.7,1.2666666666666666
698259,Thomas,Kristensen,2024,410,Denmark,Aarhus,Denmark,17-01-02,Centre-Back,Defender,Right,198.0,30-06-28,Sivebaek Sports,https://img.a.transfermarkt.technology/portrait/header/698259-1696837568.jpg?lm=1,IT1,Udinese Calcio,4500000.0,4500000.0,22,111,-75,7,4,10,8,11,4,11,9,10,13,12,11,13,12,13,11,12,12,9,11,8,14,7,12,9,13,14,14,11,9,12,17,15,14,12,14,9,8,17,7,15,3,1,1,1,2,1,3,1,3,1,3,8,15,5,12,10,13,13,10,1,1,20,1,1,1,10,1,6,1,1,1,1,1,85,8,20,3022159,5539,5539,2739,Northern_European,107,0,0,2577.0,Unknown,2000005988,5000000.0,1.0,28,12,30,1,1,7,205,2,0.4831966128605451,0.2875935828877005,0.4264705882352941,0.0024797051391116,0.0,0.0,0.0222555638909727,0.0222555638909727,0.0277507708547459,0.0,0.8139534883720931,0.1666666666666666,118,5,1,16,0,4514,6,24,63,4500000,342307.6923076923,4500000.0,0.0,50000.0,700000.0,2,2400000,0.0,0.5
698678,Hugo,Bueno,2024,234,Spain,Vigo,Spain,18-09-02,Left-Back,Defender,Left,180.0,30-06-25,Footfeel ISM  ,https://img.a.transfermarkt.technology/portrait/header/698678-1669020197.jpg?lm=1,NL1,Feyenoord Rotterdam,6000000.0,6000000.0,22,100,-75,5,13,13,8,10,5,10,6,9,12,11,8,10,13,12,9,9,13,11,11,12,2,13,10,10,9,8,11,13,12,6,10,14,13,13,8,10,13,9,7,13,1,2,3,3,1,3,2,1,1,1,3,11,11,8,10,9,10,10,10,1,15,1,1,20,1,1,1,12,1,1,1,1,1,73,20,10,25054215,4994,4994,2754,Mediterranean_Hispanic,98,0,0,1740.0,Unknown,28127371,9111392.0,2.0,89,1587,89,1,0,3,85,8,0.4110875893093411,0.2891978609625668,0.3602941176470588,0.0016714834874619,0.0,0.0,0.0297574393598399,0.0297574393598399,0.0505924720131114,0.1428571428571428,0.3953488372093026,0.1666666666666666,0,0,0,0,0,0,4,11,35,8000000,1560000.0,8000000.0,0.0,,6000000.0,1,2000000,0.3333333333333333,0.3333333333333333
699442,Kacper,Urbanski,2024,1025,Poland,Gda?sk,Poland,07-09-04,Central Midfield,Midfield,Right,183.0,30-06-25,BMG-SPORT,https://img.a.transfermarkt.technology/portrait/header/699442-1696837702.jpg?lm=1,IT1,Bologna Football Club 1909,7000000.0,7000000.0,20,92,-75,8,10,14,9,13,10,6,12,3,6,11,10,10,12,9,11,11,10,11,13,11,15,13,8,12,8,9,10,11,12,11,5,14,10,10,9,12,9,11,4,14,3,1,2,4,2,3,1,2,3,2,2,12,16,5,8,14,16,16,7,1,1,1,1,1,1,20,7,19,7,5,15,5,1,65,11,20,11349600,4599,4028,2769,Northern_European,87,0,0,1199.0,Unknown,96161950,750000.0,1.0,75,525,78,3,1,7,40,1,0.2832759989415189,0.2908021390374331,0.2794117647058823,0.0011490845465509,0.0,0.0,0.0347586896724181,0.0347586896724181,0.0041390038612183,0.0,0.4651162790697669,0.0833333333333332,119,13,10,10,0,2724,1,1,28,7000000,755555.5555555555,7000000.0,0.0,600000.0,7000000.0,2,50000,0.0,6.0
699783,Raphael,Onyedika,2024,2282,Nigeria,Imo,Nigeria,19-04-01,Defensive Midfield,Midfield,Right,184.0,30-06-27,Stirr Associates,https://img.a.transfermarkt.technology/portrait/header/699783-1666292163.jpg?lm=1,BE1,Club Brugge Koninklijke Voetbalvereniging,16000000.0,16000000.0,23,126,150,6,7,11,8,11,7,11,9,10,12,13,7,13,12,15,12,13,11,11,13,13,5,6,7,14,12,13,15,12,13,11,12,14,13,14,14,12,9,12,5,11,3,3,3,3,3,3,1,2,2,3,3,20,11,8,11,12,11,7,13,1,1,14,1,1,1,20,10,18,10,1,10,1,1,83,9,20,15000000,6400,5134,2669,African_Caribbean,118,0,0,14999.0,Unknown,27162493,9500000.0,1.0,69,655,70,3,1,1,53,4,0.4296110082032284,0.2801069518716577,0.5073529411764706,0.014474602817478,0.0,0.0,0.0797699424856214,0.0797699424856214,0.052751465318481,0.0,0.4883720930232553,0.2083333333333332,236,15,10,64,2,8924,4,5,11,16000000,1215384.6153846155,16000000.0,3000000.0,,3000000.0,2,4200000,0.6,1.0
699980,Enis,Destan,2024,449,TÃ¼rkiye,Izmir,TÃ¼rkiye,15-06-02,Centre-Forward,Attack,Right,186.0,30-06-28,Unknown,https://img.a.transfermarkt.technology/portrait/header/699980-1723801235.jpg?lm=1,TR1,Trabzonspor KulÃ¼bÃ¼,4600000.0,4800000.0,22,100,-75,4,7,9,13,13,6,13,9,6,4,11,13,5,12,12,12,10,12,11,11,11,13,11,5,12,7,13,11,10,10,11,13,11,11,12,12,11,14,12,6,14,2,2,2,3,3,3,2,3,3,2,2,12,13,12,12,13,15,8,7,1,1,1,1,1,1,1,1,1,1,1,1,1,20,79,12,20,3188336,5500,5500,3500,Mediterranean_Hispanic,101,0,0,7976.0,Warta PoznaÅ„,70137166,600000.0,1.0,100,682,100,0,1,3,204,3,0.4780365175972479,0.3689839572192513,0.3823529411764706,0.0076930727582953,0.0,0.0,0.0227556889222305,0.0237559389847461,0.0033056473790938,0.0,0.5348837209302322,0.1666666666666666,148,38,11,34,1,2605,3,11,46,4300000,251470.58823529413,4800000.0,400000.0,1700000.0,700000.0,3,1100000,-0.10416666666666667,0.72
700106,Brajan,Gruda,2024,1237,Germany,Speyer,Germany,31-05-04,Right Winger,Attack,Left,178.0,30-06-28,Robert Schneider,https://img.a.transfermarkt.technology/portrait/header/700106-1699001685.jpg?lm=1,GB1,Brighton and Hove Albion Football Club,25000000.0,25000000.0,20,96,-75,11,8,12,12,12,12,12,11,2,4,12,14,5,13,12,9,8,10,8,12,8,13,16,10,12,5,10,10,12,12,10,12,14,12,11,9,14,6,12,4,13,2,2,4,1,2,3,1,1,2,1,3,11,13,7,13,12,13,8,7,1,1,1,1,1,1,1,10,12,10,15,18,15,20,72,20,9,16720000,4809,4809,2318,Northern_European,93,0,0,1151.0,Unknown,2000180822,31500000.0,1.0,38,1407,40,0,0,7,44,10,0.3866102143424186,0.242566844919786,0.3235294117647059,0.0011027349177825,0.0,0.0,0.1247811952988247,0.1247811952988247,0.1749770826967416,0.0,0.3488372093023257,0.0833333333333332,83,22,11,14,0,2420,11,24,34,25000000,3500000.0,25000000.0,0.0,500000.0,25000000.0,1,5000000,0.25,1.7777777777777777
700182,Facundo,Pérez,2024,6418,Argentina,Quilmes,Argentina,31-07-99,Central Midfield,Midfield,Right,170.0,30-06-25,TDL COMPANY,https://img.a.transfermarkt.technology/portrait/header/700182-1637255476.JPG?lm=1,GR1,Panetolikos Agrinio,500000.0,750000.0,25,121,132,11,12,12,8,13,12,9,11,8,13,13,8,10,12,6,12,8,13,12,14,14,10,11,8,9,12,15,13,11,12,13,6,14,13,15,11,11,11,13,11,12,2,1,2,2,1,3,1,2,1,2,3,9,11,6,14,12,14,11,19,1,1,1,1,1,1,14,1,20,15,1,1,1,1,65,10,20,3440779,5749,5749,2994,Mediterranean_Hispanic,120,0,0,2192.0,Unknown,14247651,9111392.0,2.0,4,1198,4,3,1,3,151,1,0.5109817412013761,0.3148663101604277,0.5220588235294117,0.0021079424916981,0.0,0.0,0.0022505626406601,0.0035008752188047,0.0505924720131114,0.1428571428571428,0.1627906976744184,0.2916666666666665,160,5,6,45,0,5738,0,0,0,600000,50000.0,750000.0,150000.0,,150000.0,2,400000,0.2,0.2
701057,Rico,Lewis,2024,281,England,Bury,England,21-11-04,Right-Back,Defender,Right,169.0,30-06-28,CAA Base Ltd,https://img.a.transfermarkt.technology/portrait/header/701057-1684856684.jpg?lm=1,GB1,Manchester City Football Club,40000000.0,40000000.0,20,110,-8,4,8,12,7,11,5,11,4,9,9,12,11,11,12,15,11,13,11,12,11,11,15,12,12,11,14,12,14,14,16,11,3,13,13,14,12,11,10,17,13,16,4,3,2,2,3,3,2,1,3,1,1,10,8,6,14,9,16,12,15,1,16,1,20,1,15,15,1,14,1,1,1,1,1,0,8,20,39437190,5494,5494,4007,African_Caribbean,111,0,0,3480.0,Unknown,2000098727,9111392.0,2.0,32,281,33,1,1,1,131,11,0.47724265678751,0.4232085561497326,0.4558823529411764,0.0033516575303179,0.0,0.0,0.1997999499874969,0.1997999499874969,0.0505924720131114,0.1428571428571428,0.13953488372093,0.0833333333333332,128,9,12,12,0,5712,0,0,0,40000000,5571428.571428572,40000000.0,0.0,20000000.0,40000000.0,0,0,0.05263157894736842,0.05263157894736842
701757,Keke,Topp,2024,86,Germany,BremervÃ¶rde,Germany,25-03-04,Centre-Forward,Attack,Right,192.0,30-06-28,Unknown,https://img.a.transfermarkt.technology/portrait/header/701757-1722887176.jpg?lm=1,L1,Sportverein Werder Bremen von 1899,4000000.0,4000000.0,20,100,-75,2,7,11,12,11,12,13,8,4,4,11,14,5,12,11,12,13,12,9,11,9,13,12,5,12,5,11,12,11,10,12,15,14,12,11,13,13,6,13,6,8,2,2,4,3,4,2,1,2,1,2,2,7,14,4,12,10,12,12,12,1,1,1,1,1,1,1,1,1,1,1,1,1,20,81,10,20,3963999,5000,5000,3012,Northern_European,100,0,0,1917.0,Unknown,2000085414,2000000.0,1.0,38,255,40,0,1,7,194,3,0.4118814501190792,0.3167914438502673,0.3749999999999999,0.0018423977435455,0.0,0.0,0.0197549387346836,0.0197549387346836,0.0110836412122558,0.0,0.6744186046511627,0.0833333333333332,87,40,12,11,0,2711,2,15,87,4000000,500000.0,4000000.0,0.0,,4000000.0,2,1200000,0.3333333333333333,4.714285714285714
702441,Sinaly,Diomandé,2024,290,Cote d'Ivoire,Yopougon,Cote d'Ivoire,09-04-01,Centre-Back,Defender,Right,184.0,30-06-27,Ambition Group,https://img.a.transfermarkt.technology/portrait/header/702441-1672831343.jpg?lm=1,FR1,Association de la Jeunesse auxerroise,4000000.0,9000000.0,23,118,143,6,8,8,6,11,8,15,8,11,13,12,8,13,12,12,13,15,12,9,11,11,14,11,8,9,12,13,14,13,11,13,14,13,13,13,14,11,12,12,6,10,2,1,3,2,1,2,3,1,3,1,2,12,10,5,12,12,13,12,19,1,1,20,14,1,1,1,1,1,1,1,1,1,1,74,8,20,4484999,6200,5900,2500,African_Caribbean,118,9,0,17260.0,Unknown,49062672,550000.0,1.0,23,1687,24,1,1,1,23,2,0.530960571579783,0.2620320855614972,0.5073529411764706,0.0166578634559248,0.0592105263157894,0.0,0.0197549387346836,0.0447611902975743,0.0030278618850523,0.0,0.4883720930232553,0.2083333333333332,125,4,2,15,2,3175,4,34,85,5000000,269230.76923076925,9000000.0,2000000.0,,7000000.0,1,1000000,0.25,-0.2857142857142857
702869,Ismael,Saibari,2024,383,Spain,Terrassa,Morocco,28-01-01,Central Midfield,Midfield,Right,185.0,30-06-29,Unknown,https://img.a.transfermarkt.technology/portrait/header/702869-1687426997.jpg?lm=1,NL1,Eindhovense Voetbalvereniging Philips Sport Vereniging,16000000.0,16000000.0,23,126,144,7,12,13,11,13,10,12,12,10,5,12,6,6,14,9,11,14,12,10,15,12,13,15,11,12,6,14,12,13,13,11,12,13,14,13,9,10,15,9,14,13,3,2,1,2,1,3,2,1,1,2,3,14,8,5,10,12,14,3,14,1,1,1,1,1,1,1,12,14,12,18,20,16,17,0,8,20,9225000,6196,5228,4867,North_African__Middle_Eastern,116,0,0,2500.0,Unknown,18105831,9111392.0,2.0,89,1485,67,3,1,6,62,1,0.4420481608891241,0.515187165775401,0.4926470588235294,0.0024053526096289,0.0,0.0,0.0797699424856214,0.0797699424856214,0.0505924720131114,0.1428571428571428,0.5116279069767438,0.2083333333333332,153,26,31,9,0,3147,8,71,92,23000000,1641071.4285714286,23000000.0,700000.0,,400000.0,1,1550000,0.4375,1.3
703581,Egor,Ushakov,2024,2410,Russia,Moskau,Russia,02-12-02,Right Winger,Attack,Right,177.0,30-06-26,Unknown,https://img.a.transfermarkt.technology/portrait/header/703581-1694616603.png?lm=1,RU1,PFK CSKA Moskva,250000.0,500000.0,22,90,-75,9,9,12,8,10,10,6,3,6,6,10,6,7,12,6,8,8,10,12,7,10,13,8,3,11,8,13,13,13,14,10,7,11,14,10,6,12,15,6,12,15,1,2,3,3,3,2,1,2,3,3,2,8,10,5,11,12,13,9,13,1,1,1,10,13,13,1,15,10,20,13,13,13,13,65,9,20,10525838,4003,4021,1660,Northern_European,83,0,0,1402.0,Unknown,2000013729,9111392.0,2.0,78,985,81,0,1,7,148,10,0.2823498279968246,0.1721925133689839,0.2499999999999999,0.0013451048515508,0.0,0.0,0.0010002500625156,0.0022505626406601,0.0505924720131114,0.1428571428571428,0.3255813953488373,0.1666666666666666,46,8,9,6,0,1586,9,87,197,200000,12500.0,500000.0,100000.0,150000.0,400000.0,3,450000,-0.2,-0.3333333333333333
704772,Rome Jayden,Owusu-Oduro,2024,1090,Unknown,Unknown,Netherlands,02-07-04,Goalkeeper,Goalkeeper,Right,190.0,30-06-28,SEG,https://img.a.transfermarkt.technology/portrait/header/704772-1704207303.jpg?lm=1,NL1,Alkmaar Zaanstreek,900000.0,900000.0,20,94,-8,5,2,1,3,9,8,3,2,3,3,10,2,2,5,10,12,11,10,14,9,6,13,2,10,3,12,10,9,11,14,12,12,15,11,6,5,10,7,7,11,11,16,8,9,5,13,10,13,13,9,9,14,11,13,4,11,12,9,12,13,20,1,1,1,1,1,1,1,1,1,1,1,1,1,82,5,20,23940001,4600,4600,2300,African_Caribbean,95,0,0,612.0,Unknown,2000014080,9111392.0,2.0,105,1549,68,2,1,1,16,5,0.3589573961365441,0.2406417112299465,0.338235294117647,0.0005822672114035,0.0,0.0,0.0042510627656914,0.0042510627656914,0.0505924720131114,0.1428571428571428,0.6279069767441858,0.0833333333333332,0,0,0,0,0,0,3,7,42,3000000,362500.0,3000000.0,0.0,300000.0,3000000.0,1,100000,2.3333333333333335,5.0
704773,Amourricho,Van Axel-Dongen,2024,610,Netherlands,Almere,Netherlands,29-09-04,Left Winger,Attack,Right,175.0,30-06-27,SEG,https://img.a.transfermarkt.technology/portrait/header/704773-1637833715.jpg?lm=1,NL1,AFC Ajax Amsterdam,600000.0,600000.0,20,108,-85,10,11,12,11,12,11,7,11,7,8,13,10,6,12,8,10,11,11,9,13,12,15,13,12,9,8,10,12,13,12,10,8,11,13,9,10,9,9,11,13,10,1,1,4,1,1,2,3,1,1,3,3,16,12,8,12,11,11,11,10,1,1,1,1,1,1,1,18,12,1,20,13,1,1,0,15,20,33000000,5098,5098,3504,African_Caribbean,107,0,0,11999.0,Unknown,2000041123,9111392.0,2.0,67,50,68,0,1,1,6,7,0.4248478433448002,0.3694117647058823,0.4264705882352941,0.0115777510194504,0.0,0.0,0.0027506876719179,0.0027506876719179,0.0505924720131114,0.1428571428571428,0.2790697674418605,0.0833333333333332,61,17,7,2,0,2880,11,107,166,500000,28571.428571428572,600000.0,100000.0,500000.0,500000.0,1,0,-0.16666666666666666,-0.16666666666666666
705991,Matisse,Samoise,2024,157,Unknown,Unknown,Belgium,21-11-01,Right Midfield,Midfield,Right,180.0,30-06-25,Unknown,https://img.a.transfermarkt.technology/portrait/header/705991-1706020225.jpg?lm=1,BE1,Koninklijke Atletiek Associatie Gent,3500000.0,4000000.0,23,115,140,11,10,11,10,12,8,9,11,11,10,12,10,11,12,12,12,14,14,14,14,12,16,12,10,12,9,16,14,12,12,9,8,15,11,14,9,12,15,10,6,15,2,3,1,3,1,1,3,1,1,2,3,14,12,2,12,12,15,11,16,1,1,1,12,1,17,1,1,12,20,1,15,15,1,70,7,20,9025000,6000,5750,2520,Northern_European,109,0,0,8500.0,Unknown,2000019626,9111392.0,2.0,105,1549,8,3,1,7,120,9,0.5111140513363324,0.2641711229946524,0.4411764705882353,0.0081990562056842,0.0,0.0,0.0172543135783946,0.0197549387346836,0.0505924720131114,0.1428571428571428,0.3953488372093026,0.2083333333333332,186,13,19,21,2,6297,5,21,41,2500000,230000.0,4000000.0,1000000.0,200000.0,4000000.0,1,200000,-0.2857142857142857,-0.2857142857142857
706138,Javi,Llabrés,2024,237,Spain,Binissalem,Spain,11-09-02,Left Winger,Attack,Right,174.0,30-06-26,InterStarDeporte,https://img.a.transfermarkt.technology/portrait/header/706138-1702393291.jpg?lm=1,ES1,Real Club Deportivo Mallorca S.A.D.,700000.0,800000.0,22,105,-75,9,13,13,10,14,6,8,10,7,7,11,8,10,14,7,10,4,10,9,11,14,5,13,10,10,8,9,10,14,11,9,8,9,13,10,6,13,12,16,6,15,1,4,1,3,3,1,4,4,3,4,2,11,11,5,12,12,11,13,11,1,1,1,1,1,1,1,14,11,1,20,18,16,1,0,16,20,6481247,4750,4750,500,Mediterranean_Hispanic,110,0,0,781.0,Unknown,2000197966,9111392.0,2.0,89,195,89,0,1,3,166,7,0.3788039163799948,0.0481283422459893,0.4485294117647059,0.0007454565293591,0.0,0.0,0.0032508127031757,0.0037509377344336,0.0505924720131114,0.1428571428571428,0.2558139534883721,0.1666666666666666,52,8,3,3,0,1946,0,0,0,600000,50000.0,800000.0,100000.0,,300000.0,2,300000,-0.14285714285714285,0.0
707242,Badredine,Bouanani,2024,417,France,Lille,Algeria,08-12-04,Right Winger,Attack,Left,177.0,30-06-27,Classico,https://img.a.transfermarkt.technology/portrait/header/707242-1674921221.jpg?lm=1,FR1,Olympique Gymnaste Club Nice CÃ´te d'Azur,5000000.0,6000000.0,20,90,-85,9,13,14,10,14,8,8,8,4,7,9,1,9,14,6,8,6,7,9,10,10,10,13,11,12,8,9,10,14,14,9,6,12,14,5,4,9,5,20,11,18,2,3,3,1,1,1,1,2,1,2,2,16,11,6,12,12,13,11,14,1,1,1,1,1,1,1,1,1,12,13,15,20,1,0,20,8,19799999,4503,4503,1256,North_African__Middle_Eastern,90,0,0,645.0,Unknown,2000100062,9111392.0,2.0,34,834,1,0,0,6,142,10,0.3461233130457793,0.1289839572192513,0.3014705882352941,0.0006141325811818,0.0,0.0,0.0247561890472618,0.0297574393598399,0.0505924720131114,0.1428571428571428,0.3255813953488373,0.0833333333333332,100,15,8,3,0,5126,1,3,30,5000000,606250.0,6000000.0,1000000.0,6000000.0,5000000.0,2,1000000,0.0,-0.16666666666666666
707844,Mandela,Keita,2024,130,Belgium,Leuven,Belgium,10-05-02,Defensive Midfield,Midfield,Right,180.0,30-06-29,World in Motion,https://img.a.transfermarkt.technology/portrait/header/707844-1706174326.jpg?lm=1,IT1,Parma Calcio 1913,13000000.0,13000000.0,22,114,-75,11,12,12,11,11,10,11,11,5,12,12,8,12,12,15,13,14,12,12,12,12,6,13,13,12,12,12,13,13,12,11,13,13,13,11,11,11,15,15,7,17,2,1,1,2,4,3,3,3,1,2,2,12,9,8,12,11,13,11,18,1,1,1,1,1,1,20,1,15,13,1,12,1,1,78,7,20,8879999,4750,4788,2520,African_Caribbean,112,0,0,1500.0,Unknown,18116036,8500000.0,2.0,7,826,8,3,1,1,155,4,0.3838317015083355,0.2641711229946524,0.463235294117647,0.0014397353436197,0.0,0.0,0.0647661915478869,0.0647661915478869,0.047195755437651,0.1428571428571428,0.3953488372093026,0.1666666666666666,119,1,7,15,0,4249,3,35,82,11000000,986363.6363636364,13000000.0,2000000.0,,3500000.0,2,3500000,-0.15384615384615385,0.0
708240,Eduard,Kozik,2024,48332,Ukraine,"Grudky, Volyn Oblast",Ukraine,19-04-03,Centre-Back,Defender,Right,185.0,30-06-25,ProStar,https://img.a.transfermarkt.technology/portrait/header/708240-1723628055.png?lm=1,UKR1,FK Kolos Kovalivka,600000.0,800000.0,21,105,-75,3,6,8,5,11,7,14,5,12,14,9,6,13,8,14,10,13,12,9,10,11,12,5,8,10,11,11,11,11,10,10,14,14,12,12,14,10,11,10,9,9,2,1,2,2,1,3,3,1,3,3,3,10,7,2,15,13,13,10,19,1,1,20,10,1,1,1,1,1,1,1,1,1,1,79,10,20,27393675,3750,3847,256,Northern_European,104,0,0,348.0,Unknown,2000029018,9111392.0,2.0,103,567,101,1,1,7,77,2,0.2593278645144218,0.0220320855614973,0.4044117647058823,0.0003273442531771,0.0,0.0,0.0027506876719179,0.0037509377344336,0.0505924720131114,0.1428571428571428,0.5116279069767438,0.125,33,0,2,4,0,2482,0,0,0,500000,50000.0,800000.0,200000.0,50000.0,800000.0,3,350000,-0.16666666666666666,-0.375
708241,Oleg,Ocheretko,2024,85465,Ukraine,"Makiivka, Donetsk Oblast",Ukraine,25-05-03,Attacking Midfield,Midfield,Left,181.0,30-06-25,ProStar,https://img.a.transfermarkt.technology/portrait/header/708241-1690179952.png?lm=1,UKR1,FK Karpaty Lviv,700000.0,700000.0,21,111,-75,9,12,13,12,10,11,7,12,5,6,11,10,7,13,8,10,9,9,11,11,10,13,12,6,11,10,7,13,14,13,11,9,12,14,13,8,10,6,9,9,9,3,1,2,1,4,2,2,1,1,1,3,13,12,8,15,9,11,12,6,1,1,1,1,1,1,1,1,1,1,12,15,20,15,75,20,10,13799940,4500,4549,1010,Northern_European,107,0,0,752.0,Unknown,71111030,9111392.0,2.0,103,898,101,3,0,7,75,0,0.3522095792537708,0.1026737967914438,0.4264705882352941,0.0007174536286448,0.0,0.0,0.0032508127031757,0.0032508127031757,0.0505924720131114,0.1428571428571428,0.418604651162791,0.125,83,8,5,7,1,2975,5,7,44,800000,55555.555555555555,800000.0,100000.0,500000.0,600000.0,3,200000,0.14285714285714285,0.3333333333333333
708242,Andriy,Buleza,2024,85465,Ukraine,"Zarichya, Zakarpattya Oblast",Ukraine,25-01-04,Left-Back,Defender,Left,177.0,30-06-27,ProStar,https://img.a.transfermarkt.technology/portrait/header/708242-1723703628.png?lm=1,UKR1,FK Karpaty Lviv,300000.0,400000.0,20,100,-75,7,13,11,11,11,6,7,12,12,10,11,6,11,9,10,9,8,9,10,10,11,14,8,6,10,9,14,17,14,11,9,6,11,15,15,9,12,9,12,9,10,3,3,2,1,2,2,2,2,3,3,1,7,13,7,11,11,12,9,16,1,20,1,10,15,1,1,1,1,1,1,1,1,1,69,20,5,12247579,3500,2925,265,Northern_European,95,0,0,348.0,Unknown,2000028526,9111392.0,2.0,103,1702,101,1,0,7,75,8,0.1373379200846785,0.0229946524064171,0.338235294117647,0.0003273442531771,0.0,0.0,0.0012503125781445,0.0017504376094023,0.0505924720131114,0.1428571428571428,0.3255813953488373,0.0833333333333332,40,1,4,5,0,2000,2,22,185,200000,25000.0,400000.0,100000.0,50000.0,200000.0,2,200000,-0.3333333333333333,-0.42857142857142855
708265,Bradley,Barcola,2024,583,France,Lyon,France,02-09-02,Left Winger,Attack,Right,182.0,30-06-28,Gestifute,https://img.a.transfermarkt.technology/portrait/header/708265-1653406915.jpg?lm=1,FR1,Paris Saint-Germain Football Club,65000000.0,65000000.0,22,110,-8,7,9,12,12,13,7,10,8,4,4,11,8,4,12,10,12,10,11,10,11,9,13,12,6,14,6,13,14,15,13,7,11,14,15,10,7,13,12,13,7,12,1,2,1,2,1,1,4,2,3,3,2,11,10,8,9,13,11,13,19,1,1,1,1,1,1,1,1,1,1,20,1,16,19,63,8,20,30465067,5896,5496,1700,African_Caribbean,102,0,0,7019.0,Unknown,49056282,45000000.0,1.0,34,884,36,0,1,1,154,7,0.4775072770574226,0.1764705882352941,0.3897058823529412,0.0067689770347245,0.0,0.0,0.3248312078019504,0.3248312078019504,0.2499791660879468,0.0,0.4418604651162785,0.1666666666666666,0,0,0,0,0,0,2,5,16,65000000,5375000.0,65000000.0,5000000.0,,18000000.0,1,17000000,0.3,1.1666666666666667
708678,Isaak,Touré,2024,410,France,Gonesse,France,28-03-03,Centre-Back,Defender,Left,206.0,30-06-25,ND SPORTS MANAGEMENT,https://img.a.transfermarkt.technology/portrait/header/708678-1645641626.jpg?lm=1,IT1,Udinese Calcio,7000000.0,8000000.0,21,107,-75,1,6,9,7,10,5,14,7,7,12,12,7,12,11,13,12,10,11,10,10,13,12,5,5,7,11,11,11,10,7,14,17,14,12,9,17,11,8,13,16,10,3,2,2,2,3,1,1,1,2,1,1,12,13,5,10,14,13,12,11,1,8,20,1,1,1,1,1,1,1,1,1,1,1,99,20,8,28832203,5345,5345,2747,African_Caribbean,104,0,0,3121.0,Unknown,2000006106,6750000.0,2.0,34,549,36,1,0,1,205,2,0.4575284466790156,0.2884491978609625,0.4044117647058823,0.0030050009318206,0.0,0.0,0.0347586896724181,0.0397599399849962,0.0374732631461985,0.1428571428571428,0.9999999999999996,0.125,88,4,1,17,3,1570,2,8,130,8000000,645833.3333333334,8000000.0,1000000.0,1000000.0,8000000.0,5,4450000,0.14285714285714285,0.0
709187,Nico,Williams,2024,621,Spain,Pamplona,Spain,12-07-02,Left Winger,Attack,Left,181.0,30-06-27,Unknown,https://img.a.transfermarkt.technology/portrait/header/709187-1709676169.png?lm=1,ES1,Athletic Club Bilbao,70000000.0,70000000.0,22,139,-9,7,13,14,13,13,8,12,10,8,9,13,14,9,14,10,13,13,13,12,13,13,15,13,11,15,12,13,13,15,15,11,10,14,14,13,14,12,6,13,13,12,1,3,3,3,2,3,3,1,1,4,3,17,13,6,15,13,13,10,11,1,1,1,1,1,1,1,17,1,19,17,1,20,14,0,20,10,50000001,6950,6950,6200,African_Caribbean,138,0,0,21264.0,Unknown,67276230,9111392.0,2.0,89,1115,89,0,0,1,33,7,0.6698862132839376,0.6577540106951871,0.6544117647058822,0.0205241949890257,0.0,0.0,0.3498374593648412,0.3498374593648412,0.0505924720131114,0.1428571428571428,0.418604651162791,0.1666666666666666,180,33,44,17,0,2871,13,24,21,70000000,4600000.0,70000000.0,0.0,1500000.0,30000000.0,1,3500000,0.0,0.4
709726,Hugo,Ekitiké,2024,24,France,Reims,France,20-06-02,Centre-Forward,Attack,Right,189.0,30-06-29,Unknown,https://img.a.transfermarkt.technology/portrait/header/709726-1724772213.jpg?lm=1,L1,Eintracht Frankfurt FuÃŸball AG,30000000.0,30000000.0,22,124,155,10,11,12,13,12,9,13,11,9,6,12,11,6,12,12,12,13,12,11,11,12,12,12,7,12,6,11,12,14,12,12,14,13,14,12,13,10,6,11,8,12,3,3,3,1,1,2,1,2,3,1,2,11,13,8,9,10,12,10,14,1,1,1,1,1,1,1,11,1,13,14,10,18,20,70,12,20,14080000,6200,6200,4000,African_Caribbean,122,0,0,9847.0,Paris Saint-Germain,49062667,22500000.0,2.0,34,1216,36,0,1,1,63,3,0.5706536120666843,0.4224598930481283,0.536764705882353,0.0094997426629986,0.0,0.0,0.1497874468617154,0.1497874468617154,0.1249756937692713,0.1428571428571428,0.6046511627906974,0.1666666666666666,135,45,19,10,2,3581,4,16,69,40000000,3046153.846153846,40000000.0,5000000.0,600000.0,25000000.0,4,10100000,1.0,1.6666666666666667
709969,Ilias,Akhomach,2024,1050,Spain,Hostalets de Pierola,Morocco,16-04-04,Right Winger,Attack,Left,175.0,30-06-26,Unknown,https://img.a.transfermarkt.technology/portrait/header/709969-1636472170.jpg?lm=1,ES1,Villarreal Club de FÃºtbol S.A.D.,15000000.0,15000000.0,20,115,-85,10,10,15,11,14,10,6,11,6,5,12,10,6,16,11,9,13,11,9,12,12,14,17,8,13,5,11,7,14,15,12,7,14,13,11,9,15,10,15,5,15,1,3,1,3,1,3,3,1,1,1,3,12,14,10,14,15,14,11,12,1,1,1,1,1,1,1,12,18,17,14,19,20,14,0,20,8,12000000,5750,5750,2750,North_African__Middle_Eastern,110,0,0,1189.0,Unknown,2000056415,9111392.0,2.0,89,637,67,0,0,6,216,10,0.5111140513363324,0.2887700534759358,0.4485294117647059,0.0011394283738908,0.0,0.0,0.0747686921730432,0.0747686921730432,0.0505924720131114,0.1428571428571428,0.2790697674418605,0.0833333333333332,107,10,5,12,2,3249,4,33,266,15000000,1490000.0,15000000.0,0.0,3000000.0,15000000.0,2,0,0.0,4.0
711337,Unknown,Evanilson,2024,989,Brazil,Fortaleza,Brazil,06-10-99,Centre-Forward,Attack,Right,183.0,Unknown,Brazil Soccer,https://img.a.transfermarkt.technology/portrait/header/711337-1606396779.png?lm=1,GB1,Association Football Club Bournemouth,35000000.0,35000000.0,25,146,162,6,8,12,16,14,8,12,10,7,8,13,13,9,14,15,13,14,15,12,14,13,14,14,10,15,5,11,13,14,13,15,13,14,15,14,15,13,12,15,5,12,2,2,2,1,2,1,3,2,4,2,4,13,13,6,12,14,13,10,13,1,1,1,1,1,1,1,12,1,1,15,1,1,20,80,14,20,27039998,7294,6894,6294,Mediterranean_Hispanic,145,0,0,31749.0,Unknown,19342183,8800000.0,1.0,10,502,11,0,1,3,22,3,0.6624768457263827,0.667807486631016,0.7058823529411764,0.0306486920231323,0.0,0.0,0.1747936984246061,0.1747936984246061,0.0488624684019,0.0,0.4651162790697669,0.2916666666666665,211,84,23,24,1,5887,9,39,88,35000000,2184375.0,35000000.0,500000.0,,7500000.0,2,3500000,0.0,0.4
711517,Kevin,Paredes,2024,82,United States,"South Riding, Virginia",United States,07-05-03,Left Midfield,Midfield,Left,175.0,30-06-26,Shot Sports,https://img.a.transfermarkt.technology/portrait/header/711517-1657203115.jpg?lm=1,L1,Verein fÃ¼r LeibesÃ¼bungen Wolfsburg,7500000.0,7500000.0,21,115,-75,7,11,13,10,11,7,5,8,6,10,11,7,12,12,13,12,13,11,9,11,10,13,13,5,13,10,12,12,15,12,12,5,14,14,13,8,12,11,15,9,17,3,2,3,1,2,1,2,3,3,1,2,10,12,6,12,10,13,12,12,1,12,1,10,15,10,1,15,8,12,20,10,15,8,61,20,9,38849998,5745,5395,4245,Mixed_Race,109,0,0,19177.0,Unknown,72056310,6680000.0,1.0,104,1402,102,3,0,4,213,6,0.4641439534268324,0.448663101604278,0.4411764705882353,0.0185089517548645,0.0,0.0,0.0372593148287071,0.0372593148287071,0.0370843634545404,0.0,0.2790697674418605,0.125,100,7,8,13,0,1738,8,47,188,7500000,620833.3333333334,7500000.0,0.0,4000000.0,5000000.0,1,1000000,0.0,0.5
711625,José Ángel,Carmona,2024,368,Spain,El Viso del Alcor,Spain,29-01-02,Right-Back,Defender,Right,184.0,30-06-25,380amk,https://img.a.transfermarkt.technology/portrait/header/711625-1696862897.jpg?lm=1,ES1,Sevilla FÃºtbol Club S.A.D.,3500000.0,5000000.0,22,126,-85,8,9,10,9,11,6,9,9,12,14,9,6,13,12,14,13,15,13,14,11,13,17,9,12,12,13,14,14,14,13,13,10,12,13,14,12,13,9,14,6,13,2,1,1,2,2,4,3,2,1,2,3,18,10,4,12,13,11,11,13,1,1,19,20,1,14,1,1,1,1,1,1,1,1,74,8,20,42749998,6300,6300,3812,Mediterranean_Hispanic,124,0,0,8908.0,Unknown,2000053930,9111392.0,2.0,89,454,89,1,1,3,181,11,0.5838846255623181,0.4023529411764705,0.5514705882352942,0.0085930280502159,0.0,0.0,0.0172543135783946,0.0247561890472618,0.0505924720131114,0.1428571428571428,0.4883720930232553,0.1666666666666666,116,4,3,32,0,3074,2,11,62,10000000,761538.4615384615,10000000.0,1000000.0,,5000000.0,4,7800000,1.8571428571428572,1.8571428571428572
711969,Lorenz,Assignon,2024,273,France,Grasse,France,22-06-00,Right-Back,Defender,Right,181.0,30-06-28,TTMA,https://img.a.transfermarkt.technology/portrait/header/711969-1666699250.jpg?lm=1,FR1,Stade Rennais Football Club,10000000.0,10000000.0,24,114,139,7,12,11,5,12,6,10,9,8,12,13,4,11,12,8,11,13,12,11,12,11,11,7,12,12,12,13,11,14,13,12,11,13,14,13,11,12,13,10,7,10,1,3,3,3,3,1,1,3,1,3,1,7,11,2,11,12,13,11,10,1,1,14,20,1,12,1,1,1,10,1,1,10,1,76,10,20,3460000,5700,5700,2764,African_Caribbean,113,0,0,5195.0,Unknown,49053443,9111392.0,2.0,34,556,36,1,1,1,195,11,0.5044985445885155,0.2902673796791443,0.4705882352941176,0.0050076911415237,0.0,0.0,0.0497624406101525,0.0497624406101525,0.0505924720131114,0.1428571428571428,0.418604651162791,0.25,143,10,15,28,0,3115,4,20,70,9000000,870000.0,10000000.0,1000000.0,,300000.0,3,2500000,-0.1,-0.1
711976,Andy,Diouf,2024,826,France,Neuilly-sur-Seine,France,17-05-03,Central Midfield,Midfield,Left,187.0,30-06-28,Gol International,https://img.a.transfermarkt.technology/portrait/header/711976-1637070021.jpg?lm=1,FR1,Racing Club de Lens,9000000.0,13000000.0,21,105,-8,6,7,12,6,12,7,10,12,7,8,12,12,12,13,14,9,13,13,13,13,9,14,13,6,12,10,13,14,12,12,15,14,15,12,14,14,9,6,9,5,10,3,1,1,2,3,3,2,3,1,3,3,11,14,8,11,8,13,12,14,1,1,1,1,1,1,20,1,20,1,1,10,1,1,82,20,7,34040001,5240,5245,3162,African_Caribbean,104,0,0,2465.0,FC Basel 1893,49062699,9750000.0,2.0,34,1029,36,3,0,1,158,1,0.4442974331833819,0.3328342245989304,0.4044117647058823,0.0023715560053186,0.0,0.0,0.0447611902975743,0.0647661915478869,0.0541403927886885,0.1428571428571428,0.5581395348837206,0.125,132,6,11,12,0,2060,0,0,0,10000000,975000.0,13000000.0,3000000.0,500000.0,10000000.0,2,6700000,0.1111111111111111,0.0
711996,Warmed,Omari,2024,1041,Mayotte,Bandraboua,Comoros,23-04-00,Centre-Back,Defender,Right,188.0,30-06-25,Unknown,https://img.a.transfermarkt.technology/portrait/header/711996-1632760467.jpg?lm=1,FR1,Olympique Lyonnais,8000000.0,10000000.0,24,119,144,9,10,7,8,12,10,12,5,4,13,14,6,11,13,9,12,12,14,12,14,13,9,13,9,11,13,12,12,13,13,12,11,11,12,14,13,12,5,11,8,13,2,1,3,2,1,3,2,1,1,2,3,11,9,1,9,14,10,12,15,1,1,20,1,1,1,15,1,1,1,1,1,1,1,73,10,20,5619999,5950,5950,3000,African_Caribbean,119,0,0,7040.0,Unknown,49037825,9111392.0,2.0,62,134,21,1,1,1,143,2,0.5375760783275999,0.3155080213903743,0.5147058823529411,0.0067892549973107,0.0,0.0,0.0397599399849962,0.0497624406101525,0.0505924720131114,0.1428571428571428,0.581395348837209,0.25,124,2,2,17,2,2976,2,24,139,6000000,527272.7272727273,10000000.0,2000000.0,,200000.0,2,2800000,-0.25,-0.25
711999,Lesley,Ugochukwu,2024,180,France,Rennes,France,26-03-04,Defensive Midfield,Midfield,Right,190.0,31-05-25,Wasserman,https://img.a.transfermarkt.technology/portrait/header/711999-1666698684.jpg?lm=1,GB1,Southampton Football Club,25000000.0,25000000.0,20,105,-8,10,9,10,9,12,7,12,11,5,12,12,8,11,10,11,10,12,10,11,11,11,7,5,6,11,12,11,12,11,9,12,12,11,12,13,15,10,5,8,8,12,2,3,1,1,1,2,2,1,3,3,1,14,11,1,12,9,12,11,13,1,1,1,1,1,1,15,1,20,1,1,1,1,1,0,10,20,44417441,5249,5249,1999,African_Caribbean,100,0,0,2465.0,Unknown,2000006186,27000000.0,1.0,34,1218,36,3,1,1,186,4,0.4448266737232071,0.2084491978609625,0.3749999999999999,0.0023715560053186,0.0,0.0,0.1247811952988247,0.1247811952988247,0.1499763882330064,0.0,0.6279069767441858,0.0833333333333332,0,0,0,0,0,0,3,37,134,25000000,2245454.5454545454,25000000.0,0.0,4000000.0,25000000.0,3,17200000,0.0,0.0
712107,Unknown,Luiz Júnior,2024,1050,Brazil,Picos,Brazil,14-01-01,Goalkeeper,Goalkeeper,Left,192.0,30-06-30,Unknown,https://img.a.transfermarkt.technology/portrait/header/712107-1618227160.jpg?lm=1,ES1,Villarreal Club de FÃºtbol S.A.D.,6000000.0,6000000.0,23,124,152,3,2,1,1,10,6,3,2,1,3,12,1,2,10,12,13,14,8,15,10,11,13,2,7,2,8,12,11,12,12,14,16,13,13,11,14,14,14,14,14,14,15,10,10,12,13,12,12,16,18,8,12,13,13,1,13,12,10,9,20,20,1,1,1,1,1,1,1,1,1,1,1,1,1,97,20,8,13584001,6181,6181,4181,African_Caribbean,121,0,0,3499.0,Unknown,19362984,12000000.0,1.0,10,1143,11,2,0,1,216,5,0.5681397195025139,0.4418181818181818,0.5294117647058822,0.0033700042583721,0.0,0.0,0.0297574393598399,0.0297574393598399,0.0666407400205561,0.0,0.6744186046511627,0.2083333333333332,0,0,0,0,0,0,0,0,0,5000000,445454.54545454547,6000000.0,1000000.0,,3000000.0,2,1300000,-0.16666666666666666,0.0
712857,Mark,Mampassi,2024,601,Ukraine,Donetsk,Russia,12-03-03,Centre-Back,Defender,Right,185.0,30-06-25,Unknown,https://img.a.transfermarkt.technology/portrait/header/712857-1658227391.png?lm=1,BE1,Koninklijke Voetbalclub Kortrijk,800000.0,1500000.0,21,107,-75,7,6,9,7,11,6,10,8,10,12,10,6,12,11,11,10,12,10,10,11,10,13,9,8,10,12,10,14,13,14,13,12,14,12,14,14,7,12,9,9,7,1,3,1,3,3,3,1,3,2,1,2,4,18,11,4,11,9,9,13,1,1,20,1,1,1,1,1,1,1,1,1,1,1,86,12,20,17454238,4993,3946,2088,Mixed_Race,107,0,0,10337.0,Unknown,2000029480,3000000.0,1.0,103,422,81,1,1,4,124,2,0.2724265678750992,0.2179679144385026,0.4264705882352941,0.0099728951233431,0.0,0.0,0.0037509377344336,0.0072518129532383,0.0166393510930859,0.0,0.5116279069767438,0.125,83,1,3,15,1,3645,2,14,87,700000,59090.90909090909,1500000.0,300000.0,1000000.0,800000.0,4,850000,-0.125,-0.125
713787,Jhoanner,Chávez,2024,826,Ecuador,Francisco de Orellana,Ecuador,25-04-02,Left-Back,Defender,Left,182.0,30-06-28,PROSPORT Management,https://img.a.transfermarkt.technology/portrait/header/713787-1656676313.JPG?lm=1,FR1,Racing Club de Lens,4000000.0,4000000.0,22,113,-75,9,13,12,8,11,8,9,8,13,12,13,7,14,12,12,11,10,13,10,9,9,13,12,7,11,12,6,11,13,14,10,8,15,14,15,9,13,11,11,6,14,1,3,2,3,3,2,3,2,4,1,1,20,10,8,11,10,12,14,17,1,20,12,10,17,8,1,10,1,1,1,1,1,1,72,20,8,1324863,5645,5645,2147,African_Caribbean,104,0,0,2415.0,Unknown,86078359,3875000.0,2.0,30,506,31,1,0,1,158,8,0.4972214871659169,0.2242780748663101,0.4044117647058823,0.0023232751420181,0.0,0.0,0.0197549387346836,0.0197549387346836,0.0215005972388121,0.1428571428571428,0.4418604651162785,0.1666666666666666,146,11,6,27,1,8362,4,18,55,4000000,325000.0,4000000.0,200000.0,100000.0,2000000.0,4,700000,1.0,1.2222222222222223
715628,Damián,Rodríguez,2024,940,Spain,Ponteareas,Spain,17-03-03,Defensive Midfield,Midfield,Right,180.0,30-06-28,Unknown,https://img.a.transfermarkt.technology/portrait/header/default.jpg?lm=1,ES1,Real Club Celta de Vigo S. A. D.,500000.0,500000.0,21,128,140,11,11,9,8,15,9,8,10,11,13,14,5,14,15,7,15,11,12,14,13,15,12,13,13,11,13,12,11,10,16,11,7,9,10,17,7,13,10,11,10,12,3,1,1,2,2,2,3,2,1,1,1,11,11,5,13,11,11,13,12,1,1,1,1,1,1,20,1,17,1,1,1,1,1,61,8,20,2155938,6362,6362,2976,Mediterranean_Hispanic,125,2,0,14283.0,Unknown,51072523,9111392.0,2.0,89,1163,89,3,1,3,165,4,0.592087853929611,0.3129411764705882,0.5588235294117647,0.0137832208550154,0.0131578947368421,0.0,0.0022505626406601,0.0022505626406601,0.0505924720131114,0.1428571428571428,0.3953488372093026,0.125,74,3,6,16,0,1261,0,0,0,3000000,414285.71428571426,3000000.0,0.0,,250000.0,1,2500000,5.0,11.0
716276,Yerson,Mosquera,2024,543,Colombia,ApartadÃ³,Colombia,02-05-01,Centre-Back,Defender,Right,188.0,30-06-26,Goal Management SAS,https://img.a.transfermarkt.technology/portrait/header/716276-1682874906.jpg?lm=1,GB1,Wolverhampton Wanderers Football Club,6000000.0,6000000.0,23,115,-8,4,8,7,7,12,4,13,7,6,12,11,6,12,12,10,13,12,11,10,6,11,12,5,6,9,12,11,11,12,12,10,14,12,14,13,14,15,11,10,8,18,3,3,2,3,2,2,4,1,1,1,2,10,11,7,11,11,12,14,18,1,1,20,1,1,1,10,1,8,1,1,1,1,1,84,10,20,36746182,5750,5750,4350,African_Caribbean,108,0,0,11599.0,Unknown,76065062,5200000.0,1.0,20,78,20,1,1,1,222,2,0.5111140513363324,0.4598930481283422,0.4338235294117646,0.0111915041130467,0.0,0.0,0.0297574393598399,0.0297574393598399,0.0288619128309119,0.0,0.581395348837209,0.2083333333333332,0,0,0,0,0,0,4,65,254,8000000,866666.6666666666,8000000.0,0.0,,3000000.0,4,5800000,0.3333333333333333,1.2857142857142858
717411,Yegor,Yarmolyuk,2024,1148,Ukraine,"Verkhnyodniprovsk, Dnipropetrovsk Oblast",Ukraine,01-03-04,Attacking Midfield,Midfield,Right,180.0,30-06-28,ProStar,https://img.a.transfermarkt.technology/portrait/header/717411-1639148047.png?lm=1,GB1,Brentford Football Club,10000000.0,10000000.0,20,115,-8,8,11,12,13,11,7,11,13,6,11,13,6,12,12,11,15,6,8,11,13,12,15,10,6,9,13,13,18,12,12,12,8,15,12,13,7,13,7,10,5,17,2,2,3,1,2,2,1,3,1,3,3,12,9,7,11,12,15,12,12,1,1,1,1,1,1,1,1,20,1,1,20,1,1,72,12,20,60872463,5750,4117,3602,Northern_European,112,0,0,3480.0,Unknown,71110357,1500000.0,1.0,103,1575,101,3,1,7,43,0,0.2950516009526329,0.3798930481283422,0.463235294117647,0.0033516575303179,0.0,0.0,0.0497624406101525,0.0497624406101525,0.0083057862718408,0.0,0.3953488372093026,0.0833333333333332,75,1,0,8,0,2391,2,0,29,12000000,1081818.1818181819,12000000.0,0.0,400000.0,12000000.0,2,600000,0.2,3.8
718303,Ernest,Poku,2024,1090,Germany,Hamburg,Netherlands,28-01-04,Centre-Forward,Attack,Right,176.0,30-06-26,Rondo Football,https://img.a.transfermarkt.technology/portrait/header/718303-1723819840.jpg?lm=1,NL1,Alkmaar Zaanstreek,1300000.0,1300000.0,20,109,-85,7,9,11,10,11,7,5,7,4,4,9,11,5,11,6,13,9,10,8,8,9,12,13,3,12,5,7,8,17,13,9,9,12,17,7,7,8,5,10,5,12,3,2,2,3,2,3,2,2,2,1,2,13,8,2,7,7,6,14,18,1,1,1,1,1,1,1,12,1,12,18,10,20,18,0,16,20,43500001,5299,5299,3749,African_Caribbean,99,0,0,1437.0,Unknown,2000014559,9111392.0,2.0,38,594,68,0,1,1,16,3,0.4514421804710241,0.395614973262032,0.3676470588235294,0.0013789014558611,0.0,0.0,0.0062515628907226,0.0062515628907226,0.0505924720131114,0.1428571428571428,0.3023255813953489,0.0833333333333332,164,47,24,7,0,6808,1,4,23,1500000,133333.33333333334,1500000.0,0.0,300000.0,1500000.0,1,300000,0.15384615384615385,0.15384615384615385
719442,David,Pereira Da Costa,2024,826,Portugal,Almada,Portugal,05-01-01,Attacking Midfield,Midfield,Right,168.0,30-06-26,ROGON,https://img.a.transfermarkt.technology/portrait/header/719442-1630606082.jpg?lm=1,FR1,Racing Club de Lens,8000000.0,10000000.0,23,125,144,12,13,14,11,14,12,7,12,12,8,14,10,8,15,10,12,12,12,11,14,13,14,13,7,12,8,15,13,14,14,11,5,14,13,12,7,12,8,13,7,12,3,1,3,2,2,3,3,3,1,4,1,12,13,4,11,11,14,10,11,1,1,1,1,1,1,1,12,10,1,14,20,1,1,64,10,20,8877749,6246,6246,3496,African_Caribbean,125,0,0,10923.0,Unknown,49054412,9111392.0,2.0,76,46,79,3,1,1,158,0,0.5767398782746759,0.3685561497326203,0.5588235294117647,0.0105387468412245,0.0,0.0,0.0397599399849962,0.0497624406101525,0.0505924720131114,0.1428571428571428,0.1162790697674416,0.2083333333333332,146,11,17,8,1,2948,4,10,30,7000000,456666.6666666667,10000000.0,2000000.0,,2000000.0,0,0,-0.125,0.16666666666666666
719672,Adedire,Mebude,2024,968,England,London,Scotland,28-05-04,Right Winger,Attack,Right,189.0,30-06-27,Roc Nation Sports,https://img.a.transfermarkt.technology/portrait/header/719672-1662465775.jpg?lm=1,BE1,Koninklijke Voetbal Club Westerlo,1500000.0,1500000.0,20,97,-75,7,12,13,9,13,6,8,7,4,6,13,4,8,8,11,7,9,9,8,9,10,5,12,9,13,7,11,9,16,13,4,7,14,15,4,3,9,5,12,6,10,1,3,2,2,1,1,1,1,3,2,1,13,11,6,11,13,10,10,13,1,1,1,1,1,1,1,1,1,1,1,1,20,16,0,14,20,36954967,4851,4851,3002,African_Caribbean,90,0,0,3480.0,Unknown,61094109,1750000.0,1.0,32,858,83,0,1,1,123,10,0.3921672400105848,0.3157219251336898,0.3014705882352941,0.0033516575303179,0.0,0.0,0.0072518129532383,0.0072518129532383,0.0096947137420483,0.0,0.6046511627906974,0.0833333333333332,97,32,36,14,0,2366,2,5,23,1500000,170000.0,1500000.0,150000.0,,1500000.0,2,1000000,2.0,2.0
720038,Pablo,Torre,2024,131,Spain,Soto de la Marina,Spain,03-04-03,Attacking Midfield,Midfield,Right,173.0,30-06-26,AC Talent,https://img.a.transfermarkt.technology/portrait/header/720038-1724406086.jpg?lm=1,ES1,Futbol Club Barcelona,3000000.0,3000000.0,21,125,-85,14,11,13,11,15,14,6,11,6,5,16,14,9,16,12,10,14,11,10,16,14,14,16,11,12,5,11,10,12,15,12,7,13,11,10,9,14,6,15,5,8,3,2,3,3,2,4,3,3,2,1,1,13,12,6,20,14,16,15,16,1,1,1,1,1,1,8,12,18,8,14,20,10,10,57,12,20,55160000,6250,6250,4251,Mediterranean_Hispanic,122,0,0,3989.0,Unknown,2000040347,5000000.0,1.0,89,1400,89,3,1,3,96,0,0.5772691188145012,0.4493048128342246,0.536764705882353,0.0038431567187166,0.0,0.0,0.0147536884221055,0.0147536884221055,0.0277507708547459,0.0,0.2325581395348837,0.125,117,20,23,16,0,2443,5,2,31,7500000,480000.0,7500000.0,500000.0,3000000.0,3000000.0,3,2500000,1.5,2.0
720162,Justin,Diehl,2024,79,Germany,KÃ¶ln,Germany,27-11-04,Left Winger,Attack,Right,174.0,30-06-29,Unknown,https://img.a.transfermarkt.technology/portrait/header/720162-1723707320.jpg?lm=1,L1,Verein fÃ¼r Bewegungsspiele Stuttgart 1893,2500000.0,2500000.0,20,89,-75,9,13,12,12,12,8,9,7,4,5,8,3,5,12,6,9,6,11,11,12,12,13,12,5,10,5,7,10,13,12,6,11,9,12,8,11,8,11,3,5,8,2,3,3,4,3,1,1,1,1,2,1,7,13,7,13,13,13,13,13,1,1,1,1,1,1,1,13,1,13,18,17,20,12,0,13,20,7879999,4366,4366,1937,African_Caribbean,92,0,0,689.0,Unknown,2000116586,9111392.0,2.0,38,777,40,0,1,1,211,7,0.327996824556761,0.2018181818181818,0.3161764705882353,0.0006566197408862,0.0,0.0,0.0122530632658164,0.0122530632658164,0.0505924720131114,0.1428571428571428,0.2558139534883721,0.0833333333333332,83,44,15,10,0,3664,7,32,52,3500000,500000.0,3500000.0,0.0,500000.0,3500000.0,2,1500000,0.4,2.5
720791,Olivier,Aertssen,2024,1269,Netherlands,Veldhoven,Netherlands,07-08-04,Centre-Back,Defender,Right,185.0,30-06-27,Wasserman,https://img.a.transfermarkt.technology/portrait/header/720791-1724751524.jpg?lm=1,NL1,Prins Hendrik Ende Desespereert Nimmer Combinatie Zwolle,600000.0,800000.0,20,95,-8,5,6,11,5,10,7,11,6,6,9,13,7,10,10,10,10,12,11,11,12,11,12,12,8,11,12,12,13,11,11,9,12,11,10,13,12,10,6,10,8,7,1,2,4,3,3,1,2,2,3,1,3,20,12,8,10,12,12,12,10,1,1,20,1,1,1,16,1,12,1,1,1,1,1,0,16,20,27630000,4595,4595,2495,Northern_European,96,0,0,612.0,Unknown,2000020333,82000.0,2.0,67,1568,68,1,1,7,156,2,0.3582958454617624,0.2614973262032085,0.3455882352941176,0.0005822672114035,0.0,0.0,0.0027506876719179,0.0037509377344336,0.0004277896608239,0.1428571428571428,0.5116279069767438,0.0833333333333332,0,0,0,0,0,0,2,15,127,600000,41666.666666666664,800000.0,200000.0,800000.0,600000.0,1,0,0.0,0.0
720799,Julian,Rijkhoff,2024,610,Netherlands,Purmerend,Netherlands,25-01-05,Centre-Forward,Attack,Right,183.0,30-06-27,ESA,https://img.a.transfermarkt.technology/portrait/header/720799-1699370695.jpg?lm=1,NL1,AFC Ajax Amsterdam,1500000.0,1500000.0,19,102,-85,3,8,11,12,12,8,11,11,5,7,11,12,6,13,11,11,7,12,6,10,14,15,13,7,12,9,6,10,11,12,10,11,14,13,13,10,20,15,8,3,8,2,3,1,1,3,2,2,3,2,2,1,19,9,5,13,11,11,12,16,1,1,1,1,1,1,1,1,1,1,1,14,1,20,0,15,20,39300000,5100,4771,3270,Northern_European,106,0,0,2568.0,Unknown,37088406,765000.0,2.0,67,1194,68,0,1,7,6,3,0.3815824292140778,0.3443850267379679,0.4191176470588235,0.0024710145837175,0.0,0.0,0.0072518129532383,0.0072518129532383,0.0042223395094308,0.1428571428571428,0.4651162790697669,0.0416666666666666,130,89,19,8,0,5994,1,9,41,1000000,0.0,1500000.0,500000.0,,,0,0,-0.3333333333333333,0.0
721666,Zalán,Vancsa,2024,157,Hungary,Budapest,Hungary,27-10-04,Left Winger,Attack,Right,175.0,30-06-25,CAA Stellar,https://img.a.transfermarkt.technology/portrait/header/721666-1713870696.png?lm=1,BE1,Koninklijke Atletiek Associatie Gent,1200000.0,1200000.0,20,91,-75,10,15,13,12,12,10,6,10,9,4,8,5,4,12,13,13,8,9,8,12,10,12,10,9,11,5,9,8,13,13,11,6,11,13,7,5,20,8,11,6,13,3,2,2,1,1,1,2,2,1,3,1,20,12,5,11,11,12,2,12,1,1,1,1,1,1,1,1,1,1,17,1,15,20,70,10,20,4556250,4400,5203,1755,Northern_European,82,1,0,1500.0,Unknown,2000098662,3000000.0,1.0,45,273,47,0,1,7,120,7,0.4387404075152157,0.1823529411764705,0.2426470588235293,0.0014397353436197,0.006578947368421,0.0,0.0057514378594648,0.0057514378594648,0.0166393510930859,0.0,0.2790697674418605,0.0833333333333332,94,21,10,10,0,3892,1,11,47,1000000,94444.44444444444,1200000.0,300000.0,850000.0,1000000.0,2,500000,-0.16666666666666666,0.1111111111111111
724104,Fabio,Chiarodia,2024,18,Germany,Oldenburg,Italy,05-06-05,Centre-Back,Defender,Left,186.0,30-06-27,Sports360 GmbH,https://img.a.transfermarkt.technology/portrait/header/724104-1722945535.jpg?lm=1,L1,Borussia Verein fÃ¼r LeibesÃ¼bungen 1900 MÃ¶nchengladbach,2000000.0,2000000.0,19,87,-75,6,3,8,7,12,9,11,9,1,10,13,6,16,16,14,11,10,10,11,11,10,8,5,7,9,16,9,11,11,9,10,13,5,8,8,6,19,5,7,5,14,2,1,1,2,1,2,3,3,1,2,2,19,11,8,9,8,13,6,12,1,8,20,1,1,1,12,1,1,1,1,1,1,1,0,20,5,7879999,4350,4350,2272,Mediterranean_Hispanic,85,0,0,646.0,Unknown,2000116422,2000000.0,1.0,38,1076,54,1,0,3,42,2,0.3258798623974597,0.2376470588235294,0.2647058823529412,0.0006150981984478,0.0,0.0,0.0097524381095273,0.0097524381095273,0.0110836412122558,0.0,0.5348837209302322,0.0416666666666666,65,2,2,5,0,2845,2,4,15,2000000,214285.7142857143,2000000.0,0.0,2000000.0,,1,1000000,0.0,0.0
724969,Luka,Gagnidze,2024,121,Georgia,Kutaisi,Georgia,28-02-03,Central Midfield,Midfield,Right,175.0,30-06-26,Bene-Sport,https://img.a.transfermarkt.technology/portrait/header/724969-1684239232.png?lm=1,RU1,FK Dinamo Moskva,1800000.0,2000000.0,21,107,-75,12,10,12,10,13,12,6,11,3,6,13,6,10,14,15,13,7,8,12,13,10,3,16,12,11,12,10,13,13,13,10,8,12,11,11,7,14,13,10,8,13,1,2,2,1,2,3,2,1,2,1,3,7,13,7,10,10,10,14,15,1,1,1,1,1,1,18,1,20,8,1,11,9,1,68,12,20,17454238,5150,5400,2660,Northern_European,103,0,0,2400.0,Unknown,2000063176,1500000.0,1.0,37,772,39,3,1,7,74,1,0.4648055041016142,0.2791443850267379,0.3970588235294117,0.002308790883028,0.0,0.0,0.0087521880470117,0.0097524381095273,0.0083057862718408,0.0,0.2790697674418605,0.125,85,4,7,11,0,3145,3,18,55,1500000,135000.0,2000000.0,300000.0,800000.0,2000000.0,3,1000000,-0.16666666666666666,-0.25
726034,Nazar,Voloshyn,2024,338,Ukraine,"Kremenchuk, Poltava Oblast",Ukraine,17-06-03,Left Winger,Attack,Right,175.0,31-12-25,FAMK Group ,https://img.a.transfermarkt.technology/portrait/header/726034-1726135429.png?lm=1,UKR1,Futbolniy Klub Dynamo Kyiv,4000000.0,4000000.0,21,100,-8,13,12,13,9,13,10,5,9,8,5,11,7,5,13,11,8,6,9,6,13,6,3,15,3,12,7,7,12,15,14,9,8,12,14,10,9,12,5,12,5,5,3,4,2,3,1,2,2,2,2,1,2,13,15,15,13,11,7,10,11,1,1,1,4,1,6,1,12,1,18,17,6,20,10,66,8,20,22630493,4250,4275,1005,Northern_European,96,0,0,552.0,Kryvbas Kryvyi Rih,2000012061,9111392.0,2.0,103,759,101,0,1,7,97,7,0.3159566022757343,0.102139037433155,0.3455882352941176,0.000524330175443,0.0,0.0,0.0197549387346836,0.0197549387346836,0.0505924720131114,0.1428571428571428,0.2790697674418605,0.125,91,19,18,11,0,2740,2,4,12,4000000,433333.3333333333,4000000.0,0.0,,4000000.0,2,400000,0.0,1.6666666666666667
726526,Stefan,Mitrovi?,2024,2727,Yugoslavia (Republic),KruÅ¡evac,Serbia,15-08-02,Left Winger,Attack,Left,182.0,30-06-25,Unknown,https://img.a.transfermarkt.technology/portrait/header/726526-1694785618.jpg?lm=1,BE1,Oud-Heverlee Leuven,1800000.0,3500000.0,22,128,136,6,8,9,6,10,6,15,7,11,14,9,9,14,12,14,14,17,14,14,8,11,14,8,10,9,14,15,15,10,10,15,15,15,10,14,16,14,14,12,7,8,1,2,3,2,2,3,2,3,1,1,1,15,17,10,7,13,14,8,10,1,13,20,1,10,1,1,1,1,1,1,1,1,1,84,20,10,1604613,6400,6900,5650,Northern_European,127,32,0,8793.0,Unknown,62031623,900000.0,2.0,110,763,85,0,0,7,146,7,0.6632707065361206,0.5989304812834224,0.5735294117647058,0.0084819820646249,0.2105263157894736,0.0,0.0087521880470117,0.0172543135783946,0.0049723603433428,0.1428571428571428,0.4418604651162785,0.1666666666666666,0,0,0,0,0,0,0,0,0,1800000,133333.33333333334,3500000.0,1000000.0,200000.0,3500000.0,3,1700000,0.0,-0.4
726701,Rodrigo,Ribeiro,2024,110302,Portugal,Viana do Castelo,Portugal,28-04-05,Centre-Forward,Attack,Right,186.0,30-06-25,Gestifute,https://img.a.transfermarkt.technology/portrait/header/726701-1666100589.jpg?lm=1,PO1,Avs Futebol SAD,3000000.0,3000000.0,19,94,-85,5,8,13,11,12,6,9,7,4,3,11,9,4,14,12,11,9,11,10,10,9,13,14,5,12,5,9,11,13,13,9,11,14,13,11,10,11,5,13,13,11,1,1,2,1,2,3,4,3,3,2,3,17,12,2,11,14,12,10,12,1,1,1,1,1,1,1,1,1,1,14,1,17,20,75,10,20,17565000,4700,4700,2000,Mediterranean_Hispanic,94,0,0,3499.0,Unknown,2000104450,9111392.0,2.0,76,1580,79,0,1,3,35,3,0.3721884096321778,0.2085561497326203,0.3308823529411764,0.0033700042583721,0.0,0.0,0.0147536884221055,0.0147536884221055,0.0505924720131114,0.1428571428571428,0.5348837209302322,0.0416666666666666,83,18,3,3,0,3561,1,1,8,3000000,333333.3333333333,3000000.0,0.0,3000000.0,,4,2000000,0.0,0.0
727089,Noah,Sadiki,2024,3948,Belgium,Brussel,DR Congo,17-12-04,Central Midfield,Midfield,Right,183.0,30-06-27,MVP United,https://img.a.transfermarkt.technology/portrait/header/727089-1714468034.png?lm=1,BE1,Royale Union Saint-Gilloise,7000000.0,7000000.0,20,106,-75,9,13,11,10,15,8,10,11,5,12,12,10,12,13,7,11,12,13,10,9,10,14,12,7,11,8,13,10,12,14,10,10,14,12,12,11,10,10,10,7,18,2,3,4,2,3,1,1,3,3,2,4,10,11,4,13,13,10,12,16,1,14,15,16,14,13,20,1,1,15,1,1,1,1,0,7,20,23500000,5488,5488,2291,African_Caribbean,99,0,0,950.0,Unknown,2000045005,1400000.0,1.0,7,265,29,3,1,1,177,1,0.4764487959777719,0.2396791443850267,0.3676470588235294,0.0009086458473146,0.0,0.0,0.0347586896724181,0.0347586896724181,0.0077502152837578,0.0,0.4651162790697669,0.0833333333333332,126,2,8,16,0,4332,0,0,0,8000000,760000.0,8000000.0,0.0,2500000.0,,1,500000,0.6,1.6666666666666667
727132,Zach,Robinson,2024,987,England,London,England,11-06-02,Centre-Forward,Attack,Left,183.0,31-05-26,Straight Ace Sports,https://img.a.transfermarkt.technology/portrait/header/727132-1612879616.jpg?lm=1,SC1,Motherwell Football Club,350000.0,350000.0,22,124,130,9,11,8,8,12,9,13,9,18,13,12,9,13,12,14,14,16,14,12,12,12,12,9,12,9,13,12,13,11,12,12,12,12,12,14,13,13,14,14,14,14,4,3,1,1,1,3,3,3,2,3,2,12,15,5,10,11,15,10,7,1,20,20,1,10,1,1,1,1,1,1,1,1,1,64,20,9,3655751,6200,6200,4500,Northern_European,124,0,0,23198.0,Unknown,28047463,9111392.0,2.0,32,858,33,0,0,7,135,3,0.5706536120666843,0.4759358288770053,0.5514705882352942,0.0223916987814875,0.0,0.0,0.0015003750937734,0.0015003750937734,0.0505924720131114,0.1428571428571428,0.4651162790697669,0.1666666666666666,116,27,8,4,0,4841,1,21,317,350000,41666.666666666664,350000.0,0.0,,225000.0,3,50000,0.0,0.2727272727272727
727152,Hamza,Akman,2024,5817,TÃ¼rkiye,Istanbul,TÃ¼rkiye,27-09-04,Central Midfield,Midfield,Right,178.0,30-06-27,AC Talent,https://img.a.transfermarkt.technology/portrait/header/727152-1671102121.png?lm=1,DK1,SÃ¸nderjyske Fodbold,400000.0,450000.0,20,85,-75,9,8,13,7,14,7,6,7,2,3,12,7,3,13,14,8,7,12,9,12,8,14,16,6,12,5,12,10,12,13,6,5,12,10,8,5,11,7,14,6,14,3,4,1,3,2,3,2,3,1,1,2,10,13,6,14,12,14,8,10,1,1,1,1,1,1,1,1,20,1,1,18,1,1,0,14,20,8579522,4603,4603,2510,Northern_European,74,0,0,110.0,Unknown,2000129170,9111392.0,2.0,100,667,100,3,1,7,198,1,0.3593543265414131,0.2631016042780748,0.1838235294117646,9.75273438669302e-05,0.0,0.0,0.0017504376094023,0.0020005001250312,0.0505924720131114,0.1428571428571428,0.3488372093023257,0.0833333333333332,84,21,22,4,0,3090,0,0,0,300000,22222.222222222223,450000.0,125000.0,450000.0,300000.0,1,100000,-0.25,-0.3333333333333333
728262,Julián,Palacios,2024,6676,Argentina,General Pico,Argentina,04-02-99,Attacking Midfield,Midfield,Right,169.0,30-06-25,Doble G,https://img.a.transfermarkt.technology/portrait/header/728262-1727786742.jpg?lm=1,GR1,A.G.S Asteras Tripolis,450000.0,700000.0,25,121,133,11,12,14,12,12,11,6,11,9,9,14,6,7,14,13,12,14,11,10,10,13,10,8,6,13,10,11,15,14,13,10,7,13,13,14,8,13,8,9,6,10,2,3,1,3,2,3,1,2,3,4,3,11,10,7,10,12,11,11,10,1,1,1,1,1,1,1,1,16,20,1,12,14,10,73,10,20,3453383,5966,5966,3262,Mediterranean_Hispanic,117,0,0,3624.0,Club AtlÃ©tico Banfield,14128002,9111392.0,2.0,4,527,4,3,1,3,5,0,0.5396930404869013,0.3435294117647058,0.4999999999999999,0.0034907064166232,0.0,0.0,0.0020005001250312,0.0032508127031757,0.0505924720131114,0.1428571428571428,0.13953488372093,0.2916666666666665,0,0,0,0,0,0,0,0,0,450000,-22727.272727272728,700000.0,200000.0,,,3,200000,0.0,-0.25
728485,Danilo,Veiga,2024,2431,Portugal,Gondomar,Portugal,25-09-02,Right-Back,Defender,Right,183.0,30-06-27,Vision Players,https://img.a.transfermarkt.technology/portrait/header/728485-1686040042.jpg?lm=1,PO1,Club Football Estrela da Amadora,800000.0,2000000.0,22,113,-75,10,13,13,8,12,11,12,11,12,11,13,9,14,13,12,12,9,12,11,11,12,12,12,10,11,11,13,12,12,10,14,12,16,13,13,13,14,8,11,5,10,1,3,1,3,1,2,3,2,3,1,2,13,13,6,10,13,15,12,14,1,1,13,20,1,16,12,1,1,1,1,1,1,1,82,8,20,19480000,5650,5650,3654,Mixed_Race,114,0,0,1249.0,Unknown,83261126,9111392.0,2.0,76,548,79,1,1,4,55,11,0.4978830378406986,0.3854545454545454,0.4779411764705882,0.0011973654098514,0.0,0.0,0.0037509377344336,0.0097524381095273,0.0505924720131114,0.1428571428571428,0.4651162790697669,0.1666666666666666,80,1,6,16,1,3073,1,2,8,1000000,116666.66666666667,2000000.0,700000.0,,2000000.0,2,700000,0.25,-0.23076923076923078
728733,Brooke,Norton-Cuffy,2024,252,England,London,England,12-01-04,Right-Back,Defender,Right,181.0,30-06-29,Roc Nation Sports,https://img.a.transfermarkt.technology/portrait/header/728733-1684494525.jpg?lm=1,IT1,Genoa Cricket and Football Club,4500000.0,4500000.0,20,118,-8,10,11,11,6,12,6,10,7,10,10,11,6,12,12,10,12,11,10,11,7,9,13,8,8,10,10,13,14,14,15,12,13,13,15,13,12,11,4,12,3,12,2,1,1,3,1,3,2,1,3,3,2,14,12,2,11,13,10,11,13,1,13,13,19,14,20,1,1,1,13,1,1,13,1,0,9,20,36885372,5900,5900,3254,African_Caribbean,111,0,0,9279.0,Rotherham United,2000047226,9111392.0,2.0,32,858,33,1,1,1,104,11,0.530960571579783,0.3426737967914438,0.4558823529411764,0.0089512720559053,0.0,0.0,0.0222555638909727,0.0222555638909727,0.0505924720131114,0.1428571428571428,0.418604651162791,0.0833333333333332,144,4,9,17,2,2111,4,37,62,4500000,512500.0,4500000.0,0.0,1200000.0,4500000.0,4,2500000,0.0,0.0
728734,Alfie,Devine,2024,968,England,Warrington,England,01-08-04,Attacking Midfield,Midfield,Right,182.0,30-06-25,CAA Base Ltd,https://img.a.transfermarkt.technology/portrait/header/728734-1610361856.jpg?lm=1,BE1,Koninklijke Voetbal Club Westerlo,2200000.0,2200000.0,20,106,-9,10,8,11,10,11,11,9,12,9,8,11,9,9,11,14,16,13,12,8,11,10,14,13,7,9,8,12,14,13,11,13,10,15,13,13,10,9,13,11,10,11,2,1,3,2,1,1,3,2,2,3,1,18,10,6,11,15,13,8,8,1,1,1,1,1,1,15,1,20,1,1,18,1,1,0,12,20,65558529,5288,5288,3239,Northern_European,102,0,0,5800.0,Unknown,2000050627,9111392.0,2.0,32,1645,33,3,1,7,123,0,0.4499867689865043,0.3410695187165775,0.3897058823529412,0.0055918895874593,0.0,0.0,0.010752688172043,0.010752688172043,0.0505924720131114,0.1428571428571428,0.4418604651162785,0.0833333333333332,137,29,13,26,1,3458,2,11,46,2800000,383333.3333333333,2800000.0,0.0,,2800000.0,3,1900000,0.2727272727272727,1.8
729814,Georges,Mikautadze,2024,1041,France,Lyon,Georgia,31-10-00,Centre-Forward,Attack,Right,176.0,30-06-28,Unknown,https://img.a.transfermarkt.technology/portrait/header/729814-1719222514.jpg?lm=1,FR1,Olympique Lyonnais,20000000.0,20000000.0,24,116,141,12,10,13,13,13,13,7,12,6,6,12,15,6,13,12,12,13,13,12,12,13,11,12,8,10,6,12,12,14,13,12,8,13,13,12,8,12,9,11,8,11,2,1,3,2,2,2,3,1,1,3,1,18,12,4,9,8,10,10,17,1,1,1,1,1,1,1,1,1,1,17,15,14,20,69,10,20,5259999,5798,5998,3148,Mediterranean_Hispanic,108,11,2,6034.0,Unknown,49043189,15833333.33,3.0,34,884,39,0,1,3,143,3,0.5439269648055041,0.3313368983957219,0.4338235294117646,0.0058178440277054,0.0723684210526315,0.0263157894736842,0.0997749437359339,0.0997749437359339,0.0879376278785521,0.2857142857142857,0.3023255813953489,0.25,179,92,19,19,1,2847,4,2,14,18000000,1369230.7692307692,20000000.0,2000000.0,,1800000.0,4,8800000,-0.1,1.25
730581,Loïc,Badé,2024,368,France,SÃ¨vres,France,11-04-00,Centre-Back,Defender,Right,191.0,30-06-29,S.O.M FOOTBALL,https://img.a.transfermarkt.technology/portrait/header/730581-1681464974.jpg?lm=1,ES1,Sevilla FÃºtbol Club S.A.D.,14000000.0,17000000.0,24,119,145,3,7,9,7,11,2,14,6,6,13,13,8,14,10,9,13,12,7,11,12,13,13,9,10,12,13,10,11,12,14,13,13,14,14,14,13,13,7,11,12,7,3,1,3,2,3,1,3,3,3,2,3,11,15,14,10,15,12,12,14,1,1,20,1,1,1,10,1,1,1,1,1,1,1,89,8,20,5979999,6095,6095,3902,African_Caribbean,120,0,0,23014.0,Nottingham Forest,49039789,14500000.0,2.0,34,1460,36,1,1,1,181,2,0.5567610478962689,0.4119786096256684,0.5220588235294117,0.0222140252045418,0.0,0.0,0.0697674418604651,0.0847711927981995,0.0805300147226311,0.1428571428571428,0.6511627906976742,0.25,174,7,4,43,1,4874,8,35,84,25000000,1531250.0,25000000.0,2000000.0,,12000000.0,3,9000000,0.7857142857142857,1.5
730861,Milos,Kerkez,2024,989,Serbia and Montenegro,Vrbas,Hungary,07-11-03,Left-Back,Defender,Left,180.0,Unknown,YOU FIRST,https://img.a.transfermarkt.technology/portrait/header/730861-1660762995.jpg?lm=1,GB1,Association Football Club Bournemouth,20000000.0,20000000.0,21,116,-8,6,12,13,7,12,8,5,10,10,9,12,7,12,13,14,12,14,14,11,10,10,13,12,7,13,9,14,15,15,14,11,10,15,13,13,10,10,9,11,4,12,2,1,2,1,2,1,4,1,1,1,1,12,15,7,8,9,13,12,5,1,20,1,13,20,10,1,17,1,1,12,1,1,1,71,20,7,60000001,6250,5750,3750,Northern_European,107,0,0,4444.0,Unknown,2000011147,6416666.667,3.0,84,1631,47,1,0,7,22,8,0.5111140513363324,0.3957219251336898,0.4264705882352941,0.0042825125747508,0.0,0.0,0.0997749437359339,0.0997749437359339,0.0356213598544404,0.2857142857142857,0.3953488372093026,0.125,176,7,17,26,1,5410,0,0,0,28000000,2329166.6666666665,28000000.0,0.0,3000000.0,20000000.0,3,3500000,0.4,0.4
730893,Tyrick,Mitchell,2024,873,England,London,England,01-09-99,Left-Back,Defender,Left,181.0,30-06-25,Connect Force,https://img.a.transfermarkt.technology/portrait/header/730893-1693826944.jpg?lm=1,GB1,Crystal Palace Football Club,25000000.0,28000000.0,25,141,155,9,13,13,6,12,8,11,8,10,12,14,7,17,12,15,13,13,14,13,13,13,13,10,8,13,14,15,15,15,15,13,9,16,16,14,12,14,5,13,5,10,2,3,2,3,1,1,2,3,1,1,2,7,14,1,10,15,14,14,3,1,20,1,1,16,1,1,1,1,1,1,1,1,1,66,20,9,40235213,7050,7050,6000,African_Caribbean,140,2,0,46397.0,Unknown,28111507,9111392.0,2.0,32,858,33,1,0,1,58,8,0.6831172267795713,0.6363636363636364,0.6691176470588234,0.0447930537356352,0.0131578947368421,0.0,0.1247811952988247,0.1397849462365591,0.0505924720131114,0.1428571428571428,0.418604651162791,0.2916666666666665,177,3,11,16,1,1724,5,14,120,25000000,1666666.6666666667,28000000.0,6000000.0,,,0,0,0.0,0.13636363636363635
731491,Franco,Carboni,2024,607,Argentina,Buenos Aires,Argentina,04-04-03,Left-Back,Defender,Left,190.0,30-06-25,GR Sports,https://img.a.transfermarkt.technology/portrait/header/731491-1675245800.jpg?lm=1,IT1,Venezia Football Club,900000.0,1000000.0,21,109,-8,7,12,11,9,12,4,10,9,8,10,11,6,11,11,13,14,12,11,11,10,12,11,7,7,11,11,12,11,13,12,12,12,14,14,13,13,13,7,11,5,16,2,2,3,2,4,2,1,1,1,1,3,13,13,6,13,9,12,10,20,1,20,1,1,19,1,1,18,1,1,15,10,1,10,76,20,5,28000000,5450,5450,2750,Mediterranean_Hispanic,105,0,0,4741.0,Cagliari Calcio,43619130,400000.0,1.0,4,275,4,1,0,3,210,8,0.4714210108494311,0.2887700534759358,0.411764705882353,0.0045693009027555,0.0,0.0,0.0042510627656914,0.0047511877969492,0.0021945054029278,0.0,0.6279069767441858,0.125,99,3,13,21,0,2690,1,1,6,900000,-16666.666666666668,1000000.0,100000.0,,900000.0,4,0,0.0,0.0
731879,Unknown,Hernâni,2024,979,Guinea-Bissau,Bissau,Portugal,03-04-01,Right Winger,Attack,Right,178.0,30-06-26,Universal Twenty Two,https://img.a.transfermarkt.technology/portrait/header/731879-1705664010.png?lm=1,PO1,Moreirense Futebol Clube,400000.0,500000.0,23,126,141,14,11,11,11,14,14,12,12,8,12,13,13,14,14,11,11,11,14,11,12,12,11,10,11,13,13,12,13,11,11,13,13,15,12,13,12,10,12,11,10,12,3,3,2,2,3,2,2,1,3,2,2,10,12,7,11,11,12,13,10,1,1,1,1,1,1,20,1,20,1,1,12,1,1,77,12,20,2853618,6300,6800,5250,Mixed_Race,124,0,0,32018.0,Reggina 1914,19163503,9111392.0,2.0,44,202,79,0,1,4,134,10,0.6500396930404869,0.5561497326203209,0.5514705882352942,0.0309084430676888,0.0,0.0,0.0017504376094023,0.0022505626406601,0.0505924720131114,0.1428571428571428,0.3488372093023257,0.2083333333333332,55,6,3,3,0,2134,2,59,341,400000,-14285.714285714286,500000.0,100000.0,,500000.0,2,100000,0.0,0.0
732096,Santi,García,2024,2424,Spain,Madrid,Spain,29-08-01,Attacking Midfield,Midfield,Left,184.0,30-06-27,JONATHAN SÃNCHEZ,https://img.a.transfermarkt.technology/portrait/header/default.jpg?lm=1,PO1,Gil Vicente Futebol Clube,200000.0,200000.0,23,120,128,8,13,10,8,11,8,15,10,16,14,12,7,15,10,17,16,18,9,8,9,8,17,11,14,10,13,10,17,11,11,16,14,12,11,17,14,10,15,11,1,7,1,2,3,3,2,3,2,2,3,4,2,12,14,7,12,10,16,8,6,1,15,20,1,12,1,1,1,1,1,1,1,1,1,88,20,7,101438,6286,6351,3831,Mediterranean_Hispanic,123,0,0,9107.0,Unknown,14018077,9111392.0,2.0,89,892,89,3,0,3,106,0,0.5906324424450913,0.4043850267379679,0.5441176470588236,0.0087851858861517,0.0,0.0,0.0007501875468867,0.0007501875468867,0.0505924720131114,0.1428571428571428,0.4883720930232553,0.2083333333333332,72,11,6,24,0,1430,0,0,0,600000,61111.11111111111,600000.0,0.0,,,1,400000,2.0,5.0
732165,Ronnie,Edwards,2024,180,England,Harlow,England,28-03-03,Centre-Back,Defender,Right,185.0,30-06-28,Two Touch Agency,https://img.a.transfermarkt.technology/portrait/header/732165-1641462138.jpg?lm=1,GB1,Southampton Football Club,3800000.0,3800000.0,21,120,-8,4,6,12,6,13,6,11,7,6,12,13,6,13,13,12,13,13,15,12,11,13,13,7,10,10,13,13,12,13,12,12,10,13,13,13,12,12,8,12,7,11,2,4,2,2,3,1,4,1,3,1,3,11,9,4,12,12,14,12,13,1,1,20,1,1,1,10,1,1,1,1,1,1,1,0,15,20,7189168,6000,6000,3502,Northern_European,120,0,0,2900.0,Unknown,29243820,3500000.0,1.0,32,599,33,1,1,7,186,2,0.5441915850754168,0.3691978609625668,0.5220588235294117,0.0027915995160326,0.0,0.0,0.018754688672168,0.018754688672168,0.0194172060335009,0.0,0.5116279069767438,0.125,158,3,2,13,1,3176,0,0,0,3800000,462500.0,3800000.0,0.0,300000.0,3200000.0,1,0,0.0,0.1875
733309,Takahiro,Akimoto,2024,2727,Japan,"Utsunomiya, Tochigi",Japan,31-01-98,Left-Back,Defender,Left,170.0,30-06-27,UDN SPORTS,https://img.a.transfermarkt.technology/portrait/header/733309-1713337957.jpg?lm=1,BE1,Oud-Heverlee Leuven,1200000.0,1200000.0,26,125,135,14,14,14,11,15,13,5,12,5,8,15,8,6,15,11,13,13,14,13,15,14,11,14,9,13,10,12,10,13,13,16,5,13,12,12,8,9,12,11,9,14,3,2,3,1,3,3,3,1,1,3,3,13,15,8,11,10,9,9,10,1,1,1,1,1,1,1,12,1,1,20,17,20,1,76,20,10,1979997,6300,5125,5125,10,126,0,0,2500.0,Unknown,45092891,750000.0,1.0,54,1553,56,1,0,0,146,8,0.4284202169886213,0.5427807486631016,0.5661764705882353,0.0024053526096289,0.0,0.0,0.0057514378594648,0.0057514378594648,0.0041390038612183,0.0,0.1627906976744184,0.3333333333333332,217,18,22,22,2,4111,2,14,46,1500000,90000.0,1500000.0,0.0,,,1,0,0.6666666666666666,0.6666666666666666
733576,Alberto,Moleiro,2024,472,Spain,Santa Cruz de Tenerife,Spain,30-09-03,Attacking Midfield,Midfield,Right,171.0,30-06-26,Unknown,https://img.a.transfermarkt.technology/portrait/header/733576-1701157946.jpg?lm=1,ES1,UniÃ³n Deportiva Las Palmas S.A.D.,15000000.0,15000000.0,21,118,-9,11,13,15,13,15,10,6,11,11,6,14,10,5,16,8,11,11,11,10,15,12,13,15,11,13,6,11,12,12,14,11,8,13,12,9,6,10,6,12,8,12,3,2,3,3,2,3,2,1,2,4,3,12,13,5,12,12,13,14,14,1,1,1,1,1,1,1,14,15,10,19,20,14,1,64,12,20,9562500,5850,5850,3757,Mediterranean_Hispanic,117,0,0,2684.0,Unknown,2000028320,9111392.0,2.0,89,1324,89,3,1,3,207,0,0.5243450648319662,0.3964705882352941,0.4999999999999999,0.0025830261865746,0.0,0.0,0.0747686921730432,0.0747686921730432,0.0505924720131114,0.1428571428571428,0.1860465116279068,0.125,139,11,13,12,0,648,1,7,39,25000000,1919230.7692307692,25000000.0,0.0,3000000.0,15000000.0,1,2400000,0.6666666666666666,1.5
733579,Unknown,Clayton,2024,2425,Brazil,Belo Horizonte,Brazil,11-01-99,Centre-Forward,Attack,Right,184.0,30-06-25,Unknown,https://img.a.transfermarkt.technology/portrait/header/733579-1663603724.png?lm=1,PO1,Rio Ave Futebol Clube,2500000.0,2500000.0,25,122,123,11,11,14,9,13,11,6,10,6,6,11,13,6,13,10,10,8,9,8,11,8,11,15,5,13,8,10,9,17,17,10,6,12,16,12,6,10,14,11,4,14,3,3,1,3,2,2,1,3,1,1,1,14,9,8,9,12,12,9,15,1,1,1,1,1,1,1,15,1,8,20,15,16,17,63,5,20,6724309,6091,6091,3493,Mediterranean_Hispanic,110,0,0,16443.0,Unknown,19225761,3000000.0,1.0,10,168,11,0,1,3,171,3,0.5562318073564435,0.368235294117647,0.4485294117647059,0.0158689541495953,0.0,0.0,0.0122530632658164,0.0122530632658164,0.0166393510930859,0.0,0.4883720930232553,0.2916666666666665,156,43,6,31,1,2672,0,0,0,3500000,340000.0,3500000.0,200000.0,,,4,2950000,0.4,4.0
735568,Unknown,Natan,2024,150,Brazil,Itapecerica da Serra,Brazil,06-02-01,Centre-Back,Defender,Right,188.0,30-06-25,LINK SPORTS,https://img.a.transfermarkt.technology/portrait/header/735568-1708553167.jpg?lm=1,ES1,Real Betis BalompiÃ© S.A.D.,12000000.0,13000000.0,23,129,132,11,11,14,12,14,12,11,14,7,8,15,12,6,15,10,14,11,11,11,14,13,12,13,7,15,10,13,14,14,14,13,8,12,12,11,10,11,7,8,12,15,3,1,2,2,1,2,3,2,1,2,3,7,14,6,10,12,11,6,12,1,1,1,5,1,5,10,12,20,12,10,15,10,13,78,13,20,2500544,6434,6434,3745,Mediterranean_Hispanic,129,0,0,11182.0,FLU,19222989,6750000.0,2.0,10,672,11,1,1,3,164,2,0.6016141836464673,0.395187165775401,0.588235294117647,0.0107888417131209,0.0,0.0,0.0597649412353088,0.0647661915478869,0.0374732631461985,0.1428571428571428,0.581395348837209,0.2083333333333332,176,5,4,27,3,7116,3,18,54,9000000,615384.6153846154,13000000.0,3000000.0,,3500000.0,3,7500000,-0.25,-0.3076923076923077
735570,João,Gomes,2024,543,Brazil,Rio de Janeiro,Brazil,12-02-01,Central Midfield,Midfield,Right,176.0,30-06-28,Carlos Leite,https://img.a.transfermarkt.technology/portrait/header/735570-1675092223.jpg?lm=1,GB1,Wolverhampton Wanderers Football Club,40000000.0,40000000.0,23,130,155,10,10,13,11,13,12,10,12,11,14,14,10,15,13,16,13,16,14,13,12,12,16,14,8,14,14,15,15,13,13,12,12,11,13,13,12,12,10,1,10,16,3,1,1,1,1,1,2,3,3,3,1,15,14,5,14,15,14,12,12,1,1,1,12,1,1,20,14,19,12,1,1,1,1,74,6,20,11738884,6304,6304,4142,Mixed_Race,132,0,0,11182.0,Unknown,19371031,18700000.0,1.0,10,1234,11,3,1,4,222,1,0.5844138661021434,0.4376470588235294,0.6102941176470589,0.0107888417131209,0.0,0.0,0.1997999499874969,0.1997999499874969,0.1038639962221172,0.0,0.3023255813953489,0.2083333333333332,199,11,7,56,1,5642,0,0,0,40000000,3038461.5384615385,40000000.0,0.0,,5000000.0,2,6000000,0.14285714285714285,0.8181818181818182
735571,Unknown,Rodrigo Muniz,2024,931,Brazil,SÃ£o Domingos do Prata,Brazil,04-05-01,Centre-Forward,Attack,Left,186.0,30-06-26,CAA Base Ltd,https://img.a.transfermarkt.technology/portrait/header/735571-1657802369.jpg?lm=1,GB1,Fulham Football Club,20000000.0,20000000.0,23,124,139,1,2,1,2,7,5,7,2,1,1,11,12,1,9,12,13,12,12,12,7,13,14,5,13,3,12,13,12,10,13,13,13,13,7,12,14,10,9,9,14,12,12,12,13,6,14,15,9,13,8,14,13,12,13,5,15,12,14,8,12,20,1,1,1,1,1,1,1,1,1,1,1,1,1,79,20,14,52732,5874,5874,3180,Mediterranean_Hispanic,124,0,0,4674.0,Unknown,8826836,8000000.0,1.0,10,1449,11,0,0,3,95,3,0.5275205080709182,0.33475935828877,0.5514705882352942,0.0045046045459329,0.0,0.0,0.0997749437359339,0.0997749437359339,0.044417900497236,0.0,0.5348837209302322,0.2083333333333332,144,36,3,8,0,4440,4,16,42,20000000,1925000.0,20000000.0,0.0,,3000000.0,3,0,0.0,3.0
738516,Mike,Kleijn,2024,468,Netherlands,Breda,Netherlands,09-02-05,Left-Back,Defender,Left,175.0,30-06-28,Forza Sports Group,https://img.a.transfermarkt.technology/portrait/header/738516-1723809457.jpg?lm=1,NL1,Sparta Rotterdam,250000.0,250000.0,19,92,-75,6,7,8,7,14,8,8,7,8,10,12,5,11,14,7,6,5,8,7,14,9,15,9,11,12,12,14,14,12,11,13,11,11,10,12,7,12,13,11,11,11,2,4,1,1,2,3,1,1,3,3,2,9,15,1,12,15,15,14,14,1,1,1,1,1,1,12,1,20,1,1,1,1,1,0,20,10,13800000,4492,4492,1992,Northern_European,92,0,0,505.0,Unknown,2000074822,9111392.0,2.0,67,248,68,1,0,7,187,8,0.3446679015612596,0.2077005347593583,0.3161764705882353,0.0004789461639405,0.0,0.0,0.0010002500625156,0.0010002500625156,0.0505924720131114,0.1428571428571428,0.2790697674418605,0.0416666666666666,84,5,7,3,0,5828,0,0,0,250000,0.0,250000.0,0.0,,,0,0,0.0,0.0
739438,Unknown,Matheus Pereira,2024,2423,Brazil,SÃ£o Paulo,Brazil,21-12-00,Left-Back,Defender,Left,172.0,30-06-28,Dodici Sports BR,https://img.a.transfermarkt.technology/portrait/header/739438-1639252127.jpg?lm=1,PO1,Clube Desportivo Santa Clara,800000.0,800000.0,24,135,148,14,15,16,13,15,13,6,15,7,6,14,11,6,16,9,10,9,13,8,14,12,8,17,6,14,6,10,8,15,16,12,7,14,14,12,7,13,15,13,4,11,2,2,1,3,1,1,2,2,1,4,1,7,16,16,10,13,7,5,8,1,1,1,1,1,1,1,17,1,18,17,19,20,11,69,20,9,347975206,6750,5695,5745,Mixed_Race,130,0,0,123760.0,Unknown,55070289,500000.0,1.0,10,1456,11,1,0,4,57,8,0.5038369939137338,0.609090909090909,0.5955882352941175,0.1194961022859057,0.0,0.0,0.0037509377344336,0.0037509377344336,0.0027500763910108,0.0,0.2093023255813952,0.25,165,9,13,47,1,4556,2,2,8,1200000,100000.0,1200000.0,0.0,,400000.0,2,400000,0.5,0.7142857142857143
741142,Zaid,Romero,2024,2282,Argentina,Mendoza,Argentina,15-12-99,Centre-Back,Defender,Right,192.0,30-06-28,CAA Stellar,https://img.a.transfermarkt.technology/portrait/header/741142-1675697927.JPG?lm=1,BE1,Club Brugge Koninklijke Voetbalvereniging,6000000.0,6000000.0,25,108,-75,7,8,14,13,11,7,10,9,5,6,11,8,9,13,11,15,12,11,10,12,11,6,13,8,14,10,10,10,12,13,12,9,11,13,12,13,13,7,12,11,11,1,1,1,2,1,3,1,1,3,2,3,16,11,3,11,13,11,10,14,1,1,1,1,1,1,1,1,1,1,1,10,1,20,77,10,20,5705346,5150,5150,2100,Mediterranean_Hispanic,110,0,0,2286.0,Unknown,14225980,3700000.0,2.0,4,942,4,1,1,3,53,2,0.4317279703625297,0.2192513368983957,0.4485294117647059,0.0021987105147029,0.0,0.0,0.0297574393598399,0.0297574393598399,0.0205283480096669,0.1428571428571428,0.6744186046511627,0.2916666666666665,137,6,1,19,1,4221,5,25,64,5000000,495000.0,6000000.0,1000000.0,,50000.0,4,2350000,-0.16666666666666666,2.3333333333333335
741238,Omari,Hutchinson,2024,677,England,Redhill,England,30-10-03,Right Winger,Attack,Left,174.0,30-06-29,Sports Invest UK ltd,https://img.a.transfermarkt.technology/portrait/header/741238-1646905031.jpg?lm=1,GB1,Ipswich Town Football Club,18000000.0,18000000.0,21,97,-8,10,10,14,10,12,10,4,12,1,4,12,9,7,13,8,9,7,8,7,12,7,11,16,4,12,5,11,12,15,14,12,4,14,13,9,5,18,10,11,11,18,2,1,3,3,3,3,2,2,2,2,1,15,13,6,10,15,10,10,17,1,1,1,1,12,1,1,13,15,1,16,20,17,1,0,20,10,30900198,4853,4853,2506,African_Caribbean,92,0,0,17399.0,Unknown,2000047221,23500000.0,1.0,32,1212,33,0,0,1,115,10,0.3924318602804975,0.2626737967914438,0.3161764705882353,0.0167920842559001,0.0,0.0,0.0897724431107777,0.0897724431107777,0.1305314036501014,0.0,0.2558139534883721,0.125,147,38,34,16,0,1504,2,3,12,22000000,3000000.0,22000000.0,0.0,,18000000.0,1,2000000,2.142857142857143,6.333333333333333
741292,Iker,Bravo,2024,410,Spain,Sant Cugat del VallÃ¨s,Spain,13-01-05,Centre-Forward,Attack,Right,182.0,30-06-28,Phsport,https://img.a.transfermarkt.technology/portrait/header/741292-1658913909.jpg?lm=1,IT1,Udinese Calcio,500000.0,1000000.0,19,90,-8,10,9,13,12,13,7,11,10,4,3,10,11,6,14,9,10,9,9,10,9,11,10,15,4,12,6,12,12,12,13,7,9,13,12,8,7,12,6,20,12,11,3,1,1,3,3,1,1,2,1,1,3,19,14,4,10,10,13,9,13,1,1,1,1,1,1,1,1,1,1,14,1,12,20,79,8,20,24920001,4250,4250,2250,Mediterranean_Hispanic,87,0,0,723.0,R. Madrid,2000130473,600000.0,1.0,89,1314,89,0,1,3,205,3,0.3126488489018258,0.2352941176470588,0.2794117647058823,0.0006894507279305,0.0,0.0,0.0022505626406601,0.0047511877969492,0.0033056473790938,0.0,0.4418604651162785,0.0416666666666666,75,21,9,14,0,3555,0,0,0,1500000,100000.0,1500000.0,500000.0,500000.0,,3,1500000,2.0,2.0
742095,Unknown,Gabriel Pereira,2024,190,Brazil,Volta Redonda,Brazil,07-05-00,Centre-Back,Defender,Left,188.0,30-06-29,Velasco Sport Group,https://img.a.transfermarkt.technology/portrait/header/742095-1710239135.jpg?lm=1,DK1,Football Club KÃ¸benhavn,4000000.0,4000000.0,24,116,-8,11,11,15,13,14,10,6,11,4,4,14,9,3,14,5,11,6,11,11,14,12,8,15,6,14,6,13,10,15,15,12,9,12,14,13,7,8,8,10,6,8,1,2,1,2,2,3,2,3,1,2,2,11,9,5,11,13,9,12,12,1,1,1,1,1,1,1,8,15,17,10,18,20,1,0,20,5,6622183,5934,5941,3333,Mediterranean_Hispanic,116,0,0,8066.0,Unknown,19408820,2825000.0,2.0,10,1629,11,1,0,3,90,2,0.5363852871129928,0.3511229946524064,0.4926470588235294,0.0077799783122362,0.0,0.0,0.0197549387346836,0.0197549387346836,0.0156671018639406,0.1428571428571428,0.581395348837209,0.25,140,7,2,37,1,3755,0,0,0,5000000,533333.3333333334,5000000.0,-50000.0,,,2,1150000,0.25,1.0
742201,Giuliano,Simeone,2024,13,Italy,Roma,Argentina,18-12-02,Centre-Forward,Attack,Right,173.0,30-06-28,AC Talent,https://img.a.transfermarkt.technology/portrait/header/742201-1644567976.jpg?lm=1,ES1,Club AtlÃ©tico de Madrid S.A.D.,3000000.0,3000000.0,22,116,-75,7,11,12,14,10,9,11,10,6,5,10,8,6,13,14,13,16,11,14,9,12,19,11,13,11,7,14,15,14,12,12,9,11,12,13,11,13,12,9,13,12,2,2,3,3,2,3,1,2,3,3,1,8,11,7,11,12,13,10,13,1,1,1,1,1,1,1,1,1,1,17,14,15,20,75,10,20,34875001,5750,4797,3282,Mediterranean_Hispanic,110,0,0,4231.0,Zaragoza,14250859,9111392.0,2.0,52,1244,4,0,1,3,52,3,0.3850224927229426,0.3456684491978609,0.4485294117647059,0.0040768360970908,0.0,0.0,0.0147536884221055,0.0147536884221055,0.0505924720131114,0.1428571428571428,0.2325581395348837,0.1666666666666666,98,17,10,13,0,2454,1,26,147,12000000,1150000.0,12000000.0,1000000.0,500000.0,2500000.0,3,9300000,3.0,3.8
742518,Pedro,Bravo,2024,865,Colombia,Santiago de Cali,Colombia,26-11-04,Defensive Midfield,Midfield,Right,190.0,30-06-29,Aya Sport ,https://img.a.transfermarkt.technology/portrait/header/742518-1718733870.jpg?lm=1,DK1,Fodbold Club Midtjylland,850000.0,850000.0,20,89,-75,7,7,8,7,14,7,7,7,4,13,14,3,14,14,10,13,8,7,10,14,10,10,5,10,7,9,8,13,12,10,10,15,13,12,13,8,11,7,6,12,11,2,3,2,1,1,2,2,2,1,1,3,8,10,8,11,12,10,13,20,1,1,1,1,1,1,20,1,18,1,1,1,1,1,79,8,20,1637426,4329,4329,2261,Mixed_Race,94,0,0,1161.0,Unknown,2000040188,500000.0,1.0,20,1334,20,3,1,4,86,4,0.3231013495633765,0.2364705882352941,0.3308823529411764,0.0011123910904426,0.0,0.0,0.0040010002500625,0.0040010002500625,0.0027500763910108,0.0,0.6279069767441858,0.0833333333333332,62,0,3,7,0,958,0,0,0,900000,100000.0,900000.0,0.0,250000.0,900000.0,2,200000,0.058823529411764705,0.2857142857142857
742521,Jhon,Solís,2024,12321,Colombia,GuacarÃ­,Colombia,03-10-04,Central Midfield,Midfield,Right,186.0,30-06-28,Jose Levis Manager,https://img.a.transfermarkt.technology/portrait/header/742521-1715882394.jpg?lm=1,ES1,Girona FÃºtbol Club S. A. D.,3000000.0,3000000.0,20,89,-8,3,3,6,7,14,3,7,7,1,10,14,3,7,13,7,5,8,7,7,14,13,10,5,10,9,8,8,8,9,13,8,12,14,12,13,13,19,6,13,7,13,3,3,3,2,2,1,1,2,2,1,2,11,10,4,13,9,10,8,16,1,1,1,1,1,1,1,1,20,1,1,10,1,8,80,8,20,1603145,4408,4408,1618,African_Caribbean,83,0,0,64.0,Unknown,2000040214,6000000.0,1.0,20,568,20,3,1,1,107,1,0.3335538502249272,0.1677005347593582,0.2499999999999999,5.310894963050656e-05,0.0,0.0,0.0147536884221055,0.0147536884221055,0.0333064807355759,0.0,0.5348837209302322,0.0833333333333332,78,1,5,10,0,3511,1,7,32,3500000,406250.0,4000000.0,500000.0,700000.0,3500000.0,1,2300000,0.16666666666666666,0.16666666666666666
742803,Santiago,Hezze,2024,683,Argentina,Buenos Aires,Argentina,22-10-01,Defensive Midfield,Midfield,Right,178.0,30-06-28,Unknown,https://img.a.transfermarkt.technology/portrait/header/742803-1728417744.png?lm=1,GR1,Olympiakos Syndesmos Filathlon Peiraios,12000000.0,12000000.0,23,128,-75,7,8,13,11,13,9,10,9,6,14,14,8,14,13,13,14,14,10,13,12,13,11,8,14,13,14,14,14,12,14,13,9,12,13,15,13,12,11,12,9,8,3,1,4,3,3,3,1,2,2,3,2,10,11,8,11,10,11,8,6,1,1,1,1,1,1,20,1,19,1,1,1,1,1,72,7,20,5515184,6270,6270,3811,Mediterranean_Hispanic,130,0,0,1685.0,Unknown,14226789,4000000.0,1.0,4,275,4,3,1,3,141,4,0.5799153215136279,0.4022459893048128,0.5955882352941175,0.0016183745378314,0.0,0.0,0.0597649412353088,0.0597649412353088,0.0221950609739159,0.0,0.3488372093023257,0.2083333333333332,203,11,11,46,1,7502,3,4,6,12000000,991666.6666666666,12000000.0,0.0,100000.0,4000000.0,1,0,0.2,0.5
743091,Emirhan,?Lkhan,2024,416,TÃ¼rkiye,Istanbul,TÃ¼rkiye,01-06-04,Central Midfield,Midfield,Right,175.0,30-06-26,FutureBall,https://img.a.transfermarkt.technology/portrait/header/743091-1695643830.png?lm=1,IT1,Torino Calcio,3000000.0,4500000.0,20,119,-8,6,11,15,12,14,7,7,11,3,7,12,8,7,15,9,12,10,12,10,12,13,13,15,7,13,7,12,14,14,14,12,8,14,13,13,8,13,6,11,5,12,2,3,1,2,2,3,1,1,3,1,3,13,15,6,16,10,14,14,12,1,1,1,1,1,1,12,1,20,1,12,18,12,1,72,10,20,55520001,5950,2965,1207,North_African__Middle_Eastern,112,0,0,6730.0,Unknown,2000079739,4900000.0,1.0,100,667,100,3,1,6,201,1,0.142630325482932,0.1237433155080214,0.463235294117647,0.0064899136448479,0.0,0.0,0.0147536884221055,0.0222555638909727,0.0271951998666629,0.0,0.2790697674418605,0.0833333333333332,92,16,8,9,0,2565,8,37,182,2500000,218181.81818181818,4500000.0,500000.0,4500000.0,2500000.0,4,3000000,-0.16666666666666666,-0.2857142857142857
743379,Lucas,Noubi,2024,3057,Belgium,Mouscron,Belgium,15-01-05,Centre-Back,Defender,Right,184.0,30-06-25,CAA Stellar,https://img.a.transfermarkt.technology/portrait/header/743379-1663871275.jpg?lm=1,BE1,Royal Standard Club de LiÃ¨ge,3000000.0,3000000.0,19,91,-75,7,8,8,7,11,7,12,8,8,13,11,5,13,11,12,12,10,11,10,9,8,11,12,11,10,9,10,10,13,11,12,13,12,12,10,11,9,9,5,10,10,1,3,3,2,4,3,4,1,3,2,1,7,11,6,12,11,12,10,17,1,1,20,1,1,1,1,1,1,1,1,1,1,1,0,7,20,19260000,4500,4500,1750,Mixed_Race,92,0,0,749.0,Unknown,2000055457,9111392.0,2.0,7,988,8,1,1,4,176,2,0.3457263826409102,0.1818181818181818,0.3161764705882353,0.0007145567768468,0.0,0.0,0.0147536884221055,0.0147536884221055,0.0505924720131114,0.1428571428571428,0.4883720930232553,0.0416666666666666,77,0,0,16,0,3349,2,3,15,2500000,275000.0,3000000.0,500000.0,1500000.0,,0,0,-0.16666666666666666,0.6666666666666666
743386,Malick,Fofana,2024,1041,Belgium,Aalst,Belgium,31-03-05,Left Winger,Attack,Left,169.0,30-06-28,DW Sports Management,https://img.a.transfermarkt.technology/portrait/header/743386-1676881156.jpg?lm=1,FR1,Olympique Lyonnais,15000000.0,15000000.0,19,95,-75,6,8,14,8,14,7,5,8,5,5,8,8,5,13,14,6,14,9,10,10,10,12,15,6,9,5,12,8,15,6,6,6,10,15,8,6,9,7,6,6,12,3,1,1,3,4,2,2,4,2,1,3,12,11,3,12,10,10,11,15,1,1,1,1,1,1,1,1,1,12,15,1,20,1,0,20,14,18080001,4947,4947,1498,African_Caribbean,86,0,0,749.0,Unknown,2000107079,19500000.0,1.0,7,10,8,0,0,1,143,7,0.4048690129663932,0.1548663101604278,0.2720588235294117,0.0007145567768468,0.0,0.0,0.0747686921730432,0.0747686921730432,0.1083085641267812,0.0,0.13953488372093,0.0416666666666666,127,20,16,3,0,3382,1,1,7,25000000,2460000.0,25000000.0,0.0,12000000.0,,1,4000000,0.6666666666666666,2.125
743498,Wilson,Odobert,2024,148,France,Meaux,France,28-11-04,Right Winger,Attack,Right,182.0,30-06-29,Unknown,https://img.a.transfermarkt.technology/portrait/header/743498-1672838670.jpg?lm=1,GB1,Tottenham Hotspur Football Club,18000000.0,18000000.0,20,98,-75,7,8,12,12,12,9,10,10,5,6,12,10,6,13,9,11,10,12,11,11,10,14,12,7,11,7,10,12,14,11,11,10,12,13,11,6,11,8,11,6,11,1,1,3,2,2,1,1,3,3,2,2,13,13,5,13,12,14,14,14,1,1,1,1,1,1,1,12,1,1,20,1,1,1,75,8,20,21536002,4900,4900,1658,African_Caribbean,96,0,0,924.0,Unknown,2000102722,9111392.0,2.0,34,935,36,0,1,1,202,10,0.3986504366234453,0.1719786096256684,0.3455882352941176,0.0008835397983984,0.0,0.0,0.0897724431107777,0.0897724431107777,0.0505924720131114,0.1428571428571428,0.4418604651162785,0.0833333333333332,104,29,9,3,1,1116,2,34,110,18000000,1812500.0,18000000.0,0.0,9000000.0,18000000.0,2,11000000,0.8,0.8
743523,Nathan,Buayi-Kiala,2024,290,France,Lille,France,29-02-04,Defensive Midfield,Midfield,Right,177.0,30-06-26,ESN,https://img.a.transfermarkt.technology/portrait/header/743523-1660116014.jpg?lm=1,FR1,Association de la Jeunesse auxerroise,200000.0,200000.0,20,78,-75,5,7,8,6,11,5,8,8,10,10,9,8,12,9,13,8,9,10,8,9,11,11,5,7,9,12,13,11,10,12,14,7,15,11,13,11,12,9,20,13,11,1,2,1,4,1,1,1,1,2,2,1,20,11,4,12,11,11,13,12,1,1,1,1,1,1,12,1,20,1,1,1,1,1,0,7,20,6309000,3897,3897,900,African_Caribbean,78,0,0,581.0,Unknown,2000011396,9111392.0,2.0,34,834,36,3,1,1,23,4,0.2659433712622386,0.0909090909090909,0.213235294117647,0.0005523330761572,0.0,0.0,0.0007501875468867,0.0007501875468867,0.0505924720131114,0.1428571428571428,0.3255813953488373,0.0833333333333332,66,0,4,6,0,3604,2,39,300,150000,-8333.333333333334,200000.0,50000.0,200000.0,150000.0,1,0,-0.25,-0.25
743526,Breyton,Fougeu,2024,3840,France,Tremblay-en-France,France,06-01-04,Centre-Forward,Attack,Right,175.0,30-06-26,Unknown,https://img.a.transfermarkt.technology/portrait/header/743526-1728568712.jpg?lm=1,TR1,Adana Demirspor KulÃ¼bÃ¼,75000.0,75000.0,20,82,-75,7,9,14,14,14,7,9,8,6,7,14,9,7,14,9,7,3,11,7,9,14,8,13,6,12,7,8,12,12,9,14,8,15,11,9,4,20,11,3,11,9,3,3,3,2,4,3,3,1,3,3,2,19,13,7,9,12,13,9,10,1,1,1,1,1,1,1,1,1,1,18,1,13,20,0,6,20,6162750,4127,4127,1052,African_Caribbean,82,0,0,645.0,Unknown,2000006282,9111392.0,2.0,34,1518,36,0,1,1,13,3,0.2963747023021964,0.1071657754010695,0.2426470588235293,0.0006141325811818,0.0,0.0,0.0001250312578144,0.0001250312578144,0.0505924720131114,0.1428571428571428,0.2790697674418605,0.0833333333333332,68,11,1,7,0,1919,2,14,79,75000,5000.0,75000.0,0.0,,75000.0,0,0,0.5,0.5
743587,Vinícius,Tobias,2024,660,Brazil,SÃ£o Paulo,Brazil,23-02-04,Right-Back,Defender,Right,177.0,30-06-29,AGN Football,https://img.a.transfermarkt.technology/portrait/header/743587-1723486503.png?lm=1,UKR1,FC Shakhtar Donetsk,3000000.0,3000000.0,20,101,-8,8,10,12,7,12,9,7,7,6,7,11,13,8,12,10,9,11,12,8,10,9,14,13,6,11,9,12,12,16,12,11,8,13,16,10,7,13,5,8,4,14,1,2,1,2,1,3,3,1,3,1,2,13,14,2,10,13,14,10,13,1,1,1,20,1,18,1,1,1,12,1,1,12,1,66,11,20,18391767,5050,4265,2536,Mixed_Race,89,0,0,1855.0,R. Madrid,2000012523,6000000.0,1.0,10,1456,11,1,1,4,72,11,0.3146335009261709,0.2658823529411764,0.2941176470588235,0.001782529473053,0.0,0.0,0.0147536884221055,0.0147536884221055,0.0333064807355759,0.0,0.3255813953488373,0.0833333333333332,83,0,13,17,0,1727,0,0,0,3000000,0.0,3000000.0,0.0,3000000.0,3000000.0,2,0,0.0,0.0
743597,Unknown,Matheus França,2024,873,Brazil,Rio de Janeiro,Brazil,01-04-04,Attacking Midfield,Midfield,Right,184.0,30-06-28,LIFEPRO,https://img.a.transfermarkt.technology/portrait/header/743597-1708426107.jpg?lm=1,GB1,Crystal Palace Football Club,15000000.0,15000000.0,20,118,-85,7,9,13,9,14,7,9,10,2,11,13,8,11,14,15,12,12,11,11,12,11,15,15,8,12,12,12,12,13,13,12,10,15,13,11,12,11,8,17,12,16,3,2,2,1,1,3,2,2,2,2,2,15,12,2,12,11,15,10,10,1,1,1,1,1,1,1,1,19,10,14,20,13,14,67,9,20,11631104,5900,5900,2250,Mixed_Race,111,0,0,2236.0,Unknown,2000090823,20000000.0,1.0,10,1234,11,3,1,4,58,0,0.530960571579783,0.2352941176470588,0.4558823529411764,0.0021504296514025,0.0,0.0,0.0747686921730432,0.0747686921730432,0.1110864190671963,0.0,0.4883720930232553,0.0833333333333332,78,14,4,4,1,2981,1,40,332,13000000,1125000.0,15000000.0,2000000.0,4000000.0,13000000.0,1,6000000,-0.13333333333333333,-0.13333333333333333
743600,Andrey,Santos,2024,667,Brazil,Rio de Janeiro,Brazil,03-05-04,Central Midfield,Midfield,Right,180.0,30-06-25,Bertolucci Sports,https://img.a.transfermarkt.technology/portrait/header/743600-1683289619.jpg?lm=1,FR1,Racing Club de Strasbourg Alsace,18000000.0,18000000.0,20,120,-85,8,8,12,11,13,9,12,11,9,14,12,9,12,14,12,13,12,12,13,13,12,15,15,10,12,13,13,13,13,14,12,11,12,13,12,12,13,9,17,13,18,3,3,3,2,3,2,2,3,1,3,3,16,9,8,12,9,11,11,11,1,1,1,1,1,1,16,1,20,1,1,1,1,1,72,8,20,9151666,5964,5964,2531,African_Caribbean,122,0,0,6548.0,Unknown,2000007415,12500000.0,1.0,10,1234,11,3,1,1,159,1,0.5394284202169887,0.2653475935828877,0.536764705882353,0.0063141713024342,0.0,0.0,0.0897724431107777,0.0897724431107777,0.0694185949609711,0.0,0.3953488372093026,0.0833333333333332,93,22,3,19,1,2710,0,0,0,25000000,2222222.222222222,25000000.0,1000000.0,15000000.0,25000000.0,5,7000000,0.6666666666666666,0.7857142857142857
744149,Adam,Wharton,2024,873,England,Blackburn,England,06-02-04,Defensive Midfield,Midfield,Left,182.0,30-06-29,OmniSports,https://img.a.transfermarkt.technology/portrait/header/744149-1716297290.jpg?lm=1,GB1,Crystal Palace Football Club,30000000.0,30000000.0,20,105,-8,12,10,12,7,13,12,6,8,2,6,13,10,8,14,14,10,12,13,11,14,11,11,12,9,10,11,12,12,13,11,13,10,13,12,9,8,10,6,7,2,11,1,1,2,4,2,3,2,3,3,3,3,15,12,3,17,14,12,13,12,1,1,1,1,1,1,20,1,20,1,1,12,1,1,0,20,15,12276565,5249,5249,2000,Northern_European,98,0,0,2900.0,Unknown,2000053516,21100000.0,1.0,32,205,33,3,0,7,58,4,0.4448266737232071,0.2085561497326203,0.3602941176470588,0.0027915995160326,0.0,0.0,0.1497874468617154,0.1497874468617154,0.1171976999361093,0.0,0.4418604651162785,0.0833333333333332,127,7,16,10,0,3437,1,17,93,32000000,4916666.666666667,32000000.0,-1000000.0,2500000.0,32000000.0,1,10000000,0.06666666666666667,2.2
744416,Matías,Pérez,2024,14589,Argentina,Florencio Varela,Argentina,03-03-99,Centre-Back,Defender,Right,177.0,30-06-25,Anthem SSSM ,https://img.a.transfermarkt.technology/portrait/header/744416-1690112952.png?lm=1,RU1,FC Orenburg,3000000.0,3000000.0,25,124,138,7,6,6,4,12,5,13,10,4,12,11,7,14,11,10,10,12,11,9,5,16,7,6,12,11,16,11,12,11,13,12,13,14,12,13,12,13,12,9,11,16,3,2,4,1,3,2,3,1,1,3,1,19,11,8,10,12,11,13,10,1,1,20,1,1,1,1,1,1,1,1,1,1,1,81,12,20,4342731,6120,6120,3399,Mediterranean_Hispanic,122,0,0,1213.0,Unknown,14217257,1000000.0,1.0,4,494,4,1,1,3,70,2,0.5600688012701773,0.3581818181818181,0.536764705882353,0.001162603188275,0.0,0.0,0.0147536884221055,0.0147536884221055,0.0055279313314258,0.0,0.3255813953488373,0.2916666666666665,136,12,3,44,1,5130,0,0,0,2800000,240909.0909090909,3000000.0,200000.0,,,1,400000,-0.06666666666666667,0.5555555555555556
744728,Arijon,Ibrahimovic,2024,27,Germany,NÃ¼rnberg,Germany,11-12-05,Left Winger,Attack,Right,176.0,30-06-27,Unknown,https://img.a.transfermarkt.technology/portrait/header/744728-1662650250.jpg?lm=1,L1,FC Bayern MÃ¼nchen,4000000.0,4000000.0,19,95,-8,12,11,14,12,13,13,7,12,2,7,12,12,8,14,8,9,9,10,8,12,8,15,15,3,12,8,11,11,12,12,10,8,14,13,10,11,14,6,13,4,12,2,2,2,2,4,1,1,3,2,1,1,12,17,11,14,13,12,10,10,1,1,1,1,1,1,8,12,15,12,15,20,15,12,73,8,20,26279999,4996,4996,3002,Mediterranean_Hispanic,96,0,0,64.0,Unknown,2000114473,9111392.0,2.0,38,1067,40,0,1,3,68,7,0.4113522095792538,0.3157219251336898,0.3455882352941176,5.310894963050656e-05,0.0,0.0,0.0197549387346836,0.0197549387346836,0.0505924720131114,0.1428571428571428,0.3023255813953489,0.0416666666666666,89,36,29,12,1,5497,6,22,35,4000000,600000.0,4000000.0,0.0,4000000.0,,2,3000000,0.0,0.0
744729,Tarek,Buchmann,2024,27,Germany,Dillingen an der Donau,Germany,28-02-05,Centre-Back,Defender,Right,188.0,30-06-26,11WINS,https://img.a.transfermarkt.technology/portrait/header/744729-1662650037.jpg?lm=1,L1,FC Bayern MÃ¼nchen,500000.0,500000.0,19,93,-8,2,7,10,6,11,3,12,6,4,12,12,6,12,12,12,10,12,13,10,12,8,16,10,11,8,12,12,12,12,11,12,13,14,13,10,12,13,3,12,4,8,3,1,3,3,1,3,3,3,3,1,2,12,16,6,12,10,15,16,16,1,1,20,10,1,1,10,1,10,1,1,1,1,1,0,9,20,21000000,4660,4660,2170,African_Caribbean,95,0,0,2877.0,Unknown,2000171001,9111392.0,2.0,38,414,40,1,1,1,68,2,0.3668960042339243,0.2267379679144385,0.338235294117647,0.0027693903189144,0.0,0.0,0.0022505626406601,0.0022505626406601,0.0505924720131114,0.1428571428571428,0.581395348837209,0.0416666666666666,41,2,1,3,0,3252,7,85,308,500000,0.0,500000.0,0.0,500000.0,,0,0,0.0,0.0
745191,Ramón,Sosa,2024,703,Paraguay,MaracanÃ¡,Paraguay,31-08-99,Left Winger,Attack,Right,179.0,30-06-29,Osvaldo Daniel Campo,https://img.a.transfermarkt.technology/portrait/header/745191-1707062573.JPG?lm=1,GB1,Nottingham Forest Football Club,13000000.0,13000000.0,25,124,134,7,12,13,12,14,11,12,11,11,8,12,12,9,14,12,12,11,12,12,12,11,9,13,6,14,10,11,13,14,13,11,11,12,14,12,12,12,8,9,12,12,1,3,2,3,1,1,2,1,1,2,3,7,11,4,13,12,12,8,19,1,1,1,1,1,1,1,10,1,14,20,1,20,10,76,8,20,2645725,6200,4316,3776,Mediterranean_Hispanic,122,0,0,7994.0,Unknown,2000017278,4023000.0,4.0,73,911,75,0,1,3,140,7,0.3213813178089442,0.3985026737967914,0.536764705882353,0.0077104538690835,0.0,0.0,0.0647661915478869,0.0647661915478869,0.022322842301175,0.4285714285714285,0.3720930232558141,0.2916666666666665,174,33,24,22,0,5102,4,11,23,13000000,942307.6923076923,13000000.0,200000.0,,,4,1800000,0.0,0.625
745200,Maghnes,Akliouche,2024,162,France,Tremblay-en-France,France,25-02-02,Right Winger,Attack,Left,183.0,30-06-28,DW Sports Management,https://img.a.transfermarkt.technology/portrait/header/745200-1717406573.jpg?lm=1,FR1,Association sportive de Monaco Football Club,30000000.0,30000000.0,22,104,-75,11,13,12,8,13,10,7,9,4,6,13,11,7,13,11,11,12,13,11,13,11,12,13,11,11,8,12,12,12,13,10,7,13,12,12,8,11,8,9,5,17,1,2,2,3,1,1,1,2,3,2,2,8,13,2,10,11,12,12,20,1,1,1,1,1,1,1,13,20,13,17,18,15,1,63,20,10,30465067,5200,5200,1150,North_African__Middle_Eastern,100,0,0,2275.0,Unknown,49055037,9111392.0,2.0,34,1518,36,0,0,6,24,10,0.4383434771103467,0.1176470588235294,0.3749999999999999,0.0021880887247768,0.0,0.0,0.1497874468617154,0.1497874468617154,0.0505924720131114,0.1428571428571428,0.4651162790697669,0.1666666666666666,103,17,14,17,0,2885,2,3,8,40000000,3053846.153846154,40000000.0,0.0,,4000000.0,1,2000000,0.6,3.0
745233,Taha,Alt?Karde?,2024,1467,TÃ¼rkiye,Bursa,TÃ¼rkiye,22-08-03,Centre-Back,Defender,Right,190.0,30-06-26,EMG Mundial,https://img.a.transfermarkt.technology/portrait/header/745233-1727795744.png?lm=1,TR1,GÃ¶ztepe Sportif Yat?r?mlar A.?.,3100000.0,3100000.0,21,85,-75,3,8,9,5,11,8,9,5,5,11,13,6,12,12,12,11,12,13,12,12,10,13,5,4,8,9,13,12,12,12,9,10,9,11,12,9,13,7,17,2,12,2,2,3,2,1,1,3,3,2,3,3,15,12,8,12,10,12,12,12,1,1,20,12,1,1,16,1,1,1,1,1,1,1,75,8,20,9688676,4697,4686,2696,Mediterranean_Hispanic,83,0,0,5317.0,Unknown,2000096481,1310000.0,1.0,100,280,100,1,1,3,110,2,0.3703360677427891,0.2829946524064171,0.2499999999999999,0.0051254964479768,0.0,0.0,0.0152538134533633,0.0152538134533633,0.0072502013944831,0.0,0.6279069767441858,0.125,80,5,5,6,1,2245,2,10,44,5500000,351666.6666666667,5500000.0,100000.0,1100000.0,2800000.0,2,550000,0.9642857142857143,4.5
745284,Vadim,Rakov,2024,932,Russia,Voronezh,Russia,09-01-05,Centre-Forward,Attack,Right,178.0,30-06-27,Unknown,https://img.a.transfermarkt.technology/portrait/header/745284-1721716089.png?lm=1,RU1,"?????????? ???? ""?????????"" ??????",800000.0,800000.0,19,75,-8,7,11,11,13,12,6,10,8,3,4,8,6,5,12,11,10,3,10,3,9,11,11,13,1,10,7,7,8,10,13,7,7,12,9,7,7,10,15,3,8,9,3,2,3,2,1,3,3,2,2,3,2,12,10,3,10,10,9,12,20,1,1,1,1,1,1,1,1,1,1,15,14,16,20,72,9,20,8926977,3498,3498,1498,Northern_European,67,0,0,826.0,Unknown,2000230767,9111392.0,2.0,78,1630,81,0,1,7,3,3,0.2131516274146599,0.1548663101604278,0.1323529411764705,0.0007889093063295,0.0,0.0,0.0037509377344336,0.0037509377344336,0.0505924720131114,0.1428571428571428,0.3488372093023257,0.0416666666666666,97,64,21,11,0,2410,0,0,0,800000,100000.0,800000.0,0.0,500000.0,,1,0,0.6,0.6
746180,Nikita,Krivtsov,2024,16704,Russia,"Volodarsk, Nizhny Novgorod Oblast",Russia,18-08-02,Attacking Midfield,Midfield,Right,186.0,30-06-29,MG MEDIATOR TRANSFER,https://img.a.transfermarkt.technology/portrait/header/746180-1721724464.png?lm=1,RU1,FK Krasnodar,3500000.0,3500000.0,22,116,-75,11,11,11,11,14,10,12,11,5,12,13,9,10,11,11,9,10,9,13,13,11,14,14,13,11,11,14,13,11,12,12,12,13,12,12,11,16,5,19,8,15,2,2,2,1,1,2,3,3,4,4,2,18,10,3,11,11,12,9,10,1,1,1,1,1,1,13,1,20,1,1,15,1,1,80,10,20,17454238,5500,5500,2918,Northern_European,109,0,0,19303.0,Unknown,2000006748,90000.0,1.0,78,1627,81,3,1,7,78,0,0.4780365175972479,0.3067379679144384,0.4411764705882353,0.0186306195303816,0.0,0.0,0.0172543135783946,0.0172543135783946,0.0004722353398705,0.0,0.5348837209302322,0.1666666666666666,144,24,11,27,0,3249,2,11,71,3500000,269230.76923076925,3500000.0,0.0,400000.0,2800000.0,3,400000,0.0,0.0
746695,Kamaldeen,Sulemana,2024,180,Ghana,Techiman,Ghana,15-02-02,Left Winger,Attack,Right,175.0,30-06-27,Unknown,https://img.a.transfermarkt.technology/portrait/header/746695-1666698770.jpg?lm=1,GB1,Southampton Football Club,13000000.0,22000000.0,22,122,-8,8,11,15,14,12,6,5,12,2,3,11,10,3,16,9,12,11,12,9,12,12,13,17,3,14,5,9,12,16,15,8,8,12,16,8,7,11,13,9,12,9,1,2,3,3,2,2,1,1,2,1,3,12,13,7,12,11,14,13,13,1,1,1,1,1,1,1,16,1,13,20,12,14,11,69,12,20,70117004,6093,6093,3993,African_Caribbean,117,11,0,9270.0,Unknown,29244869,21000000.0,2.0,39,1476,41,0,1,1,186,7,0.5564964276263562,0.421711229946524,0.4999999999999999,0.0089425815005112,0.0723684210526315,0.0,0.0647661915478869,0.1097774443610902,0.1166421289480263,0.1428571428571428,0.2790697674418605,0.1666666666666666,152,24,19,23,1,4830,5,39,75,13000000,860000.0,22000000.0,4000000.0,3000000.0,18000000.0,2,10000000,0.0,-0.1875
746833,Caleb,Wiley,2024,667,United States,"Atlanta, Georgia",United States,22-12-04,Left-Back,Defender,Left,180.0,30-06-25,Octagon,https://img.a.transfermarkt.technology/portrait/header/746833-1709363688.jpg?lm=1,FR1,Racing Club de Strasbourg Alsace,8000000.0,8000000.0,20,92,-75,9,12,11,7,11,7,7,6,8,10,11,5,9,10,9,10,11,12,10,8,8,11,10,4,11,9,10,12,13,11,11,11,17,13,12,8,12,4,18,5,11,2,1,2,2,2,3,3,2,1,3,1,18,11,4,11,11,12,12,12,1,20,1,1,20,1,1,15,1,1,14,1,1,1,74,20,7,7220372,5240,4740,3095,African_Caribbean,80,0,0,1269.0,Unknown,2000111594,10100000.0,1.0,104,105,102,1,0,1,159,8,0.3774808150304314,0.3256684491978609,0.2279411764705882,0.0012166777551716,0.0,0.0,0.0397599399849962,0.0397599399849962,0.056084891246979,0.0,0.3953488372093026,0.0833333333333332,125,6,10,10,0,1847,4,24,67,8000000,777777.7777777778,8000000.0,0.0,5000000.0,,1,3000000,0.6,0.6
746910,Mohamed,Amoura,2024,82,Algeria,Tahir,Algeria,09-05-00,Centre-Forward,Attack,Right,170.0,30-06-25,TTMA,https://img.a.transfermarkt.technology/portrait/header/746910-1724771303.jpg?lm=1,L1,Verein fÃ¼r LeibesÃ¼bungen Wolfsburg,16000000.0,16000000.0,24,137,160,7,9,10,9,13,8,8,9,5,14,13,10,14,12,12,14,16,12,13,14,13,17,10,8,10,14,14,15,16,14,12,8,14,14,14,13,12,7,10,5,8,1,2,2,4,2,1,2,1,3,2,3,13,12,1,13,13,10,10,11,1,1,1,1,1,1,17,1,20,1,1,1,1,1,73,13,20,33919997,6850,6500,4650,African_Caribbean,135,15,3,23363.0,Unknown,13193983,2600000.0,2.0,1,1465,1,0,1,1,213,3,0.6103466525535857,0.4919786096256684,0.6323529411764706,0.022551025630379,0.0986842105263157,0.0394736842105263,0.0797699424856214,0.0797699424856214,0.0144170671407539,0.1428571428571428,0.1627906976744184,0.25,0,0,0,0,0,0,6,17,39,22000000,1820833.3333333333,22000000.0,200000.0,,450000.0,3,8500000,0.375,1.2
747017,Dave,Kwakman,2024,1090,Netherlands,Volendam,Netherlands,07-08-04,Central Midfield,Midfield,Right,185.0,30-06-28,Muy Manero,https://img.a.transfermarkt.technology/portrait/header/747017-1664800779.jpg?lm=1,NL1,Alkmaar Zaanstreek,700000.0,700000.0,20,95,-75,6,6,11,5,13,6,5,8,4,8,12,10,8,13,8,11,10,14,11,13,12,10,13,8,10,10,11,11,11,13,13,10,11,11,11,9,12,4,12,5,10,2,3,3,1,3,3,1,2,2,3,1,14,9,1,12,10,12,12,13,1,1,1,1,1,1,18,1,20,1,1,15,1,1,0,10,20,15000000,4497,4497,2262,Northern_European,95,0,0,505.0,Unknown,2000014557,9111392.0,2.0,67,1625,68,3,1,7,16,1,0.3453294522360413,0.2365775401069518,0.338235294117647,0.0004789461639405,0.0,0.0,0.0032508127031757,0.0032508127031757,0.0505924720131114,0.1428571428571428,0.5116279069767438,0.0833333333333332,148,8,15,14,0,5672,1,3,57,1000000,180000.0,1000000.0,-100000.0,350000.0,1000000.0,1,300000,0.42857142857142855,1.2222222222222223
747153,Daniel,Gore,2024,985,England,Manchester,England,26-09-04,Central Midfield,Midfield,Right,183.0,30-06-26,CAA Stellar,https://img.a.transfermarkt.technology/portrait/header/747153-1693217936.jpg?lm=1,GB1,Manchester United Football Club,900000.0,900000.0,20,90,-8,6,8,10,9,12,7,2,7,2,5,13,6,8,13,10,9,8,11,10,11,9,17,10,5,10,7,12,11,12,13,10,4,10,11,11,6,19,8,17,14,15,3,3,1,3,2,1,2,1,3,1,1,9,13,6,11,8,14,12,16,1,1,1,1,1,1,18,1,20,1,14,14,12,1,62,14,20,37581322,4755,4505,2259,Northern_European,82,0,0,1392.0,Unknown,2000123626,9111392.0,2.0,32,905,33,3,1,7,132,1,0.3463879333156919,0.2362566844919786,0.2426470588235293,0.0013354486788907,0.0,0.0,0.0042510627656914,0.0042510627656914,0.0505924720131114,0.1428571428571428,0.4651162790697669,0.0833333333333332,78,6,12,23,0,2612,1,20,177,900000,100000.0,900000.0,0.0,,900000.0,0,0,0.0,0.0
747487,Valdemar,Byskov,2024,865,Denmark,Herning,Denmark,25-01-05,Attacking Midfield,Midfield,Right,180.0,31-12-27,Elite Consulting,https://img.a.transfermarkt.technology/portrait/header/747487-1727290319.jpg?lm=1,DK1,Fodbold Club Midtjylland,450000.0,450000.0,19,78,-75,6,8,10,7,11,6,4,6,3,3,11,1,3,11,12,7,8,7,3,10,10,13,15,4,8,2,7,10,13,13,5,6,12,13,7,4,10,13,15,9,9,3,3,3,3,3,3,1,2,3,2,2,20,10,2,11,10,13,11,15,1,1,1,1,1,1,1,8,12,13,15,20,18,1,0,15,20,3280280,4592,3992,624,Northern_European,65,0,0,1227.0,Unknown,2000140078,9111392.0,2.0,28,620,30,3,1,7,86,0,0.2785128340830908,0.0613903743315507,0.1176470588235293,0.0011761218299992,0.0,0.0,0.0020005001250312,0.0020005001250312,0.0505924720131114,0.1428571428571428,0.3953488372093026,0.0416666666666666,116,28,27,9,0,3663,0,0,0,750000,108333.33333333333,750000.0,0.0,350000.0,,2,200000,0.6666666666666666,1.1428571428571428
747720,Jayden,Addai,2024,1090,Unknown,Unknown,Netherlands,26-08-05,Right Winger,Attack,Left,177.0,30-06-28,Forza Sports Group,https://img.a.transfermarkt.technology/portrait/header/747720-1723819872.jpg?lm=1,NL1,Alkmaar Zaanstreek,1000000.0,1000000.0,19,98,-8,9,9,14,10,15,9,9,15,7,9,11,1,9,12,12,11,5,11,10,11,11,13,10,12,13,7,10,11,13,13,15,9,11,13,6,5,9,9,19,5,11,4,2,1,3,3,1,2,2,3,4,2,20,11,7,13,7,14,10,10,1,1,1,1,1,1,1,1,1,12,16,1,20,1,0,20,12,27300000,4800,4800,2654,North_African__Middle_Eastern,101,0,0,115.0,Unknown,2000129012,9111392.0,2.0,105,1549,68,0,0,6,16,10,0.3854194231278116,0.2785026737967914,0.3823529411764706,0.0001023554301969,0.0,0.0,0.0047511877969492,0.0047511877969492,0.0505924720131114,0.1428571428571428,0.3255813953488373,0.0416666666666666,145,58,17,10,0,7369,0,0,0,1500000,225000.0,1500000.0,0.0,1000000.0,,2,650000,0.5,0.875
748316,Juan Manuel,Cruz,2024,276,Argentina,Buenos Aires,Argentina,19-07-99,Centre-Forward,Attack,Right,185.0,30-06-27,Nauru BR,https://img.a.transfermarkt.technology/portrait/header/748316-1695711115.jpg?lm=1,IT1,Verona Hellas Football Club,450000.0,1300000.0,25,121,130,7,7,12,13,13,8,14,12,8,5,9,12,6,13,9,13,12,13,10,11,12,12,12,8,13,8,13,12,12,13,13,11,13,13,14,12,11,8,9,5,10,2,1,1,1,2,4,3,2,2,3,1,12,11,5,10,11,13,14,11,1,1,1,1,1,1,1,1,1,1,1,1,1,20,71,12,20,3035736,5925,5925,3413,Mediterranean_Hispanic,121,0,0,267.0,Unknown,14244914,9111392.0,2.0,4,275,4,0,1,3,214,3,0.5342683249536915,0.3596791443850267,0.5294117647058822,0.0002491292546303,0.0,0.0,0.0020005001250312,0.0062515628907226,0.0505924720131114,0.1428571428571428,0.5116279069767438,0.2916666666666665,80,11,2,3,0,2448,4,39,165,400000,34090.90909090909,1300000.0,300000.0,,,1,0,-0.1111111111111111,-0.1111111111111111
748382,Amin,Sarr,2024,276,Sweden,MalmÃ¶,Sweden,11-03-01,Centre-Forward,Attack,Right,188.0,30-06-25,Unknown,https://img.a.transfermarkt.technology/portrait/header/748382-1695624167.jpg?lm=1,IT1,Verona Hellas Football Club,4000000.0,9000000.0,23,121,135,7,7,12,13,12,8,10,10,6,5,11,9,5,13,13,12,12,12,12,9,11,14,13,6,13,7,12,11,15,13,13,14,12,15,13,13,11,8,12,5,7,3,2,1,2,1,3,3,2,4,2,2,8,12,6,10,10,11,10,11,1,1,1,1,1,1,1,10,1,10,17,1,16,20,83,9,20,4880000,6250,5500,3852,African_Caribbean,117,0,0,3999.0,Unknown,93122985,6650000.0,2.0,91,902,91,0,1,1,214,3,0.4780365175972479,0.4066310160427807,0.4999999999999999,0.0038528128913767,0.0,0.0,0.0197549387346836,0.0447611902975743,0.0369176921581154,0.1428571428571428,0.581395348837209,0.2083333333333332,132,25,11,3,0,3207,3,11,49,4000000,291666.6666666667,9000000.0,4000000.0,,800000.0,6,11050000,0.0,0.0
748601,Gastón,Ávila,2024,610,Argentina,Rosario,Argentina,30-09-01,Centre-Back,Defender,Left,182.0,30-06-28,Carlos Bilicich,https://img.a.transfermarkt.technology/portrait/header/748601-1666894690.jpg?lm=1,NL1,AFC Ajax Amsterdam,5000000.0,6000000.0,23,126,-85,6,6,6,10,13,13,14,10,6,14,13,14,14,12,14,12,14,13,11,13,12,14,6,12,10,14,14,13,14,12,12,12,14,13,12,13,13,11,12,13,12,3,3,2,4,1,2,3,3,3,3,3,13,11,8,7,13,12,10,8,1,13,20,7,1,1,1,1,1,1,1,1,1,1,80,20,8,23100000,5400,5472,3015,Mediterranean_Hispanic,127,0,0,4999.0,Unknown,14207518,6233333.333,3.0,4,1248,4,1,0,3,6,2,0.4743318338184705,0.3171122994652406,0.5735294117647058,0.0048184301573859,0.0,0.0,0.0247561890472618,0.0297574393598399,0.034602813039251,0.2857142857142857,0.4418604651162785,0.2083333333333332,91,4,3,16,1,5179,3,58,350,4000000,166666.66666666666,6000000.0,1000000.0,,4500000.0,4,6500000,-0.2,-0.2
748804,Mika,Godts,2024,610,Belgium,Leuven,Belgium,07-06-05,Left Winger,Attack,Right,176.0,30-06-27,Christophe Henrotay,https://img.a.transfermarkt.technology/portrait/header/748804-1652692872.jpg?lm=1,NL1,AFC Ajax Amsterdam,4000000.0,4000000.0,19,87,-75,8,10,7,7,15,8,8,10,4,4,12,6,8,12,6,12,9,9,9,10,15,6,9,4,12,12,7,8,11,11,10,5,6,12,8,8,15,5,17,9,11,1,1,3,2,1,1,2,1,2,1,2,15,10,1,11,11,10,11,11,1,1,1,1,1,1,1,1,12,1,15,20,12,1,0,11,20,15200000,4251,4251,2005,Northern_European,86,0,0,1249.0,Unknown,2000102845,1000000.0,1.0,7,826,8,0,1,7,6,7,0.3127811590367823,0.209090909090909,0.2720588235294117,0.0011973654098514,0.0,0.0,0.0197549387346836,0.0197549387346836,0.0055279313314258,0.0,0.3023255813953489,0.0416666666666666,99,26,13,7,0,4296,4,20,91,10000000,1314285.7142857143,10000000.0,0.0,4000000.0,,2,2200000,1.5,4.0
749559,Unknown,Victor Hugo,2024,1467,Brazil,Rio de Janeiro,Brazil,11-05-04,Attacking Midfield,Midfield,Left,182.0,30-06-25,Roc Nation Sports,https://img.a.transfermarkt.technology/portrait/header/749559-1660511634.jpg?lm=1,TR1,GÃ¶ztepe Sportif Yat?r?mlar A.?.,5000000.0,5000000.0,20,135,141,4,9,10,9,11,6,15,10,5,14,11,9,15,10,12,15,14,13,13,11,13,14,10,14,8,14,13,12,12,11,12,16,13,12,14,15,12,12,12,8,7,2,2,3,3,2,3,3,2,1,1,2,13,13,10,12,13,13,12,11,1,1,20,1,1,1,1,1,1,1,1,1,1,1,80,20,9,4809065,6700,6600,4850,Mixed_Race,135,0,0,43268.0,Unknown,19144097,9111392.0,2.0,10,1234,11,3,0,4,110,0,0.6235776660492194,0.5133689839572192,0.6323529411764706,0.0417716373102924,0.0,0.0,0.0247561890472618,0.0247561890472618,0.0505924720131114,0.1428571428571428,0.4418604651162785,0.0833333333333332,131,10,5,8,0,2549,0,0,0,5000000,388888.8888888889,5000000.0,0.0,3000000.0,5000000.0,1,0,0.0,0.0
752862,Tymur,Puzankov,2024,660,Ukraine,"Kremenchuk, Poltava Oblast",Ukraine,04-03-03,Goalkeeper,Goalkeeper,Right,194.0,30-06-28,Unknown,https://img.a.transfermarkt.technology/portrait/header/752862-1723486365.png?lm=1,UKR1,FC Shakhtar Donetsk,100000.0,100000.0,21,108,-75,2,3,2,1,10,4,11,5,4,4,12,9,5,11,6,9,10,8,10,11,12,11,3,6,11,9,12,13,9,11,10,18,9,12,11,10,8,4,9,7,1,16,11,10,3,12,10,13,15,8,10,11,5,8,5,20,9,15,14,5,20,1,1,1,1,1,1,1,1,1,1,1,1,1,0,4,20,13798412,4500,4536,2016,Northern_European,101,0,0,1160.0,Unknown,71109701,9111392.0,2.0,103,759,101,2,1,7,72,5,0.3504895474993384,0.2102673796791443,0.3823529411764706,0.0011114254731766,0.0,0.0,0.0002500625156289,0.0002500625156289,0.0505924720131114,0.1428571428571428,0.7209302325581395,0.125,0,0,0,0,0,0,1,39,317,100000,10000.0,100000.0,0.0,,100000.0,0,0,0.0,0.0
756990,Alan,Varela,2024,720,Argentina,Isidro Casanova,Argentina,04-07-01,Defensive Midfield,Midfield,Right,177.0,30-06-28,Sports360 GmbH,https://img.a.transfermarkt.technology/portrait/header/756990-1693590239.png?lm=1,PO1,Futebol Clube do Porto,35000000.0,35000000.0,23,130,145,4,8,12,7,14,5,8,13,3,14,14,13,12,13,13,13,11,13,13,15,13,14,14,12,13,14,16,14,14,14,12,7,15,13,14,12,14,10,13,6,10,1,1,2,2,3,2,2,1,2,2,2,17,12,6,16,14,12,14,14,1,1,1,1,1,1,20,1,19,1,1,1,1,1,72,8,20,8859170,6455,5842,3130,Mediterranean_Hispanic,130,0,0,1881.0,Unknown,14241914,8000000.0,1.0,4,663,4,3,1,3,100,4,0.5232865837523154,0.3294117647058823,0.5955882352941175,0.0018076355219692,0.0,0.0,0.1747936984246061,0.1747936984246061,0.044417900497236,0.0,0.3255813953488373,0.2083333333333332,187,4,10,48,0,6262,2,3,8,35000000,2750000.0,35000000.0,1000000.0,,7000000.0,1,5000000,0.0,1.5
764859,Williot,Swedberg,2024,940,Sweden,Stockholm,Sweden,01-02-04,Attacking Midfield,Midfield,Right,187.0,30-06-27,Nordic Sky,https://img.a.transfermarkt.technology/portrait/header/764859-1653656881.png?lm=1,ES1,Real Club Celta de Vigo S. A. D.,5000000.0,5000000.0,20,114,-85,8,12,12,11,13,9,8,9,6,11,12,11,8,13,8,13,12,13,13,12,12,14,12,8,13,12,10,10,11,12,10,12,12,12,12,8,13,9,6,5,14,1,3,2,2,3,2,2,2,2,2,1,14,13,1,18,15,15,16,18,1,1,1,1,1,1,14,14,20,14,15,15,15,15,67,12,20,54900000,5700,5700,3004,Northern_European,107,0,0,3068.0,Unknown,2000008568,5500000.0,1.0,91,1426,91,3,1,7,165,0,0.5044985445885155,0.3159358288770053,0.4264705882352941,0.0029538232167221,0.0,0.0,0.0247561890472618,0.0247561890472618,0.0305286257951609,0.0,0.5581395348837206,0.0833333333333332,120,18,6,16,0,5013,4,11,50,5000000,455555.55555555556,5000000.0,1000000.0,5000000.0,5000000.0,1,0,0.0,1.0
766583,Kike,Salas,2024,368,Spain,Sevilla,Spain,23-04-02,Centre-Back,Defender,Left,188.0,30-06-26,YOU FIRST,https://img.a.transfermarkt.technology/portrait/header/766583-1647594742.png?lm=1,ES1,Sevilla FÃºtbol Club S.A.D.,10000000.0,10000000.0,22,117,-8,6,5,8,8,13,4,12,6,4,12,15,9,15,15,14,12,12,13,12,9,12,2,6,11,9,15,10,11,12,10,11,15,12,10,6,7,14,8,13,8,13,2,3,2,3,1,2,1,2,1,3,2,18,13,7,8,11,8,10,12,1,12,20,1,1,1,1,1,1,1,1,1,1,1,0,20,12,44670004,5850,5850,3376,Mediterranean_Hispanic,108,0,0,3898.0,Unknown,2000165617,9111392.0,2.0,89,1364,89,1,0,3,181,2,0.5243450648319662,0.3557219251336898,0.4338235294117646,0.0037552855475098,0.0,0.0,0.0497624406101525,0.0497624406101525,0.0505924720131114,0.1428571428571428,0.581395348837209,0.1666666666666666,109,6,6,26,1,2791,4,9,32,8000000,603846.1538461539,10000000.0,2000000.0,,1500000.0,2,1500000,-0.2,3.0
766723,Manu,Bueno,2024,368,Spain,Jerez de la Frontera,Spain,27-07-04,Central Midfield,Midfield,Left,178.0,30-06-26,YOU FIRST,https://img.a.transfermarkt.technology/portrait/header/766723-1702412015.jpg?lm=1,ES1,Sevilla FÃºtbol Club S.A.D.,300000.0,300000.0,20,85,-75,7,6,10,8,15,6,7,8,4,9,14,2,7,13,14,14,7,11,7,11,14,16,10,4,14,6,14,9,10,10,8,5,10,10,6,4,16,7,8,12,19,3,3,3,1,4,1,2,3,2,3,3,10,14,1,10,8,11,12,13,1,1,1,1,1,1,1,1,20,1,1,1,1,1,0,20,12,6354963,4250,4250,1750,Mediterranean_Hispanic,81,0,0,348.0,Unknown,2000187407,9111392.0,2.0,89,688,89,3,0,3,181,1,0.3126488489018258,0.1818181818181818,0.2352941176470588,0.0003273442531771,0.0,0.0,0.0012503125781445,0.0012503125781445,0.0505924720131114,0.1428571428571428,0.3488372093023257,0.0833333333333332,95,4,10,13,0,1537,0,0,0,1500000,240000.0,1500000.0,0.0,300000.0,1500000.0,0,0,4.0,4.0
768380,Arouna,Sangante,2024,738,Senegal,Mbao,Senegal,12-04-02,Centre-Back,Defender,Right,189.0,30-06-26,Pinnacle Sports,https://img.a.transfermarkt.technology/portrait/header/768380-1661006246.jpg?lm=1,FR1,Le Havre Athletic Club,10000000.0,10000000.0,22,110,-75,5,8,6,6,10,6,12,7,8,13,11,6,12,8,12,14,13,13,12,7,10,9,6,8,9,14,12,12,13,12,13,14,14,13,13,11,12,5,10,4,12,2,1,3,2,2,2,1,1,2,1,2,10,12,4,14,13,15,12,10,1,1,20,10,1,1,1,1,1,1,1,1,1,1,76,7,20,5576250,5650,5500,2264,African_Caribbean,110,0,0,4590.0,Unknown,49062287,9111392.0,2.0,83,933,84,1,1,1,126,2,0.4780365175972479,0.2367914438502673,0.4485294117647059,0.0044234926955881,0.0,0.0,0.0497624406101525,0.0497624406101525,0.0505924720131114,0.1428571428571428,0.6046511627906974,0.1666666666666666,143,6,3,32,2,2437,4,11,79,10000000,816666.6666666666,10000000.0,0.0,,4000000.0,0,0,0.0,0.0
769063,Luka,Romero,2024,1108,Mexico,Victoria de Durango,Argentina,18-11-04,Right Winger,Attack,Right,169.0,30-06-25,LIAN Sports Group,https://img.a.transfermarkt.technology/portrait/header/769063-1695024330.jpg?lm=1,ES1,Deportivo AlavÃ©s S.A.D.,5000000.0,5000000.0,20,126,137,8,9,11,8,13,8,6,12,11,15,12,12,14,14,16,14,15,13,12,12,11,16,11,11,11,14,14,16,13,13,11,5,16,14,16,10,10,15,12,10,18,2,2,2,2,2,1,1,2,3,3,2,12,16,8,9,15,13,13,13,1,1,1,14,1,13,20,1,19,1,1,1,1,1,70,8,20,2131675,6347,6347,4036,Mediterranean_Hispanic,126,0,0,26383.0,Unknown,14047196,200000.0,1.0,63,1583,4,0,1,3,59,10,0.590103201905266,0.4263101604278074,0.5661764705882353,0.0254671897737269,0.0,0.0,0.0247561890472618,0.0247561890472618,0.0010833634267618,0.0,0.13953488372093,0.0833333333333332,67,6,0,4,0,2189,1,1,7,3500000,227272.72727272726,5000000.0,1500000.0,3000000.0,3500000.0,4,3500000,-0.3,0.16666666666666666
774771,Malamine,Efekele,2024,520,France,Livry-Gargan,France,19-07-04,Right Winger,Attack,Right,180.0,30-06-25,Unknown,https://img.a.transfermarkt.technology/portrait/header/774771-1693948808.png?lm=1,BE1,Cercle Brugge Koninklijke Sportvereniging,500000.0,500000.0,20,92,-8,8,11,13,12,16,9,7,10,5,6,10,7,5,12,12,7,7,11,9,11,10,10,11,7,12,6,11,12,13,12,10,7,11,12,10,9,10,10,14,4,16,2,1,2,1,3,3,2,2,1,1,1,12,10,1,8,12,10,11,15,1,1,1,1,1,1,1,12,1,12,15,14,20,14,0,10,20,18960000,4607,4607,1114,African_Caribbean,96,0,0,703.0,Unknown,2000031533,9111392.0,2.0,34,848,36,0,1,1,49,10,0.3598835670812385,0.1137967914438502,0.3455882352941176,0.0006701383826103,0.0,0.0,0.0022505626406601,0.0022505626406601,0.0505924720131114,0.1428571428571428,0.3953488372093026,0.0833333333333332,39,7,0,4,0,1649,2,12,28,500000,80000.0,500000.0,0.0,100000.0,500000.0,1,200000,0.0,0.6666666666666666
775605,Pablo,Barrios,2024,13,Spain,Madrid,Spain,15-06-03,Central Midfield,Midfield,Right,181.0,30-06-28,CAA Stellar,https://img.a.transfermarkt.technology/portrait/header/775605-1699431384.jpg?lm=1,ES1,Club AtlÃ©tico de Madrid S.A.D.,25000000.0,25000000.0,21,105,-8,8,8,6,9,14,8,8,8,4,11,14,7,8,14,6,7,7,9,10,12,12,8,5,8,9,7,9,13,14,14,9,10,5,14,9,9,9,7,14,9,14,3,1,1,3,1,3,3,2,1,2,3,14,11,1,11,11,13,12,16,1,1,1,1,1,1,14,1,20,1,1,1,1,1,0,8,20,21960001,5250,5250,2250,Mediterranean_Hispanic,94,0,0,1944.0,Unknown,2000125958,9111392.0,2.0,89,892,89,3,1,3,52,1,0.4449589838581635,0.2352941176470588,0.3308823529411764,0.0018684694097278,0.0,0.0,0.1247811952988247,0.1247811952988247,0.0505924720131114,0.1428571428571428,0.418604651162791,0.125,108,6,6,13,2,2538,6,40,52,50000000,5544444.444444444,50000000.0,0.0,,25000000.0,0,0,1.0,1.0
776798,Abdallah,Sima,2024,3911,Senegal,Dakar,Senegal,17-06-01,Right Winger,Attack,Right,188.0,30-06-25,PSM,https://img.a.transfermarkt.technology/portrait/header/776798-1672669896.jpg?lm=1,FR1,Stade brestois 29,8000000.0,11000000.0,23,121,144,4,7,14,15,11,6,15,6,3,11,8,6,10,11,10,10,11,13,9,10,15,7,13,13,13,7,13,10,16,12,12,16,7,15,11,13,12,8,1,14,14,1,1,1,3,2,1,3,1,2,3,4,14,13,2,14,12,8,13,11,1,1,1,1,1,1,1,6,1,12,14,1,20,15,74,8,20,15171719,6050,6050,4500,African_Caribbean,114,4,0,9279.0,Angers SCO,2000052135,4057500.0,2.0,83,402,84,0,1,1,196,10,0.5508070918232336,0.4759358288770053,0.4779411764705882,0.0089512720559053,0.0263157894736842,0.0,0.0397599399849962,0.0547636909227306,0.0225145142920636,0.1428571428571428,0.581395348837209,0.2083333333333332,159,54,15,15,1,4625,8,76,99,10000000,181818.18181818182,11000000.0,3000000.0,,8000000.0,4,5500000,0.3333333333333333,0.42857142857142855
776890,Nicolas,Jackson,2024,631,Unknown,Unknown,Senegal,20-06-01,Centre-Forward,Attack,Right,187.0,30-06-33,Epic Jackson,https://img.a.transfermarkt.technology/portrait/header/776890-1726227971.jpg?lm=1,GB1,Chelsea Football Club,40000000.0,40000000.0,23,133,158,8,9,15,14,12,8,13,10,6,8,11,13,9,15,7,10,12,13,11,12,10,12,12,7,9,11,9,12,16,13,8,12,8,16,14,12,9,7,6,13,16,3,1,1,4,3,1,3,3,3,4,1,13,9,5,13,11,9,12,16,1,1,1,1,1,1,1,12,12,12,16,16,18,20,78,7,20,18300000,6650,6650,4850,African_Caribbean,121,0,0,15220.0,Unknown,12087972,37000000.0,1.0,105,1549,84,0,1,1,50,3,0.6301931727970362,0.5133689839572192,0.5294117647058822,0.014688004233266,0.0,0.0,0.1997999499874969,0.1997999499874969,0.2055334870413067,0.0,0.5581395348837206,0.2083333333333332,160,47,26,26,2,2496,6,29,70,55000000,3921428.5714285714,55000000.0,100000.0,,500000.0,3,14000000,0.5714285714285714,0.5714285714285714
780630,Willy,Kambwala,2024,1050,DR Congo,Kinshasa,France,25-08-04,Centre-Back,Defender,Right,192.0,30-06-29,Darren Dein,https://img.a.transfermarkt.technology/portrait/header/780630-1705304426.jpg?lm=1,ES1,Villarreal Club de FÃºtbol S.A.D.,5000000.0,5000000.0,20,75,-75,1,4,5,4,10,2,8,2,4,10,9,3,9,10,13,10,12,9,8,6,8,10,8,6,4,10,10,10,12,8,11,14,14,14,9,11,9,6,13,6,8,1,1,3,2,2,2,3,3,2,2,2,10,13,8,12,13,13,13,7,1,1,20,1,1,1,1,1,1,1,1,1,1,1,76,8,20,22340008,3735,3735,1735,African_Caribbean,65,0,0,1740.0,Unknown,2000006158,9111392.0,2.0,27,729,36,1,1,1,216,2,0.244509129399312,0.1802139037433155,0.1176470588235293,0.0016714834874619,0.0,0.0,0.0247561890472618,0.0247561890472618,0.0505924720131114,0.1428571428571428,0.6744186046511627,0.0833333333333332,63,2,1,6,1,4407,1,8,92,4000000,500000.0,5000000.0,1000000.0,,4000000.0,2,4000000,-0.2,1.0
782630,Khalil,Fayad,2024,969,France,Montpellier,Morocco,09-06-04,Central Midfield,Midfield,Right,172.0,30-06-27,Unknown,https://img.a.transfermarkt.technology/portrait/header/782630-1702663427.JPG?lm=1,FR1,Montpellier HÃ©rault Sport Club,5000000.0,5000000.0,20,95,-75,8,8,8,7,13,8,8,7,3,10,13,5,10,15,8,11,9,10,10,13,14,14,5,8,6,8,9,13,12,11,9,5,6,11,11,10,15,10,8,12,12,3,2,3,3,3,2,1,1,3,2,3,8,14,12,10,13,9,10,13,1,1,1,1,1,1,12,1,20,1,1,1,1,1,61,12,20,11034399,4747,4747,1747,North_African__Middle_Eastern,96,0,0,2320.0,Unknown,2000006178,9111392.0,2.0,34,978,67,3,1,6,133,1,0.3784069859751257,0.1814973262032085,0.3455882352941176,0.0022315415017472,0.0,0.0,0.0247561890472618,0.0247561890472618,0.0505924720131114,0.1428571428571428,0.2093023255813952,0.0833333333333332,79,4,4,10,1,1580,5,18,53,4000000,500000.0,5000000.0,1000000.0,2500000.0,4000000.0,0,0,-0.2,-0.2
783396,Ramón,Terrats,2024,1050,Unknown,Unknown,Spain,18-10-00,Defensive Midfield,Midfield,Left,181.0,30-06-26,MagicPlayers,https://img.a.transfermarkt.technology/portrait/header/783396-1726231968.jpg?lm=1,ES1,Villarreal Club de FÃºtbol S.A.D.,4000000.0,4000000.0,24,113,145,13,12,12,8,15,12,9,8,5,7,13,7,10,15,8,12,8,10,11,14,13,14,13,13,12,10,13,12,12,12,11,10,10,11,13,11,11,6,19,10,12,3,4,1,1,1,1,2,3,1,2,3,15,13,4,12,12,12,11,10,1,1,1,1,1,1,15,14,20,10,1,1,1,1,0,20,8,3807999,5650,5650,3150,Mediterranean_Hispanic,111,0,0,2973.0,Unknown,2000063225,2500000.0,1.0,105,1549,89,3,0,3,216,4,0.4978830378406986,0.3315508021390373,0.4558823529411764,0.0028620895764512,0.0,0.0,0.0197549387346836,0.0197549387346836,0.0138614961526709,0.0,0.418604651162791,0.25,119,2,5,19,0,3554,3,31,97,3500000,309090.9090909091,4000000.0,500000.0,,1000000.0,1,2500000,-0.125,-0.125
786436,Ismaël,Doukouré,2024,667,France,Lille,France,24-07-03,Defensive Midfield,Midfield,Right,183.0,30-06-26,Unknown,https://img.a.transfermarkt.technology/portrait/header/786436-1618842420.jpg?lm=1,FR1,Racing Club de Strasbourg Alsace,10000000.0,12000000.0,21,102,-75,8,3,10,4,10,7,13,5,10,11,12,5,12,13,5,12,11,11,12,11,10,5,5,8,9,10,10,11,10,12,13,12,13,10,9,12,11,10,16,9,7,3,3,1,3,2,3,3,1,2,1,2,10,12,7,10,12,13,9,13,1,1,20,1,1,1,1,1,1,1,1,1,1,1,80,11,20,20543999,5089,5089,2339,African_Caribbean,93,0,0,1535.0,Unknown,2000016808,1500000.0,1.0,34,834,36,3,1,1,159,4,0.4236570521301932,0.2448128342245989,0.3235294117647059,0.00147353194793,0.0,0.0,0.0497624406101525,0.0597649412353088,0.0083057862718408,0.0,0.4651162790697669,0.125,112,2,2,24,0,1610,2,15,69,15000000,1060714.2857142857,15000000.0,2000000.0,1500000.0,10000000.0,1,0,0.5,0.25
787151,Lukas,Ullrich,2024,18,Germany,Berlin,Germany,16-03-04,Left-Back,Defender,Left,180.0,30-06-27,SEG,https://img.a.transfermarkt.technology/portrait/header/787151-1691248738.jpg?lm=1,L1,Borussia Verein fÃ¼r LeibesÃ¼bungen 1900 MÃ¶nchengladbach,750000.0,750000.0,20,95,-75,9,14,10,6,15,9,9,6,9,11,11,5,15,11,15,12,9,10,12,11,12,5,5,1,9,10,10,11,11,14,10,9,11,15,11,8,9,9,2,5,15,1,1,1,2,3,1,2,3,1,1,1,7,11,5,13,11,9,9,20,1,20,1,1,17,1,1,15,1,1,10,1,1,1,0,20,6,15080000,4363,4363,1620,Northern_European,99,0,0,807.0,Unknown,2000154596,9111392.0,2.0,38,178,40,1,0,7,42,8,0.327599894151892,0.1679144385026738,0.3676470588235294,0.0007705625782753,0.0,0.0,0.0035008752188047,0.0035008752188047,0.0505924720131114,0.1428571428571428,0.3953488372093026,0.0833333333333332,90,12,16,19,0,1668,3,13,70,3000000,343750.0,3000000.0,0.0,350000.0,3000000.0,1,0,3.0,3.0
787618,Valentín,Carboni,2024,244,Argentina,Buenos Aires,Argentina,05-03-05,Attacking Midfield,Midfield,Left,185.0,30-06-25,GR Sports,https://img.a.transfermarkt.technology/portrait/header/787618-1667405332.jpg?lm=1,FR1,Olympique de Marseille,15000000.0,15000000.0,19,99,-85,5,10,14,14,14,6,4,12,2,3,14,9,4,15,7,10,4,11,5,13,12,16,15,6,11,4,9,7,13,14,8,5,15,14,9,6,13,5,10,3,14,1,1,2,3,1,1,2,1,1,3,1,11,18,3,13,13,14,11,13,1,1,1,1,1,1,1,1,10,1,8,20,17,16,0,20,8,22400000,4850,4850,1750,Mediterranean_Hispanic,94,0,0,2123.0,Unknown,2000097988,300000.0,1.0,4,275,4,3,0,3,144,0,0.3920349298756285,0.1818181818181818,0.3308823529411764,0.0020413149003434,0.0,0.0,0.0747686921730432,0.0747686921730432,0.0016389344148448,0.0,0.5116279069767438,0.0416666666666666,91,14,14,12,0,3418,2,35,265,12000000,1387500.0,15000000.0,3000000.0,5000000.0,,2,3000000,-0.2,1.4
787912,El Chadaille,Bitshiabu,2024,23826,France,Villeneuve-Saint-Georges,France,16-05-05,Centre-Back,Defender,Left,196.0,30-06-28,Gestifute,https://img.a.transfermarkt.technology/portrait/header/787912-1672304780.jpg?lm=1,L1,RasenBallsport Leipzig,12000000.0,15000000.0,19,100,-85,6,7,7,7,11,6,15,8,4,10,10,6,11,11,12,11,12,11,11,12,10,4,9,10,7,11,11,11,8,11,12,16,15,10,12,15,10,8,10,5,19,2,3,2,1,2,2,1,2,2,4,2,20,15,8,11,14,12,11,17,1,1,20,1,1,1,1,1,1,1,1,1,1,1,95,20,8,29400001,5000,5000,2500,African_Caribbean,96,0,0,1388.0,Unknown,2000100253,9111392.0,2.0,34,1604,36,1,0,1,162,2,0.4118814501190792,0.2620320855614972,0.3455882352941176,0.0013315862098267,0.0,0.0,0.0597649412353088,0.0747686921730432,0.0505924720131114,0.1428571428571428,0.7674418604651163,0.0416666666666666,80,3,1,3,1,3582,3,23,86,12000000,1045454.5454545454,15000000.0,3000000.0,12000000.0,,2,8000000,0.0,-0.2
788445,Zidan,Sertdemir,2024,2778,Denmark,IshÃ¸j,Denmark,04-02-05,Central Midfield,Midfield,Left,186.0,31-12-25,Unknown,https://img.a.transfermarkt.technology/portrait/header/788445-1658913730.jpg?lm=1,DK1,Fodbold Club NordsjÃ¦lland,1200000.0,2000000.0,19,90,-8,9,8,12,11,13,12,8,12,3,3,12,12,4,13,9,10,9,10,10,11,9,8,12,5,12,5,12,12,11,12,8,10,13,11,10,7,12,4,12,5,11,2,2,1,3,3,1,2,1,1,2,2,8,9,5,10,11,14,14,13,1,1,1,1,1,1,1,1,17,10,1,20,10,1,76,20,12,5960000,4496,3670,2581,Mediterranean_Hispanic,90,0,0,6711.0,Unknown,2000016037,1750000.0,2.0,28,662,30,3,0,3,87,1,0.23590897062715,0.2706951871657753,0.3014705882352941,0.0064715669167937,0.0,0.0,0.0057514378594648,0.0097524381095273,0.0096947137420483,0.1428571428571428,0.5348837209302322,0.0416666666666666,98,14,8,12,0,4056,1,14,106,1700000,-37500.0,2000000.0,1000000.0,1000000.0,,1,1000000,0.4166666666666667,0.7
789082,Unknown,Vanderson,2024,162,Brazil,RondonÃ³polis,Brazil,21-06-01,Right-Back,Defender,Right,173.0,30-06-28,Bertolucci Sports,https://img.a.transfermarkt.technology/portrait/header/789082-1655282894.jpg?lm=1,FR1,Association sportive de Monaco Football Club,20000000.0,20000000.0,23,137,146,14,12,15,11,13,13,6,11,6,7,14,4,10,15,11,13,12,14,13,13,12,14,14,9,15,8,12,12,15,14,14,8,13,15,14,9,11,9,8,5,12,2,1,2,1,4,1,3,2,1,3,2,14,15,4,11,12,8,10,14,1,1,1,1,1,1,1,12,1,13,18,1,20,13,74,9,20,12770906,6850,6500,4700,Mixed_Race,135,0,0,38461.0,INT,18073840,11000000.0,1.0,10,1246,11,1,1,4,24,11,0.6103466525535857,0.4973262032085561,0.6323529411764706,0.0371299151125861,0.0,0.0,0.0997749437359339,0.0997749437359339,0.0610850301397261,0.0,0.2325581395348837,0.2083333333333332,0,0,0,0,0,0,5,21,38,20000000,1781818.1818181819,20000000.0,0.0,,18000000.0,1,2500000,0.0,0.0
789252,Bence,Dárdai,2024,82,Germany,Berlin,Germany,24-01-06,Attacking Midfield,Midfield,Right,189.0,Unknown,PRO Profil GmbH,https://img.a.transfermarkt.technology/portrait/header/789252-1695045596.jpg?lm=1,L1,Verein fÃ¼r LeibesÃ¼bungen Wolfsburg,2000000.0,2000000.0,18,87,-8,12,8,12,9,12,12,7,10,3,6,13,12,6,14,13,8,8,11,8,12,9,15,15,6,12,6,9,9,12,12,10,11,13,12,10,7,11,7,14,6,12,1,2,3,3,3,3,1,3,1,1,1,8,12,5,16,12,12,9,9,1,1,1,1,1,1,1,10,18,10,16,20,15,13,0,7,20,15359999,4362,3617,1944,Northern_European,85,0,0,64.0,Unknown,2000215183,9111392.0,2.0,38,178,40,3,1,7,213,0,0.2288965334744641,0.2025668449197861,0.2647058823529412,5.310894963050656e-05,0.0,0.0,0.0097524381095273,0.0097524381095273,0.0505924720131114,0.1428571428571428,0.6046511627906974,0.0,76,12,28,16,0,3838,1,18,114,6000000,1100000.0,6000000.0,0.0,6000000.0,,1,4000000,2.0,2.0
791528,Telmo,Arcanjo,2024,2420,Portugal,Lisboa,Cape Verde,21-06-01,Attacking Midfield,Midfield,Left,180.0,30-06-27,STV ,https://img.a.transfermarkt.technology/portrait/header/791528-1695206920.jpg?lm=1,PO1,VitÃ³ria Sport Clube,800000.0,1000000.0,23,114,152,13,13,13,9,14,11,7,12,5,8,14,10,11,15,12,12,14,11,9,14,12,13,5,10,8,11,13,13,12,12,14,10,13,12,13,13,12,5,10,5,5,4,2,3,3,3,1,1,1,2,2,1,7,11,5,12,13,12,12,17,1,1,1,1,1,1,1,17,20,1,13,13,1,1,76,20,7,2899999,5698,5698,3700,Mixed_Race,115,1,0,1349.0,Unknown,83228313,492000.0,1.0,76,843,17,3,0,4,217,0,0.5042339243186028,0.3903743315508021,0.4852941176470588,0.0012939271364523,0.006578947368421,0.0,0.0037509377344336,0.0047511877969492,0.0027056307119642,0.0,0.3953488372093026,0.2083333333333332,93,11,11,13,1,1980,2,46,405,800000,70000.0,1000000.0,200000.0,,300000.0,1,200000,0.0,0.0
792331,Roony,Bardghji,2024,190,Kuwait,Kuwait City,Sweden,15-11-05,Right Winger,Attack,Left,173.0,31-12-25,CAA Base Ltd,https://img.a.transfermarkt.technology/portrait/header/792331-1667420074.jpg?lm=1,DK1,Football Club KÃ¸benhavn,9000000.0,9000000.0,19,106,-85,6,10,14,13,14,11,5,13,5,3,12,9,3,15,11,13,13,11,9,13,11,16,15,7,13,6,12,13,13,14,13,5,15,12,7,8,7,5,19,13,14,3,1,1,3,2,1,2,3,2,3,3,14,17,2,10,15,15,15,13,1,1,1,1,1,1,1,1,1,15,12,13,20,12,0,20,13,9098744,5748,5748,5248,North_African__Middle_Eastern,107,0,0,5108.0,Unknown,2000088490,9111392.0,2.0,58,773,91,0,0,6,90,10,0.5108494310664197,0.5559358288770053,0.4264705882352941,0.0049236824393809,0.0,0.0,0.0447611902975743,0.0447611902975743,0.0505924720131114,0.1428571428571428,0.2325581395348837,0.0416666666666666,101,23,5,6,0,4307,3,98,425,9000000,1000000.0,9000000.0,0.0,9000000.0,,1,500000,0.0,0.0
795274,Mayckel,Lahdo,2024,1090,Sweden,Stockholm,Sweden,30-12-02,Right Winger,Attack,Right,171.0,30-06-27,Unknown,https://img.a.transfermarkt.technology/portrait/header/795274-1723819960.jpg?lm=1,NL1,Alkmaar Zaanstreek,3000000.0,3000000.0,21,115,-75,8,9,13,10,12,8,6,8,5,7,10,9,6,11,13,12,12,8,9,9,7,13,15,7,13,8,11,11,16,14,13,9,12,15,12,13,9,11,12,5,9,1,1,1,1,4,1,3,1,1,3,3,10,12,7,12,12,12,9,9,1,1,1,1,10,10,1,18,10,18,19,14,20,12,75,10,20,55500000,5349,5159,3403,North_African__Middle_Eastern,107,0,0,1503.0,Unknown,93123140,600000.0,1.0,91,1426,91,0,1,6,16,10,0.4329187615771368,0.3586096256684492,0.4264705882352941,0.0014426321954177,0.0,0.0,0.0147536884221055,0.0147536884221055,0.0033056473790938,0.0,0.1860465116279068,0.125,154,25,12,6,1,5500,5,27,108,3000000,330555.55555555556,3000000.0,300000.0,150000.0,3000000.0,2,425000,0.0,0.0
796213,Nelson,Weiper,2024,39,Germany,Mainz,Germany,17-03-05,Centre-Forward,Attack,Right,192.0,30-06-25,ASBW Sport Marketing,https://img.a.transfermarkt.technology/portrait/header/796213-1692000176.jpg?lm=1,L1,1. FuÃŸball- und Sportverein Mainz 05,5000000.0,5000000.0,19,102,-8,1,7,11,13,13,6,13,8,4,5,11,15,6,12,11,10,11,10,8,11,8,17,13,8,13,6,12,12,12,11,12,14,14,12,11,12,16,6,14,5,4,3,1,1,3,3,3,1,1,1,1,1,12,16,2,16,16,16,14,15,1,1,1,1,1,1,1,1,1,1,14,14,14,20,0,12,20,29000001,5100,5100,3600,Northern_European,102,0,0,6711.0,Unknown,2000170587,9111392.0,2.0,38,894,40,0,1,7,1,3,0.4251124636147129,0.3796791443850267,0.3897058823529412,0.0064715669167937,0.0,0.0,0.0247561890472618,0.0247561890472618,0.0505924720131114,0.1428571428571428,0.6744186046511627,0.0416666666666666,72,46,5,10,0,2878,2,34,200,4000000,514285.71428571426,5000000.0,1000000.0,5000000.0,,0,0,-0.2,-0.2
796429,Justin,Che,2024,206,United States,"Richardson, Texas",United States,18-11-03,Right-Back,Defender,Right,185.0,30-06-26,SXI,https://img.a.transfermarkt.technology/portrait/header/796429-1657200302.jpg?lm=1,DK1,BrÃ¸ndby IdrÃ¦tsforening,700000.0,3000000.0,21,97,-75,8,10,9,8,10,8,12,8,8,10,10,7,12,10,10,11,11,10,11,10,11,15,8,7,9,10,11,11,13,12,7,11,11,14,12,10,10,8,18,9,11,3,3,3,3,1,2,1,2,2,2,3,19,12,8,12,10,11,11,15,1,1,18,20,1,13,1,1,1,1,1,1,1,1,75,10,20,5505990,5092,5092,2744,African_Caribbean,96,0,0,4033.0,TSG Hoffenheim,2000055263,9111392.0,2.0,104,1228,102,1,1,1,45,11,0.4240539825350622,0.2881283422459892,0.3455882352941176,0.003885643878421,0.0,0.0,0.0032508127031757,0.0147536884221055,0.0505924720131114,0.1428571428571428,0.5116279069767438,0.125,91,1,7,8,0,1391,3,35,196,700000,52272.72727272727,3000000.0,1000000.0,3000000.0,700000.0,5,1500000,0.0,-0.3
796574,Unknown,Stênio,2024,85465,Brazil,PoÃ§os de Caldas,Brazil,05-04-03,Right Winger,Attack,Right,180.0,30-06-26,OTB Sports,https://img.a.transfermarkt.technology/portrait/header/796574-1723703738.png?lm=1,UKR1,FK Karpaty Lviv,900000.0,1000000.0,21,92,-75,6,7,11,12,11,8,9,8,5,5,10,10,7,11,10,11,10,10,9,8,10,10,12,6,12,5,8,10,13,12,10,9,11,12,12,6,10,10,10,10,10,3,4,1,4,2,1,3,1,2,1,3,10,10,9,9,9,9,8,8,1,1,1,1,1,1,1,13,10,14,19,15,20,15,71,10,20,1158284,4605,4605,782,Mixed_Race,84,0,0,223.0,Unknown,2000014409,200000.0,1.0,10,1178,11,0,1,4,75,10,0.3596189468113258,0.0782887700534759,0.2573529411764706,0.0002066420949259,0.0,0.0,0.0042510627656914,0.0047511877969492,0.0010833634267618,0.0,0.3953488372093026,0.125,108,10,7,14,0,2590,2,8,92,700000,-33333.333333333336,1000000.0,400000.0,1000000.0,1000000.0,4,700000,-0.2222222222222222,-0.3
798043,Tom,Rothe,2024,89,Germany,Rendsburg,Germany,29-10-04,Left-Back,Defender,Left,193.0,Unknown,Wasserman,https://img.a.transfermarkt.technology/portrait/header/798043-1715607518.jpg?lm=1,L1,1. FC Union Berlin,8000000.0,8000000.0,20,110,-8,8,14,10,10,14,10,14,7,9,13,12,7,14,12,5,12,11,8,8,11,14,15,7,2,9,8,10,8,11,11,14,15,10,13,14,13,9,6,13,11,14,2,1,1,2,2,2,4,3,2,3,2,17,10,6,11,9,10,12,16,1,20,14,1,18,1,10,16,1,1,1,1,1,1,0,20,7,21000000,5500,5500,3510,Northern_European,107,0,0,4424.0,Unknown,2000146948,5000000.0,1.0,38,1217,40,1,0,7,0,8,0.4780365175972479,0.3700534759358288,0.4264705882352941,0.0042632002294306,0.0,0.0,0.0397599399849962,0.0397599399849962,0.0277507708547459,0.0,0.6976744186046511,0.0833333333333332,115,11,34,20,1,5013,3,13,61,12000000,1542857.142857143,12000000.0,0.0,5000000.0,12000000.0,3,7800000,0.5,1.0
798404,Alidu,Seidu,2024,273,Ghana,Accra,Ghana,04-06-00,Centre-Back,Defender,Right,173.0,30-06-28,BLACKSKILL,https://img.a.transfermarkt.technology/portrait/header/798404-1679507806.jpg?lm=1,FR1,Stade Rennais Football Club,9000000.0,9000000.0,24,124,142,10,11,10,6,11,8,11,9,12,13,10,9,13,11,11,11,15,10,13,11,12,14,11,10,10,12,12,12,14,11,14,11,15,12,14,15,12,9,10,8,10,2,1,3,2,3,3,2,1,1,3,1,11,11,8,10,11,13,12,14,1,16,20,20,1,16,1,1,1,1,1,1,1,1,68,10,20,4495999,6200,6200,2802,African_Caribbean,118,2,0,9541.0,Unknown,49063222,11000000.0,1.0,39,20,41,1,1,1,195,2,0.5706536120666843,0.294331550802139,0.5073529411764706,0.0092042637795997,0.0131578947368421,0.0,0.0447611902975743,0.0447611902975743,0.0610850301397261,0.0,0.2325581395348837,0.25,125,0,3,33,4,3548,2,20,89,9000000,625000.0,9000000.0,100000.0,,400000.0,1,2000000,0.0,0.2857142857142857
799899,Theo,Sander,2024,190,Denmark,SkÃ¸rping,Denmark,08-01-05,Goalkeeper,Goalkeeper,Right,192.0,30-06-28,FullNinety,https://img.a.transfermarkt.technology/portrait/header/799899-1669038501.jpg?lm=1,DK1,Football Club KÃ¸benhavn,700000.0,700000.0,19,95,-75,3,1,2,1,5,6,2,2,1,3,11,1,1,10,13,15,11,12,11,10,10,20,3,6,2,10,11,10,9,10,10,16,13,8,8,8,12,9,10,6,11,14,8,10,5,10,12,11,13,13,10,10,13,9,8,11,11,12,13,20,20,1,1,1,1,1,1,1,1,1,1,1,1,1,84,15,20,3549155,5250,4508,780,Northern_European,90,0,0,2036.0,Unknown,2000094429,1080000.0,1.0,28,1382,30,2,1,7,90,5,0.346784863720561,0.0780748663101604,0.3014705882352941,0.0019573061982006,0.0,0.0,0.0032508127031757,0.0032508127031757,0.0059723881218922,0.0,0.6744186046511627,0.0416666666666666,0,0,0,0,0,0,2,20,185,1000000,107142.85714285714,1000000.0,0.0,700000.0,,2,200000,0.42857142857142855,0.42857142857142855
800176,Unknown,André,2024,543,Brazil,Ibirataia,Brazil,16-07-01,Defensive Midfield,Midfield,Right,176.0,Unknown,Carlos Leite,https://img.a.transfermarkt.technology/portrait/header/800176-1699348390.jpg?lm=1,GB1,Wolverhampton Wanderers Football Club,25000000.0,25000000.0,23,132,158,7,8,12,10,13,9,11,10,9,13,13,10,14,13,13,14,13,13,13,13,13,13,11,13,13,14,14,14,13,12,13,8,13,13,14,13,13,14,12,4,12,3,2,1,2,3,1,1,1,2,1,1,13,13,1,11,12,13,13,12,1,1,1,1,1,1,18,1,20,1,1,1,1,1,0,10,20,18395455,6587,6587,3566,Mediterranean_Hispanic,130,0,0,14497.0,Unknown,19375640,22000000.0,1.0,10,650,11,3,1,3,222,4,0.621857634294787,0.376042780748663,0.5955882352941175,0.0139898629499414,0.0,0.0,0.1247811952988247,0.1247811952988247,0.1221978388288563,0.0,0.3023255813953489,0.2083333333333332,219,4,4,52,2,5856,1,16,69,25000000,1915384.6153846155,25000000.0,0.0,,6000000.0,2,250000,0.0,0.0
800946,Dennis,Seimen,2024,79,Germany,Heilbronn,Germany,01-12-05,Goalkeeper,Goalkeeper,Left,192.0,30-06-29,ROGON,https://img.a.transfermarkt.technology/portrait/header/800946-1691998825.jpg?lm=1,L1,Verein fÃ¼r Bewegungsspiele Stuttgart 1893,1500000.0,1500000.0,19,100,-85,2,3,2,1,11,4,5,1,3,1,11,11,2,11,15,9,10,11,9,11,10,18,8,13,2,12,11,11,9,12,12,16,15,9,10,11,16,6,15,5,12,15,12,13,12,12,10,12,12,16,7,11,7,17,3,16,17,17,12,10,20,1,1,1,1,1,1,1,1,1,1,1,1,1,82,20,6,34349999,4847,4847,2811,Northern_European,100,0,0,64.0,Unknown,2000175080,9111392.0,2.0,38,607,40,2,0,7,211,5,0.3916379994707595,0.2952941176470587,0.3749999999999999,5.310894963050656e-05,0.0,0.0,0.0072518129532383,0.0072518129532383,0.0505924720131114,0.1428571428571428,0.6744186046511627,0.0416666666666666,0,0,0,0,0,0,2,15,62,1500000,260000.0,1500000.0,0.0,1500000.0,,1,800000,0.5,0.5
800976,Adamo,Nagalo,2024,383,Cote d'Ivoire,AdjamÃ©,Burkina Faso,22-09-02,Centre-Back,Defender,Right,188.0,30-06-29,Unknown,https://img.a.transfermarkt.technology/portrait/header/800976-1662451797.jpg?lm=1,NL1,Eindhovense Voetbalvereniging Philips Sport Vereniging,7000000.0,7000000.0,22,120,-8,8,7,9,5,12,7,12,6,9,13,12,8,13,12,16,14,13,13,10,11,10,14,7,13,8,13,14,14,12,13,11,13,14,13,13,13,11,11,9,5,15,2,3,1,2,3,4,3,2,1,1,1,11,13,8,11,9,14,14,10,1,13,20,15,7,10,14,1,7,1,1,1,1,1,75,14,20,3878527,6500,4206,1623,African_Caribbean,120,0,0,6165.0,Unknown,2000026207,7000000.0,1.0,23,23,13,1,1,1,62,2,0.306827202963747,0.168235294117647,0.5220588235294117,0.0059443398895526,0.0,0.0,0.0347586896724181,0.0347586896724181,0.038862190616406,0.0,0.581395348837209,0.1666666666666666,136,4,6,16,2,5372,1,17,94,7000000,733333.3333333334,7000000.0,100000.0,400000.0,5000000.0,2,400000,0.0,0.16666666666666666
801031,Lewis,Schouten,2024,1090,Netherlands,Alkmaar,Netherlands,04-02-04,Central Midfield,Midfield,Right,191.0,30-06-27,Muy Manero,https://img.a.transfermarkt.technology/portrait/header/801031-1664801015.jpg?lm=1,NL1,Alkmaar Zaanstreek,600000.0,600000.0,20,100,-75,5,9,14,7,14,7,8,8,8,10,13,5,10,14,7,10,9,11,10,11,14,10,13,4,14,5,15,15,9,12,14,12,12,9,10,6,12,7,17,9,15,3,2,3,3,3,1,2,1,3,1,2,19,10,6,10,11,12,9,12,1,1,13,1,1,1,20,13,20,13,1,15,1,1,0,8,20,24240000,4850,4850,2750,Northern_European,87,0,0,886.0,Unknown,2000014552,9111392.0,2.0,67,45,68,3,1,7,16,1,0.3920349298756285,0.2887700534759358,0.2794117647058823,0.00084684634229,0.0,0.0,0.0027506876719179,0.0027506876719179,0.0505924720131114,0.1428571428571428,0.6511627906976742,0.0833333333333332,118,8,19,12,1,4935,4,29,142,600000,82142.85714285714,600000.0,0.0,150000.0,600000.0,1,200000,0.0,0.0
801734,Mathys,Tel,2024,27,France,Sarcelles,France,27-04-05,Left Winger,Attack,Right,183.0,30-06-29,Unknown,https://img.a.transfermarkt.technology/portrait/header/801734-1700040486.jpg?lm=1,L1,FC Bayern MÃ¼nchen,40000000.0,50000000.0,19,120,-9,11,8,14,12,12,12,12,11,3,5,12,13,6,14,8,11,10,11,10,12,9,16,16,11,13,6,11,11,15,12,12,12,15,15,11,12,13,6,14,5,17,1,3,1,3,3,1,3,3,3,1,1,12,17,7,11,13,11,15,16,1,1,5,1,1,1,1,10,8,10,18,11,15,20,77,11,20,75392000,6000,5257,5006,African_Caribbean,116,0,0,76711.0,Unknown,2000104850,20000000.0,1.0,34,1345,36,0,1,1,68,7,0.4458851548028579,0.5300534759358289,0.4926470588235294,0.0740647755374384,0.0,0.0,0.1997999499874969,0.2498124531132783,0.1110864190671963,0.0,0.4651162790697669,0.0416666666666666,107,29,7,4,0,2655,5,7,12,30000000,2636363.6363636362,50000000.0,10000000.0,40000000.0,,1,18000000,-0.25,-0.4
802986,Justin,Bengui Joao,2024,1041,France,MontbÃ©liard,France,09-07-05,Goalkeeper,Goalkeeper,Right,190.0,30-06-25,Soccer and more,https://img.a.transfermarkt.technology/portrait/header/802986-1706082699.jpg?lm=1,FR1,Olympique Lyonnais,300000.0,300000.0,19,80,-75,3,3,2,2,1,5,1,1,2,3,14,2,1,4,5,13,15,8,7,7,9,8,2,2,2,11,8,7,10,8,8,11,15,12,3,8,7,6,17,9,10,9,12,10,12,9,10,14,12,13,5,10,10,11,7,11,13,12,10,12,20,1,1,1,1,1,1,1,1,1,1,1,1,1,0,6,20,4514999,4005,4005,1014,African_Caribbean,73,0,0,645.0,Unknown,2000104852,9111392.0,2.0,34,974,36,2,1,1,143,5,0.2802328658375231,0.1031016042780748,0.1764705882352941,0.0006141325811818,0.0,0.0,0.0012503125781445,0.0012503125781445,0.0505924720131114,0.1428571428571428,0.6279069767441858,0.0416666666666666,0,0,0,0,0,0,0,0,0,300000,0.0,300000.0,0.0,300000.0,,0,0,0.0,0.0
804711,Ousmane,Camara,2024,1420,France,Paris,France,06-03-03,Centre-Back,Defender,Right,197.0,30-06-26,Unknown,https://img.a.transfermarkt.technology/portrait/header/804711-1672669470.jpg?lm=1,FR1,Angers Sporting Club de l'Ouest,600000.0,2000000.0,21,110,-75,7,8,11,5,10,5,14,5,7,13,14,8,13,12,8,11,12,12,11,8,12,15,8,10,11,12,12,12,11,8,12,18,14,11,12,14,11,13,13,7,8,3,1,3,2,2,1,1,2,2,1,3,14,10,7,10,11,11,8,19,1,1,20,1,1,1,17,1,14,1,1,1,1,1,90,6,20,18912001,5500,5500,2250,African_Caribbean,110,0,0,3288.0,Unknown,2000066137,2200000.0,1.0,34,1122,36,1,1,1,18,2,0.4780365175972479,0.2352941176470588,0.4485294117647059,0.0031662590152442,0.0,0.0,0.0027506876719179,0.0097524381095273,0.0121947831884219,0.0,0.7906976744186047,0.125,81,1,1,16,0,3334,0,0,0,500000,25000.0,2000000.0,500000.0,1000000.0,1000000.0,2,100000,-0.16666666666666666,-0.5
805714,Renato,Veiga,2024,631,Portugal,Lisboa,Portugal,29-07-03,Left-Back,Defender,Left,190.0,30-06-31,Mondo Victory,https://img.a.transfermarkt.technology/portrait/header/805714-1676275963.jpg?lm=1,GB1,Chelsea Football Club,8000000.0,8000000.0,21,86,-75,7,7,7,3,13,7,8,9,1,9,14,6,11,9,9,7,8,7,9,12,14,10,5,9,8,14,8,12,14,14,7,8,12,14,7,6,8,5,7,7,16,1,2,2,3,3,2,2,3,3,1,2,14,10,8,10,12,13,10,12,1,1,14,1,1,1,20,1,17,1,1,1,1,1,72,20,7,12090000,4296,4296,2296,African_Caribbean,84,0,0,1456.0,Unknown,83320123,9300000.0,2.0,76,843,79,1,0,1,50,8,0.3187351151098174,0.2402139037433155,0.2573529411764706,0.0013972481839153,0.0,0.0,0.0397599399849962,0.0397599399849962,0.051640323342315,0.1428571428571428,0.6279069767441858,0.125,124,11,3,39,1,5966,3,13,43,10000000,1125000.0,10000000.0,0.0,,3000000.0,2,5500000,2.3333333333333335,4.0
806168,Paul,Joly,2024,290,France,OrlÃ©ans,France,07-06-00,Right-Back,Defender,Right,182.0,30-06-26,Concept Sport Agency,https://img.a.transfermarkt.technology/portrait/header/806168-1667290785.jpg?lm=1,FR1,Association de la Jeunesse auxerroise,2500000.0,2500000.0,24,119,137,6,14,11,6,12,6,12,9,6,12,11,7,13,10,11,15,12,13,12,11,11,13,9,8,13,14,14,14,13,12,12,12,13,13,15,12,12,8,11,6,10,2,2,3,3,3,1,1,1,3,1,2,16,12,1,12,11,12,12,11,1,12,13,20,1,1,1,1,1,1,1,1,1,1,75,8,20,1531999,5950,5950,2750,Northern_European,119,0,0,6076.0,Unknown,49054998,9111392.0,2.0,34,1092,36,1,1,7,23,11,0.5375760783275999,0.2887700534759358,0.5147058823529411,0.0058583999528778,0.0,0.0,0.0122530632658164,0.0122530632658164,0.0505924720131114,0.1428571428571428,0.4418604651162785,0.25,131,3,17,17,3,4489,1,4,38,2000000,172727.27272727274,2500000.0,500000.0,,100000.0,3,700000,0.1111111111111111,0.3333333333333333
807128,Saïdou,Sow,2024,667,Guinea,Conakry,Guinea,04-07-02,Centre-Back,Defender,Right,187.0,30-06-28,MDC Advisors,https://img.a.transfermarkt.technology/portrait/header/807128-1617875269.jpg?lm=1,FR1,Racing Club de Strasbourg Alsace,4000000.0,4000000.0,22,112,-75,5,7,11,6,10,5,13,7,10,14,8,8,15,10,12,12,14,11,12,9,11,15,8,10,12,13,12,13,11,11,13,12,14,13,12,12,12,10,14,7,10,3,3,3,3,3,2,3,2,2,3,3,14,14,7,13,13,10,12,12,1,1,20,1,1,1,1,1,1,1,1,1,1,1,75,8,20,15800000,5590,5290,3002,African_Caribbean,111,12,0,4691.0,Unknown,49055608,3000000.0,1.0,43,378,44,1,1,1,159,2,0.450251389256417,0.3157219251336898,0.4558823529411764,0.0045210200394551,0.0789473684210526,0.0,0.0197549387346836,0.0197549387346836,0.0166393510930859,0.0,0.5581395348837206,0.1666666666666666,97,2,3,13,0,4398,3,8,31,6000000,386666.6666666667,6000000.0,1000000.0,2500000.0,3500000.0,1,500000,1.4,2.0
808475,Unknown,Mt,2024,2423,Brazil,Cabo Frio,Brazil,01-03-01,Left-Back,Defender,Left,185.0,30-06-28,7 Braga Sports,https://img.a.transfermarkt.technology/portrait/header/808475-1660572657.jpg?lm=1,PO1,Clube Desportivo Santa Clara,700000.0,700000.0,23,111,140,8,11,14,10,13,7,10,10,6,7,12,9,8,14,7,11,10,11,11,12,10,12,15,6,11,8,11,13,14,13,13,8,14,12,11,13,9,13,8,7,18,3,2,1,1,3,3,2,1,1,2,1,11,16,15,8,9,7,10,7,1,12,1,1,1,1,1,1,20,1,17,20,1,15,75,20,7,1132529,5544,5544,3744,African_Caribbean,100,0,0,971.0,Santa Clara AÃ§ores Futebol,19410808,9111392.0,2.0,10,293,11,1,0,1,57,8,0.4838581635353268,0.3950802139037432,0.3749999999999999,0.0009289238099008,0.0,0.0,0.0032508127031757,0.0032508127031757,0.0505924720131114,0.1428571428571428,0.5116279069767438,0.2083333333333332,103,3,3,12,0,1325,1,2,22,2000000,188888.88888888888,2000000.0,125000.0,,450000.0,1,0,3.4444444444444446,5.153846153846154
808574,Miguel,Menino,2024,4294,Portugal,Almada,Portugal,10-01-03,Central Midfield,Midfield,Right,181.0,30-06-28,Sportsbloom,https://img.a.transfermarkt.technology/portrait/header/default.jpg?lm=1,PO1,Sporting Clube Farense,300000.0,300000.0,21,80,-75,10,11,11,8,10,9,7,8,8,6,10,7,8,11,9,12,11,11,9,9,10,16,15,8,11,7,10,11,13,11,10,8,15,9,9,9,15,14,16,8,12,3,2,2,1,1,2,3,2,1,3,2,11,10,5,10,11,11,8,12,1,1,1,1,1,1,1,10,1,12,16,1,20,1,70,7,20,9921750,3999,3999,1249,Mediterranean_Hispanic,78,0,0,2549.0,Unknown,83320117,9111392.0,2.0,76,46,79,3,1,3,191,1,0.2794390050277852,0.128235294117647,0.213235294117647,0.0024526678556633,0.0,0.0,0.0012503125781445,0.0012503125781445,0.0505924720131114,0.1428571428571428,0.418604651162791,0.125,73,11,9,12,0,2237,0,0,0,700000,200000.0,700000.0,-400000.0,,,0,0,0.0,0.0
810092,Warren,Zaïre-Emery,2024,583,France,Montreuil,France,08-03-06,Central Midfield,Midfield,Right,178.0,30-06-29,Gestifute,https://img.a.transfermarkt.technology/portrait/header/810092-1672303575.jpg?lm=1,FR1,Paris Saint-Germain Football Club,60000000.0,60000000.0,18,100,-95,11,10,12,8,12,8,8,8,4,12,12,10,11,13,6,12,12,10,11,13,10,15,12,7,10,11,11,11,12,12,11,8,12,12,11,11,10,6,10,4,9,2,2,3,2,1,2,2,2,1,2,3,12,13,3,14,13,14,13,12,1,1,1,1,1,1,20,1,18,1,1,1,1,1,0,10,20,42290922,4989,4989,1639,African_Caribbean,99,0,0,1388.0,Unknown,2000179712,9111392.0,2.0,34,979,36,3,1,1,154,1,0.4104260386345594,0.1699465240641711,0.3676470588235294,0.0013315862098267,0.0,0.0,0.2998249562390597,0.2998249562390597,0.0505924720131114,0.1428571428571428,0.3488372093023257,0.0,137,13,12,11,0,4574,2,11,24,60000000,6875000.0,60000000.0,0.0,60000000.0,,0,0,0.0,0.0
810093,Ayman,Kari,2024,583,France,Ivry-sur-Seine,France,19-11-04,Central Midfield,Midfield,Right,176.0,30-06-25,Unknown,https://img.a.transfermarkt.technology/portrait/header/810093-1672304278.jpg?lm=1,FR1,Paris Saint-Germain Football Club,4000000.0,4000000.0,20,95,-8,7,7,11,8,11,7,8,10,6,11,11,8,12,12,7,12,11,11,11,11,11,15,11,6,12,10,12,12,11,12,10,10,13,11,13,11,10,7,10,5,12,3,1,3,2,3,1,2,3,2,2,1,13,14,6,12,12,15,14,10,1,1,1,1,1,1,13,1,20,1,1,1,1,1,0,8,20,24599999,4738,4738,1489,African_Caribbean,95,0,0,1010.0,Unknown,2000127853,9111392.0,2.0,34,680,36,3,1,1,154,1,0.3772161947605187,0.153903743315508,0.338235294117647,0.0009665828832752,0.0,0.0,0.0197549387346836,0.0197549387346836,0.0505924720131114,0.1428571428571428,0.3023255813953489,0.0833333333333332,73,5,7,3,0,3362,2,13,51,3000000,385714.28571428574,4000000.0,1000000.0,1000000.0,3000000.0,2,1500000,-0.25,2.3333333333333335
810096,Ismaël,Gharbi,2024,1075,France,Paris,Spain,10-04-04,Attacking Midfield,Midfield,Right,173.0,30-06-29,AMS CONSULTING,https://img.a.transfermarkt.technology/portrait/header/810096-1699715578.jpg?lm=1,PO1,Sporting Clube de Braga,7500000.0,7500000.0,20,97,-8,11,11,13,11,13,10,7,9,3,6,10,10,7,13,10,11,12,11,10,13,9,12,13,7,11,6,11,11,12,14,12,7,12,11,12,7,10,10,10,4,10,3,3,3,1,2,2,3,1,3,1,1,17,13,7,9,11,11,11,14,1,1,1,1,1,1,1,1,12,1,1,20,15,1,63,10,20,28560000,4846,4846,1760,North_African__Middle_Eastern,97,0,0,1162.0,Unknown,2000006181,9111392.0,2.0,34,1122,89,3,1,6,192,0,0.3915056893358031,0.1828877005347593,0.3529411764705882,0.0011133567077086,0.0,0.0,0.0372593148287071,0.0372593148287071,0.0505924720131114,0.1428571428571428,0.2325581395348837,0.0833333333333332,110,36,22,15,1,3609,1,2,16,7500000,591666.6666666666,7500000.0,0.0,5000000.0,7500000.0,3,0,0.0,0.5
810895,Eliesse,Ben Seghir,2024,162,France,Saint-Tropez,Morocco,16-02-05,Left Winger,Attack,Right,178.0,30-06-27,Unknown,https://img.a.transfermarkt.technology/portrait/header/810895-1682691420.jpg?lm=1,FR1,Association sportive de Monaco Football Club,18000000.0,18000000.0,19,90,-8,8,6,12,10,13,7,5,10,4,6,14,7,10,13,11,4,10,10,7,13,12,5,10,9,11,6,8,8,14,13,9,4,12,14,10,7,12,10,19,10,15,1,2,1,1,2,1,2,2,1,2,1,10,9,4,12,10,11,13,17,1,1,1,1,1,1,1,1,17,1,1,20,1,1,0,8,20,14849999,4500,4500,1150,North_African__Middle_Eastern,92,0,0,645.0,Unknown,2000104892,9111392.0,2.0,34,1280,67,0,1,6,24,7,0.3457263826409102,0.1176470588235294,0.3161764705882353,0.0006141325811818,0.0,0.0,0.0897724431107777,0.0897724431107777,0.0505924720131114,0.1428571428571428,0.3488372093023257,0.0416666666666666,0,0,0,0,0,0,4,43,84,30000000,3311111.111111111,30000000.0,3000000.0,18000000.0,,1,17800000,1.0,0.6666666666666666
811544,Aleksandr,Kovalenko,2024,14589,Russia,Moskau,Russia,08-08-03,Central Midfield,Midfield,Right,177.0,30-06-28,Pavel Andreev,https://img.a.transfermarkt.technology/portrait/header/811544-1721723584.png?lm=1,RU1,FC Orenburg,2000000.0,2800000.0,21,110,-8,7,6,12,11,14,9,8,13,7,7,14,3,12,14,11,10,9,11,8,14,12,5,14,5,12,9,10,13,14,12,10,8,5,13,8,6,19,5,10,5,12,2,3,2,1,4,2,3,1,3,1,2,9,14,3,11,14,13,12,20,1,1,1,1,1,1,13,1,20,1,1,15,1,10,67,15,20,17454238,5500,5500,2750,Mediterranean_Hispanic,108,0,0,19303.0,Krylja Sovetov Samara,2000088746,9111392.0,2.0,78,985,81,3,1,3,70,1,0.4780365175972479,0.2887700534759358,0.4338235294117646,0.0186306195303816,0.0,0.0,0.0097524381095273,0.0137534383595899,0.0505924720131114,0.1428571428571428,0.3255813953488373,0.125,129,11,15,14,0,3786,1,5,34,1800000,177500.0,2800000.0,500000.0,500000.0,2000000.0,3,900000,-0.1,-0.28
811779,Alejandro,Garnacho,2024,985,Spain,Madrid,Argentina,01-07-04,Left Winger,Attack,Right,180.0,30-06-28,#LEADERS,https://img.a.transfermarkt.technology/portrait/header/811779-1703629085.jpg?lm=1,GB1,Manchester United Football Club,50000000.0,50000000.0,20,119,-85,5,7,15,13,14,5,6,6,2,2,11,11,2,14,10,8,7,13,8,7,9,2,16,4,11,2,8,10,16,14,10,9,8,16,12,8,11,5,13,4,14,3,3,2,4,2,1,2,2,2,3,2,7,13,6,10,10,9,10,19,1,1,1,1,1,1,1,14,1,13,20,14,18,15,64,14,20,59851735,6250,5750,4015,Mediterranean_Hispanic,106,0,0,1450.0,Unknown,2000035036,465000.0,1.0,89,892,4,0,1,3,132,7,0.5111140513363324,0.4240641711229946,0.4191176470588235,0.0013914544803192,0.0,0.0,0.2498124531132783,0.2498124531132783,0.0025556265451818,0.0,0.3953488372093026,0.0833333333333332,178,46,25,14,0,6314,1,14,54,50000000,4800000.0,50000000.0,0.0,25000000.0,50000000.0,0,0,0.1111111111111111,0.6666666666666666
812654,Rare?,Ilie,2024,417,Romania,Bucharest,Romania,19-04-03,Attacking Midfield,Midfield,Right,186.0,30-06-27,"Flashforward, S.L.",https://img.a.transfermarkt.technology/portrait/header/812654-1667549482.jpg?lm=1,FR1,Olympique Gymnaste Club Nice CÃ´te d'Azur,2000000.0,3300000.0,21,110,-8,13,12,12,11,13,12,11,11,6,8,13,9,11,14,7,11,9,12,10,13,10,13,11,4,12,9,12,12,11,12,12,10,10,12,12,11,11,5,10,5,8,2,1,1,3,3,1,1,3,2,2,2,20,13,2,14,11,14,13,15,1,1,1,1,1,1,1,1,18,1,19,20,1,1,73,10,20,38442936,5500,5500,3550,Mediterranean_Hispanic,108,0,0,3620.0,Unknown,2000045306,2500000.0,2.0,77,270,80,3,1,3,142,0,0.4780365175972479,0.374331550802139,0.4338235294117646,0.0034868439475592,0.0,0.0,0.0097524381095273,0.0162540635158789,0.0138614961526709,0.1428571428571428,0.5348837209302322,0.125,112,13,17,10,0,2824,2,4,23,1500000,95000.0,3300000.0,1000000.0,700000.0,3300000.0,4,3900000,-0.5,-0.4642857142857143
813437,Isaac,Babadi,2024,383,Netherlands,Nijmegen,Netherlands,06-04-05,Attacking Midfield,Midfield,Right,179.0,30-06-28,Unknown,https://img.a.transfermarkt.technology/portrait/header/813437-1691582768.jpg?lm=1,NL1,Eindhovense Voetbalvereniging Philips Sport Vereniging,6000000.0,6000000.0,19,100,-85,7,13,13,10,14,7,8,9,8,5,12,13,9,11,11,6,11,6,7,15,7,15,14,3,14,9,12,12,14,15,8,8,12,14,6,7,5,7,10,14,12,3,3,2,4,2,2,1,3,3,2,2,8,10,3,11,11,11,10,18,1,1,1,1,1,1,1,17,16,16,18,20,16,12,0,10,20,25800001,5000,5000,3251,African_Caribbean,94,0,0,1050.0,Unknown,2000087434,9111392.0,2.0,67,1047,68,3,1,1,62,0,0.4118814501190792,0.3423529411764705,0.3308823529411764,0.0010052075739155,0.0,0.0,0.0297574393598399,0.0297574393598399,0.0505924720131114,0.1428571428571428,0.3720930232558141,0.0416666666666666,109,22,17,4,0,3267,2,10,81,4000000,437500.0,6000000.0,2000000.0,6000000.0,,1,2000000,-0.3333333333333333,0.0
814268,Unknown,Cauê,2024,2424,Brazil,Ituverava,Brazil,16-11-02,Centre-Forward,Attack,Right,184.0,30-06-25,Bertolucci Sports,https://img.a.transfermarkt.technology/portrait/header/814268-1704280505.jpg?lm=1,PO1,Gil Vicente Futebol Clube,800000.0,1000000.0,22,103,-75,6,8,12,13,11,7,12,10,5,5,9,9,5,13,6,11,10,12,11,10,10,5,13,12,12,5,12,11,13,11,10,11,15,13,13,11,12,6,9,11,13,2,3,2,3,3,1,1,2,1,2,1,15,12,1,10,11,11,11,10,1,1,1,1,1,1,1,1,1,1,1,1,1,20,72,9,20,1875001,5400,5400,500,Mixed_Race,102,0,0,3499.0,Unknown,89068839,9111392.0,2.0,10,676,11,0,1,4,106,3,0.4648055041016142,0.0481283422459893,0.3897058823529412,0.0033700042583721,0.0,0.0,0.0037509377344336,0.0047511877969492,0.0505924720131114,0.1428571428571428,0.4883720930232553,0.1666666666666666,0,0,0,0,0,0,0,0,0,800000,-22222.222222222223,1000000.0,200000.0,1000000.0,700000.0,3,100000,0.0,0.14285714285714285
814269,Gustavo,Mantuan,2024,964,Brazil,Santo AndrÃ©,Brazil,20-06-01,Right Winger,Attack,Right,176.0,30-06-27,Elenko Sports Ltda.,https://img.a.transfermarkt.technology/portrait/header/814269-1721723837.png?lm=1,RU1,AO FK Zenit Sankt-Peterburg,2500000.0,3000000.0,23,120,-75,7,10,12,12,13,6,10,13,5,6,10,11,9,13,9,12,10,11,12,11,11,11,13,5,12,8,11,12,14,14,6,8,10,14,15,9,14,5,11,13,12,1,3,2,2,3,1,1,3,1,4,3,13,14,3,12,11,11,12,10,1,1,1,5,1,10,1,1,1,15,20,15,16,17,76,8,20,13355896,6000,6000,3000,Mediterranean_Hispanic,112,0,0,6428.0,Zenit St. Petersburg,19346096,2000000.0,1.0,10,1337,11,0,1,3,7,10,0.5441915850754168,0.3155080213903743,0.463235294117647,0.0061982972305131,0.0,0.0,0.0122530632658164,0.0147536884221055,0.0110836412122558,0.0,0.3023255813953489,0.2083333333333332,134,19,13,8,0,5189,9,13,245,3000000,214285.7142857143,3000000.0,500000.0,,1500000.0,1,1500000,0.2,0.0
814273,Saúl,Guarirapa,2024,2410,Venezuela,"Puerto La Cruz, AnzoÃ¡tegui",Venezuela,18-10-02,Centre-Forward,Attack,Right,189.0,30-06-25,Ultimate Sports,https://img.a.transfermarkt.technology/portrait/header/814273-1726167569.png?lm=1,RU1,PFK CSKA Moskva,1200000.0,1200000.0,22,101,-75,6,7,10,12,11,6,11,8,6,4,9,10,5,11,13,11,12,10,11,10,10,15,8,7,11,6,13,12,13,12,12,14,12,13,13,12,11,6,12,12,9,2,3,1,1,2,3,2,1,3,1,2,11,15,2,13,10,12,12,14,1,1,1,1,1,1,1,1,1,1,15,1,15,20,78,10,20,396531,4986,4986,1918,Mixed_Race,100,0,0,541.0,Unknown,86079978,900000.0,1.0,108,1191,105,0,1,4,148,3,0.4100291082296904,0.1997860962566844,0.3749999999999999,0.0005137083855168,0.0,0.0,0.0057514378594648,0.0057514378594648,0.0049723603433428,0.0,0.6046511627906974,0.1666666666666666,109,30,16,27,0,5347,1,23,246,1000000,77272.72727272728,1200000.0,200000.0,150000.0,450000.0,2,500000,-0.16666666666666666,1.5
815384,Matheus,Dias,2024,982,Brazil,SÃ£o Paulo,Brazil,09-05-02,Defensive Midfield,Midfield,Right,187.0,30-06-25,LINK SPORTS,https://img.a.transfermarkt.technology/portrait/header/815384-1664420751.jpg?lm=1,PO1,Clube Desportivo Nacional,2000000.0,2000000.0,22,100,-75,8,8,9,8,10,6,8,13,8,13,10,7,14,13,15,6,9,10,9,14,14,5,5,9,9,14,9,12,13,14,9,9,11,14,8,8,20,5,9,9,12,2,3,4,1,2,1,1,2,3,3,2,20,9,5,8,10,11,11,13,1,1,1,1,1,1,20,1,15,1,1,1,1,1,0,8,20,5523406,4976,4976,1240,Mixed_Race,100,0,0,956.0,Unknown,2000155265,9111392.0,2.0,10,1456,11,3,1,4,56,4,0.408706006880127,0.1272727272727272,0.3749999999999999,0.0009144395509107,0.0,0.0,0.0097524381095273,0.0097524381095273,0.0505924720131114,0.1428571428571428,0.5581395348837206,0.1666666666666666,72,5,2,15,1,2537,1,15,74,1800000,212500.0,2000000.0,200000.0,,500000.0,1,200000,-0.1,-0.1
816580,Tiago,Santos,2024,1082,Portugal,Lisboa,Portugal,23-07-02,Right-Back,Defender,Right,175.0,30-06-28,Gestifute,https://img.a.transfermarkt.technology/portrait/header/816580-1708342212.jpg?lm=1,FR1,Lille Olympique Sporting Club Lille MÃ©tropole,15000000.0,15000000.0,22,120,129,6,8,8,8,11,7,12,8,11,14,10,8,15,11,15,15,15,12,11,10,12,14,11,9,10,14,16,16,11,12,13,12,13,12,14,14,12,16,12,7,6,1,3,3,3,3,1,1,1,2,3,1,9,12,7,12,11,14,9,10,1,1,13,1,1,1,20,1,16,1,1,1,1,1,78,9,20,97472,5912,5912,3440,Mixed_Race,119,0,0,13418.0,Unknown,19249773,6500000.0,1.0,76,843,79,1,1,4,128,11,0.5325482931992591,0.3625668449197861,0.5147058823529411,0.0129479619199174,0.0,0.0,0.0747686921730432,0.0747686921730432,0.0360843356759909,0.0,0.2790697674418605,0.1666666666666666,123,5,12,19,0,3868,1,24,129,15000000,1837500.0,15000000.0,0.0,,3500000.0,1,1500000,0.0,0.875
816974,Tygo,Land,2024,383,Netherlands,Peize,Netherlands,11-01-06,Central Midfield,Midfield,Right,178.0,30-06-29,V4S,https://img.a.transfermarkt.technology/portrait/header/816974-1704704136.jpg?lm=1,NL1,Eindhovense Voetbalvereniging Philips Sport Vereniging,3000000.0,3000000.0,18,90,-8,8,8,8,4,13,8,8,13,2,6,13,7,8,14,9,6,9,12,7,12,14,8,13,7,12,8,14,11,10,12,12,4,14,11,14,7,18,5,11,9,9,2,2,2,2,2,1,4,1,4,1,2,18,9,7,8,12,11,12,13,1,1,1,1,1,1,19,1,20,1,1,16,1,1,0,8,20,30150000,4400,4400,2400,Northern_European,90,0,0,100.0,Unknown,2000088444,700000.0,1.0,67,1134,68,3,1,7,62,1,0.3324953691452765,0.2513368983957219,0.3014705882352941,8.787117120683812e-05,0.0,0.0,0.0147536884221055,0.0147536884221055,0.0038612183671768,0.0,0.3488372093023257,0.0,100,16,11,8,0,4986,0,0,0,3000000,333333.3333333333,3000000.0,0.0,3000000.0,,1,1000000,0.0,0.5
817665,Unknown,Pablo,2024,2424,Portugal,Braga,Brazil,02-01-04,Centre-Forward,Attack,Right,184.0,30-06-25,Jorge Pires,https://img.a.transfermarkt.technology/portrait/header/817665-1705756797.jpg?lm=1,PO1,Gil Vicente Futebol Clube,400000.0,500000.0,20,128,139,5,5,7,6,11,5,16,8,7,15,11,9,14,8,16,14,17,12,11,6,11,12,8,12,8,14,13,15,11,10,14,15,13,11,14,14,16,13,11,13,10,2,2,3,2,2,1,2,3,2,3,3,12,12,9,9,15,12,8,7,1,1,20,1,1,1,1,1,1,1,1,1,1,1,85,12,20,2183524,6400,6400,4500,Mixed_Race,126,2,0,11793.0,Unknown,19125312,9111392.0,2.0,76,237,11,0,1,4,106,3,0.5971156390579518,0.4759358288770053,0.5661764705882353,0.0113788338626525,0.0131578947368421,0.0,0.0017504376094023,0.0022505626406601,0.0505924720131114,0.1428571428571428,0.4883720930232553,0.0833333333333332,115,20,5,13,0,5955,2,3,22,400000,25000.0,500000.0,100000.0,300000.0,400000.0,3,300000,0.0,-0.2
817676,Unknown,Geovani,2024,18303,Brazil,MarabÃ¡,Brazil,15-05-01,Right Winger,Attack,Left,177.0,30-06-26,ProStar,https://img.a.transfermarkt.technology/portrait/header/817676-1724667255.png?lm=1,UKR1,FC Oleksandriya,300000.0,300000.0,23,104,-85,11,10,13,11,13,9,10,10,9,8,15,9,10,14,8,11,10,10,9,12,9,7,11,9,10,9,9,11,12,14,7,11,14,13,14,7,15,7,10,10,12,3,1,2,3,3,3,1,4,4,3,3,19,9,1,12,9,14,10,18,1,1,1,1,1,1,1,10,5,8,17,11,20,13,70,20,7,7326556,5201,5201,2830,Mixed_Race,104,0,0,1268.0,Unknown,2000082429,9111392.0,2.0,10,909,11,0,0,4,69,10,0.438475787245303,0.2973262032085561,0.4044117647058823,0.0012157121379055,0.0,0.0,0.0012503125781445,0.0012503125781445,0.0505924720131114,0.1428571428571428,0.3255813953488373,0.2083333333333332,91,6,2,11,0,4288,0,0,0,500000,42857.142857142855,500000.0,0.0,,200000.0,1,0,0.6666666666666666,1.0
818252,Pedro,Malheiro,2024,449,Portugal,Vila Verde,Portugal,21-01-01,Right-Back,Defender,Right,179.0,30-06-28,Gestifute,https://img.a.transfermarkt.technology/portrait/header/818252-1723802085.jpg?lm=1,TR1,Trabzonspor KulÃ¼bÃ¼,5000000.0,5000000.0,23,114,135,8,13,12,7,12,8,10,8,11,10,11,6,10,13,12,12,13,12,10,11,11,14,11,7,12,10,12,14,13,13,11,8,12,13,14,9,12,5,11,9,13,3,2,4,2,1,3,1,4,2,1,2,12,13,4,14,13,13,14,15,1,1,1,18,1,20,1,5,1,12,14,1,16,1,69,10,20,1087998,5700,5700,3462,Mediterranean_Hispanic,109,0,0,1165.0,Unknown,83335576,2000000.0,1.0,76,1590,79,1,1,3,204,11,0.5044985445885155,0.3649197860962566,0.4411764705882353,0.0011162535595066,0.0,0.0,0.0247561890472618,0.0247561890472618,0.0110836412122558,0.0,0.3720930232558141,0.2083333333333332,108,6,10,26,1,2216,3,19,66,4800000,455000.0,5000000.0,200000.0,,300000.0,1,1000000,0.2,0.2
818495,Unknown,Otávio,2024,720,Brazil,SÃ£o Paulo,Brazil,21-04-02,Centre-Back,Defender,Right,188.0,30-06-28,LINK SPORTS,https://img.a.transfermarkt.technology/portrait/header/818495-1708599170.png?lm=1,PO1,Futebol Clube do Porto,12000000.0,13000000.0,22,153,155,11,12,15,11,15,10,7,10,8,8,16,11,13,15,18,13,19,14,15,15,14,20,14,11,15,12,17,18,13,15,16,6,17,13,15,10,16,20,16,5,16,2,3,3,3,3,3,2,3,2,2,2,12,13,17,13,15,15,2,6,1,1,1,1,1,1,1,15,19,20,17,19,17,5,65,11,20,37346402,7650,7500,6150,Mediterranean_Hispanic,148,7,2,38849.0,Unknown,19186901,6250000.0,2.0,10,1456,11,1,1,3,100,2,0.7426567875099233,0.6524064171122994,0.7279411764705881,0.0375045746117977,0.0460526315789473,0.0263157894736842,0.0597649412353088,0.0647661915478869,0.0346954082057834,0.1428571428571428,0.581395348837209,0.1666666666666666,83,4,3,22,2,3065,0,0,0,12000000,1487500.0,13000000.0,1000000.0,,100000.0,3,8400000,-0.07692307692307693,3.0
818888,Antonio,Raimondo,2024,607,Italy,Ravenna,Italy,18-03-04,Centre-Forward,Attack,Left,185.0,30-06-25,Giuseppe Galli,https://img.a.transfermarkt.technology/portrait/header/818888-1663656468.jpg?lm=1,IT1,Venezia Football Club,4500000.0,4500000.0,20,95,-75,5,5,12,13,11,7,11,10,3,3,11,10,6,12,9,12,11,9,11,11,10,13,7,8,13,5,9,13,12,12,12,10,12,13,10,11,13,5,10,5,5,3,2,2,1,1,2,1,3,2,2,1,12,15,6,12,12,14,12,12,1,1,1,1,1,1,1,1,1,1,1,1,1,20,71,20,9,6006600,4700,4300,2004,Northern_European,95,0,0,1422.0,Unknown,2000021170,9111392.0,2.0,52,1206,54,0,0,7,210,3,0.3192643556496428,0.2089839572192513,0.338235294117647,0.001364417196871,0.0,0.0,0.0222555638909727,0.0222555638909727,0.0505924720131114,0.1428571428571428,0.5116279069767438,0.0833333333333332,140,54,8,19,0,2198,1,4,27,4500000,444444.44444444444,4500000.0,0.0,500000.0,4500000.0,2,600000,0.0,0.6071428571428571
819215,Julien,Duranville,2024,16,Belgium,Uccle,Belgium,05-05-06,Right Winger,Attack,Right,173.0,Unknown,Unknown,https://img.a.transfermarkt.technology/portrait/header/819215-1659621322.jpg?lm=1,L1,Borussia Dortmund,8500000.0,8500000.0,18,101,-9,8,10,14,12,9,10,5,9,2,4,12,4,6,14,14,9,13,8,9,9,9,15,14,5,10,9,12,10,17,15,6,6,12,15,8,8,8,6,6,11,12,1,2,3,2,3,3,2,1,1,1,2,12,11,8,9,12,13,12,15,1,1,1,1,1,1,1,14,1,12,20,1,18,12,0,8,20,24620000,4750,5000,4000,African_Caribbean,97,0,0,2000.0,Unknown,2000155483,8500000.0,1.0,7,1541,8,0,1,1,41,10,0.4118814501190792,0.4224598930481283,0.3529411764705882,0.0019225439766243,0.0,0.0,0.0422605651412853,0.0422605651412853,0.047195755437651,0.0,0.2325581395348837,0.0,39,3,5,4,0,1405,9,96,165,8500000,1250000.0,8500000.0,0.0,8500000.0,,1,3500000,0.0,0.0
820148,Emre,Uzun,2024,589,Germany,Hannover,TÃ¼rkiye,20-06-05,Right Winger,Attack,Left,179.0,30-06-25,SPOCS Global Sports,https://img.a.transfermarkt.technology/portrait/header/820148-1725540567.jpg?lm=1,TR1,Antalyaspor,900000.0,900000.0,19,70,-75,8,8,10,10,12,10,6,11,4,8,12,6,5,12,5,7,10,9,6,12,11,4,12,8,9,6,11,8,12,11,6,7,16,11,5,4,19,5,9,7,14,1,2,2,1,4,4,3,1,3,1,3,14,11,3,11,11,11,13,10,1,1,1,1,1,1,1,1,10,1,10,20,10,15,65,20,10,3864650,4150,4093,2139,Mediterranean_Hispanic,71,0,0,82.0,Unknown,2000045628,9111392.0,2.0,38,596,100,0,0,3,19,10,0.2918761577136809,0.2234224598930481,0.1617647058823529,7.049006041867233e-05,0.0,0.0,0.0042510627656914,0.0042510627656914,0.0505924720131114,0.1428571428571428,0.3720930232558141,0.0416666666666666,91,30,1,15,0,1544,2,27,213,900000,121428.57142857143,900000.0,0.0,900000.0,,0,0,0.0,17.0
820374,Kobbie,Mainoo,2024,985,England,Stockport,England,19-04-05,Central Midfield,Midfield,Right,180.0,30-06-27,CAA Stellar,https://img.a.transfermarkt.technology/portrait/header/820374-1719349758.jpg?lm=1,GB1,Manchester United Football Club,55000000.0,55000000.0,19,100,-85,5,8,12,8,14,5,6,7,4,8,13,7,10,14,14,11,10,15,12,10,11,2,10,6,11,10,12,12,14,13,12,8,15,13,12,10,10,5,6,3,14,1,3,3,1,3,2,3,3,4,4,2,13,11,4,10,10,12,10,20,1,1,1,1,1,1,18,1,20,13,1,14,1,1,66,11,20,44076859,5248,4751,2254,African_Caribbean,105,0,0,1392.0,Unknown,2000123586,9111392.0,2.0,32,1427,33,3,1,1,132,1,0.378936226514951,0.2357219251336898,0.411764705882353,0.0013354486788907,0.0,0.0,0.274818704676169,0.274818704676169,0.0505924720131114,0.1428571428571428,0.3953488372093026,0.0416666666666666,122,12,8,10,0,3628,2,22,88,55000000,6837500.0,55000000.0,0.0,35000000.0,,1,500000,0.0,8.166666666666666
821622,Yunus Emre,ÃÂ¡Ift,2024,152,TÃ¼rkiye,Samsun,TÃ¼rkiye,01-09-03,Centre-Back,Defender,Right,185.0,30-06-27,Yasin Ã‡?plak,https://img.a.transfermarkt.technology/portrait/header/821622-1727716891.png?lm=1,TR1,Samsunspor,400000.0,850000.0,21,90,-75,5,5,9,7,9,12,10,4,4,11,9,5,12,10,14,10,15,11,13,10,12,12,10,11,12,12,12,11,10,9,12,12,12,11,11,9,12,9,10,7,8,1,1,3,2,1,2,2,2,1,1,2,15,12,6,12,13,13,14,14,1,1,20,1,1,1,1,1,1,1,1,1,1,1,78,9,20,1084034,4950,4950,2950,Mediterranean_Hispanic,91,0,0,1110.0,Unknown,2000048031,9111392.0,2.0,100,1294,100,1,1,3,180,2,0.4052659433712622,0.3101604278074866,0.3088235294117646,0.0010631446098761,0.0,0.0,0.0017504376094023,0.0040010002500625,0.0505924720131114,0.1428571428571428,0.5116279069767438,0.125,69,1,0,16,1,1590,4,8,23,350000,25000.0,850000.0,150000.0,500000.0,500000.0,0,0,-0.3,-0.5
822331,Omar,El Hilali,2024,714,Spain,L'Hospitalet de Llobregat,Morocco,12-09-03,Right-Back,Defender,Left,183.0,30-06-27,Promoesport,https://img.a.transfermarkt.technology/portrait/header/822331-1683211692.jpg?lm=1,ES1,Reial Club Deportiu Espanyol de Barcelona S.A.D.,2000000.0,2000000.0,21,95,-75,5,9,10,3,10,3,8,5,7,10,10,6,14,10,12,9,9,10,9,10,14,11,5,9,9,10,8,10,14,14,9,11,15,14,14,8,14,5,8,10,18,1,3,1,1,1,3,1,1,2,1,1,13,11,2,11,12,10,6,13,1,14,10,20,1,18,1,1,1,14,1,1,14,1,0,20,6,6391246,4500,4500,1250,North_African__Middle_Eastern,93,0,0,420.0,Unknown,2000049425,9111392.0,2.0,89,779,67,1,0,6,170,11,0.3457263826409102,0.1283422459893048,0.3235294117647059,0.0003968686963297,0.0,0.0,0.0097524381095273,0.0097524381095273,0.0505924720131114,0.1428571428571428,0.4651162790697669,0.125,135,0,7,34,1,3020,2,12,32,3000000,215384.61538461538,3000000.0,0.0,200000.0,2000000.0,1,0,0.5,2.0
822458,Bamba,Dieng,2024,1420,Senegal,Pikine,Senegal,23-03-00,Centre-Forward,Attack,Right,178.0,30-06-25,Classico,https://img.a.transfermarkt.technology/portrait/header/822458-1668163298.jpg?lm=1,FR1,Angers Sporting Club de l'Ouest,4000000.0,10000000.0,24,120,145,5,8,12,14,12,6,11,10,1,6,10,8,8,13,8,13,13,14,11,10,11,13,14,10,14,8,13,12,16,13,12,9,14,15,13,11,13,10,12,10,7,1,2,1,1,1,2,1,2,1,3,3,18,15,1,12,10,12,12,19,1,1,1,1,1,1,1,1,1,1,12,1,1,20,72,8,20,4754999,5999,5999,4999,African_Caribbean,118,11,1,7795.0,Unknown,12092876,3700000.0,2.0,83,1145,84,0,1,1,18,3,0.5440592749404605,0.5293048128342246,0.5073529411764706,0.0075182960331477,0.0723684210526315,0.0131578947368421,0.0197549387346836,0.0497624406101525,0.0205283480096669,0.1428571428571428,0.3488372093023257,0.25,0,0,0,0,0,0,6,27,92,3500000,272727.2727272727,10000000.0,2000000.0,,500000.0,3,4800000,-0.125,-0.5
822959,Tom,Bischof,2024,533,Germany,Aschaffenburg,Germany,28-06-05,Attacking Midfield,Midfield,Left,176.0,30-06-25,Sports360 GmbH,https://img.a.transfermarkt.technology/portrait/header/822959-1723921256.jpg?lm=1,L1,TSG 1899 Hoffenheim FuÃŸball-Spielbetriebs GmbH,3500000.0,3500000.0,19,92,-85,7,7,13,11,15,9,9,11,7,11,14,8,11,15,13,10,7,13,6,14,15,5,15,4,11,9,14,10,10,11,10,5,8,8,5,5,6,8,11,8,13,2,1,2,1,1,2,2,1,3,1,3,11,9,8,9,12,11,11,10,1,1,1,1,1,1,1,1,20,1,1,19,1,1,66,20,7,21000000,4750,4750,2750,Mediterranean_Hispanic,91,0,0,1409.0,Unknown,2000147056,9111392.0,2.0,38,97,40,3,0,3,199,0,0.3788039163799948,0.2887700534759358,0.3088235294117646,0.0013518641724128,0.0,0.0,0.0172543135783946,0.0172543135783946,0.0505924720131114,0.1428571428571428,0.3023255813953489,0.0416666666666666,107,24,22,14,0,2458,2,7,33,12000000,1250000.0,12000000.0,0.0,3500000.0,,0,0,2.4285714285714284,2.4285714285714284
823231,Dango,Ouattara,2024,989,Burkina Faso,Ouagadougou,Burkina Faso,11-02-02,Left Winger,Attack,Left,177.0,30-06-28,PSM,https://img.a.transfermarkt.technology/portrait/header/823231-1663162842.jpg?lm=1,GB1,Association Football Club Bournemouth,20000000.0,25000000.0,22,123,-75,11,12,13,11,16,12,8,9,5,10,12,11,10,13,6,11,8,11,10,12,12,10,12,7,12,11,14,14,14,13,12,9,15,14,13,9,13,7,13,7,11,3,1,2,1,3,2,2,3,2,3,2,12,11,6,12,9,15,13,13,1,1,1,1,1,1,1,12,1,14,14,1,20,17,68,20,8,43189421,6197,6147,3749,African_Caribbean,121,8,4,9618.0,Unknown,12091814,22500000.0,1.0,12,1100,13,0,0,1,22,7,0.5636411749139985,0.395614973262032,0.5294117647058822,0.0092786163090824,0.0526315789473684,0.0526315789473684,0.0997749437359339,0.1247811952988247,0.1249756937692713,0.0,0.3255813953488373,0.1666666666666666,125,19,17,11,0,1674,4,17,51,20000000,2166666.6666666665,25000000.0,5000000.0,,10000000.0,1,10000000,0.0,0.0
825199,Facundo,González,2024,234,Uruguay,Montevideo,Uruguay,06-06-03,Centre-Back,Defender,Right,193.0,30-06-25,Guastadisegno,https://img.a.transfermarkt.technology/portrait/header/825199-1676634319.jpg?lm=1,NL1,Feyenoord Rotterdam,2000000.0,2000000.0,21,121,130,11,11,9,10,11,10,8,14,6,12,12,10,13,16,10,12,12,10,13,14,12,19,5,14,12,14,12,13,14,12,12,8,12,12,13,9,12,7,11,12,14,3,2,3,1,2,1,3,2,4,3,3,9,12,7,12,9,10,9,20,1,1,1,1,1,1,20,1,15,1,1,1,1,1,74,10,20,1055172,6024,6024,2152,Mediterranean_Hispanic,120,0,0,10014.0,Unknown,51030948,1750000.0,1.0,106,975,103,1,1,3,85,2,0.5473670283143689,0.2248128342245989,0.5220588235294117,0.0096610007464221,0.0,0.0,0.0097524381095273,0.0097524381095273,0.0096947137420483,0.0,0.6976744186046511,0.125,76,3,2,23,0,606,1,3,12,4000000,316666.6666666667,4000000.0,0.0,200000.0,2000000.0,2,2500000,1.0,1.0
825437,Ilyes,Housni,2024,738,France,CrÃ©teil,Morocco,14-05-05,Centre-Forward,Attack,Right,172.0,30-06-25,VV Consulting,https://img.a.transfermarkt.technology/portrait/header/825437-1665043208.jpg?lm=1,FR1,Le Havre Athletic Club,3000000.0,3500000.0,19,88,-8,9,12,11,12,11,8,15,10,8,8,12,5,4,12,10,12,6,10,7,11,12,9,10,10,10,6,8,10,11,9,9,10,13,11,10,9,11,11,18,5,12,4,2,2,3,2,3,2,1,3,2,3,18,9,4,10,12,10,12,20,1,1,1,1,1,1,1,1,1,1,17,1,1,20,0,8,20,16599999,4397,4397,1147,North_African__Middle_Eastern,87,0,0,645.0,Unknown,2000091572,9111392.0,2.0,34,395,67,0,1,6,126,3,0.3320984387404075,0.1173262032085561,0.2794117647058823,0.0006141325811818,0.0,0.0,0.0147536884221055,0.0172543135783946,0.0505924720131114,0.1428571428571428,0.2093023255813952,0.0416666666666666,53,36,8,2,0,1735,1,1,9,2500000,-83333.33333333333,3500000.0,500000.0,2800000.0,,2,700000,-0.10714285714285714,-0.16666666666666666
826224,Arnau,Martínez,2024,12321,Spain,PremiÃ  de Dalt,Spain,25-04-03,Right-Back,Defender,Right,182.0,30-06-27,TRIPLE MATCH,https://img.a.transfermarkt.technology/portrait/header/826224-1701444094.jpg?lm=1,ES1,Girona FÃºtbol Club S. A. D.,10000000.0,15000000.0,21,118,-8,7,11,15,7,15,3,11,10,10,12,11,6,15,12,6,11,12,9,10,11,13,7,9,12,15,12,14,9,15,13,14,10,12,15,10,6,20,10,14,9,15,2,3,2,1,2,3,2,3,4,2,2,18,10,2,13,13,9,10,18,1,11,16,20,11,18,1,1,1,1,1,1,1,1,0,11,20,10000000,5900,5900,2750,Mediterranean_Hispanic,115,0,0,3068.0,Unknown,2000062512,9111392.0,2.0,89,1182,89,1,1,3,107,11,0.530960571579783,0.2887700534759358,0.4852941176470588,0.0029538232167221,0.0,0.0,0.0497624406101525,0.0747686921730432,0.0505924720131114,0.1428571428571428,0.4418604651162785,0.125,150,9,18,24,0,2136,0,0,0,10000000,746153.8461538461,15000000.0,5000000.0,3000000.0,10000000.0,0,0,0.0,-0.3333333333333333
830108,Julián,Malatini,2024,86,Argentina,CÃ³rdoba,Argentina,31-05-01,Centre-Back,Defender,Right,191.0,Unknown,SP,https://img.a.transfermarkt.technology/portrait/header/830108-1722887346.jpg?lm=1,L1,Sportverein Werder Bremen von 1899,2500000.0,2500000.0,23,110,135,6,9,13,11,10,5,12,11,12,12,11,1,12,10,10,12,14,9,11,11,12,18,9,10,11,13,15,10,13,10,9,12,13,12,13,12,10,7,15,10,11,3,3,3,3,4,1,2,1,3,2,3,10,10,1,13,12,15,11,9,1,1,19,20,1,16,1,1,1,1,1,1,1,1,78,8,20,3140128,4996,4996,2134,Native_American,104,0,0,1664.0,Unknown,14247879,1345000.0,2.0,4,400,4,1,1,5,194,2,0.4113522095792538,0.2228877005347593,0.4044117647058823,0.0015980965752452,0.0,0.0,0.0122530632658164,0.0122530632658164,0.0074446512403122,0.1428571428571428,0.6511627906976742,0.2083333333333332,105,3,2,19,1,4837,2,4,20,3000000,295000.0,3000000.0,250000.0,,800000.0,3,1750000,0.2,0.7647058823529411
834483,Álex,Padilla,2024,621,Spain,Zarautz,Mexico,01-09-03,Goalkeeper,Goalkeeper,Right,190.0,30-06-27,Wasserman,https://img.a.transfermarkt.technology/portrait/header/834483-1709676711.png?lm=1,ES1,Athletic Club Bilbao,200000.0,200000.0,21,91,-8,3,2,2,3,4,6,1,3,3,2,13,2,3,6,12,8,11,8,7,7,12,11,2,7,2,12,8,7,10,8,3,13,15,7,2,9,15,7,5,8,13,13,13,7,5,13,11,13,13,15,12,8,19,11,6,10,11,9,10,10,20,1,1,1,1,1,1,1,1,1,1,1,1,1,0,9,20,24240000,4550,4550,2050,Mediterranean_Hispanic,81,0,0,501.0,Unknown,2000065884,9111392.0,2.0,89,1700,64,2,1,3,33,5,0.3523418893887272,0.213903743315508,0.2352941176470588,0.0004750836948765,0.0,0.0,0.0007501875468867,0.0007501875468867,0.0505924720131114,0.1428571428571428,0.6279069767441858,0.125,0,0,0,0,0,0,1,6,52,2000000,237500.0,2000000.0,0.0,,200000.0,1,1800000,9.0,12.333333333333334
834899,Unknown,Felipe Augusto,2024,520,Brazil,SÃ£o Paulo,Brazil,18-02-04,Centre-Forward,Attack,Left,187.0,30-06-28,Bertolucci Sports,https://img.a.transfermarkt.technology/portrait/header/834899-1689215871.jpg?lm=1,BE1,Cercle Brugge Koninklijke Sportvereniging,3000000.0,3000000.0,20,130,134,12,12,13,6,12,15,11,12,10,9,16,10,14,14,14,14,13,14,12,13,13,13,13,13,12,12,14,12,11,12,14,12,14,12,13,14,15,15,11,13,10,3,2,2,1,1,2,2,2,3,2,3,10,12,11,11,12,11,9,10,1,1,1,1,1,1,19,7,20,1,1,7,1,1,76,20,10,-1,6250,6250,5000,Mediterranean_Hispanic,128,0,0,32655.0,Unknown,19125422,3000000.0,1.0,10,1456,11,0,0,3,49,3,0.5772691188145012,0.5294117647058822,0.5808823529411764,0.0315235412661366,0.0,0.0,0.0147536884221055,0.0147536884221055,0.0166393510930859,0.0,0.5581395348837206,0.0833333333333332,105,17,3,8,0,3453,0,0,0,3000000,475000.0,3000000.0,0.0,150000.0,3000000.0,2,600000,0.0,0.0
840640,Sammy,Braybrooke,2024,511,England,Leicester,England,12-03-04,Defensive Midfield,Midfield,Right,183.0,31-05-25,SEG,https://img.a.transfermarkt.technology/portrait/header/default.jpg?lm=1,SC1,Dundee Football Club,200000.0,250000.0,20,103,-85,8,6,10,10,12,9,9,13,6,7,13,9,10,13,15,12,10,13,8,14,12,4,9,12,12,10,8,12,10,13,12,7,12,11,12,7,20,8,16,11,15,3,2,2,2,3,3,3,2,1,2,3,13,14,5,11,12,12,10,13,1,1,1,1,1,1,16,1,20,1,1,14,1,1,0,14,20,46535884,4999,5149,2757,Northern_European,105,0,0,1160.0,Unknown,2000048960,9111392.0,2.0,32,813,33,3,1,7,61,4,0.4315956602275734,0.2895187165775401,0.411764705882353,0.0011114254731766,0.0,0.0,0.0007501875468867,0.0010002500625156,0.0505924720131114,0.1428571428571428,0.4651162790697669,0.0833333333333332,83,6,12,15,0,2371,0,0,0,300000,16666.666666666668,300000.0,50000.0,250000.0,300000.0,1,100000,0.5,0.5
842910,Ayrton,Costa,2024,1096,Argentina,Quilmes,Argentina,12-07-99,Left-Back,Defender,Left,179.0,30-06-28,Lucio Corporation,https://img.a.transfermarkt.technology/portrait/header/842910-1676234340.JPG?lm=1,BE1,Royal Antwerp Football Club,2000000.0,2000000.0,25,120,132,6,11,12,10,11,1,12,4,10,14,10,8,13,11,14,13,9,11,15,10,12,12,8,4,11,13,11,12,13,11,12,11,10,13,13,12,12,13,9,6,13,1,1,3,1,3,1,1,3,2,2,2,18,9,1,9,8,10,13,9,1,15,20,1,1,1,1,1,1,1,1,1,1,1,74,20,9,1710506,5756,5756,3244,Mediterranean_Hispanic,113,0,0,5865.0,Club AtlÃ©tico Platense,2000011616,9111392.0,2.0,4,1198,4,1,0,3,173,8,0.5119079121460705,0.3416042780748662,0.4705882352941176,0.0056546547097499,0.0,0.0,0.0097524381095273,0.0097524381095273,0.0505924720131114,0.1428571428571428,0.3720930232558141,0.2916666666666665,103,5,2,38,1,3534,4,11,21,3000000,283333.3333333333,3000000.0,100000.0,,,3,1350000,0.5,1.5
844516,Luis,Vázquez,2024,58,Argentina,Recreo,Argentina,24-04-01,Centre-Forward,Attack,Right,190.0,30-06-28,La Squadra Sports,https://img.a.transfermarkt.technology/portrait/header/844516-1699907027.jpg?lm=1,BE1,Royal Sporting Club Anderlecht,4000000.0,5000000.0,23,121,138,5,10,11,14,12,7,14,9,2,5,11,8,5,11,8,12,12,13,11,10,11,20,8,14,13,8,13,13,12,13,14,16,14,13,14,13,13,11,12,8,5,3,3,2,2,1,1,4,2,3,3,2,18,13,7,13,11,11,12,13,1,1,1,1,1,1,1,1,1,1,1,1,1,20,78,9,20,3618942,5898,5898,2519,Mediterranean_Hispanic,119,0,0,1958.0,Unknown,14223179,2415000.0,2.0,4,1209,4,0,1,3,175,3,0.5306959513098704,0.2640641711229946,0.5147058823529411,0.0018819880514519,0.0,0.0,0.0197549387346836,0.0247561890472618,0.0133892608128003,0.1428571428571428,0.6279069767441858,0.2083333333333332,181,28,10,11,1,4262,4,10,70,3000000,207142.85714285713,5000000.0,1500000.0,,3800000.0,2,2700000,-0.4,0.0
847279,Oumar,Diakité,2024,1421,Cote d'Ivoire,Bingerville,Cote d'Ivoire,20-12-03,Centre-Forward,Attack,Right,182.0,30-06-28,AMS CONSULTING,https://img.a.transfermarkt.technology/portrait/header/847279-1723837401.png?lm=1,FR1,Stade de Reims,6000000.0,6000000.0,21,112,135,8,10,12,8,12,8,12,9,8,9,12,9,9,13,6,12,11,11,10,12,11,13,12,5,11,12,12,12,15,13,13,14,13,14,13,12,9,5,9,15,10,3,1,3,3,4,4,1,3,1,3,3,14,13,2,9,10,10,11,15,1,1,1,1,1,1,20,1,15,1,1,1,1,1,87,13,20,1656999,5606,5602,3902,African_Caribbean,111,0,0,768.0,Unknown,12078756,2500000.0,1.0,23,194,24,0,1,1,197,3,0.4915321513627944,0.4119786096256684,0.4558823529411764,0.0007329035049009,0.0,0.0,0.0297574393598399,0.0297574393598399,0.0138614961526709,0.0,0.4418604651162785,0.125,95,25,13,16,0,1735,1,4,65,9000000,955555.5555555555,9000000.0,0.0,900000.0,9000000.0,1,1000000,0.5,1.25
848875,Diego,Callai,2024,336,Brazil,Caxias do Sul,Brazil,18-07-04,Goalkeeper,Goalkeeper,Right,190.0,Unknown,Promoesport,https://img.a.transfermarkt.technology/portrait/header/848875-1693591996.jpg?lm=1,PO1,Sporting Clube de Portugal,1000000.0,1000000.0,20,80,-8,3,2,2,2,8,4,7,1,2,1,8,1,3,7,7,8,9,11,10,7,9,12,2,9,3,12,11,7,9,9,11,13,12,8,7,11,14,5,14,8,10,13,11,13,6,11,11,8,12,11,13,10,13,9,2,12,10,9,13,11,20,1,1,1,1,1,1,1,1,1,1,1,1,1,83,7,20,13979999,3994,3994,1246,Mediterranean_Hispanic,81,0,0,2850.0,Unknown,83335582,9111392.0,2.0,10,337,11,2,1,3,193,5,0.2787774543530035,0.1279144385026737,0.2352941176470588,0.0027433186527321,0.0,0.0,0.0047511877969492,0.0047511877969492,0.0505924720131114,0.1428571428571428,0.6279069767441858,0.0833333333333332,0,0,0,0,0,0,0,0,0,1000000,0.0,1000000.0,0.0,,1000000.0,2,0,0.0,0.0
849410,Valentín,Barco,2024,368,Argentina,25 de Mayo,Argentina,23-07-04,Left-Back,Defender,Left,170.0,30-06-25,Unknown,https://img.a.transfermarkt.technology/portrait/header/849410-1683292377.jpg?lm=1,ES1,Sevilla FÃºtbol Club S.A.D.,13000000.0,13000000.0,20,105,-8,13,12,12,10,9,12,3,14,11,10,12,12,12,14,11,10,10,8,8,9,11,13,15,2,15,11,14,14,14,11,15,4,11,12,15,6,15,5,13,11,11,1,3,2,2,1,3,1,3,2,1,1,17,10,6,10,9,12,10,18,1,20,1,1,15,1,1,15,1,1,14,1,1,1,0,20,7,8660407,5000,5000,2000,Northern_European,96,0,0,2149.0,Unknown,2000033291,9150000.0,1.0,4,2,4,1,0,7,181,8,0.4118814501190792,0.2085561497326203,0.3455882352941176,0.0020664209492597,0.0,0.0,0.0647661915478869,0.0647661915478869,0.0508069668601905,0.0,0.1627906976744184,0.0833333333333332,54,1,6,11,0,3511,2,2,11,6000000,661111.1111111111,13000000.0,4000000.0,3500000.0,6000000.0,3,5000000,-0.5384615384615384,-0.5384615384615384
849520,Santiago,Castro,2024,1025,Argentina,Buenos Aires,Argentina,18-09-04,Centre-Forward,Attack,Right,179.0,30-06-28,Unknown,https://img.a.transfermarkt.technology/portrait/header/849520-1724827267.jpg?lm=1,IT1,Bologna Football Club 1909,12000000.0,12000000.0,20,108,-75,7,8,11,12,11,8,13,11,6,7,10,14,8,12,14,12,12,12,10,11,15,14,12,9,12,8,13,14,13,13,12,11,13,13,13,12,12,7,9,5,12,3,3,1,3,2,3,3,3,3,2,2,13,9,4,10,11,10,7,13,1,1,1,1,1,1,1,10,1,1,18,1,1,20,80,8,20,7651870,5249,5249,2525,Mediterranean_Hispanic,112,0,0,483.0,Unknown,14236223,12000000.0,1.0,4,275,4,0,1,3,40,3,0.4448266737232071,0.2647058823529411,0.463235294117647,0.0004577025840883,0.0,0.0,0.0597649412353088,0.0597649412353088,0.0666407400205561,0.0,0.3720930232558141,0.0833333333333332,105,18,11,19,0,3115,0,0,0,25000000,2766666.6666666665,25000000.0,0.0,1000000.0,25000000.0,1,5000000,1.0833333333333333,2.5714285714285716
851111,Luciano,Gondou,2024,964,Argentina,Rufino,Argentina,22-06-01,Centre-Forward,Attack,Left,189.0,30-06-28,Universal Twenty Two,https://img.a.transfermarkt.technology/portrait/header/851111-1725247115.png?lm=1,RU1,AO FK Zenit Sankt-Peterburg,11000000.0,11000000.0,23,117,138,10,8,11,13,12,11,15,8,5,5,11,12,5,12,8,13,10,12,12,10,12,17,6,4,13,5,12,13,13,12,12,14,13,12,12,13,11,5,9,6,8,1,1,4,3,3,2,1,2,1,3,2,10,13,7,11,11,10,12,20,1,1,1,1,1,1,1,1,1,1,12,1,10,20,83,20,10,3891755,5850,5850,3128,Mediterranean_Hispanic,115,0,0,2386.0,Unknown,14242394,7590000.0,2.0,4,1259,4,0,0,3,7,3,0.5243450648319662,0.3291978609625668,0.4852941176470588,0.0022952722413038,0.0,0.0,0.0547636909227306,0.0547636909227306,0.0421400594460957,0.1428571428571428,0.6046511627906974,0.2083333333333332,140,38,11,10,0,3714,0,0,0,12000000,907692.3076923077,12000000.0,75000.0,,825000.0,3,5750000,0.2,0.5
851595,Unknown,Jefté,2024,124,Brazil,Rio de Janeiro,Brazil,21-12-03,Left-Back,Defender,Left,183.0,30-06-28,Promanager,https://img.a.transfermarkt.technology/portrait/header/851595-1716581601.jpg?lm=1,SC1,Rangers Football Club,1500000.0,1500000.0,21,82,-75,4,10,13,1,11,1,8,6,7,9,9,3,8,11,11,9,9,8,7,9,13,15,13,7,7,10,8,8,15,13,8,6,12,13,10,7,14,8,3,9,11,2,1,2,1,3,1,2,2,2,3,2,11,11,2,12,11,7,11,11,1,20,1,1,19,1,1,1,1,1,1,1,1,1,64,20,7,790288,4100,4100,678,Mediterranean_Hispanic,73,0,0,152.0,Unknown,2000079323,9111392.0,2.0,10,1234,11,1,0,3,161,8,0.2928023286583753,0.0671657754010695,0.1764705882352941,0.0001380832690393,0.0,0.0,0.0072518129532383,0.0072518129532383,0.0505924720131114,0.1428571428571428,0.4651162790697669,0.125,96,5,10,14,0,3821,0,0,0,2500000,460000.0,2500000.0,-300000.0,,2500000.0,1,700000,2.125,4.0
855015,Farès,Chaïbi,2024,24,France,Lyon,Algeria,28-11-02,Attacking Midfield,Midfield,Right,183.0,30-06-28,KDS FM,https://img.a.transfermarkt.technology/portrait/header/855015-1693383538.jpg?lm=1,L1,Eintracht Frankfurt FuÃŸball AG,18000000.0,18000000.0,22,110,-8,10,9,11,11,12,10,10,11,5,8,13,10,11,13,11,12,12,12,10,13,12,15,13,8,12,12,12,12,12,13,11,11,14,13,13,12,12,5,13,7,14,3,1,2,2,1,2,2,2,1,3,3,14,13,7,12,12,13,7,12,1,1,1,1,1,1,10,1,20,1,14,14,13,12,79,8,20,27424000,5499,5499,2519,North_African__Middle_Eastern,111,0,0,1942.0,Unknown,49060523,10000000.0,1.0,34,884,1,3,1,6,63,0,0.4779042074622917,0.2640641711229946,0.4558823529411764,0.0018665381751958,0.0,0.0,0.0897724431107777,0.0897724431107777,0.055529320258896,0.0,0.4651162790697669,0.1666666666666666,126,18,23,10,0,2493,2,3,14,14000000,1550000.0,18000000.0,4000000.0,,10000000.0,2,5750000,-0.2222222222222222,-0.06666666666666667
855256,Alex,Scott,2024,989,Guernsey,Guernsey,England,21-08-03,Central Midfield,Midfield,Right,178.0,Unknown,Unknown,https://img.a.transfermarkt.technology/portrait/header/855256-1656922605.jpg?lm=1,GB1,Association Football Club Bournemouth,20000000.0,20000000.0,21,123,-85,5,10,14,11,13,6,8,9,4,8,13,7,10,13,12,11,12,13,11,14,13,14,13,9,14,10,14,12,13,15,11,8,12,14,14,9,11,8,13,7,13,3,2,2,3,3,3,2,3,3,1,3,10,10,8,15,10,13,14,13,1,1,1,1,1,14,18,1,20,1,1,20,16,1,0,8,20,11587574,6150,6150,3263,Northern_European,116,0,0,1740.0,Unknown,95079228,23000000.0,1.0,42,577,33,3,1,7,22,1,0.5640381053188674,0.3436363636363636,0.4926470588235294,0.0016714834874619,0.0,0.0,0.0997749437359339,0.0997749437359339,0.1277535487096864,0.0,0.3488372093023257,0.125,131,11,11,30,0,1685,2,32,115,20000000,1995000.0,20000000.0,0.0,800000.0,20000000.0,2,250000,0.0,0.0
857818,Yaser,Asprilla,2024,12321,Colombia,Bajo BaudÃ³,Colombia,19-11-03,Right Winger,Attack,Left,175.0,30-06-30,Unknown,https://img.a.transfermarkt.technology/portrait/header/857818-1691597301.jpg?lm=1,ES1,Girona FÃºtbol Club S. A. D.,9000000.0,9000000.0,21,126,-9,11,12,14,11,12,11,8,11,4,5,13,9,6,13,13,11,12,12,11,12,12,10,13,6,13,5,11,13,13,12,10,12,13,13,13,11,13,14,16,8,11,4,2,4,1,3,3,3,3,2,3,1,7,10,3,10,10,12,9,20,1,1,1,1,1,1,1,10,11,12,18,20,20,15,75,20,15,15700641,6300,6300,3252,African_Caribbean,117,2,1,5800.0,Unknown,2000053239,10500000.0,2.0,20,130,20,0,0,1,107,10,0.5838846255623181,0.3424598930481283,0.4999999999999999,0.0055918895874593,0.0131578947368421,0.0131578947368421,0.0447611902975743,0.0447611902975743,0.058307175199311,0.1428571428571428,0.2790697674418605,0.125,147,15,13,17,1,1890,1,7,39,18000000,1376923.076923077,18000000.0,0.0,3000000.0,18000000.0,4,11000000,1.0,2.0
857948,Kevin,Castaño,2024,16704,Colombia,ItagÃ¼Ã­,Colombia,29-09-00,Defensive Midfield,Midfield,Right,177.0,30-06-28,Top Champ,https://img.a.transfermarkt.technology/portrait/header/857948-1721724428.png?lm=1,RU1,FK Krasnodar,6000000.0,6000000.0,24,105,135,11,11,12,13,13,14,7,15,11,6,13,13,5,14,11,11,7,14,12,12,12,13,13,10,10,8,13,10,10,13,12,8,9,11,9,11,11,4,13,6,8,1,1,3,3,3,3,3,1,2,2,1,10,11,2,12,11,8,10,11,1,1,1,1,1,1,1,1,18,1,1,20,1,1,78,10,20,1482153,4405,4669,1783,Mediterranean_Hispanic,105,0,0,319.0,Unknown,51072325,5480000.0,2.0,20,671,20,3,1,3,78,4,0.3680867954485314,0.1853475935828877,0.411764705882353,0.0002993413524628,0.0,0.0,0.0297574393598399,0.0297574393598399,0.0304175115975443,0.1428571428571428,0.3255813953488373,0.25,127,3,10,24,0,4057,0,0,0,6000000,450000.0,6000000.0,0.0,,200000.0,2,1800000,0.2,0.5
858712,Unknown,Pedro Henrique,2024,660,Brazil,Salvador,Brazil,11-07-02,Left-Back,Defender,Right,177.0,30-06-28,Unknown,https://img.a.transfermarkt.technology/portrait/header/858712-1723486558.png?lm=1,UKR1,FC Shakhtar Donetsk,1000000.0,1000000.0,22,131,138,5,5,8,9,12,9,15,7,6,13,10,7,14,11,10,14,12,12,14,10,10,14,10,9,9,14,12,14,14,13,13,16,14,14,13,13,13,9,11,4,9,1,2,3,2,1,3,3,3,3,3,2,9,12,6,12,13,12,10,10,1,1,20,13,1,1,1,1,1,1,1,1,1,1,82,12,20,6035689,6460,6460,3537,Mediterranean_Hispanic,130,0,0,2458.0,Unknown,19232517,9111392.0,2.0,10,1289,11,1,1,3,72,8,0.6050542471553321,0.3729411764705882,0.5955882352941175,0.0023647966844565,0.0,0.0,0.0047511877969492,0.0047511877969492,0.0505924720131114,0.1428571428571428,0.3255813953488373,0.1666666666666666,132,0,3,19,3,6117,0,0,0,2500000,321428.5714285714,2500000.0,0.0,,1000000.0,2,0,1.5,1.5
858719,Telasco,Segovia,2024,3268,Venezuela,"Barquisimeto, Lara",Venezuela,02-04-03,Central Midfield,Midfield,Right,180.0,30-06-26,T&C,https://img.a.transfermarkt.technology/portrait/header/858719-1718705752.jpg?lm=1,PO1,Casa Pia AtlÃ©tico Clube,700000.0,700000.0,21,113,-8,13,9,11,8,12,12,8,10,5,11,13,5,10,13,12,13,10,12,12,12,13,9,12,8,11,12,13,13,13,13,13,8,14,12,13,10,12,6,13,5,12,4,3,1,3,4,2,3,2,2,3,1,12,13,1,12,9,11,10,13,1,1,1,1,1,1,15,12,20,1,1,1,1,1,73,10,20,700000,5500,5500,2250,Mediterranean_Hispanic,113,1,0,994.0,U.C. Sampdoria,86080119,9111392.0,2.0,108,146,105,3,1,3,48,1,0.4780365175972479,0.2352941176470588,0.4705882352941176,0.000951133007019,0.006578947368421,0.0,0.0032508127031757,0.0032508127031757,0.0505924720131114,0.1428571428571428,0.3953488372093026,0.125,108,9,5,16,0,5803,0,0,0,1000000,90000.0,1000000.0,200000.0,200000.0,400000.0,2,100000,0.42857142857142855,1.5
859035,Kees,Smit,2024,1090,Netherlands,Heiloo,Netherlands,20-01-06,Central Midfield,Midfield,Right,182.0,30-06-28,Forza Sports Group,https://img.a.transfermarkt.technology/portrait/header/859035-1723819911.jpg?lm=1,NL1,Alkmaar Zaanstreek,800000.0,800000.0,18,80,-8,6,6,6,8,13,6,6,5,6,8,7,6,13,13,15,11,8,4,7,9,13,9,5,3,6,8,7,11,12,13,7,6,13,13,6,6,20,8,4,14,8,2,1,3,3,3,1,3,2,1,3,2,15,11,1,12,10,14,8,15,1,1,1,1,1,1,18,1,20,1,1,12,1,1,0,10,20,12374999,3849,3849,2199,Northern_European,65,0,0,100.0,Unknown,2000181764,9111392.0,2.0,67,608,68,3,1,7,16,1,0.2595924847843345,0.2298395721925133,0.1176470588235293,8.787117120683812e-05,0.0,0.0,0.0037509377344336,0.0037509377344336,0.0505924720131114,0.1428571428571428,0.4418604651162785,0.0,113,17,18,11,0,4806,0,0,0,2000000,466666.6666666667,2000000.0,-200000.0,2000000.0,,1,1200000,1.5,2.3333333333333335
859218,Plamen,Andreev,2024,234,Bulgaria,Sofia,Bulgaria,15-12-04,Goalkeeper,Goalkeeper,Right,192.0,30-06-29,Viktor Kirkov,https://img.a.transfermarkt.technology/portrait/header/859218-1680124673.png?lm=1,NL1,Feyenoord Rotterdam,2000000.0,2000000.0,20,96,-75,5,1,3,1,9,7,9,2,1,1,10,3,3,9,8,12,12,10,13,8,9,13,4,12,5,11,15,11,10,12,10,14,13,9,10,11,13,7,14,8,12,13,11,8,6,11,13,10,11,13,8,13,17,12,5,15,13,15,17,15,20,1,1,1,1,1,1,1,1,1,1,1,1,1,70,5,20,3159999,5067,4467,1234,Mediterranean_Hispanic,97,0,0,349.0,Unknown,2000076241,1200000.0,1.0,11,1389,12,2,1,3,85,5,0.3413601481873511,0.1266310160427807,0.3529411764705882,0.0003283098704431,0.0,0.0,0.0097524381095273,0.0097524381095273,0.0066390733075918,0.0,0.6744186046511627,0.0833333333333332,0,0,0,0,0,0,0,0,0,1500000,103571.42857142857,2000000.0,500000.0,1800000.0,1500000.0,1,500000,-0.25,-0.0625
861410,Arda,Güler,2024,418,Unknown,Unknown,TÃ¼rkiye,25-02-05,Right Winger,Attack,Left,175.0,30-06-29,Unknown,https://img.a.transfermarkt.technology/portrait/header/861410-1699472585.jpg?lm=1,ES1,Real Madrid Club de FÃºtbol,45000000.0,45000000.0,19,100,-9,14,15,13,13,15,14,12,12,2,3,14,14,4,18,11,13,4,14,8,14,8,16,16,11,14,4,12,7,10,11,10,8,7,10,7,6,14,4,14,9,11,1,1,2,2,3,1,1,2,2,1,3,9,14,5,10,10,16,15,17,1,1,1,1,1,1,9,9,14,9,11,20,14,12,68,20,12,10059683,5900,5500,5000,Mediterranean_Hispanic,99,0,0,2764.0,Unknown,2000077193,11250000.0,2.0,105,1549,100,0,0,3,167,10,0.4780365175972479,0.5294117647058822,0.3676470588235294,0.0026602755678553,0.0,0.0,0.2248062015503876,0.2248062015503876,0.0624739576099336,0.1428571428571428,0.2790697674418605,0.0416666666666666,121,32,30,8,0,4279,8,45,60,45000000,3453846.153846154,45000000.0,0.0,15000000.0,,1,0,0.0,2.0
861981,Alan,Matturro,2024,252,Uruguay,Montevideo,Uruguay,11-10-04,Centre-Back,Defender,Left,189.0,30-06-26,Unknown,https://img.a.transfermarkt.technology/portrait/header/861981-1692967519.jpg?lm=1,IT1,Genoa Cricket and Football Club,4000000.0,4000000.0,20,107,-75,4,1,11,5,11,1,14,13,5,14,13,6,14,12,6,10,13,5,10,12,12,14,5,13,6,14,8,9,11,11,9,14,10,12,9,7,11,8,16,12,14,4,3,3,3,2,1,1,2,3,2,2,13,11,3,13,10,9,12,20,1,7,20,1,1,1,1,1,1,1,1,1,1,1,74,20,11,1512401,4350,4373,2261,Mediterranean_Hispanic,102,0,0,205.0,Unknown,2000009463,3000000.0,1.0,106,975,103,1,0,3,104,2,0.3289229955014554,0.2364705882352941,0.3897058823529412,0.0001892609841378,0.0,0.0,0.0197549387346836,0.0197549387346836,0.0166393510930859,0.0,0.6046511627906974,0.0833333333333332,54,2,2,5,0,3812,7,27,86,8000000,993750.0,8000000.0,0.0,2500000.0,8000000.0,1,800000,1.0,1.0
866001,Viktor,Melekhin,2024,1083,Russia,"Domodedovo, Moskau Oblast",Russia,16-12-03,Centre-Back,Defender,Right,189.0,30-06-27,Emerald Promotion,https://img.a.transfermarkt.technology/portrait/header/866001-1721922173.png?lm=1,RU1,FK Rostov,3000000.0,3500000.0,21,104,-75,9,9,9,7,11,7,13,10,5,12,11,6,13,11,12,12,9,10,12,12,10,6,9,7,10,12,13,15,12,13,13,10,6,12,13,8,13,7,8,13,16,3,3,1,2,2,2,1,3,1,2,3,19,12,3,12,13,10,11,16,1,1,20,1,1,1,15,1,12,1,1,1,1,1,70,8,20,12664315,5005,5005,2906,Northern_European,99,0,0,9725.0,Unknown,2000105989,9111392.0,2.0,78,419,81,1,1,7,81,2,0.4125430007938608,0.3054545454545454,0.3676470588235294,0.0093819373565454,0.0,0.0,0.0147536884221055,0.0172543135783946,0.0505924720131114,0.1428571428571428,0.6046511627906974,0.125,0,0,0,0,0,0,1,3,27,3000000,270454.54545454547,3500000.0,300000.0,2500000.0,3000000.0,1,225000,-0.0625,-0.14285714285714285
866246,Lucas,Bergvall,2024,148,Sweden,Stockholm,Sweden,02-02-06,Central Midfield,Midfield,Right,187.0,30-06-29,Nordic Sky,https://img.a.transfermarkt.technology/portrait/header/866246-1701861399.jpg?lm=1,GB1,Tottenham Hotspur Football Club,12000000.0,12000000.0,18,87,-85,11,8,11,8,13,11,4,6,3,6,13,8,7,14,12,12,8,10,10,13,11,17,12,11,9,7,11,11,12,11,7,11,12,11,9,7,11,12,12,5,14,3,3,2,2,3,3,2,3,4,2,3,19,14,2,15,13,14,15,18,1,1,1,1,1,1,15,1,20,1,1,18,1,1,0,8,20,373223,4350,4350,1500,Northern_European,82,0,0,9.0,Unknown,2000169739,9111392.0,2.0,91,1426,91,3,1,7,202,1,0.3258798623974597,0.1550802139037433,0.2426470588235293,0.0,0.0,0.0,0.0597649412353088,0.0597649412353088,0.0505924720131114,0.1428571428571428,0.5581395348837206,0.0,91,11,10,14,0,4454,1,7,32,12000000,1600000.0,12000000.0,0.0,12000000.0,,2,3200000,0.2,1.4
866579,Cole,Campbell,2024,16,United States,"Houston, Texas",United States,20-02-06,Right Winger,Attack,Right,183.0,30-06-28,CAA Stellar,https://img.a.transfermarkt.technology/portrait/header/866579-1713463452.jpg?lm=1,L1,Borussia Dortmund,300000.0,300000.0,18,95,-75,8,11,13,9,8,13,8,13,8,7,14,5,7,12,14,12,1,8,8,10,10,12,14,13,12,8,9,13,15,14,9,8,15,13,8,8,10,15,17,11,11,2,2,1,1,2,2,2,2,2,2,3,18,10,12,13,11,11,9,5,1,1,1,1,1,5,1,15,1,15,20,13,18,1,72,12,20,23592719,4748,4748,2510,Northern_European,99,0,0,5800.0,Unknown,28127368,9111392.0,2.0,104,638,102,0,1,7,41,10,0.3785392961100821,0.2631016042780748,0.3676470588235294,0.0055918895874593,0.0,0.0,0.0012503125781445,0.0012503125781445,0.0505924720131114,0.1428571428571428,0.4651162790697669,0.0,80,21,22,3,1,3122,2,2,9,1500000,600000.0,1500000.0,-1200000.0,1500000.0,,0,0,0.0,0.0
866655,Tyler,Dibling,2024,180,Unknown,Unknown,England,17-02-06,Right Winger,Attack,Left,178.0,30-06-27,ROOF,https://img.a.transfermarkt.technology/portrait/header/866655-1724485194.jpg?lm=1,GB1,Southampton Football Club,5000000.0,5000000.0,18,80,-8,6,8,13,14,13,6,7,11,3,6,7,2,7,13,7,13,8,8,6,8,8,9,13,8,10,4,7,8,13,9,13,5,10,12,8,4,11,6,18,10,11,3,1,3,2,2,1,1,2,2,2,3,18,9,7,14,11,10,12,17,1,1,1,1,1,1,1,1,1,1,18,15,20,15,0,20,12,29142924,4000,4000,2000,Northern_European,76,0,0,203.0,Unknown,2000198043,1700000.0,1.0,105,1549,33,0,0,7,186,10,0.2795713151627415,0.2085561497326203,0.1985294117647059,0.0001873297496057,0.0,0.0,0.0247561890472618,0.0247561890472618,0.0094169282480068,0.0,0.3488372093023257,0.0,102,23,13,17,0,2955,1,2,13,22000000,8500000.0,22000000.0,-17000000.0,22000000.0,,0,0,0.0,0.0
867082,Abakar,Gadzhiev,2024,75231,Russia,Makhachkala,Russia,31-12-03,Attacking Midfield,Midfield,Left,180.0,30-06-27,SGGM,https://img.a.transfermarkt.technology/portrait/header/867082-1651487517.png?lm=1,RU1,Dinamo Makhachkala,600000.0,600000.0,20,88,-75,10,9,13,10,10,10,7,11,5,7,10,13,7,12,10,11,5,6,8,12,11,10,14,10,8,8,8,13,13,12,7,8,11,11,12,8,10,11,16,9,13,2,2,3,3,1,3,2,2,1,3,3,17,14,3,11,10,10,9,20,1,1,1,1,1,1,1,1,13,1,1,20,1,1,70,20,10,280674,3986,4015,1526,North_African__Middle_Eastern,88,0,0,1120.0,Unknown,2000091210,9111392.0,2.0,78,897,81,3,0,6,60,0,0.2815559671870865,0.1578609625668449,0.286764705882353,0.0010728007825362,0.0,0.0,0.0027506876719179,0.0027506876719179,0.0505924720131114,0.1428571428571428,0.3953488372093026,0.0833333333333332,110,29,21,25,0,1536,2,18,97,600000,50000.0,600000.0,100000.0,400000.0,600000.0,0,0,1.0,0.7142857142857143
867137,Alessandro,Circati,2024,130,Italy,Fidenza,Australia,10-10-03,Centre-Back,Defender,Right,190.0,30-06-27,Unknown,https://img.a.transfermarkt.technology/portrait/header/867137-1712749046.jpeg?lm=1,IT1,Parma Calcio 1913,8500000.0,8500000.0,21,105,-75,7,9,9,9,9,4,11,10,14,14,10,7,11,8,12,12,12,12,12,10,12,11,11,9,12,13,11,11,12,12,12,12,14,12,12,11,11,12,11,4,9,1,3,3,1,1,2,2,1,1,3,1,14,11,10,11,11,12,12,10,1,1,20,12,1,7,1,1,1,1,1,1,1,1,0,5,20,7479000,5247,5497,1747,Mediterranean_Hispanic,105,0,0,3039.0,Unknown,2000017415,9111392.0,2.0,52,489,6,1,1,3,155,2,0.477639587192379,0.1814973262032085,0.411764705882353,0.0029258203160079,0.0,0.0,0.0422605651412853,0.0422605651412853,0.0505924720131114,0.1428571428571428,0.6279069767441858,0.125,101,3,3,17,2,2936,1,25,187,8500000,927777.7777777778,8500000.0,0.0,600000.0,8500000.0,1,450000,0.0,1.5757575757575757
867357,Unknown,Nacho Ferri,2024,601,Spain,Montaverner,Spain,05-10-04,Centre-Forward,Attack,Right,192.0,30-06-25,Unknown,https://img.a.transfermarkt.technology/portrait/header/867357-1696509071.jpg?lm=1,BE1,Koninklijke Voetbalclub Kortrijk,2000000.0,3000000.0,20,95,-75,9,9,10,11,15,8,14,10,5,9,10,6,5,11,13,15,15,5,10,10,15,16,15,12,6,10,8,10,9,10,15,16,12,8,11,11,11,15,12,5,13,2,1,3,1,4,1,2,3,3,4,2,17,11,1,13,13,11,11,18,1,1,1,1,1,1,1,1,1,1,1,1,1,20,0,9,20,21640000,4754,3676,2570,Mediterranean_Hispanic,90,0,0,1391.0,Unknown,2000111379,9111392.0,2.0,89,973,89,0,1,3,124,3,0.236702831436888,0.26951871657754,0.3014705882352941,0.0013344830616247,0.0,0.0,0.0097524381095273,0.0147536884221055,0.0505924720131114,0.1428571428571428,0.6744186046511627,0.0833333333333332,107,51,20,32,0,1307,7,37,134,2200000,283333.3333333333,3000000.0,1000000.0,500000.0,2200000.0,1,200000,0.1,-0.26666666666666666
872184,Tadeo,Allende,2024,940,Argentina,Mina Clavero,Argentina,20-02-99,Right Winger,Attack,Right,183.0,30-06-28,CAA Stellar,https://img.a.transfermarkt.technology/portrait/header/872184-1657542237.JPG?lm=1,ES1,Real Club Celta de Vigo S. A. D.,4000000.0,4500000.0,25,126,132,5,10,12,13,12,8,14,14,9,11,12,11,8,12,11,13,13,12,12,11,12,13,12,13,13,8,12,16,14,12,13,13,14,14,13,13,12,11,17,8,11,2,1,1,4,2,1,1,2,3,1,3,17,12,5,13,12,14,12,13,1,1,1,1,1,1,1,11,1,13,17,1,20,17,79,8,20,3454090,6003,6003,3402,Native_American,123,0,0,5303.0,Unknown,2000091490,2391000.0,2.0,4,956,4,0,1,5,165,10,0.5445885154802858,0.3585026737967914,0.5441176470588236,0.0051119778062527,0.0,0.0,0.0197549387346836,0.0222555638909727,0.0132559237756604,0.1428571428571428,0.4651162790697669,0.2916666666666665,117,18,7,9,0,3105,1,5,39,2000000,199000.0,4500000.0,1000000.0,,,2,575000,-0.5,-0.5555555555555556
873981,Diego,González,2024,398,Paraguay,Alto ParanÃ¡,Paraguay,07-01-03,Right Winger,Attack,Left,177.0,30-06-25,Aztk Sports,https://img.a.transfermarkt.technology/portrait/header/873981-1695026273.jpg?lm=1,IT1,SocietÃ  Sportiva Lazio S.p.A.,1000000.0,1500000.0,21,123,129,3,14,11,4,12,5,14,5,4,15,13,7,14,12,14,11,14,13,11,6,10,13,10,14,7,13,13,14,13,13,7,13,13,13,14,13,13,11,12,5,14,2,3,2,1,1,3,1,2,2,2,1,13,12,5,12,8,12,13,13,1,14,20,12,12,4,12,10,10,1,1,1,1,1,83,20,15,1709774,6150,6150,4400,Mediterranean_Hispanic,124,0,0,5408.0,Unknown,67184689,1100000.0,1.0,73,54,75,0,0,3,185,10,0.5640381053188674,0.4652406417112299,0.5514705882352942,0.0052133676191837,0.0,0.0,0.0047511877969492,0.0072518129532383,0.0060835023195088,0.0,0.3255813953488373,0.125,88,29,7,17,0,2752,2,5,30,700000,92857.14285714286,1500000.0,500000.0,50000.0,1500000.0,3,900000,-0.3,-0.5333333333333333
875332,Arthur,Chaves,2024,533,Brazil,FlorianÃ³polis,Brazil,29-01-01,Centre-Back,Defender,Right,188.0,Unknown,Agencia 90 Minutos,https://img.a.transfermarkt.technology/portrait/header/875332-1660313594.jpg?lm=1,L1,TSG 1899 Hoffenheim FuÃŸball-Spielbetriebs GmbH,1200000.0,2000000.0,23,116,140,4,6,10,8,9,3,14,8,6,13,11,10,13,9,13,14,12,11,13,8,13,2,5,9,8,13,14,12,14,10,11,14,15,13,14,14,15,13,13,8,4,4,3,3,1,1,1,4,1,3,4,1,17,12,6,11,12,10,11,14,1,1,20,1,1,1,1,1,1,1,1,1,1,1,81,5,20,4765498,5750,5750,3250,Northern_European,118,0,0,2350.0,Unknown,19335705,9111392.0,2.0,10,495,11,1,1,7,199,2,0.5111140513363324,0.3422459893048128,0.5073529411764706,0.0022605100197275,0.0,0.0,0.0057514378594648,0.0097524381095273,0.0505924720131114,0.1428571428571428,0.581395348837209,0.2083333333333332,112,6,0,34,1,2690,1,1,1,3000000,421428.5714285714,3000000.0,500000.0,,50000.0,2,3250000,1.5,1.0
875334,Semih,K?L?Çsoy,2024,114,TÃ¼rkiye,Istanbul,TÃ¼rkiye,15-08-05,Left Winger,Attack,Right,178.0,30-06-28,Unknown,https://img.a.transfermarkt.technology/portrait/header/875334-1727355952.png?lm=1,TR1,Be?ikta? Jimnastik KulÃ¼bÃ¼,15000000.0,15000000.0,19,80,-8,3,4,11,12,11,4,8,7,1,4,7,10,2,13,14,12,13,12,11,7,12,15,11,6,10,5,12,14,12,12,10,8,15,12,9,10,13,8,11,4,11,3,3,3,3,2,2,1,2,2,3,2,13,10,2,13,10,12,11,12,1,1,1,1,1,1,1,1,1,1,12,1,12,20,67,7,20,8683867,4704,4643,2691,Northern_European,80,0,0,82.0,Unknown,2000154217,9111392.0,2.0,100,667,100,0,1,7,37,7,0.3646467319396665,0.2824598930481283,0.2279411764705882,7.049006041867233e-05,0.0,0.0,0.0747686921730432,0.0747686921730432,0.0505924720131114,0.1428571428571428,0.3488372093023257,0.0416666666666666,144,56,15,20,0,2279,4,12,22,15000000,1856250.0,15000000.0,0.0,12000000.0,,1,25000,0.25,26.272727272727273
875511,Unknown,Paulo Victor,2024,4294,Brazil,BoicaÃºva,Brazil,13-04-01,Left-Back,Defender,Left,180.0,30-06-26,ADRIANO SPORTS,https://img.a.transfermarkt.technology/portrait/header/875511-1631628777.jpg?lm=1,PO1,Sporting Clube Farense,1000000.0,2200000.0,23,120,130,1,1,3,2,10,8,8,1,5,2,10,2,2,9,12,13,11,10,13,10,10,13,2,14,3,12,13,11,11,14,12,15,12,12,11,13,11,9,11,6,13,13,11,12,6,12,13,12,15,13,14,14,12,10,7,10,12,14,12,13,20,1,1,1,1,1,1,1,1,1,1,1,1,1,76,20,8,1336830,6000,6000,4500,Mediterranean_Hispanic,120,0,0,19604.0,Unknown,19014205,500000.0,1.0,10,217,11,1,0,3,191,8,0.5441915850754168,0.4759358288770053,0.5220588235294117,0.0189212703274504,0.0,0.0,0.0047511877969492,0.010752688172043,0.0027500763910108,0.0,0.3953488372093026,0.2083333333333332,112,0,5,28,2,6366,1,3,18,1000000,-150000.0,2200000.0,500000.0,,2200000.0,3,500000,-0.3333333333333333,-0.4444444444444444
875581,Adrian,Blake,2024,200,England,London,England,15-07-05,Left Winger,Attack,Left,183.0,30-06-27,Concilium Sport,https://img.a.transfermarkt.technology/portrait/header/875581-1690967340.jpg?lm=1,NL1,Football Club Utrecht,500000.0,500000.0,19,80,-75,7,11,13,11,13,6,7,8,6,3,13,3,6,10,8,6,7,4,4,8,12,14,10,8,8,6,7,8,13,13,8,7,15,13,10,6,14,11,10,13,13,1,1,4,1,2,2,2,2,3,1,3,8,11,7,9,11,9,11,19,1,1,1,1,1,1,1,1,1,1,20,12,1,12,0,20,8,12527107,4002,4002,1002,Mixed_Race,77,0,0,203.0,Unknown,2000106517,9111392.0,2.0,32,858,33,0,0,4,92,7,0.2798359354326541,0.1018181818181818,0.2058823529411764,0.0001873297496057,0.0,0.0,0.0022505626406601,0.0022505626406601,0.0505924720131114,0.1428571428571428,0.4651162790697669,0.0416666666666666,68,14,5,5,0,1753,0,0,0,500000,50000.0,500000.0,0.0,500000.0,,1,0,0.0,0.6666666666666666
876631,Habib,Diarra,2024,667,Senegal,GuÃ©diawaye,Senegal,03-01-04,Attacking Midfield,Midfield,Right,178.0,30-06-28,Carmenta,https://img.a.transfermarkt.technology/portrait/header/876631-1693476916.jpg?lm=1,FR1,Racing Club de Strasbourg Alsace,20000000.0,20000000.0,20,90,-75,4,10,12,7,13,7,9,10,6,11,12,6,10,12,10,11,12,8,11,10,11,15,12,5,9,11,10,13,10,12,9,9,12,11,10,12,12,7,11,9,8,1,1,2,1,2,3,1,1,4,3,2,12,8,5,12,12,8,9,20,1,1,1,1,1,1,13,1,20,1,1,10,1,1,0,10,20,7131200,4498,4498,2250,African_Caribbean,90,0,0,645.0,Unknown,2000025485,9111392.0,2.0,83,580,84,3,1,1,159,0,0.3454617623709977,0.2352941176470588,0.3014705882352941,0.0006141325811818,0.0,0.0,0.0997749437359339,0.0997749437359339,0.0505924720131114,0.1428571428571428,0.3488372093023257,0.0833333333333332,107,14,8,15,0,1746,0,0,0,20000000,1515384.6153846155,20000000.0,0.0,3000000.0,20000000.0,1,2400000,0.1111111111111111,0.1111111111111111
877139,Unknown,Alberto Costa,2024,2420,Portugal,Santo Tirso,Portugal,29-09-03,Right-Back,Defender,Right,186.0,30-06-26,MRP.POSITIONUMBER,https://img.a.transfermarkt.technology/portrait/header/877139-1672674973.png?lm=1,PO1,VitÃ³ria Sport Clube,500000.0,500000.0,21,125,130,4,7,6,7,11,5,15,9,9,14,10,6,15,9,15,12,16,12,11,9,12,14,7,13,8,15,14,14,10,11,15,15,11,12,13,15,12,10,12,10,10,3,2,1,1,1,2,2,1,2,2,3,15,13,4,16,10,15,12,10,1,1,20,1,1,1,1,1,1,1,1,1,1,1,80,7,20,1736505,6250,6250,3000,Mediterranean_Hispanic,124,0,0,19839.0,Unknown,67024158,9111392.0,2.0,76,1339,79,1,1,3,217,11,0.5772691188145012,0.3155080213903743,0.5514705882352942,0.0191481903849626,0.0,0.0,0.0022505626406601,0.0022505626406601,0.0505924720131114,0.1428571428571428,0.5348837209302322,0.125,0,0,0,0,0,0,0,0,0,1000000,250000.0,1000000.0,-500000.0,,,0,0,0.0,0.0
880245,Mateus,Fernandes,2024,180,Portugal,OlhÃ£o,Portugal,10-07-04,Central Midfield,Midfield,Right,178.0,30-06-29,Gestifute,https://img.a.transfermarkt.technology/portrait/header/880245-1727786403.jpg?lm=1,GB1,Southampton Football Club,12000000.0,12000000.0,20,123,140,10,9,13,11,13,8,12,12,9,13,13,11,13,13,11,12,14,12,11,12,11,14,11,10,13,13,14,14,14,14,14,11,13,12,13,9,11,12,14,9,15,2,2,1,1,2,1,2,3,3,4,1,5,13,12,13,13,13,14,11,1,1,1,1,1,1,18,1,20,1,1,8,1,1,67,8,20,1422092,6139,6139,3567,African_Caribbean,122,0,0,31308.0,ATP,19250978,15000000.0,1.0,76,1079,79,3,1,1,186,1,0.5625826938343477,0.3761497326203208,0.536764705882353,0.0302228548088222,0.0,0.0,0.0597649412353088,0.0597649412353088,0.0833078696630462,0.0,0.3488372093023257,0.0833333333333332,117,10,17,22,0,3844,0,0,0,15000000,1812500.0,15000000.0,0.0,1500000.0,15000000.0,2,5500000,0.875,4.0
880517,Alexander,Lyng,2024,5817,Denmark,Copenhagen,Denmark,26-11-04,Left Winger,Attack,Right,177.0,30-06-25,Beckster Int.,https://img.a.transfermarkt.technology/portrait/header/880517-1684604068.png?lm=1,DK1,SÃ¸nderjyske Fodbold,500000.0,500000.0,20,124,127,9,11,13,9,12,8,9,11,7,10,13,10,14,12,17,11,14,11,11,13,11,15,12,15,13,13,15,17,14,13,11,7,13,12,15,10,12,11,13,10,17,3,3,2,3,1,4,2,1,1,2,3,14,15,6,9,11,15,11,14,1,1,13,1,1,1,19,12,20,12,1,1,1,1,74,12,20,2235956,6250,6150,4508,Northern_European,124,44,2,31798.0,Unknown,91005031,350000.0,1.0,28,382,30,0,1,7,198,7,0.5640381053188674,0.4767914438502673,0.5514705882352942,0.0306960072691667,0.2894736842105263,0.0263157894736842,0.0022505626406601,0.0022505626406601,0.0019167199088863,0.0,0.3255813953488373,0.0833333333333332,100,33,3,7,0,3804,1,17,85,550000,44444.444444444445,550000.0,0.0,500000.0,550000.0,2,50000,0.1,0.1
881116,Darío,Osorio,2024,865,Chile,Hijuelas,Chile,24-01-04,Right Winger,Attack,Left,184.0,30-06-28,UNOSPORTS ,https://img.a.transfermarkt.technology/portrait/header/881116-1711546194.jpg?lm=1,DK1,Fodbold Club Midtjylland,7000000.0,7000000.0,20,106,-75,10,11,13,8,12,11,6,9,8,6,12,8,6,13,8,10,9,8,11,13,12,15,14,7,12,7,10,11,13,14,8,7,13,13,11,8,13,7,11,6,9,1,1,2,3,3,3,1,4,3,2,1,12,11,5,10,10,12,11,14,1,1,1,1,1,1,1,20,15,9,15,16,8,1,0,20,15,1484951,5234,5234,4972,Mediterranean_Hispanic,104,2,0,29.0,Unknown,2000129380,5200000.0,1.0,19,625,19,0,0,3,86,10,0.4428420216988621,0.5264171122994652,0.4044117647058823,1.93123453201842e-05,0.0131578947368421,0.0,0.0347586896724181,0.0347586896724181,0.0288619128309119,0.0,0.4883720930232553,0.0833333333333332,102,24,4,16,1,3522,2,5,33,8000000,861111.1111111111,8000000.0,0.0,3000000.0,8000000.0,1,1000000,0.14285714285714285,0.6
883349,Kevin,Zeroli,2024,5,Italy,Busto Arsizio,Italy,11-01-05,Central Midfield,Midfield,Right,187.0,30-06-28,Rafaela Pimenta,https://img.a.transfermarkt.technology/portrait/header/883349-1696430935.jpg?lm=1,IT1,Associazione Calcio Milan,2000000.0,2000000.0,19,76,-8,4,7,10,7,11,7,10,8,5,7,11,8,7,12,8,9,7,7,10,11,10,11,8,9,12,8,11,9,10,10,11,12,11,13,10,8,9,6,8,5,8,4,1,1,1,1,2,1,3,2,1,2,18,11,2,12,13,10,11,12,1,1,1,1,1,1,11,9,20,12,1,14,1,1,60,12,20,8360000,3550,3550,752,Mixed_Race,76,0,0,255.0,Unknown,2000103118,9111392.0,2.0,52,285,54,3,1,4,27,1,0.2200317544323895,0.0750802139037433,0.1985294117647059,0.0002375418474382,0.0,0.0,0.0097524381095273,0.0097524381095273,0.0505924720131114,0.1428571428571428,0.5581395348837206,0.0416666666666666,0,0,0,0,0,0,1,4,16,3500000,500000.0,3500000.0,0.0,,,1,1500000,0.75,0.0
884810,Kjell,Wätjen,2024,16,Germany,Gevelsberg,Germany,16-02-06,Central Midfield,Midfield,Right,183.0,30-06-28,CAA Stellar,https://img.a.transfermarkt.technology/portrait/header/884810-1713462935.jpg?lm=1,L1,Borussia Dortmund,2000000.0,2000000.0,18,86,-75,4,7,11,8,11,4,11,9,4,10,12,7,12,12,15,7,12,9,8,12,7,17,12,12,12,11,12,12,12,11,10,11,15,13,12,11,11,11,8,5,16,2,2,1,2,1,4,1,3,1,3,2,7,13,4,15,12,14,12,10,1,1,1,12,1,12,15,10,20,10,10,15,10,1,72,8,20,10824000,4299,4299,2313,Northern_European,87,0,0,64.0,Unknown,2000229933,9111392.0,2.0,38,537,40,3,1,7,41,1,0.3191320455146864,0.2420320855614973,0.2794117647058823,5.310894963050656e-05,0.0,0.0,0.0097524381095273,0.0097524381095273,0.0505924720131114,0.1428571428571428,0.4651162790697669,0.0,85,23,24,15,1,3620,3,18,67,2000000,0.0,2000000.0,0.0,2000000.0,,1,0,0.0,0.0
884820,Almugera,Kabar,2024,16,Germany,Bremen,Germany,06-06-06,Left-Back,Defender,Left,186.0,30-06-26,Unknown,https://img.a.transfermarkt.technology/portrait/header/884820-1713462323.jpg?lm=1,L1,Borussia Dortmund,1000000.0,1000000.0,18,82,-75,6,12,13,5,10,3,7,6,8,10,10,3,11,9,15,7,8,10,7,10,6,18,7,8,4,9,9,14,15,12,9,11,14,16,12,10,11,13,13,5,8,1,2,2,3,2,3,3,1,3,3,1,20,10,1,13,11,13,10,18,1,20,1,1,18,1,1,12,1,1,10,1,1,1,73,20,6,15080000,4095,4095,1745,North_African__Middle_Eastern,77,0,0,64.0,Unknown,2000180861,9111392.0,2.0,38,253,40,1,0,6,41,8,0.2921407779835936,0.181283422459893,0.2058823529411764,5.310894963050656e-05,0.0,0.0,0.0047511877969492,0.0047511877969492,0.0505924720131114,0.1428571428571428,0.5348837209302322,0.0,67,9,6,12,1,2561,5,32,64,1000000,0.0,1000000.0,0.0,1000000.0,,0,0,0.0,0.0
888493,Alejo,Veliz,2024,714,Argentina,GÃ¶deken,Argentina,19-09-03,Centre-Forward,Attack,Right,186.0,30-06-25,Lion Volt,https://img.a.transfermarkt.technology/portrait/header/888493-1674736266.JPG?lm=1,ES1,Reial Club Deportiu Espanyol de Barcelona S.A.D.,9000000.0,11000000.0,21,119,-75,12,12,13,15,14,12,14,16,11,12,13,7,9,13,10,14,9,13,14,4,14,15,13,10,14,10,12,13,12,13,14,15,16,12,11,14,12,8,9,10,12,1,3,2,3,3,2,2,2,1,2,3,15,12,5,11,10,8,11,12,1,1,1,1,1,1,1,1,1,1,1,1,1,20,77,5,20,5697078,5641,5641,2969,Mediterranean_Hispanic,128,0,0,4944.0,Unknown,2000096330,15000000.0,1.0,4,581,4,0,1,3,170,3,0.4966922466260915,0.3121925133689839,0.5808823529411764,0.0047653212077554,0.0,0.0,0.0447611902975743,0.0547636909227306,0.0833078696630462,0.0,0.5348837209302322,0.125,101,25,2,13,0,2058,1,5,37,4000000,438888.8888888889,11000000.0,5000000.0,1500000.0,9000000.0,4,12325000,-0.5555555555555556,-0.6363636363636364
890385,Sebastian,Otoa,2024,1053,Denmark,Roskilde,Denmark,13-05-04,Centre-Back,Defender,Right,198.0,30-06-27,People In Sport,https://img.a.transfermarkt.technology/portrait/header/default.jpg?lm=1,DK1,Aalborg Boldspilklub,350000.0,350000.0,20,95,-75,8,8,7,5,8,3,14,9,8,14,10,4,14,9,15,11,10,6,11,8,14,13,6,4,6,9,8,8,13,11,9,15,7,10,7,7,9,5,11,7,15,2,2,1,1,1,3,2,1,1,1,2,8,14,7,10,11,10,11,15,1,1,20,1,1,1,18,1,1,1,1,1,1,1,80,10,20,763999,4500,4500,1324,Northern_European,93,0,0,420.0,Unknown,2000054390,9111392.0,2.0,28,1250,30,1,1,7,10,2,0.3457263826409102,0.1362566844919786,0.3235294117647059,0.0003968686963297,0.0,0.0,0.0015003750937734,0.0015003750937734,0.0505924720131114,0.1428571428571428,0.8139534883720931,0.0833333333333332,76,2,5,6,1,3494,2,8,49,600000,100000.0,600000.0,0.0,100000.0,600000.0,1,150000,0.7142857142857143,0.7142857142857143
891998,Antoine,Mendy,2024,417,France,Marseille,France,27-05-04,Right-Back,Defender,Right,187.0,30-06-25,Wasserman,https://img.a.transfermarkt.technology/portrait/header/891998-1667549413.jpg?lm=1,FR1,Olympique Gymnaste Club Nice CÃ´te d'Azur,2000000.0,2000000.0,20,80,-75,2,5,4,5,9,1,9,5,6,8,9,6,14,8,9,9,9,5,7,8,14,13,5,3,6,5,13,13,14,12,8,12,12,12,8,10,13,10,11,11,10,3,1,2,1,2,1,4,1,3,2,2,17,12,5,10,11,14,12,12,1,1,12,20,1,15,1,1,1,1,1,1,1,1,75,10,20,11004999,4117,4117,1034,African_Caribbean,72,0,0,645.0,Unknown,2000130977,9111392.0,2.0,34,919,36,1,1,1,142,11,0.2950516009526329,0.1052406417112299,0.1691176470588235,0.0006141325811818,0.0,0.0,0.0097524381095273,0.0097524381095273,0.0505924720131114,0.1428571428571428,0.5581395348837206,0.0833333333333332,62,2,1,7,0,2331,5,23,102,3000000,316666.6666666667,3000000.0,200000.0,1000000.0,3000000.0,1,0,2.75,2.75
892929,Hugo,Álvarez,2024,940,Spain,Ourense,Spain,02-07-03,Left Winger,Attack,Left,176.0,30-06-25,ROOF,https://img.a.transfermarkt.technology/portrait/header/892929-1715867247.jpg?lm=1,ES1,Real Club Celta de Vigo S. A. D.,1500000.0,1500000.0,21,76,-8,6,6,8,8,13,6,6,11,1,4,13,3,8,13,5,11,7,7,7,13,11,15,15,8,11,6,7,12,13,13,7,10,15,13,13,4,10,6,17,14,12,2,3,2,1,1,3,1,1,1,1,1,20,12,5,18,12,12,13,14,1,1,1,1,1,1,1,1,20,1,8,16,1,1,0,20,4,11739445,3800,3800,1300,Mediterranean_Hispanic,77,0,0,269.0,Unknown,2000052525,9111392.0,2.0,89,1102,89,0,0,3,165,7,0.2531092881714739,0.1336898395721925,0.2058823529411764,0.0002510604891623,0.0,0.0,0.0072518129532383,0.0072518129532383,0.0505924720131114,0.1428571428571428,0.3023255813953489,0.125,106,13,12,10,0,1403,0,0,0,7500000,827777.7777777778,7500000.0,0.0,,1500000.0,1,1500000,4.0,24.0
893661,Joel,Ordóñez,2024,2282,Ecuador,Guayaquil,Ecuador,21-04-04,Centre-Back,Defender,Right,188.0,30-06-28,AGN Football,https://img.a.transfermarkt.technology/portrait/header/893661-1666292051.jpg?lm=1,BE1,Club Brugge Koninklijke Voetbalvereniging,9000000.0,9000000.0,20,100,-75,3,5,8,6,11,1,11,4,6,12,11,5,13,10,7,11,10,5,10,7,13,3,6,11,5,12,7,8,12,13,14,14,16,12,15,13,13,11,6,7,8,3,1,1,2,2,1,2,1,1,1,3,10,11,4,9,12,10,11,13,1,1,20,1,1,1,1,1,1,1,1,1,1,1,80,8,20,20219999,5000,5000,1500,African_Caribbean,102,0,0,3999.0,Unknown,2000033033,9111392.0,2.0,30,576,31,1,1,1,53,2,0.4118814501190792,0.1550802139037433,0.3897058823529412,0.0038528128913767,0.0,0.0,0.0447611902975743,0.0447611902975743,0.0505924720131114,0.1428571428571428,0.581395348837209,0.0833333333333332,119,5,3,10,0,5750,4,12,54,18000000,1994444.4444444445,18000000.0,500000.0,2000000.0,18000000.0,2,2400000,2.0,6.2
894914,Antonio,Nusa,2024,23826,Norway,Langhus,Norway,17-04-05,Left Winger,Attack,Right,180.0,30-06-29,Aneke/PMG ,https://img.a.transfermarkt.technology/portrait/header/894914-1724337096.jpg?lm=1,L1,RasenBallsport Leipzig,22000000.0,22000000.0,19,90,-75,9,10,13,10,13,10,5,12,4,6,8,8,5,13,11,9,11,11,9,9,8,14,16,6,11,5,11,11,12,13,11,5,11,12,8,6,14,11,13,11,13,3,1,2,3,1,3,1,2,2,2,1,13,15,10,10,12,13,11,11,1,1,1,1,1,1,1,15,1,17,19,1,20,12,65,14,20,23640000,4746,4988,3990,Northern_European,89,0,0,6499.0,Unknown,2000090211,13350000.0,2.0,71,799,73,0,1,7,162,7,0.4102937284996031,0.4213903743315507,0.2941176470588235,0.0062668560563997,0.0,0.0,0.1097774443610902,0.1097774443610902,0.0741409483596766,0.1428571428571428,0.3953488372093026,0.0416666666666666,140,17,14,1,0,4297,6,21,29,28000000,2300000.0,28000000.0,3000000.0,17000000.0,,2,8100000,0.8666666666666667,0.6470588235294118
895334,Yarek,Gasiorowski,2024,1049,Spain,PolinyÃ  del XÃºquer,Spain,12-01-05,Centre-Back,Defender,Left,192.0,30-06-25,Unknown,https://img.a.transfermarkt.technology/portrait/header/895334-1669037327.jpg?lm=1,ES1,Valencia Club de FÃºtbol S. A. D.,15000000.0,15000000.0,19,75,-75,2,4,2,1,8,4,9,2,6,13,6,6,9,6,10,8,9,7,6,6,13,14,6,2,6,10,6,7,11,9,7,15,14,13,7,6,11,6,6,5,8,1,2,2,3,4,3,2,3,3,1,3,7,11,1,12,10,10,11,20,1,18,20,1,1,1,1,1,1,1,1,1,1,1,0,20,10,5839999,3750,3750,1250,Mediterranean_Hispanic,63,0,0,269.0,Unknown,2000141707,9111392.0,2.0,89,1161,89,1,0,3,208,2,0.246493781423657,0.1283422459893048,0.1029411764705882,0.0002510604891623,0.0,0.0,0.0747686921730432,0.0747686921730432,0.0505924720131114,0.1428571428571428,0.6744186046511627,0.0416666666666666,45,0,0,6,1,3137,0,0,0,15000000,2960000.0,15000000.0,0.0,10000000.0,,1,800000,0.0,0.5
897051,Alan,Minda,2024,520,Ecuador,Esmeraldas,Ecuador,14-05-03,Right Winger,Attack,Right,171.0,30-06-28,OTB Sports,https://img.a.transfermarkt.technology/portrait/header/897051-1669399749.jpg?lm=1,BE1,Cercle Brugge Koninklijke Sportvereniging,6000000.0,6000000.0,21,123,133,14,13,13,15,15,14,13,14,11,10,10,7,8,14,11,9,10,8,7,11,10,12,14,13,13,10,11,13,15,15,9,6,6,11,12,7,9,15,5,9,15,2,3,2,2,1,2,1,2,4,2,2,17,10,1,13,11,13,10,14,1,1,1,10,1,12,1,1,1,18,1,1,20,16,68,13,20,1062793,5738,5738,5242,Mediterranean_Hispanic,119,0,0,1160.0,Unknown,78095059,2000000.0,1.0,30,471,31,0,1,3,49,10,0.5095263297168563,0.5552941176470588,0.5147058823529411,0.0011114254731766,0.0,0.0,0.0297574393598399,0.0297574393598399,0.0110836412122558,0.0,0.1860465116279068,0.125,116,17,16,7,0,2855,3,48,255,6000000,540909.0909090909,6000000.0,200000.0,350000.0,4000000.0,1,900000,0.0,2.0
897423,David,Odogu,2024,82,Germany,Berlin,Germany,03-06-06,Centre-Back,Defender,Right,191.0,Unknown,11WINS,https://img.a.transfermarkt.technology/portrait/header/897423-1724771146.jpg?lm=1,L1,Verein fÃ¼r LeibesÃ¼bungen Wolfsburg,10774124.0,17195854.0,18,82,-75,1,6,10,6,10,2,11,6,6,12,11,6,12,11,14,8,11,8,8,9,8,16,10,10,7,12,10,11,12,10,12,13,13,13,9,12,15,8,13,8,7,3,3,1,3,3,3,3,2,4,3,3,12,16,4,10,15,15,11,11,1,1,20,1,1,1,1,1,1,1,1,1,1,1,81,7,20,6246000,4100,4100,1600,African_Caribbean,82,0,0,64.0,Unknown,2000218552,9111392.0,2.0,38,178,40,1,1,1,213,2,0.2928023286583753,0.1657754010695187,0.2426470588235293,5.310894963050656e-05,0.0,0.0,0.0536340285071267,0.0857507076769192,0.0505924720131114,0.1428571428571428,0.6511627906976742,0.0,62,7,5,12,0,1563,0,0,0,0,,,,,,0,0,,
897424,Assan,Ouédraogo,2024,23826,Germany,MÃ¼lheim an der Ruhr,Germany,09-05-06,Central Midfield,Midfield,Right,191.0,30-06-29,Unknown,https://img.a.transfermarkt.technology/portrait/header/897424-1689877890.jpg?lm=1,L1,RasenBallsport Leipzig,10000000.0,10000000.0,18,91,-85,7,8,12,11,12,9,9,14,2,9,12,10,11,12,12,8,10,9,8,12,8,16,15,7,11,10,11,11,12,11,11,11,15,12,12,11,15,4,13,5,16,2,3,3,3,3,3,2,1,2,1,3,12,15,4,12,14,15,14,14,1,1,1,1,1,1,14,12,20,12,14,18,14,12,77,8,20,5411999,4756,4756,3256,African_Caribbean,91,0,0,64.0,Unknown,2000188173,10000000.0,1.0,38,1005,40,3,1,1,162,1,0.3795977771897327,0.3428877005347593,0.3088235294117646,5.310894963050656e-05,0.0,0.0,0.0497624406101525,0.0497624406101525,0.055529320258896,0.0,0.6511627906976742,0.0,58,19,16,4,0,2553,8,64,96,10000000,1900000.0,10000000.0,0.0,10000000.0,,1,0,0.0,0.25
897479,Bennit,Bröger,2024,82,Germany,Braunschweig,Germany,01-07-06,Attacking Midfield,Midfield,Right,181.0,30-06-25,CAA Stellar,https://img.a.transfermarkt.technology/portrait/header/897479-1701533448.jpg?lm=1,L1,Verein fÃ¼r LeibesÃ¼bungen Wolfsburg,500000.0,500000.0,18,80,-75,11,8,12,7,13,11,7,9,4,7,12,9,8,13,8,7,9,9,7,12,7,9,13,3,11,8,8,8,12,12,8,11,13,12,11,8,9,4,15,6,11,3,2,1,1,3,4,2,3,2,4,3,6,10,15,12,5,4,10,6,1,1,1,1,1,1,14,12,20,12,12,18,12,1,71,8,20,5310000,3999,3999,1999,Northern_European,76,0,0,64.0,Unknown,2000230024,9111392.0,2.0,38,246,40,3,1,7,213,0,0.2794390050277852,0.2084491978609625,0.1985294117647059,5.310894963050656e-05,0.0,0.0,0.0022505626406601,0.0022505626406601,0.0505924720131114,0.1428571428571428,0.418604651162791,0.0,71,13,27,5,0,2317,0,0,0,500000,0.0,500000.0,0.0,500000.0,,0,0,0.0,0.0
897481,Eric,Da Silva Moreira,2024,703,Germany,Hamburg,Germany,03-05-06,Right Winger,Attack,Right,185.0,30-06-28,Gestifute,https://img.a.transfermarkt.technology/portrait/header/897481-1701679168.jpg?lm=1,GB1,Nottingham Forest Football Club,1000000.0,1000000.0,18,87,-75,6,10,12,11,11,6,6,7,6,4,10,11,6,12,11,8,8,6,4,10,13,3,15,1,11,6,7,10,13,12,9,9,15,12,8,7,12,6,18,4,10,3,1,2,2,1,3,3,2,3,2,2,8,10,8,12,8,13,12,17,1,1,1,1,1,10,1,12,1,15,15,10,18,20,0,8,20,4842000,4300,4300,1750,African_Caribbean,69,0,0,64.0,Unknown,2000180880,1500000.0,1.0,38,594,40,0,1,1,140,10,0.3192643556496428,0.1818181818181818,0.1470588235294117,5.310894963050656e-05,0.0,0.0,0.0047511877969492,0.0047511877969492,0.0083057862718408,0.0,0.5116279069767438,0.0,57,18,11,7,0,1830,0,0,0,1000000,0.0,1000000.0,0.0,1000000.0,,1,0,0.0,0.0
900195,Unknown,Kevin,2024,660,Brazil,SÃ£o Paulo,Brazil,04-01-03,Left Winger,Attack,Right,176.0,31-12-28,Talents Sports,https://img.a.transfermarkt.technology/portrait/header/900195-1723486821.png?lm=1,UKR1,FC Shakhtar Donetsk,12000000.0,12000000.0,21,127,135,8,12,13,6,11,10,12,11,13,12,13,8,13,11,13,14,12,15,13,11,13,13,11,9,12,14,13,15,14,13,11,6,13,14,13,11,16,8,11,7,13,3,3,3,3,2,1,1,1,2,1,2,16,10,4,10,10,12,10,14,1,1,1,20,1,18,1,1,1,1,1,1,1,1,72,10,20,2287618,6350,6350,3000,Mediterranean_Hispanic,126,0,0,22022.0,Unknown,67107816,6062500.0,2.0,10,1456,11,0,1,3,72,7,0.590500132310135,0.3155080213903743,0.5661764705882353,0.0212561328766607,0.0,0.0,0.0597649412353088,0.0597649412353088,0.0336537126031278,0.1428571428571428,0.3023255813953489,0.125,92,24,12,17,0,5668,0,0,0,12000000,2200000.0,12000000.0,0.0,,4000000.0,2,9000000,0.0,2.0
900909,Paul,Wanner,2024,2036,Austria,Dornbirn,Germany,23-12-05,Attacking Midfield,Midfield,Left,185.0,30-06-25,11WINS,https://img.a.transfermarkt.technology/portrait/header/900909-1661800800.jpg?lm=1,L1,1. FuÃŸballclub Heidenheim 1846,15000000.0,15000000.0,19,112,-9,12,11,13,11,14,12,6,11,4,7,13,12,7,15,6,9,8,12,9,13,10,13,16,4,11,7,11,11,14,13,12,11,14,14,10,7,14,4,13,4,16,2,3,2,3,1,3,2,1,3,3,3,8,19,2,14,16,15,14,17,1,11,1,1,14,8,10,12,18,12,14,20,15,10,72,20,12,46050001,5747,5747,4003,Northern_European,111,0,0,64.0,Unknown,2000138516,9111392.0,2.0,6,424,40,3,0,7,2,0,0.5107171209314634,0.4227807486631015,0.4558823529411764,5.310894963050656e-05,0.0,0.0,0.0747686921730432,0.0747686921730432,0.0505924720131114,0.1428571428571428,0.5116279069767438,0.0416666666666666,105,19,16,14,0,3391,4,23,94,18000000,1725000.0,18000000.0,0.0,18000000.0,,2,7500000,1.25,4.142857142857143
903611,Nilson,Angulo,2024,58,Ecuador,Quito,Ecuador,19-06-03,Left Winger,Attack,Right,183.0,30-06-27,Wasserman,https://img.a.transfermarkt.technology/portrait/header/903611-1658140117.jpg?lm=1,BE1,Royal Sporting Club Anderlecht,1500000.0,1500000.0,21,108,-75,7,10,14,11,13,9,9,8,2,6,13,8,6,14,7,11,10,10,11,12,16,8,13,5,15,5,8,8,15,9,10,10,14,13,13,9,10,11,12,9,10,3,3,3,3,2,3,2,1,2,1,4,7,9,5,11,11,10,11,14,1,1,1,1,1,1,1,1,1,1,15,20,17,15,64,9,20,24620000,5000,5000,2218,African_Caribbean,106,3,0,4499.0,Unknown,2000035859,9111392.0,2.0,30,1200,31,0,1,1,175,7,0.4118814501190792,0.2318716577540107,0.4191176470588235,0.0043356215243813,0.0197368421052631,0.0,0.0072518129532383,0.0072518129532383,0.0505924720131114,0.1428571428571428,0.4651162790697669,0.125,114,18,10,15,2,3803,1,1,4,1500000,140000.0,1500000.0,300000.0,500000.0,1500000.0,1,200000,0.0,0.25
904802,Jorrel,Hato,2024,610,Netherlands,Rotterdam,Netherlands,07-03-06,Centre-Back,Defender,Left,182.0,30-06-28,Football Mix B.V.,https://img.a.transfermarkt.technology/portrait/header/904802-1701361717.jpg?lm=1,NL1,AFC Ajax Amsterdam,30000000.0,30000000.0,18,93,-85,6,7,10,3,9,3,10,6,9,14,10,5,10,9,9,9,12,12,9,9,9,14,5,13,4,12,12,12,14,11,14,14,14,10,10,12,11,6,10,9,11,2,1,1,1,3,3,2,3,2,2,2,20,13,1,14,13,11,13,13,1,17,20,1,10,1,10,1,1,1,1,1,1,1,0,20,7,22620001,4505,4505,2108,African_Caribbean,92,0,0,100.0,Unknown,2000105654,9111392.0,2.0,67,1253,68,1,0,1,6,2,0.3463879333156919,0.2201069518716577,0.3161764705882353,8.787117120683812e-05,0.0,0.0,0.1497874468617154,0.1497874468617154,0.0505924720131114,0.1428571428571428,0.4418604651162785,0.0,146,7,12,19,0,6258,0,0,0,30000000,4583333.333333333,30000000.0,0.0,30000000.0,,1,2500000,0.0,0.36363636363636365
907813,Pablo,Marín,2024,681,Spain,LogroÃ±o,Spain,03-07-03,Attacking Midfield,Midfield,Right,178.0,30-06-27,InterStarDeporte,https://img.a.transfermarkt.technology/portrait/header/907813-1683212131.jpg?lm=1,ES1,Real Sociedad de FÃºtbol S.A.D.,1500000.0,1500000.0,21,122,132,11,11,11,9,13,11,9,10,6,11,13,10,11,13,12,12,14,12,14,12,12,12,11,11,13,12,14,14,12,12,10,9,14,12,14,12,13,8,13,7,10,2,1,1,3,2,2,2,1,1,4,2,19,12,2,11,11,11,9,20,1,1,1,1,1,1,15,13,20,10,12,18,8,1,74,12,20,1973959,6100,6100,3800,Mediterranean_Hispanic,120,0,0,5562.0,Unknown,67257916,9111392.0,2.0,89,855,89,3,1,3,168,0,0.5574225985710506,0.4010695187165775,0.5220588235294117,0.0053620726781491,0.0,0.0,0.0072518129532383,0.0072518129532383,0.0505924720131114,0.1428571428571428,0.3488372093023257,0.125,108,15,5,15,0,1739,0,0,0,1800000,160000.0,1800000.0,0.0,200000.0,1500000.0,2,500000,0.2,0.2
910905,Mamadou,Sarr,2024,667,France,Martigues,France,29-08-05,Centre-Back,Defender,Right,194.0,30-06-29,Classico,https://img.a.transfermarkt.technology/portrait/header/910905-1683283740.jpg?lm=1,FR1,Racing Club de Strasbourg Alsace,5000000.0,5000000.0,19,84,-8,5,5,3,5,9,5,12,8,5,11,9,2,14,8,11,8,9,8,8,9,14,6,12,2,8,9,7,9,10,9,12,14,8,10,5,12,7,10,19,7,10,1,3,1,2,2,3,2,3,3,3,3,19,8,1,9,9,11,11,14,1,1,20,1,1,1,18,1,1,1,1,1,1,1,0,10,20,11007750,4200,4200,1055,African_Caribbean,78,0,0,645.0,Unknown,2000107103,10000000.0,1.0,34,921,36,1,1,1,159,2,0.306033342154009,0.1074866310160427,0.213235294117647,0.0006141325811818,0.0,0.0,0.0247561890472618,0.0247561890472618,0.055529320258896,0.0,0.7209302325581395,0.0416666666666666,73,4,1,5,0,1578,4,6,21,8000000,1166666.6666666667,8000000.0,0.0,1000000.0,,3,4000000,7.0,7.0
911065,Andrés,Salazar,2024,43,Colombia,Rionegro,Colombia,15-01-03,Left-Back,Defender,Left,182.0,30-06-25,Elite Player,https://img.a.transfermarkt.technology/portrait/header/911065-1675085055.jpeg?lm=1,SC1,Heart of Midlothian Football Club,750000.0,750000.0,21,94,-75,9,13,11,7,7,8,9,8,6,10,8,7,11,10,7,13,13,6,11,9,14,9,9,9,10,12,13,13,13,9,9,9,15,9,12,4,15,5,19,12,13,1,1,1,3,2,2,3,1,1,2,1,15,13,3,9,11,10,12,15,1,20,1,1,20,1,1,18,1,1,16,1,1,1,72,20,8,1695906,4700,4700,1700,Mixed_Race,84,0,0,1479.0,Fortaleza FÃºtbol Club S.A.,2000110773,9111392.0,2.0,20,1235,20,1,0,4,112,8,0.3721884096321778,0.1764705882352941,0.2573529411764706,0.0014194573810335,0.0,0.0,0.0035008752188047,0.0035008752188047,0.0505924720131114,0.1428571428571428,0.4418604651162785,0.125,69,3,3,15,0,4184,1,11,41,600000,56250.0,750000.0,150000.0,,550000.0,2,300000,-0.2,0.09090909090909091
911328,Mohamed,Kaba,2024,1005,France,OrlÃ©ans,France,27-10-01,Central Midfield,Midfield,Right,185.0,30-06-27,P.P.M.,https://img.a.transfermarkt.technology/portrait/header/911328-1695033138.jpg?lm=1,IT1,Unione Sportiva Lecce,3500000.0,3500000.0,23,112,-75,9,8,11,8,12,10,13,11,4,12,13,2,12,12,15,9,14,12,10,12,15,12,5,10,11,15,12,13,12,10,12,12,15,12,14,13,12,11,10,9,8,1,2,2,2,1,1,3,1,1,3,1,18,11,6,13,10,14,10,12,1,1,1,1,1,1,20,1,17,1,1,1,1,1,0,7,20,4155000,5700,5600,2282,African_Caribbean,112,0,0,4726.0,Unknown,49061282,3000000.0,1.0,34,1092,36,3,1,1,206,1,0.4912675310928817,0.2387165775401069,0.463235294117647,0.0045548166437654,0.0,0.0,0.0172543135783946,0.0172543135783946,0.0166393510930859,0.0,0.5116279069767438,0.2083333333333332,109,6,9,18,0,972,3,26,219,3500000,275000.0,3500000.0,0.0,,1800000.0,1,500000,0.0,0.0
912902,Guillaume,Restes,2024,415,France,Toulouse,France,11-03-05,Goalkeeper,Goalkeeper,Left,188.0,30-06-28,Classico,https://img.a.transfermarkt.technology/portrait/header/912902-1676656145.jpg?lm=1,FR1,Toulouse Football Club,18000000.0,18000000.0,19,88,-75,3,1,2,3,11,5,2,2,3,2,11,3,1,11,6,11,15,8,11,12,10,16,1,8,1,12,7,8,10,11,9,14,14,9,4,8,4,5,13,9,12,15,11,10,5,10,11,11,10,11,11,11,14,13,4,11,11,14,11,13,20,1,1,1,1,1,1,1,1,1,1,1,1,1,82,20,5,7103999,4400,4400,1500,African_Caribbean,89,0,0,645.0,Unknown,2000094715,9111392.0,2.0,34,1512,36,2,0,1,203,5,0.3324953691452765,0.1550802139037433,0.2941176470588235,0.0006141325811818,0.0,0.0,0.0897724431107777,0.0897724431107777,0.0505924720131114,0.1428571428571428,0.581395348837209,0.0416666666666666,0,0,0,0,0,0,2,5,29,18000000,2666666.6666666665,18000000.0,0.0,10000000.0,,0,0,0.0,0.8
914562,Désiré,Doué,2024,583,France,Angers,France,03-06-05,Left Winger,Attack,Right,181.0,30-06-29,Unknown,https://img.a.transfermarkt.technology/portrait/header/914562-1667317075.jpg?lm=1,FR1,Paris Saint-Germain Football Club,40000000.0,40000000.0,19,109,-9,11,10,14,10,14,10,8,9,4,9,13,10,9,14,5,10,12,11,11,13,11,15,14,7,10,8,11,11,13,14,11,8,13,13,12,11,11,5,9,4,7,1,1,1,2,1,2,3,1,2,1,1,13,15,5,16,10,14,14,18,1,1,1,1,1,1,1,1,20,1,1,16,1,1,0,10,20,48164165,5450,5450,3014,African_Caribbean,108,0,0,3470.0,Unknown,2000115202,50000000.0,1.0,34,70,36,0,1,1,154,7,0.4714210108494311,0.3170053475935828,0.4338235294117646,0.0033420013576578,0.0,0.0,0.1997999499874969,0.1997999499874969,0.277757715492097,0.0,0.418604651162791,0.0416666666666666,128,15,16,14,0,4064,3,10,51,40000000,3960000.0,40000000.0,0.0,20000000.0,,2,13600000,0.3333333333333333,1.6666666666666667
918414,Paris,Brunner,2024,520,Germany,Dortmund,Germany,15-02-06,Centre-Forward,Attack,Right,186.0,30-06-25,Unknown,https://img.a.transfermarkt.technology/portrait/header/918414-1713463287.jpg?lm=1,BE1,Cercle Brugge Koninklijke Sportvereniging,1500000.0,1500000.0,18,88,-8,9,9,10,11,11,9,8,9,9,4,10,11,7,12,11,11,8,10,7,11,7,12,12,1,11,9,9,11,13,12,10,11,17,12,8,10,8,8,16,5,11,3,2,1,2,1,2,1,1,2,4,4,17,12,3,11,13,9,12,17,1,1,1,1,1,1,1,1,1,1,12,14,12,20,0,8,20,31480000,4344,4344,1845,African_Caribbean,81,0,0,64.0,Unknown,2000180882,4000000.0,1.0,38,425,40,0,1,1,49,3,0.3250860015877216,0.1919786096256684,0.2352941176470588,5.310894963050656e-05,0.0,0.0,0.0072518129532383,0.0072518129532383,0.0221950609739159,0.0,0.5348837209302322,0.0,98,57,16,15,0,4078,2,12,62,1500000,0.0,1500000.0,0.0,1500000.0,,0,0,0.0,0.0
918969,Lamine,Camara,2024,162,Senegal,Diouloulou,Senegal,01-01-04,Central Midfield,Midfield,Right,173.0,30-06-29,Wasserman,https://img.a.transfermarkt.technology/portrait/header/918969-1726834088.jpg?lm=1,FR1,Association sportive de Monaco Football Club,15000000.0,15000000.0,20,99,-75,5,7,6,9,14,8,8,14,8,8,14,5,13,9,9,9,9,10,9,14,8,5,8,9,7,6,9,13,14,14,9,8,12,14,14,6,10,9,18,6,12,3,1,3,3,2,1,1,3,1,2,1,19,12,4,11,13,10,10,17,1,1,1,1,1,1,1,1,20,1,1,1,1,1,0,5,20,93749,4750,4750,1250,African_Caribbean,91,3,2,116.0,Unknown,12093439,15000000.0,1.0,83,416,84,3,1,1,24,1,0.3788039163799948,0.1283422459893048,0.3088235294117646,0.0001033210474629,0.0197368421052631,0.0263157894736842,0.0747686921730432,0.0747686921730432,0.0833078696630462,0.0,0.2325581395348837,0.0833333333333332,66,4,12,10,1,1102,0,0,0,20000000,2828571.4285714286,20000000.0,-600000.0,,20000000.0,2,5600000,1.0,4.0
919515,Jeanuël,Belocian,2024,15,Guadeloupe,Les Abymes,France,17-02-05,Centre-Back,Defender,Left,182.0,30-06-29,One Team Football ,https://img.a.transfermarkt.technology/portrait/header/919515-1727378177.jpg?lm=1,L1,Bayer 04 Leverkusen FuÃŸball,20000000.0,20000000.0,19,93,-8,7,10,11,6,12,7,12,10,7,11,11,8,12,12,10,11,10,11,11,11,10,14,12,8,9,11,10,10,11,13,10,12,12,11,12,10,13,6,11,6,8,4,3,3,2,2,4,1,2,1,1,2,11,13,6,13,12,12,12,11,1,15,20,1,12,1,15,1,10,1,1,1,1,1,73,20,8,8199999,4645,4645,1549,African_Caribbean,93,0,0,749.0,Unknown,2000115205,15000000.0,1.0,41,823,36,1,0,1,36,2,0.3649113522095792,0.1603208556149732,0.3235294117647059,0.0007145567768468,0.0,0.0,0.0997749437359339,0.0997749437359339,0.0833078696630462,0.0,0.4418604651162785,0.0416666666666666,73,0,1,8,1,3549,9,95,176,20000000,1950000.0,20000000.0,0.0,9000000.0,,2,10000000,1.0,1.2222222222222223
922693,Archie,Gray,2024,148,England,Durham,England,12-03-06,Central Midfield,Midfield,Right,187.0,30-06-30,Unknown,https://img.a.transfermarkt.technology/portrait/header/922693-1695108880.jpg?lm=1,GB1,Tottenham Hotspur Football Club,25000000.0,25000000.0,18,97,-9,8,8,11,9,13,9,6,10,5,7,13,7,9,13,13,11,11,12,9,13,10,13,13,8,11,9,13,12,11,11,13,8,12,12,12,7,11,8,13,3,11,3,3,1,3,2,3,3,2,3,3,1,10,11,2,14,16,13,10,13,1,1,1,1,1,1,12,1,20,1,1,14,1,1,0,12,20,29675326,4848,4848,3248,Northern_European,97,0,0,203.0,Unknown,2000182795,41250000.0,1.0,32,439,33,3,1,7,202,1,0.3917703096057158,0.3420320855614973,0.3529411764705882,0.0001873297496057,0.0,0.0,0.1247811952988247,0.1247811952988247,0.2291452540348343,0.0,0.5581395348837206,0.0,122,4,7,8,0,5619,0,0,0,25000000,3542857.1428571427,25000000.0,0.0,25000000.0,,2,12800000,0.3888888888888889,0.7857142857142857
923504,Sindre Walle,Egeli,2024,2778,Norway,Larvik,Norway,21-06-06,Right Winger,Attack,Right,182.0,30-06-28,Keypass AS,https://img.a.transfermarkt.technology/portrait/header/default.jpg?lm=1,DK1,Fodbold Club NordsjÃ¦lland,250000.0,250000.0,18,95,-75,8,11,13,13,13,8,9,9,5,4,13,10,5,13,9,12,10,11,9,12,5,2,10,9,13,5,12,12,13,12,6,10,13,13,9,6,10,9,18,6,11,3,2,3,1,4,1,2,2,3,1,3,10,9,4,8,10,11,10,20,1,1,1,1,1,1,1,1,1,14,14,1,20,16,0,10,20,3878527,3300,3681,302,Northern_European,94,0,0,409.0,Unknown,2000193842,9111392.0,2.0,71,801,73,0,1,7,87,10,0.2373643821116697,0.026951871657754,0.3308823529411764,0.0003862469064036,0.0,0.0,0.0010002500625156,0.0010002500625156,0.0505924720131114,0.1428571428571428,0.4418604651162785,0.0,52,32,10,8,0,1089,0,0,0,7000000,2266666.6666666665,7000000.0,-50000.0,7000000.0,,1,50000,27.0,34.0
923595,Max,Moerstedt,2024,533,Germany,Mannheim,Germany,15-01-06,Centre-Forward,Attack,Right,194.0,30-06-27,Sports360 GmbH,https://img.a.transfermarkt.technology/portrait/header/923595-1723920909.jpg?lm=1,L1,TSG 1899 Hoffenheim FuÃŸball-Spielbetriebs GmbH,3000000.0,3000000.0,18,82,-75,1,6,10,12,12,4,12,7,3,3,12,12,4,13,8,8,11,11,10,12,8,11,14,4,11,4,10,8,10,10,12,15,16,11,11,11,14,3,14,4,7,2,1,2,3,3,4,2,3,3,4,2,13,18,7,7,12,16,14,16,1,1,1,1,1,1,1,1,1,1,14,14,14,20,73,8,20,15080000,4104,4104,2106,Northern_European,82,0,0,64.0,Unknown,2000230641,9111392.0,2.0,38,906,40,0,1,7,199,3,0.2933315691982006,0.2198930481283422,0.2426470588235293,5.310894963050656e-05,0.0,0.0,0.0147536884221055,0.0147536884221055,0.0505924720131114,0.1428571428571428,0.7209302325581395,0.0,89,59,20,10,0,3372,3,2,15,4000000,1000000.0,4000000.0,-1000000.0,4000000.0,,0,0,3.0,0.0
923831,Leny,Yoro,2024,985,France,Saint-Maurice,France,13-11-05,Centre-Back,Defender,Right,190.0,30-06-29,Gestifute,https://img.a.transfermarkt.technology/portrait/header/923831-1701768506.jpg?lm=1,GB1,Manchester United Football Club,55000000.0,55000000.0,19,86,-8,4,3,7,7,8,2,15,5,1,14,8,1,14,7,8,11,6,8,8,7,14,14,7,6,4,14,7,8,14,11,8,15,15,11,6,5,12,11,2,14,12,1,3,3,3,3,3,2,2,3,3,2,19,11,7,12,9,12,12,16,1,1,20,1,1,1,10,1,1,1,1,1,1,1,0,3,20,11850000,4299,4299,1053,African_Caribbean,86,0,0,645.0,Unknown,2000182819,62000000.0,1.0,34,1276,36,1,1,1,132,2,0.3191320455146864,0.1072727272727272,0.2720588235294117,0.0006141325811818,0.0,0.0,0.274818704676169,0.274818704676169,0.3444262340620572,0.0,0.6279069767441858,0.0416666666666666,103,3,1,9,1,4875,3,23,126,55000000,4986363.636363637,55000000.0,0.0,55000000.0,,2,5350000,0.1,1.2
924349,Issa,Doumbia,2024,607,Italy,Treviglio,Italy,16-10-03,Central Midfield,Midfield,Right,187.0,30-06-29,StarAssist,https://img.a.transfermarkt.technology/portrait/header/924349-1723448039.jpg?lm=1,IT1,Venezia Football Club,500000.0,500000.0,21,120,133,8,8,12,8,12,8,9,11,5,11,12,10,13,12,13,12,13,11,12,12,10,14,9,10,13,12,15,12,14,13,12,12,15,14,15,14,10,12,10,7,11,2,3,1,3,2,1,3,1,1,2,2,11,14,12,11,10,13,11,8,1,1,1,1,1,1,20,1,17,1,1,13,1,7,82,11,20,528842,6000,5700,4700,African_Caribbean,119,0,0,16836.0,Alanyaspor,18099960,9111392.0,2.0,52,1521,54,3,1,1,210,1,0.5044985445885155,0.4973262032085561,0.5147058823529411,0.0162484417351369,0.0,0.0,0.0022505626406601,0.0022505626406601,0.0505924720131114,0.1428571428571428,0.5581395348837206,0.125,95,4,5,7,0,1368,1,2,11,1000000,132142.85714285713,1000000.0,0.0,75000.0,500000.0,1,500000,1.0,4.714285714285714
924857,Lennon,Miller,2024,987,Scotland,Wishaw,Scotland,25-08-06,Central Midfield,Midfield,Right,182.0,31-05-26,Unknown,https://img.a.transfermarkt.technology/portrait/header/924857-1701702197.jpg?lm=1,SC1,Motherwell Football Club,1600000.0,1600000.0,18,70,-75,7,9,6,5,14,7,7,9,3,7,9,3,9,12,13,10,5,13,6,13,12,8,11,2,7,6,13,9,10,11,8,10,12,11,9,5,8,5,14,8,10,1,2,1,4,1,2,3,2,2,3,1,14,10,2,10,11,13,13,13,1,1,1,1,1,1,1,15,16,1,17,20,1,1,0,5,20,5576883,2750,2789,583,Northern_European,65,0,0,35.0,Unknown,2000170028,9111392.0,2.0,82,1671,83,3,1,7,135,1,0.1193437417306166,0.0570053475935828,0.1176470588235293,2.510604891623946e-05,0.0,0.0,0.0077519379844961,0.0077519379844961,0.0505924720131114,0.1428571428571428,0.4418604651162785,0.0,0,0,0,0,0,0,1,9,55,4000000,633333.3333333334,4000000.0,-100000.0,4000000.0,,0,0,1.6666666666666667,4.0
926763,Unknown,Chuki,2024,366,Spain,Valladolid,Spain,29-04-04,Attacking Midfield,Midfield,Left,183.0,30-06-25,LEADERBROCK,https://img.a.transfermarkt.technology/portrait/header/926763-1700777200.jpg?lm=1,ES1,Real Valladolid Club de FÃºtbol S.A.D.,300000.0,300000.0,20,85,-75,8,8,10,16,15,6,7,10,7,6,15,8,8,15,14,6,8,10,9,15,15,16,13,8,16,10,14,10,10,6,12,5,7,9,5,8,11,12,13,5,13,2,2,3,2,2,3,1,2,2,1,2,20,11,1,11,8,9,11,10,1,1,1,1,1,1,1,1,15,1,1,20,1,1,0,20,8,6363121,4249,4249,1749,Mediterranean_Hispanic,89,0,0,348.0,Unknown,2000139344,9111392.0,2.0,89,1558,89,3,0,3,169,0,0.3125165387668696,0.181711229946524,0.2941176470588235,0.0003273442531771,0.0,0.0,0.0012503125781445,0.0012503125781445,0.0505924720131114,0.1428571428571428,0.4651162790697669,0.0833333333333332,73,15,4,13,0,966,0,0,0,500000,27777.777777777777,500000.0,0.0,250000.0,500000.0,0,0,0.6666666666666666,0.6666666666666666
931838,Hugo,Larsson,2024,24,Sweden,Svarte,Sweden,27-06-04,Central Midfield,Midfield,Right,187.0,30-06-29,Unknown,https://img.a.transfermarkt.technology/portrait/header/931838-1696509259.jpg?lm=1,L1,Eintracht Frankfurt FuÃŸball AG,28000000.0,28000000.0,20,105,-75,10,10,11,7,11,9,8,10,7,8,12,8,10,11,11,12,12,11,12,12,11,14,11,11,13,10,13,13,13,12,11,13,10,13,13,11,12,8,14,6,12,3,3,1,1,1,1,3,2,3,3,3,11,13,2,14,14,13,15,15,1,1,8,8,1,1,15,8,20,8,8,16,8,1,70,10,20,1977483,5250,5250,1266,Northern_European,105,0,0,1118.0,Unknown,2000019708,9000000.0,1.0,91,1440,91,3,1,7,63,1,0.4449589838581635,0.1300534759358289,0.411764705882353,0.0010708695480042,0.0,0.0,0.1397849462365591,0.1397849462365591,0.049973610378066,0.0,0.5581395348837206,0.0833333333333332,0,0,0,0,0,0,5,14,20,35000000,4187500.0,35000000.0,0.0,4000000.0,35000000.0,1,8000000,0.25,0.25
933017,Zach,Abbott,2024,703,Unknown,Unknown,England,13-05-06,Centre-Back,Defender,Right,183.0,30-06-26,Footfeel ISM  ,https://img.a.transfermarkt.technology/portrait/header/933017-1724485038.jpg?lm=1,GB1,Nottingham Forest Football Club,300000.0,300000.0,18,82,-75,3,1,1,2,6,1,13,1,3,13,7,2,11,6,9,11,9,7,9,1,13,14,6,4,6,13,6,7,13,10,7,12,16,12,6,7,20,10,14,10,15,2,2,2,1,1,1,1,1,3,1,2,17,9,8,12,8,12,12,16,1,1,20,1,1,1,1,1,1,1,1,1,1,1,0,12,20,18623633,4109,4109,1766,Northern_European,77,0,0,203.0,Unknown,2000222768,9111392.0,2.0,105,1549,33,1,1,7,140,2,0.2939931198729822,0.1835294117647058,0.2058823529411764,0.0001873297496057,0.0,0.0,0.0012503125781445,0.0012503125781445,0.0505924720131114,0.1428571428571428,0.4651162790697669,0.0,88,2,0,14,0,1600,0,0,0,300000,16666.666666666668,300000.0,0.0,300000.0,,1,50000,0.0,0.0
933900,Samuel,Amo-Ameyaw,2024,180,Unknown,Unknown,England,18-07-06,Right Winger,Attack,Left,174.0,30-06-26,Two Touch Agency,https://img.a.transfermarkt.technology/portrait/header/933900-1695110050.jpg?lm=1,GB1,Southampton Football Club,300000.0,300000.0,18,75,-75,6,12,14,10,14,4,4,8,7,7,14,5,3,11,7,8,4,9,8,9,10,12,10,10,10,6,8,9,14,14,8,4,11,14,6,5,6,14,14,9,10,1,3,2,1,1,2,3,1,2,2,3,15,11,6,12,10,11,11,17,1,1,1,1,1,1,1,1,1,1,20,1,17,17,0,20,1,19965077,3750,3750,1250,African_Caribbean,77,0,0,203.0,Unknown,2000190479,9111392.0,2.0,105,1549,33,0,0,1,186,10,0.246493781423657,0.1283422459893048,0.2058823529411764,0.0001873297496057,0.0,0.0,0.0012503125781445,0.0012503125781445,0.0505924720131114,0.1428571428571428,0.2558139534883721,0.0,67,19,11,7,0,3756,0,0,0,300000,0.0,300000.0,0.0,300000.0,,0,0,0.0,0.0
935039,Maryan,Faryna,2024,660,Ukraine,"Kamyane, Lviv Oblast",Ukraine,28-08-03,Centre-Back,Defender,Left,180.0,31-12-26,MSM Group,https://img.a.transfermarkt.technology/portrait/header/935039-1723486587.png?lm=1,UKR1,FC Shakhtar Donetsk,400000.0,400000.0,21,110,-8,5,8,10,9,13,6,14,5,12,14,14,3,11,8,10,9,10,10,11,10,11,12,5,8,9,14,11,13,12,11,11,14,14,12,11,11,8,9,10,8,11,2,2,3,2,3,1,3,2,3,2,1,5,10,7,15,10,12,12,9,1,15,20,1,13,1,1,1,1,1,1,1,1,1,78,20,10,27587651,4250,4320,1524,Northern_European,108,0,0,64.0,Unknown,2000028534,9111392.0,2.0,103,705,101,1,0,7,72,2,0.3219105583487696,0.1576470588235294,0.4338235294117646,5.310894963050656e-05,0.0,0.0,0.0017504376094023,0.0017504376094023,0.0505924720131114,0.1428571428571428,0.3953488372093026,0.125,38,1,0,7,0,1307,0,0,0,400000,50000.0,400000.0,0.0,100000.0,400000.0,2,100000,0.0,0.3333333333333333
935358,Alexander,Simmelhack,2024,1177,Denmark,Roskilde,Denmark,11-11-05,Centre-Forward,Attack,Right,190.0,31-12-27,Nordic Sky,https://img.a.transfermarkt.technology/portrait/header/935358-1721916965.jpg?lm=1,DK1,Silkeborg IdrÃ¦tsforening,100000.0,100000.0,19,85,-75,6,4,13,10,12,6,13,7,6,6,5,5,5,10,6,10,7,9,6,5,10,11,9,2,11,4,6,7,13,11,7,14,12,12,9,9,14,12,9,9,7,3,1,3,2,1,3,2,3,3,3,3,19,10,1,11,10,11,12,15,1,1,1,1,1,1,1,1,1,1,1,1,1,20,0,8,20,8816425,4250,4250,700,Northern_European,76,0,0,991.0,Unknown,2000169857,350000.0,1.0,28,1250,30,0,1,7,182,3,0.3126488489018258,0.0695187165775401,0.1985294117647059,0.000948236155221,0.0,0.0,0.0002500625156289,0.0002500625156289,0.0019167199088863,0.0,0.6279069767441858,0.0416666666666666,82,29,6,3,0,1787,0,0,0,400000,150000.0,400000.0,-300000.0,100000.0,,1,300000,3.0,0.0
935480,Unknown,Martim Fernandes,2024,720,Portugal,Valongo,Portugal,18-01-06,Right-Back,Defender,Right,181.0,30-06-28,PCR Sports,https://img.a.transfermarkt.technology/portrait/header/935480-1725014659.png?lm=1,PO1,Futebol Clube do Porto,6000000.0,6000000.0,18,84,-85,6,11,12,7,11,3,8,6,10,9,11,7,11,11,12,9,10,9,11,8,10,11,11,6,7,12,10,12,12,11,12,9,8,12,11,8,11,8,8,12,12,1,1,2,1,3,2,3,4,2,1,3,17,11,5,11,12,13,10,11,1,1,1,20,1,17,1,1,1,1,1,1,1,1,74,7,20,10249501,4185,4185,2186,Mediterranean_Hispanic,81,0,0,64.0,Unknown,2000183245,9111392.0,2.0,76,1561,79,1,1,3,100,11,0.3040486901296639,0.2284491978609625,0.2352941176470588,5.310894963050656e-05,0.0,0.0,0.0297574393598399,0.0297574393598399,0.0505924720131114,0.1428571428571428,0.418604651162791,0.0,84,2,8,13,0,2313,2,7,19,8000000,1283333.3333333333,8000000.0,-200000.0,8000000.0,,1,3000000,1.0,7.0
936842,Michael,Golding,2024,1003,England,Kingston,England,23-05-06,Central Midfield,Midfield,Right,180.0,30-06-28,Unique Sports Group,https://img.a.transfermarkt.technology/portrait/header/936842-1715156410.jpg?lm=1,GB1,Leicester City Football Club,2000000.0,2000000.0,18,70,-8,6,6,8,8,13,6,3,8,3,6,13,6,11,13,6,10,8,5,6,13,13,18,13,11,8,4,8,11,9,9,8,10,11,9,7,6,15,12,18,5,10,1,3,2,3,2,1,3,1,2,1,2,9,11,3,13,12,12,10,12,1,1,1,1,1,1,17,1,20,1,1,16,1,1,0,9,20,7117253,3499,3499,1749,Mixed_Race,65,0,0,203.0,Unknown,2000184620,5900000.0,1.0,32,728,33,3,1,4,127,1,0.2132839375496163,0.181711229946524,0.1176470588235293,0.0001873297496057,0.0,0.0,0.0097524381095273,0.0097524381095273,0.0327509097474929,0.0,0.3953488372093026,0.0,50,9,8,2,0,3169,0,0,0,2000000,566666.6666666666,2000000.0,0.0,2000000.0,,1,1700000,5.666666666666667,0.0
937955,Héctor,Fort,2024,131,Spain,Barcelona,Spain,02-08-06,Right-Back,Defender,Right,185.0,30-06-26,AC Talent,https://img.a.transfermarkt.technology/portrait/header/937955-1702504973.jpg?lm=1,ES1,Futbol Club Barcelona,10000000.0,10000000.0,18,85,-75,6,11,9,7,10,6,10,7,10,10,11,7,11,11,14,11,12,9,9,9,10,14,11,8,9,10,12,10,12,11,11,10,14,12,10,9,12,10,12,5,15,4,2,3,3,2,1,3,1,2,2,3,13,11,1,9,10,13,10,15,1,1,19,20,1,19,1,1,1,12,1,1,1,1,0,7,20,1874998,4249,4249,1749,Mediterranean_Hispanic,81,0,0,64.0,Unknown,2000227977,9111392.0,2.0,89,141,89,1,1,3,96,11,0.3125165387668696,0.181711229946524,0.2352941176470588,5.310894963050656e-05,0.0,0.0,0.0497624406101525,0.0497624406101525,0.0505924720131114,0.1428571428571428,0.5116279069767438,0.0,48,2,4,4,0,1961,2,3,18,10000000,1650000.0,10000000.0,0.0,10000000.0,,1,0,0.0,9.0
938146,Adam,Aznou,2024,27,Spain,Barcelona,Morocco,02-06-06,Left-Back,Defender,Left,178.0,30-06-27,CAA Stellar,https://img.a.transfermarkt.technology/portrait/header/938146-1692946563.jpg?lm=1,L1,FC Bayern MÃ¼nchen,1500000.0,1500000.0,18,90,-8,4,12,12,7,12,4,6,7,7,10,12,7,12,12,12,8,9,9,8,11,8,13,15,2,12,10,11,11,14,12,8,7,13,14,12,7,13,5,12,6,15,1,3,3,2,2,1,2,1,3,2,3,8,17,5,10,13,13,13,13,1,20,1,10,18,10,1,12,10,1,12,1,1,1,68,20,8,28200000,4500,3527,2620,North_African__Middle_Eastern,81,0,0,64.0,Unknown,2000191507,9111392.0,2.0,89,141,67,1,0,6,68,8,0.2169886213283937,0.2748663101604278,0.2352941176470588,5.310894963050656e-05,0.0,0.0,0.0072518129532383,0.0072518129532383,0.0505924720131114,0.1428571428571428,0.3488372093023257,0.0,60,7,9,18,0,3025,2,21,139,3000000,575000.0,3000000.0,-200000.0,3000000.0,,0,0,2.3333333333333335,0.0
938158,Marc,Guiu,2024,631,Spain,Granollers,Spain,04-01-06,Centre-Forward,Attack,Right,187.0,30-06-29,IFM,https://img.a.transfermarkt.technology/portrait/header/938158-1719846394.jpg?lm=1,GB1,Chelsea Football Club,7500000.0,7500000.0,18,80,-75,5,7,9,12,12,8,12,9,6,7,9,10,8,11,11,9,10,10,9,9,8,14,11,6,11,7,9,9,11,12,10,11,14,12,9,9,12,8,12,12,5,3,3,2,1,1,2,1,3,2,3,2,17,12,5,11,11,11,11,10,1,1,1,1,1,1,1,1,1,1,10,1,10,20,0,8,20,6000000,4000,4000,1500,Mediterranean_Hispanic,80,0,0,455.0,Unknown,2000228120,6000000.0,1.0,89,554,89,0,1,3,50,3,0.2795713151627415,0.1550802139037433,0.2279411764705882,0.0004306653006401,0.0,0.0,0.0372593148287071,0.0372593148287071,0.0333064807355759,0.0,0.5581395348837206,0.0,0,0,0,0,0,0,3,9,59,8000000,1375000.0,8000000.0,0.0,8000000.0,,2,5500000,0.06666666666666667,2.2
939964,Jean-Mattéo,Bahoya,2024,24,France,Montfermeil,France,07-05-05,Left Winger,Attack,Left,180.0,30-06-29,Concept Sport Agency,https://img.a.transfermarkt.technology/portrait/header/939964-1724772389.jpg?lm=1,L1,Eintracht Frankfurt FuÃŸball AG,7500000.0,7500000.0,19,85,-75,8,11,14,12,14,7,9,4,7,7,14,6,8,14,15,11,8,6,5,8,14,15,13,4,11,7,8,9,10,10,4,11,11,12,7,7,7,12,14,6,9,1,4,3,2,1,2,2,1,1,2,1,7,12,4,12,11,12,10,14,1,1,1,1,1,1,1,17,1,1,20,1,1,15,0,20,10,8735999,4281,4281,1160,African_Caribbean,79,0,0,645.0,Unknown,2000113245,8000000.0,1.0,34,976,36,0,0,1,63,7,0.3167504630854724,0.1187165775401069,0.2205882352941177,0.0006141325811818,0.0,0.0,0.0372593148287071,0.0372593148287071,0.044417900497236,0.0,0.3953488372093026,0.0416666666666666,0,0,0,0,0,0,3,3,11,7500000,1057142.857142857,7500000.0,0.0,7500000.0,,2,6400000,0.0,2.0
943837,Unknown,Vitor Roque,2024,150,Brazil,TimÃ³teo,Brazil,28-02-05,Centre-Forward,Attack,Right,174.0,30-06-25,LINK SPORTS,https://img.a.transfermarkt.technology/portrait/header/943837-1704703716.jpg?lm=1,ES1,Real Betis BalompiÃ© S.A.D.,30000000.0,40000000.0,19,122,-9,11,12,13,13,13,8,11,13,8,7,11,12,8,13,11,13,10,13,13,11,13,11,13,9,13,7,13,13,14,14,8,8,11,13,13,10,12,9,13,10,13,3,3,2,3,1,2,1,3,2,4,2,9,7,5,10,10,9,12,17,1,1,1,1,1,1,1,1,1,1,15,1,15,20,76,10,20,16963077,6211,6211,3383,Mixed_Race,119,0,0,7296.0,Unknown,2000095783,22350000.0,2.0,10,1493,11,0,1,4,164,3,0.5721090235512041,0.3564705882352941,0.5147058823529411,0.0070364530174091,0.0,0.0,0.1497874468617154,0.1997999499874969,0.1241423372871468,0.1428571428571428,0.2558139534883721,0.0416666666666666,149,44,15,24,0,3592,2,11,63,20000000,2188888.888888889,40000000.0,10000000.0,40000000.0,,3,26700000,-0.3333333333333333,-0.5
946883,Iván,Fresneda,2024,336,Spain,Madrid,Spain,28-09-04,Right-Back,Defender,Right,183.0,30-06-28,LIAN Sports Group,https://img.a.transfermarkt.technology/portrait/header/946883-1725523108.jpg?lm=1,PO1,Sporting Clube de Portugal,9000000.0,15000000.0,20,95,-8,8,6,9,8,10,3,10,5,3,11,10,8,15,10,12,11,11,10,12,6,13,12,5,10,9,8,14,14,14,12,10,8,15,11,11,6,11,9,9,7,14,2,3,1,2,2,1,2,3,2,2,2,19,9,4,13,10,13,10,12,1,1,1,20,1,1,1,1,1,1,1,1,1,1,75,5,20,11424001,4746,4746,2780,Mediterranean_Hispanic,87,0,0,856.0,Unknown,2000165653,9000000.0,1.0,89,892,89,1,1,3,193,11,0.3782746758401694,0.2919786096256684,0.2794117647058823,0.0008178778243098,0.0,0.0,0.0447611902975743,0.0747686921730432,0.049973610378066,0.0,0.4651162790697669,0.0833333333333332,65,2,1,7,0,2160,4,25,86,7000000,755555.5555555555,15000000.0,2000000.0,15000000.0,7000000.0,1,2000000,-0.2222222222222222,-0.46153846153846156
948275,Álvaro,Rodríguez,2024,3709,Spain,PalamÃ³s,Uruguay,14-07-04,Centre-Forward,Attack,Left,193.0,30-06-25,Footfeel ISM  ,https://img.a.transfermarkt.technology/portrait/header/948275-1660124773.jpg?lm=1,ES1,Getafe Club de FÃºtbol S.A.D. Team Dubai,3500000.0,6000000.0,20,99,-8,7,10,13,13,13,7,15,8,5,6,13,7,7,10,7,13,1,7,6,7,13,12,12,2,10,2,7,8,13,10,8,16,9,13,9,13,12,9,10,12,11,2,3,3,3,1,4,2,2,3,3,1,11,11,6,15,12,11,11,20,1,1,1,1,1,1,1,1,1,1,16,1,1,20,0,20,11,15330000,4950,4950,2500,Mixed_Race,99,0,0,1206.0,Unknown,2000218258,9111392.0,2.0,89,1110,103,0,0,4,105,3,0.4052659433712622,0.2620320855614972,0.3676470588235294,0.001155843867413,0.0,0.0,0.0172543135783946,0.0297574393598399,0.0505924720131114,0.1428571428571428,0.6976744186046511,0.0833333333333332,110,25,11,11,1,1964,1,8,54,3000000,280000.0,6000000.0,2000000.0,6000000.0,3000000.0,1,500000,-0.14285714285714285,-0.14285714285714285
948294,Nico,Paz,2024,1047,Spain,Santa Cruz de Tenerife,Argentina,08-09-04,Attacking Midfield,Midfield,Left,186.0,30-06-28,DCGLOBALSL,https://img.a.transfermarkt.technology/portrait/header/948294-1699472504.jpg?lm=1,IT1,Calcio Como,10000000.0,10000000.0,20,94,-85,9,11,13,9,12,7,7,9,7,7,13,4,9,11,10,4,5,9,6,12,13,14,14,4,11,5,9,5,13,13,9,7,7,13,9,8,8,15,17,12,15,3,3,3,3,1,2,3,2,2,1,1,15,12,1,9,9,12,9,17,1,1,1,1,1,1,1,16,11,15,20,12,17,1,64,20,12,19799999,4700,4700,3000,Mediterranean_Hispanic,88,0,0,769.0,Unknown,2000163799,6000000.0,1.0,89,1324,4,3,0,3,47,0,0.3721884096321778,0.3155080213903743,0.286764705882353,0.0007338691221669,0.0,0.0,0.0497624406101525,0.0497624406101525,0.0333064807355759,0.0,0.5348837209302322,0.0833333333333332,92,24,11,10,0,1625,0,0,0,20000000,2571428.5714285714,20000000.0,0.0,2000000.0,20000000.0,2,8000000,1.0,1.0
951579,Saël,Kumbedi,2024,1041,France,Stains,France,26-03-05,Right-Back,Defender,Right,175.0,30-06-27,Mickael Libong,https://img.a.transfermarkt.technology/portrait/header/951579-1672831110.jpg?lm=1,FR1,Olympique Lyonnais,5000000.0,12000000.0,19,90,-8,5,9,9,9,11,2,7,9,9,9,11,5,15,11,12,11,11,10,13,9,13,13,12,11,9,14,10,10,13,14,11,8,15,13,8,6,10,13,11,9,10,1,3,2,2,1,3,3,2,1,1,3,19,10,7,13,9,13,11,11,1,14,1,20,13,17,1,1,1,1,1,1,1,1,63,1,20,12810000,4800,4500,1500,African_Caribbean,88,0,0,998.0,Unknown,2000104915,1000000.0,1.0,34,1417,36,1,1,1,143,11,0.3457263826409102,0.1550802139037433,0.286764705882353,0.0009549954760831,0.0,0.0,0.0247561890472618,0.0597649412353088,0.0055279313314258,0.0,0.2790697674418605,0.0416666666666666,89,1,6,18,1,4797,0,0,0,4000000,422222.22222222225,12000000.0,2000000.0,9000000.0,,1,800000,-0.42857142857142855,-0.6
953901,Santiago,Mouriño,2024,1108,Uruguay,Montevideo,Uruguay,13-02-02,Centre-Back,Defender,Right,186.0,30-06-29,After90Group,https://img.a.transfermarkt.technology/portrait/header/953901-1691396102.jpg?lm=1,ES1,Deportivo AlavÃ©s S.A.D.,1200000.0,1200000.0,22,106,-8,9,8,11,13,12,9,10,13,3,6,13,4,2,13,9,15,10,11,10,11,12,14,11,14,12,9,9,10,12,14,13,11,15,12,14,8,11,6,9,7,12,2,1,3,2,1,1,3,3,3,1,1,19,11,3,15,11,11,12,20,1,1,1,1,1,1,1,1,1,1,1,1,1,20,65,9,20,7348257,5300,5300,3008,Mediterranean_Hispanic,106,0,0,3128.0,Newcastle United,51078481,1746666.667,3.0,106,975,103,1,1,3,59,2,0.4515744906059804,0.3163636363636363,0.4191176470588235,0.0030117602526827,0.0,0.0,0.0057514378594648,0.0057514378594648,0.0096761947109641,0.2857142857142857,0.5348837209302322,0.1666666666666666,75,1,0,18,1,2126,0,0,0,2000000,197500.0,2000000.0,0.0,,150000.0,3,925000,0.6666666666666666,2.3333333333333335
954104,Jayden,Meghoma,2024,1148,Unknown,Unknown,England,28-06-06,Left-Back,Defender,Left,176.0,30-06-28,Unknown,https://img.a.transfermarkt.technology/portrait/header/954104-1725051533.jpg?lm=1,GB1,Brentford Football Club,10774124.0,17195854.0,18,75,-75,4,6,3,3,9,1,9,1,7,12,5,7,11,5,6,6,9,8,9,5,13,8,5,1,6,14,8,8,10,14,8,8,13,13,7,11,8,8,17,9,13,2,3,2,3,1,2,1,2,3,1,3,12,13,5,11,9,14,11,16,1,20,14,1,1,1,1,1,1,1,1,1,1,1,0,20,9,19965077,3750,3750,1250,African_Caribbean,64,0,0,203.0,Unknown,2000190480,9111392.0,2.0,105,1549,33,1,0,1,43,8,0.246493781423657,0.1283422459893048,0.1102941176470588,0.0001873297496057,0.0,0.0,0.0536340285071267,0.0857507076769192,0.0505924720131114,0.1428571428571428,0.3023255813953489,0.0,56,0,3,8,0,3204,0,0,0,0,,,,,,0,0,,
955070,Ernest,Nuamah,2024,1041,Ghana,Kumasi,Ghana,01-11-03,Right Winger,Attack,Left,178.0,30-06-28,HC,https://img.a.transfermarkt.technology/portrait/header/955070-1702991257.jpg?lm=1,FR1,Olympique Lyonnais,18000000.0,20000000.0,21,115,-75,7,9,14,11,14,7,9,8,4,4,12,9,3,14,10,13,10,10,9,10,5,14,15,10,13,5,12,12,17,16,8,10,14,17,8,9,11,7,10,13,16,3,2,2,1,2,3,3,1,1,2,3,10,12,6,12,11,13,12,12,1,1,1,1,1,1,1,11,1,13,20,1,16,14,71,20,8,3878527,6250,3826,304,African_Caribbean,109,0,0,1008.0,Unknown,2000156783,26750000.0,2.0,39,768,41,0,0,1,143,10,0.2565493516803387,0.0271657754010695,0.4411764705882353,0.0009646516487432,0.0,0.0,0.0897724431107777,0.0997749437359339,0.1485874607627989,0.1428571428571428,0.3488372093023257,0.125,112,27,9,12,0,3389,0,0,0,15000000,1856250.0,20000000.0,3000000.0,700000.0,18000000.0,1,14000000,-0.16666666666666666,-0.16666666666666666
955253,Bastien,Meupiyou,2024,543,France,Paris,France,19-03-06,Centre-Back,Defender,Left,191.0,30-06-29,Gestifute,https://img.a.transfermarkt.technology/portrait/header/955253-1703065461.jpg?lm=1,GB1,Wolverhampton Wanderers Football Club,2500000.0,2500000.0,18,86,-8,6,8,9,6,11,6,14,10,4,11,10,9,11,10,8,11,10,11,10,10,10,18,9,8,8,11,9,11,11,9,11,14,10,11,11,10,10,5,10,4,10,2,3,2,3,1,3,1,2,3,3,3,11,13,8,8,12,12,11,15,1,13,20,1,1,1,17,1,1,1,1,1,1,1,0,20,6,15800000,4300,4300,1100,African_Caribbean,87,0,0,645.0,Unknown,2000183492,5000000.0,1.0,34,1122,36,1,0,1,222,2,0.3192643556496428,0.1122994652406417,0.2794117647058823,0.0006141325811818,0.0,0.0,0.0122530632658164,0.0122530632658164,0.0277507708547459,0.0,0.6511627906976742,0.0,43,0,0,6,1,2108,1,40,397,2500000,450000.0,2500000.0,200000.0,2500000.0,,1,1700000,2.125,1.5
955358,Gaël,Lafont,2024,244,France,Aix-en-Provence,France,07-06-06,Central Midfield,Midfield,Left,175.0,30-06-26,PASSE-D,https://img.a.transfermarkt.technology/portrait/header/955358-1725448244.jpg?lm=1,FR1,Olympique de Marseille,10774124.0,17195854.0,18,80,-8,6,8,13,8,13,11,6,7,5,3,8,2,5,13,5,10,8,8,7,8,7,2,13,5,13,6,7,8,13,13,13,8,13,13,8,3,9,10,13,13,15,3,3,1,2,2,3,2,1,3,2,1,15,13,8,11,11,13,8,10,1,1,1,1,1,1,1,12,1,13,12,16,20,12,0,20,10,9018749,4016,4016,1030,Northern_European,75,0,0,645.0,Unknown,2000214877,9111392.0,2.0,34,27,36,3,0,7,144,1,0.2816882773220429,0.1048128342245989,0.1911764705882353,0.0006141325811818,0.0,0.0,0.0536340285071267,0.0857507076769192,0.0505924720131114,0.1428571428571428,0.2790697674418605,0.0,54,9,2,10,0,2265,0,0,0,0,,,,,,0,0,,
956920,Nestory,Irankunda,2024,27,Tanzania,Kigoma,Australia,09-02-06,Right Winger,Attack,Right,175.0,30-06-28,Griffin Sports,https://img.a.transfermarkt.technology/portrait/header/956920-1718184025.jpg?lm=1,L1,FC Bayern MÃ¼nchen,3000000.0,3000000.0,18,90,-75,8,10,8,10,6,8,10,8,5,8,8,6,6,9,11,8,7,11,8,13,14,13,16,11,8,3,13,10,15,17,7,4,8,14,9,5,11,10,17,9,12,3,3,2,1,3,3,3,3,3,1,2,11,9,4,10,10,11,13,12,1,1,1,1,1,1,1,1,1,1,20,1,1,18,74,10,20,1161241,5100,4950,1250,African_Caribbean,89,0,0,592.0,Unknown,2000093091,9111392.0,2.0,94,726,6,0,1,1,68,10,0.4052659433712622,0.1283422459893048,0.2941176470588235,0.0005629548660833,0.0,0.0,0.0147536884221055,0.0147536884221055,0.0505924720131114,0.1428571428571428,0.2790697674418605,0.0,85,21,14,23,0,2420,0,0,0,3000000,458333.3333333333,3000000.0,0.0,3000000.0,,1,1200000,0.6666666666666666,3.6153846153846154
957874,Unknown,Rômulo,2024,1467,Brazil,Marialva,Brazil,08-02-02,Centre-Forward,Attack,Right,193.0,30-06-25,Un1que Football,https://img.a.transfermarkt.technology/portrait/header/957874-1727796494.jpg?lm=1,TR1,GÃ¶ztepe Sportif Yat?r?mlar A.?.,2600000.0,2600000.0,22,78,-75,5,6,9,7,5,9,7,7,8,10,10,9,12,5,11,9,12,9,11,8,10,7,3,12,9,11,10,11,11,9,7,11,15,10,13,12,11,7,9,11,17,3,1,4,1,2,2,4,2,3,4,1,10,13,2,8,11,12,11,14,1,1,20,1,1,1,1,1,1,1,1,1,1,1,78,5,20,509440,3878,3878,1622,Mixed_Race,74,0,0,88.0,Unknown,2000015116,9111392.0,2.0,10,916,11,0,1,4,110,3,0.2634294786980683,0.1681283422459893,0.1838235294117646,7.628376401472761e-05,0.0,0.0,0.0127531882970742,0.0127531882970742,0.0505924720131114,0.1428571428571428,0.6976744186046511,0.1666666666666666,116,27,16,9,0,3241,3,17,50,3700000,170000.0,3700000.0,300000.0,,2000000.0,1,300000,0.6818181818181818,1.1764705882352942
961022,Benja,Domínguez,2024,1025,Argentina,La Plata,Argentina,19-09-03,Left Winger,Attack,Right,172.0,30-06-29,Interplayers,https://img.a.transfermarkt.technology/portrait/header/961022-1699913374.jpg?lm=1,IT1,Bologna Football Club 1909,5500000.0,6000000.0,21,117,-8,11,12,14,11,14,8,8,12,11,7,12,11,7,14,13,12,11,14,9,12,12,14,15,3,14,8,10,12,14,14,8,8,6,14,9,8,10,7,9,6,16,4,2,1,1,2,3,2,4,2,2,3,9,8,6,10,9,13,11,20,1,1,1,1,1,1,1,12,1,12,20,1,14,6,68,9,20,5253368,5901,5901,3095,Mediterranean_Hispanic,115,0,0,4719.0,Unknown,2000110081,9111392.0,2.0,4,784,4,0,1,3,40,7,0.5310928817147393,0.3256684491978609,0.4852941176470588,0.0045480573229033,0.0,0.0,0.0272568142035508,0.0297574393598399,0.0505924720131114,0.1428571428571428,0.2093023255813952,0.125,101,14,7,5,0,4025,1,14,67,6000000,835714.2857142857,6000000.0,1000000.0,150000.0,5500000.0,1,500000,0.09090909090909091,0.2
962555,Abakar,Sylla,2024,667,Cote d'Ivoire,Yamoussoukro,Cote d'Ivoire,25-12-02,Centre-Back,Defender,Left,188.0,30-06-28,Epic Sylla,https://img.a.transfermarkt.technology/portrait/header/962555-1658167503.jpg?lm=1,FR1,Racing Club de Strasbourg Alsace,12000000.0,15000000.0,22,115,-8,8,8,9,8,11,8,15,9,9,14,11,8,13,10,18,10,16,10,11,8,10,12,11,8,9,9,8,12,14,14,15,14,15,15,12,14,11,14,12,5,11,3,3,1,2,4,2,2,3,2,4,1,16,9,1,10,11,13,8,8,1,1,20,1,1,1,1,1,1,1,1,1,1,1,0,20,7,25600000,6383,5733,2659,African_Caribbean,115,0,0,4499.0,Unknown,12094339,10100000.0,2.0,23,1681,24,1,0,1,159,2,0.5088647790420746,0.2790374331550802,0.4852941176470588,0.0043356215243813,0.0,0.0,0.0597649412353088,0.0747686921730432,0.056084891246979,0.1428571428571428,0.581395348837209,0.1666666666666666,70,5,1,16,1,1989,5,6,14,12000000,1475000.0,15000000.0,3000000.0,,12000000.0,1,7000000,0.0,0.0
967948,Garang,Kuol,2024,762,Egypt,Kairo,Australia,15-09-04,Left Winger,Attack,Right,175.0,30-06-26,Unknown,https://img.a.transfermarkt.technology/portrait/header/967948-1697908437.jpg?lm=1,GB1,Newcastle United Football Club,600000.0,800000.0,20,109,-8,8,12,10,12,13,8,14,4,8,8,7,7,2,10,5,12,9,10,7,5,13,15,9,6,10,9,8,10,14,14,9,9,15,18,7,8,13,6,13,14,11,1,1,2,1,2,4,2,3,2,2,2,10,16,7,9,9,9,12,12,1,1,1,1,1,1,1,1,1,1,1,1,18,20,0,12,20,547852,5750,5750,3250,African_Caribbean,99,0,0,1691.0,Unknown,2000080496,350000.0,1.0,31,699,6,0,1,1,137,7,0.5111140513363324,0.3422459893048128,0.3676470588235294,0.0016241682414274,0.0,0.0,0.0027506876719179,0.0037509377344336,0.0019167199088863,0.0,0.2790697674418605,0.0833333333333332,53,11,6,7,0,2049,3,9,42,600000,83333.33333333333,800000.0,100000.0,800000.0,600000.0,3,100000,0.0,-0.14285714285714285
971570,Unknown,Endrick,2024,418,Brazil,Taguatinga,Brazil,21-07-06,Centre-Forward,Attack,Left,173.0,30-06-30,Roc Nation Sports,https://img.a.transfermarkt.technology/portrait/header/971570-1723665994.jpg?lm=1,ES1,Real Madrid Club de FÃºtbol,60000000.0,60000000.0,18,102,-10,7,10,14,13,13,7,9,10,2,4,10,11,4,13,11,12,9,12,11,11,11,13,18,4,12,6,8,10,13,13,13,6,14,13,10,12,10,11,6,11,12,1,3,1,2,3,1,2,4,1,1,1,8,16,7,12,14,15,10,14,1,1,1,1,1,1,1,6,5,7,13,12,16,20,0,20,14,20756837,5372,5372,3205,African_Caribbean,106,0,0,4025.0,Unknown,2000220941,47500000.0,1.0,10,1464,11,0,0,1,167,3,0.4611008203228367,0.3374331550802139,0.4191176470588235,0.0038779189402929,0.0,0.0,0.2998249562390597,0.2998249562390597,0.2638684407900219,0.0,0.2325581395348837,0.0,120,35,5,21,1,4269,0,0,0,40000000,3125000.0,60000000.0,20000000.0,40000000.0,,2,20000000,-0.3333333333333333,-0.1111111111111111
973085,Carlos,Baleba,2024,1237,Cameroon,Douala,Cameroon,03-01-04,Defensive Midfield,Midfield,Left,179.0,30-06-28,Unknown,https://img.a.transfermarkt.technology/portrait/header/973085-1666690662.jpg?lm=1,GB1,Brighton and Hove Albion Football Club,22000000.0,22000000.0,20,96,-75,6,7,11,8,12,8,9,8,5,10,12,7,10,12,12,11,12,11,10,12,11,10,11,7,12,10,11,10,12,13,10,9,14,12,14,10,10,7,9,6,10,2,3,3,2,3,1,1,4,3,1,2,11,8,6,11,10,11,12,18,1,1,1,1,1,1,1,1,20,1,1,15,1,1,0,20,8,11580000,4800,4800,1500,African_Caribbean,96,0,0,929.0,Unknown,2000166563,27000000.0,1.0,15,426,15,3,0,1,44,4,0.3854194231278116,0.1550802139037433,0.3455882352941176,0.0008883678847284,0.0,0.0,0.1097774443610902,0.1097774443610902,0.1499763882330064,0.0,0.3720930232558141,0.0833333333333332,98,4,4,18,1,2292,1,1,8,35000000,3872222.222222222,35000000.0,0.0,800000.0,35000000.0,2,15350000,0.5909090909090909,0.75
974374,Anthony,Valencia,2024,1096,Ecuador,Guayaquil,Ecuador,21-07-03,Right Winger,Attack,Left,174.0,30-06-26,Kancha Agency,https://img.a.transfermarkt.technology/portrait/header/974374-1659086874.jpg?lm=1,BE1,Royal Antwerp Football Club,800000.0,1200000.0,21,108,-75,11,10,14,11,12,10,6,11,4,3,11,12,4,13,5,7,10,13,9,10,15,7,14,6,15,5,7,9,15,13,7,6,13,15,13,7,14,6,13,11,13,2,2,1,2,3,2,3,3,1,1,3,8,10,4,11,10,9,11,19,1,1,1,1,1,1,1,1,1,1,13,1,20,15,60,20,8,23100000,5900,5500,1500,Mixed_Race,108,0,0,10215.0,Unknown,86066857,1500000.0,1.0,30,576,31,0,0,4,173,10,0.4780365175972479,0.1550802139037433,0.4338235294117646,0.0098550898168899,0.0,0.0,0.0037509377344336,0.0057514378594648,0.0083057862718408,0.0,0.2558139534883721,0.125,69,10,7,6,0,2700,5,56,161,1200000,127777.77777777778,1200000.0,200000.0,800000.0,800000.0,2,1050000,0.5,0.2
975689,ÃÂScar,Cortés,2024,124,Colombia,Tumaco,Colombia,03-12-03,Right Winger,Attack,Right,178.0,30-06-25,TOP,https://img.a.transfermarkt.technology/portrait/header/975689-1674523048.JPG?lm=1,SC1,Rangers Football Club,3500000.0,4200000.0,21,89,-75,7,4,14,9,14,7,7,13,7,7,14,4,3,14,9,10,4,11,7,14,12,10,15,9,14,13,9,13,12,12,14,5,13,10,9,4,11,5,17,9,16,2,3,3,3,1,3,3,2,1,3,3,9,9,5,12,10,10,11,18,1,1,1,1,1,1,1,1,20,1,1,20,1,1,74,8,20,1403508,4005,4005,1094,African_Caribbean,92,0,0,795.0,Unknown,2000069652,4500000.0,1.0,20,1535,20,0,1,1,161,10,0.2802328658375231,0.1116577540106951,0.3161764705882353,0.0007589751710832,0.0,0.0,0.0172543135783946,0.0207551887971993,0.0249729159143309,0.0,0.3488372093023257,0.125,0,0,0,0,0,0,2,12,68,3500000,431250.0,4200000.0,700000.0,50000.0,3500000.0,2,700000,0.0,0.0
977464,Unknown,Arthur,2024,15,Brazil,Belo Horizonte,Brazil,17-03-03,Right-Back,Defender,Right,174.0,30-06-28,Roc Nation Sports,https://img.a.transfermarkt.technology/portrait/header/977464-1689709842.jpg?lm=1,L1,Bayer 04 Leverkusen FuÃŸball,5000000.0,5000000.0,21,143,155,12,12,15,8,16,12,7,10,5,8,18,11,11,16,10,15,11,14,15,12,14,13,14,9,8,13,14,12,13,17,17,8,9,12,13,11,12,10,14,16,12,4,4,2,2,1,1,2,1,3,1,2,12,14,10,14,12,12,11,14,1,1,1,1,1,1,17,1,20,1,1,13,1,1,67,12,20,11511005,7150,7750,6250,Mediterranean_Hispanic,140,22,1,146153.0,Liverpool,19259600,7000000.0,1.0,10,168,11,1,1,3,36,11,0.7757343212490078,0.6631016042780749,0.6691176470588234,0.14111916972365,0.1447368421052631,0.0131578947368421,0.0247561890472618,0.0247561890472618,0.038862190616406,0.0,0.2558139534883721,0.125,50,0,5,4,0,2294,1,37,213,5000000,685714.2857142857,5000000.0,0.0,,5000000.0,2,4800000,0.0,0.0
978037,Unknown,Igor Jesus,2024,2431,Brazil,GoiÃ¢nia,Brazil,07-03-03,Defensive Midfield,Midfield,Right,179.0,30-06-28,DK,https://img.a.transfermarkt.technology/portrait/header/978037-1711566428.png?lm=1,PO1,Club Football Estrela da Amadora,3000000.0,3000000.0,21,108,-75,6,10,12,12,11,8,12,10,7,5,11,13,7,11,11,12,13,11,10,11,10,13,10,7,12,7,11,12,13,13,13,11,13,13,13,12,13,5,14,6,10,3,1,2,2,1,3,2,1,1,1,3,14,11,4,13,13,13,8,12,1,1,1,1,1,1,1,1,1,1,1,1,1,20,73,10,20,10898055,5400,5400,1250,Mediterranean_Hispanic,108,0,0,23544.0,Unknown,19377081,2000000.0,1.0,10,547,11,3,1,3,55,4,0.4648055041016142,0.1283422459893048,0.4338235294117646,0.0227258023555267,0.0,0.0,0.0147536884221055,0.0147536884221055,0.0110836412122558,0.0,0.3720930232558141,0.125,0,0,0,0,0,0,1,8,28,2000000,264285.71428571426,3000000.0,1000000.0,,1000000.0,2,1000000,-0.3333333333333333,1.0
978057,Unknown,Petterson,2024,2431,Brazil,FlorianÃ³polis,Brazil,04-01-04,Left Winger,Attack,Right,181.0,30-06-25,MCL Sports,https://img.a.transfermarkt.technology/portrait/header/default.jpg?lm=1,PO1,Club Football Estrela da Amadora,250000.0,250000.0,20,82,-75,7,9,14,4,14,7,8,11,7,7,7,4,6,12,12,14,8,9,8,9,9,5,11,7,9,7,6,9,14,14,13,9,7,14,4,5,9,5,9,7,10,1,3,4,3,2,1,1,3,3,2,2,20,12,2,11,11,11,11,20,1,1,1,1,1,1,1,1,1,1,20,1,1,15,0,8,20,931740,4066,4066,982,Mediterranean_Hispanic,82,0,0,161.0,Unknown,2000098426,9111392.0,2.0,10,495,11,0,1,3,55,7,0.2883037840698598,0.0996791443850267,0.2426470588235293,0.0001467738244333,0.0,0.0,0.0010002500625156,0.0010002500625156,0.0505924720131114,0.1428571428571428,0.418604651162791,0.0833333333333332,55,13,6,14,0,3487,0,0,0,750000,100000.0,750000.0,0.0,150000.0,750000.0,2,550000,2.0,2.75
980576,Amine,Salama,2024,1421,France,Paris,France,18-07-00,Centre-Forward,Attack,Right,192.0,30-06-27,AIS SPORT SERVICE,https://img.a.transfermarkt.technology/portrait/header/980576-1723837386.png?lm=1,FR1,Stade de Reims,2000000.0,3000000.0,24,109,135,11,10,13,11,13,10,15,10,5,5,12,10,6,13,5,10,11,10,11,13,10,15,13,7,12,7,10,10,13,11,12,16,12,13,11,12,10,5,10,5,12,2,1,4,1,1,2,2,2,2,3,2,18,14,6,11,13,12,12,10,1,1,1,1,1,1,1,1,1,1,14,1,14,20,0,8,20,1327999,5449,5449,2999,North_African__Middle_Eastern,108,0,0,3066.0,Unknown,2000180911,4000000.0,1.0,34,1122,36,0,1,6,197,3,0.4712887007144747,0.3154010695187165,0.4338235294117646,0.0029518919821901,0.0,0.0,0.0097524381095273,0.0147536884221055,0.0221950609739159,0.0,0.6744186046511627,0.25,88,5,3,2,0,2578,1,5,95,1800000,150000.0,3000000.0,500000.0,,,4,2800000,-0.1,-0.4
982575,Gustavo,Sá,2024,3329,Portugal,PÃ³voa de Varzim,Portugal,11-11-04,Attacking Midfield,Midfield,Right,189.0,30-06-29,SoccerSoul,https://img.a.transfermarkt.technology/portrait/header/982575-1668437788.jpg?lm=1,PO1,Futebol Clube de FamalicÃ£o,8000000.0,8000000.0,20,86,-75,8,8,11,10,12,8,3,14,2,3,12,12,7,11,15,11,9,12,8,12,11,12,8,6,12,6,9,14,11,11,7,13,12,12,12,12,18,5,16,8,10,3,2,2,3,3,2,1,3,2,1,3,12,11,8,11,13,11,10,14,1,1,1,1,1,1,1,1,18,1,1,20,1,1,80,7,20,10400000,4316,4316,1530,Mediterranean_Hispanic,90,0,0,974.0,Unknown,2000146882,9111392.0,2.0,76,1197,79,3,1,3,99,0,0.3213813178089442,0.1582887700534759,0.3014705882352941,0.0009318206616988,0.0,0.0,0.0397599399849962,0.0397599399849962,0.0505924720131114,0.1428571428571428,0.6046511627906974,0.0833333333333332,79,8,10,18,0,1372,1,3,15,10000000,1200000.0,10000000.0,-200000.0,1500000.0,10000000.0,0,0,0.25,2.3333333333333335
982855,Reda,Belahyane,2024,276,France,Aubervilliers,Morocco,01-06-04,Defensive Midfield,Midfield,Right,173.0,30-06-28,DW Sports Management,https://img.a.transfermarkt.technology/portrait/header/982855-1674921768.jpg?lm=1,IT1,Verona Hellas Football Club,500000.0,500000.0,20,75,-75,7,6,14,9,14,5,7,9,7,8,14,6,9,14,8,7,1,12,8,14,13,11,13,9,11,7,8,9,9,12,4,3,5,10,4,3,12,8,18,14,12,3,2,3,3,3,4,2,2,2,1,2,14,14,3,13,9,10,14,19,1,1,1,1,1,1,1,1,18,1,1,20,1,1,0,7,20,8914000,3600,3600,866,North_African__Middle_Eastern,71,0,0,645.0,Unknown,2000031073,500000.0,1.0,34,106,67,3,1,6,214,4,0.2266472611802064,0.0872727272727272,0.1617647058823529,0.0006141325811818,0.0,0.0,0.0022505626406601,0.0022505626406601,0.0027500763910108,0.0,0.2325581395348837,0.0833333333333332,67,3,2,19,0,1302,1,1,6,10000000,1231250.0,10000000.0,100000.0,150000.0,10000000.0,2,450000,19.0,49.0
983989,Facundo,Buonanotte,2024,1003,Argentina,PÃ©rez,Argentina,23-12-04,Attacking Midfield,Midfield,Left,174.0,30-06-25,CAA Stellar,https://img.a.transfermarkt.technology/portrait/header/983989-1682588141.jpg?lm=1,GB1,Leicester City Football Club,18000000.0,18000000.0,20,118,-85,11,11,12,11,13,11,9,13,10,9,12,13,10,13,12,11,11,13,12,13,11,9,14,10,14,8,12,13,14,13,13,7,9,12,14,10,14,6,13,12,9,1,1,3,3,1,2,2,2,2,2,3,13,11,5,12,12,13,9,14,1,1,1,1,1,1,1,1,12,20,15,15,18,1,66,20,10,6535507,5787,5787,3073,Mediterranean_Hispanic,119,0,0,5244.0,Unknown,2000051578,6000000.0,1.0,4,1196,4,3,0,3,127,0,0.5160095263297169,0.3233155080213903,0.5147058823529411,0.0050550063875582,0.0,0.0,0.0897724431107777,0.0897724431107777,0.0333064807355759,0.0,0.2558139534883721,0.0833333333333332,109,14,7,24,0,1563,1,1,11,22000000,2438888.888888889,22000000.0,0.0,12000000.0,,2,7000000,0.2222222222222222,0.8333333333333334
984869,Tomás,Muro,2024,14589,Argentina,General Pinto,Argentina,05-05-02,Central Midfield,Midfield,Right,180.0,30-06-26,Seven Group,https://img.a.transfermarkt.technology/portrait/header/984869-1690113391.png?lm=1,RU1,FC Orenburg,750000.0,1000000.0,22,115,-75,14,12,13,11,12,13,11,12,7,8,13,10,8,13,13,12,11,13,12,12,12,5,14,6,13,12,10,12,13,14,12,11,13,12,11,12,14,15,6,8,13,4,3,1,3,2,3,2,3,2,3,2,17,10,1,12,12,12,10,16,1,1,1,1,1,1,1,1,16,12,14,20,15,8,75,8,20,3502245,5750,5750,3000,Mediterranean_Hispanic,114,0,0,438.0,Unknown,14245920,1000000.0,1.0,4,528,4,3,1,3,70,1,0.5111140513363324,0.3155080213903743,0.4779411764705882,0.0004142498071179,0.0,0.0,0.0035008752188047,0.0047511877969492,0.0055279313314258,0.0,0.3953488372093026,0.1666666666666666,47,2,2,7,0,1817,2,33,249,500000,64285.71428571428,1000000.0,250000.0,,400000.0,2,850000,-0.3333333333333333,-0.4444444444444444
991800,Unknown,Luis Guilherme,2024,379,Brazil,Aracaju,Brazil,09-02-06,Right Winger,Attack,Left,175.0,30-06-29,Un1que Football,https://img.a.transfermarkt.technology/portrait/header/991800-1676571608.jpg?lm=1,GB1,West Ham United Football Club,24000000.0,24000000.0,18,75,-9,5,7,7,10,12,5,7,5,1,4,12,2,6,10,13,4,6,7,2,10,12,5,11,8,3,6,6,7,16,14,3,5,8,15,8,4,12,9,13,10,12,2,2,2,1,1,1,2,1,3,1,3,8,10,5,11,11,10,12,10,1,1,1,1,1,1,1,8,11,8,12,20,15,16,0,20,9,367997,3750,3750,750,African_Caribbean,64,0,0,71.0,Unknown,2000221458,9111392.0,2.0,10,80,11,0,0,1,220,10,0.246493781423657,0.0748663101604278,0.1102941176470588,5.986827049257102e-05,0.0,0.0,0.1197799449862465,0.1197799449862465,0.0505924720131114,0.1428571428571428,0.2790697674418605,0.0,57,1,3,2,0,1598,0,0,0,22000000,2928571.4285714286,24000000.0,2000000.0,22000000.0,,1,2000000,-0.08333333333333333,0.29411764705882354
1000674,Gianluca,Prestianni,2024,294,Argentina,Ciudadela,Argentina,31-01-06,Right Winger,Attack,Right,166.0,30-06-29,Doble G,https://img.a.transfermarkt.technology/portrait/header/1000674-1725535781.jpg?lm=1,PO1,Sport Lisboa e Benfica,10000000.0,10000000.0,18,99,-8,10,11,13,9,13,11,5,12,5,5,12,15,6,13,12,9,10,9,11,13,14,13,14,9,12,8,12,11,13,14,11,5,11,12,10,8,9,12,19,6,12,1,2,3,2,1,1,3,3,3,2,1,16,13,6,13,12,12,9,8,1,1,1,1,1,1,1,14,1,11,20,18,18,10,63,8,20,7651870,4750,4750,2000,Mediterranean_Hispanic,103,0,0,483.0,Unknown,2000104173,9000000.0,1.0,4,366,4,0,1,3,188,10,0.3788039163799948,0.2085561497326203,0.3970588235294117,0.0004577025840883,0.0,0.0,0.0497624406101525,0.0497624406101525,0.049973610378066,0.0,0.0697674418604648,0.0,57,5,3,8,0,1398,2,14,51,10000000,1421428.5714285714,10000000.0,0.0,10000000.0,,2,3000000,0.0,0.0
1004723,Fellipe,Jack,2024,1047,Brazil,SÃ£o Paulo,Brazil,12-01-06,Centre-Back,Defender,Left,187.0,30-06-25,SPORT AGENCY LTDA,https://img.a.transfermarkt.technology/portrait/header/1004723-1680450497.jpg?lm=1,IT1,Calcio Como,200000.0,200000.0,18,60,-75,3,1,1,5,6,1,13,3,2,13,6,1,13,3,9,5,8,5,9,5,12,4,5,1,5,8,5,6,12,8,6,13,13,8,3,6,12,8,17,9,10,3,3,1,1,3,1,2,1,1,4,2,14,12,6,12,12,13,10,17,1,1,20,1,1,1,1,1,1,1,1,1,1,1,0,20,9,2128157,3250,3250,250,Mixed_Race,49,0,0,41.0,Unknown,2000221615,9111392.0,2.0,10,1456,11,1,0,4,47,2,0.1803387139454882,0.0213903743315508,0.0,3.089975251229472e-05,0.0,0.0,0.0007501875468867,0.0007501875468867,0.0505924720131114,0.1428571428571428,0.5581395348837206,0.0,29,2,1,7,0,832,0,0,0,200000,0.0,200000.0,0.0,200000.0,,1,0,0.0,0.0
1005240,Christian,Mawissa,2024,162,France,Saint-Jean-de-Verges,France,18-04-05,Centre-Back,Defender,Left,184.0,30-06-29,Classico,https://img.a.transfermarkt.technology/portrait/header/1005240-1708555606.jpg?lm=1,FR1,Association sportive de Monaco Football Club,12000000.0,12000000.0,19,85,-75,6,8,10,9,12,6,12,10,10,12,12,8,17,9,12,10,10,12,12,9,7,16,5,12,8,12,13,11,11,12,11,12,14,12,11,7,12,5,13,8,13,2,1,2,3,1,3,3,1,3,3,3,13,9,5,13,13,13,10,13,1,15,20,1,1,1,1,1,1,1,1,1,1,1,77,20,10,6559998,4250,4250,1750,African_Caribbean,95,0,0,93.0,Unknown,2000131124,16000000.0,1.0,34,1273,36,1,0,1,24,2,0.3126488489018258,0.1818181818181818,0.338235294117647,8.111185034477366e-05,0.0,0.0,0.0597649412353088,0.0597649412353088,0.0888635795438762,0.0,0.4883720930232553,0.0416666666666666,63,2,0,13,1,1962,1,6,33,12000000,1700000.0,12000000.0,0.0,7000000.0,,2,3000000,0.3333333333333333,47.0
1005649,Unknown,Murillo,2024,703,Brazil,SÃ£o Paulo,Brazil,04-07-02,Centre-Back,Defender,Right,184.0,30-06-28,FWD Team,https://img.a.transfermarkt.technology/portrait/header/1005649-1709159139.jpg?lm=1,GB1,Nottingham Forest Football Club,40000000.0,40000000.0,22,132,141,7,7,8,8,11,5,16,9,10,15,11,13,14,11,15,14,15,13,12,8,13,10,5,11,7,14,15,14,12,12,12,15,12,14,15,13,12,12,12,12,11,1,3,3,3,3,3,1,1,3,3,4,10,8,7,10,12,14,10,15,1,1,20,1,1,1,14,1,8,1,1,1,1,1,84,8,20,10038231,6545,6545,3774,Mixed_Race,135,0,0,15390.0,Unknown,95040312,12000000.0,1.0,10,1456,11,1,1,4,140,2,0.6163006086266208,0.3982887700534759,0.6323529411764706,0.0148521591684876,0.0,0.0,0.1997999499874969,0.1997999499874969,0.0666407400205561,0.0,0.4883720930232553,0.1666666666666666,106,3,2,22,0,3212,1,1,9,50000000,6187500.0,50000000.0,-3000000.0,,500000.0,1,5500000,0.42857142857142855,1.2727272727272727
1015624,ÃÂScar,Perea,2024,667,Colombia,Pereira,Colombia,27-09-05,Left Winger,Attack,Right,174.0,30-06-29,Unknown,https://img.a.transfermarkt.technology/portrait/header/1015624-1721095896.jpg?lm=1,FR1,Racing Club de Strasbourg Alsace,3000000.0,3000000.0,19,75,-8,4,9,13,7,13,6,5,7,6,6,13,2,5,12,15,7,6,8,5,13,13,13,12,6,10,6,7,12,13,13,7,4,12,13,7,1,8,14,11,5,11,2,1,1,2,1,2,1,2,2,2,2,11,11,4,13,11,9,12,17,1,1,1,1,1,1,1,1,1,1,20,1,18,1,0,8,20,1131881,3750,3750,3750,African_Caribbean,76,0,0,64.0,Unknown,2000149459,5200000.0,1.0,20,1137,20,0,1,1,159,7,0.246493781423657,0.3957219251336898,0.1985294117647059,5.310894963050656e-05,0.0,0.0,0.0147536884221055,0.0147536884221055,0.0288619128309119,0.0,0.2558139534883721,0.0416666666666666,59,8,5,7,1,2003,0,0,0,2500000,300000.0,3000000.0,500000.0,2000000.0,,1,1000000,0.25,0.9230769230769231
1018938,Jon,Martín,2024,681,Spain,Donostia-San SebastiÃ¡n,Spain,23-04-06,Centre-Back,Defender,Right,187.0,30-06-30,IDUB GLOBAL,https://img.a.transfermarkt.technology/portrait/header/1018938-1700816229.png?lm=1,ES1,Real Sociedad de FÃºtbol S.A.D.,2000000.0,2000000.0,18,76,-75,4,3,1,4,7,2,13,4,6,13,7,3,13,3,11,5,9,7,9,6,13,6,5,8,4,11,6,7,10,12,7,8,8,12,4,9,11,10,4,10,9,2,2,1,1,3,2,2,3,1,2,1,8,13,7,11,10,11,11,12,1,1,20,1,1,1,1,1,1,1,1,1,1,1,0,8,20,5792000,3801,3801,1052,Mediterranean_Hispanic,66,0,0,350.0,Unknown,2000229718,9111392.0,2.0,89,423,89,1,1,3,168,2,0.2532415983064303,0.1071657754010695,0.125,0.0003292754877091,0.0,0.0,0.0097524381095273,0.0097524381095273,0.0505924720131114,0.1428571428571428,0.5581395348837206,0.0,41,4,0,7,0,925,0,0,0,2000000,380000.0,2000000.0,0.0,2000000.0,,1,0,0.0,0.0
1026255,Saná,Fernandes,2024,132,Guinea-Bissau,Bissau,Portugal,10-03-06,Left Winger,Attack,Right,165.0,30-06-25,Unknown,https://img.a.transfermarkt.technology/portrait/header/1026255-1715671060.jpg?lm=1,NL1,Nooit Opgeven Altijd Doorzetten Aangenaam Door Vermaak En Nuttig Door Ontspanning Combinatie Breda,800000.0,800000.0,18,80,-75,7,9,10,10,12,7,8,8,6,5,14,7,3,14,13,11,4,10,7,8,11,15,13,2,14,7,8,9,14,14,8,1,12,14,10,1,11,7,3,5,10,2,2,1,2,1,2,2,3,3,2,3,19,10,1,11,11,10,12,12,1,1,1,1,1,1,1,1,1,1,20,1,18,14,0,5,20,7189999,4000,4000,1250,African_Caribbean,81,0,0,255.0,Unknown,2000202651,9111392.0,2.0,44,202,79,0,1,1,139,7,0.2795713151627415,0.1283422459893048,0.2352941176470588,0.0002375418474382,0.0,0.0,0.0037509377344336,0.0037509377344336,0.0505924720131114,0.1428571428571428,0.0465116279069768,0.0,83,21,24,16,1,1794,0,0,0,800000,150000.0,800000.0,0.0,800000.0,,1,0,0.0,0.0
1032864,Emre,Gökay,2024,2381,TÃ¼rkiye,Kayseri,TÃ¼rkiye,18-02-06,Right Winger,Attack,Left,181.0,30-06-25,F-F SPORT,https://img.a.transfermarkt.technology/portrait/header/1032864-1724077010.png?lm=1,TR1,Sivasspor KulÃ¼bÃ¼,1400000.0,1500000.0,18,75,-8,6,6,13,8,8,11,6,11,4,4,8,13,5,10,5,8,6,10,7,8,8,12,16,5,11,4,6,6,13,9,11,7,18,13,9,11,13,10,13,4,9,1,3,3,3,2,1,3,3,3,3,3,9,12,7,11,12,10,11,15,1,1,1,1,1,1,1,15,1,15,15,1,20,1,0,20,12,7779539,4488,4418,2461,Mediterranean_Hispanic,70,0,0,82.0,Unknown,2000204344,9111392.0,2.0,100,717,100,0,0,3,183,10,0.3348769515744906,0.2578609625668449,0.1544117647058823,7.049006041867233e-05,0.0,0.0,0.0067516879219804,0.0072518129532383,0.0505924720131114,0.1428571428571428,0.418604651162791,0.0,37,6,0,1,1,1458,6,22,52,1200000,115000.0,1500000.0,200000.0,1200000.0,,1,0,-0.2,1.4
1033963,Unknown,Eguinaldo,2024,660,Brazil,MonÃ§Ã£o,Brazil,09-08-04,Left Winger,Attack,Right,175.0,30-06-28,SH Sports,https://img.a.transfermarkt.technology/portrait/header/1033963-1723486951.png?lm=1,UKR1,FC Shakhtar Donetsk,2500000.0,3000000.0,20,109,-75,7,10,12,12,9,10,11,11,6,8,10,10,7,12,11,11,12,11,10,8,10,12,11,5,12,8,11,11,17,13,10,7,9,15,11,7,11,10,9,9,9,1,3,3,2,3,1,1,1,1,1,1,9,12,5,11,10,9,9,13,1,1,1,1,1,1,1,1,1,1,11,1,12,20,0,14,20,6101111,5450,5450,2000,Mixed_Race,106,0,0,1575.0,Unknown,2000180114,1810000.0,2.0,10,981,11,0,1,4,72,7,0.4714210108494311,0.2085561497326203,0.4191176470588235,0.0015121566385704,0.0,0.0,0.0122530632658164,0.0147536884221055,0.0100280563348981,0.1428571428571428,0.2790697674418605,0.0833333333333332,76,9,7,9,1,2906,3,6,16,3000000,414285.71428571426,3000000.0,500000.0,900000.0,3000000.0,1,2100000,0.2,0.0
1045972,Mario,Dorgeles,2024,2778,Cote d'Ivoire,Andokoi,Cote d'Ivoire,07-08-04,Central Midfield,Midfield,Left,177.0,30-06-27,Unknown,https://img.a.transfermarkt.technology/portrait/header/1045972-1697191813.jpg?lm=1,DK1,Fodbold Club NordsjÃ¦lland,1200000.0,1200000.0,20,100,-75,8,8,11,6,12,8,10,8,8,12,12,9,12,12,11,12,12,12,11,11,8,3,5,3,12,12,13,13,12,13,11,11,14,12,12,11,11,12,13,10,13,1,2,2,3,2,3,3,2,2,2,1,13,13,8,12,12,14,13,12,1,1,1,1,1,1,20,1,20,1,1,10,1,1,67,20,9,3878527,4251,4295,1209,African_Caribbean,99,0,0,898.0,Unknown,2000184837,9111392.0,2.0,23,68,24,3,0,1,87,1,0.3186028049748611,0.1239572192513369,0.3676470588235294,0.0008584337494821,0.0,0.0,0.0057514378594648,0.0057514378594648,0.0505924720131114,0.1428571428571428,0.3255813953488373,0.0833333333333332,74,2,5,4,0,2380,0,0,0,3500000,558333.3333333334,3500000.0,0.0,350000.0,3500000.0,0,0,1.9166666666666667,3.6666666666666665
1047860,Gustavo,Silva,2024,2420,Brazil,SÃ£o Paulo,Brazil,01-06-99,Right Winger,Attack,Right,180.0,30-06-28,NG Soccer,https://img.a.transfermarkt.technology/portrait/header/1047860-1705778236.jpg?lm=1,PO1,VitÃ³ria Sport Clube,1500000.0,1500000.0,25,128,135,8,12,15,12,13,8,7,11,7,6,11,11,7,13,12,9,11,10,10,11,10,14,13,7,12,7,11,14,16,16,8,5,12,16,10,7,10,5,11,7,12,1,3,3,2,1,3,2,1,1,3,1,16,13,2,12,9,14,11,10,1,1,1,1,1,1,1,12,1,10,16,10,20,15,63,10,20,3885259,6367,6367,2604,Mediterranean_Hispanic,118,0,0,11577.0,Unknown,19227511,500000.0,1.0,10,1456,11,0,1,3,217,10,0.5927494046043927,0.2731550802139037,0.5073529411764706,0.0111702605331945,0.0,0.0,0.0072518129532383,0.0072518129532383,0.0027500763910108,0.0,0.3953488372093026,0.2916666666666665,92,24,16,15,0,1410,3,11,49,1500000,245000.0,1500000.0,0.0,,,1,0,0.0,1.5
1054839,Mamadou,Diakhon,2024,1421,France,Strasbourg,France,22-09-05,Left Winger,Attack,Left,180.0,30-06-26,BLACKSKILL,https://img.a.transfermarkt.technology/portrait/header/1054839-1723837204.png?lm=1,FR1,Stade de Reims,700000.0,700000.0,19,127,154,4,7,10,7,10,6,14,5,11,14,13,7,14,8,15,14,15,13,13,11,13,16,10,17,12,14,14,12,10,10,10,15,12,11,14,16,14,12,15,14,5,1,2,3,1,2,3,2,3,1,3,2,13,16,8,15,14,16,11,14,1,1,20,1,1,1,1,1,1,1,1,1,1,1,83,20,7,347975206,6350,6350,5500,African_Caribbean,127,29,2,25314.0,Unknown,34000070,9111392.0,2.0,34,1430,36,0,0,1,197,7,0.590500132310135,0.5828877005347594,0.5735294117647058,0.024434944916363,0.1907894736842105,0.0263157894736842,0.0032508127031757,0.0032508127031757,0.0505924720131114,0.1428571428571428,0.3953488372093026,0.0416666666666666,71,8,4,3,0,1886,0,0,0,1500000,270000.0,1500000.0,0.0,700000.0,,0,0,1.1428571428571428,1.1428571428571428
1070035,Lucas,Moura,2024,110302,Unknown,Unknown,Brazil,10-03-04,Goalkeeper,Goalkeeper,Right,187.0,30-06-25,GL22 SPORTS,https://img.a.transfermarkt.technology/portrait/header/default.jpg?lm=1,PO1,Avs Futebol SAD,100000.0,100000.0,20,143,154,11,12,16,13,13,9,15,9,6,6,13,11,9,13,11,13,12,12,11,12,12,14,13,7,13,7,15,16,15,13,11,11,17,15,15,8,12,8,8,6,13,2,1,3,1,3,3,4,3,3,1,2,10,15,6,14,12,16,10,15,1,1,1,1,1,1,1,1,5,20,15,14,20,15,66,10,20,24727118,7150,7000,6250,Mediterranean_Hispanic,130,36,4,92793.0,Unknown,19073564,9111392.0,2.0,105,1549,11,2,1,3,35,5,0.6765017200317545,0.6631016042780749,0.5955882352941175,0.0895938324093985,0.2368421052631578,0.0526315789473684,0.0002500625156289,0.0002500625156289,0.0505924720131114,0.1428571428571428,0.5581395348837206,0.0833333333333332,0,0,0,0,0,0,1,21,201,100000,6250.0,100000.0,0.0,,100000.0,1,25000,0.0,0.0
1082823,Unknown,Newerton,2024,660,Brazil,Palmares,Brazil,03-06-05,Left Winger,Attack,Left,165.0,30-06-28,Bertolucci Sports,https://img.a.transfermarkt.technology/portrait/header/1082823-1723486979.png?lm=1,UKR1,FC Shakhtar Donetsk,2500000.0,3000000.0,19,124,136,5,7,6,6,11,9,14,8,10,14,12,7,14,11,7,13,14,14,15,8,13,15,6,15,7,14,13,10,9,9,13,16,10,11,11,14,16,10,13,12,6,2,2,3,2,3,1,1,1,2,3,2,12,14,10,10,16,13,9,12,1,12,20,1,1,1,1,1,1,1,1,1,1,1,89,20,10,-1,6100,5516,5164,Mediterranean_Hispanic,124,0,0,32655.0,Unknown,19047410,3600000.0,1.0,10,1113,11,0,0,3,72,7,0.4801534797565493,0.5469518716577539,0.5514705882352942,0.0315235412661366,0.0,0.0,0.0122530632658164,0.0147536884221055,0.0199727770215839,0.0,0.0465116279069768,0.0416666666666666,48,4,5,1,0,2085,0,0,0,3000000,360000.0,3000000.0,500000.0,3000000.0,,0,0,0.2,0.0
1084714,Unknown,Robert,2024,190,Brazil,Pirapora,Brazil,13-04-05,Left Winger,Attack,Right,174.0,30-06-25,CAA Base Ltd,https://img.a.transfermarkt.technology/portrait/header/1084714-1697289066.jpg?lm=1,DK1,Football Club KÃ¸benhavn,1000000.0,1000000.0,19,125,145,3,3,6,3,8,4,8,2,2,2,8,1,3,9,8,13,12,13,13,7,12,13,4,13,2,14,13,13,10,12,13,15,13,10,12,12,13,6,14,3,1,13,11,12,4,12,14,14,15,7,17,15,12,14,6,11,12,16,16,14,20,1,1,1,1,1,1,1,1,1,1,1,1,1,93,10,20,163690,6250,6250,4750,Mediterranean_Hispanic,124,0,0,10547.0,Unknown,1510293,9111392.0,2.0,10,1149,11,0,1,3,90,7,0.5772691188145012,0.5026737967914437,0.5514705882352942,0.010175674749205,0.0,0.0,0.0047511877969492,0.0047511877969492,0.0505924720131114,0.1428571428571428,0.2558139534883721,0.0416666666666666,62,6,7,4,0,2447,1,2,6,1500000,250000.0,1500000.0,0.0,1000000.0,,2,1150000,0.5,0.6666666666666666
1086636,Gabriel,Moscardo,2024,1421,Brazil,TaubatÃ©,Brazil,28-09-05,Defensive Midfield,Midfield,Right,185.0,30-06-25,Bertolucci Sports,https://img.a.transfermarkt.technology/portrait/header/1086636-1724752763.png?lm=1,FR1,Stade de Reims,15000000.0,15000000.0,19,78,-75,4,6,4,7,10,6,12,7,4,10,10,6,11,9,5,10,8,6,9,10,13,11,8,11,6,11,12,11,10,10,5,12,8,10,7,11,14,9,14,5,10,3,4,2,3,1,1,3,3,1,2,2,15,11,6,12,8,9,11,19,1,1,15,1,1,1,20,1,10,1,1,1,1,1,0,8,20,502737,3900,3900,50,Mediterranean_Hispanic,70,0,0,87.0,Unknown,2000208439,20000000.0,1.0,10,1473,11,3,1,3,197,4,0.2663403016671077,0.0,0.1544117647058823,7.531814674871837e-05,0.0,0.0,0.0747686921730432,0.0747686921730432,0.1110864190671963,0.0,0.5116279069767438,0.0416666666666666,43,2,1,11,0,1444,2,18,92,12000000,2100000.0,15000000.0,3000000.0,15000000.0,,1,3000000,-0.2,-0.2
1091519,Unknown,Caio Gomes,2024,6992,Brazil,Curitiba,Brazil,06-07-02,Left-Back,Defender,Right,177.0,30-06-27,ADRIANO SPORTS,https://img.a.transfermarkt.technology/portrait/header/1091519-1723468577.png?lm=1,UKR1,ZAO FK Chornomorets Odessa,150000.0,150000.0,22,106,135,5,9,10,7,11,5,9,8,6,10,12,4,12,13,14,12,13,12,12,11,11,11,10,12,10,12,13,14,13,14,12,6,15,13,12,9,12,9,14,8,16,1,2,3,1,1,1,2,2,1,2,3,15,12,4,10,11,14,13,12,1,10,14,10,1,1,20,1,19,1,1,1,1,1,0,10,20,654374,5350,5400,3500,African_Caribbean,104,0,0,19999.0,Unknown,49037592,9111392.0,2.0,10,398,11,1,1,1,224,8,0.4648055041016142,0.3689839572192513,0.4044117647058823,0.0193026891475241,0.0,0.0,0.0005001250312578,0.0005001250312578,0.0505924720131114,0.1428571428571428,0.3255813953488373,0.1666666666666666,28,0,0,3,0,1548,0,0,0,250000,50000.0,250000.0,-100000.0,,,0,0,0.0,0.0
1099788,Lucas,Oliveira,2024,982,Brazil,Trindade,Brazil,05-02-04,Centre-Back,Defender,Right,195.0,30-06-25,Unknown,https://img.a.transfermarkt.technology/portrait/header/default.jpg?lm=1,PO1,Clube Desportivo Nacional,50000.0,100000.0,20,120,124,6,8,8,7,10,7,13,8,11,14,10,8,14,9,13,14,14,12,12,9,11,12,8,10,9,13,13,13,12,11,12,15,13,13,12,14,13,10,12,8,10,2,1,1,4,2,3,1,4,2,1,2,12,11,7,13,11,12,13,12,1,1,20,1,1,1,1,1,1,1,1,1,1,1,82,8,20,1291863,5951,5951,2749,Mediterranean_Hispanic,120,0,0,6548.0,Unknown,19367739,9111392.0,2.0,10,1524,11,1,1,3,56,2,0.5377083884625562,0.288663101604278,0.5220588235294117,0.0063141713024342,0.0,0.0,0.0,0.0002500625156289,0.0505924720131114,0.1428571428571428,0.7441860465116279,0.0833333333333332,0,0,0,0,0,0,0,0,0,50000,-12500.0,100000.0,50000.0,,50000.0,0,0,0.0,-0.5
1153785,Luís,Pires,2024,2503,Unknown,Unknown,Brazil,17-11-04,Goalkeeper,Goalkeeper,Left,188.0,30-06-25,ML3 Football,https://img.a.transfermarkt.technology/portrait/header/default.jpg?lm=1,PO1,Boavista Futebol Clube,100000.0,100000.0,20,120,-8,10,15,13,10,11,10,10,11,10,9,13,7,9,14,6,11,9,11,11,13,12,11,12,5,14,10,12,9,14,13,12,11,13,13,13,11,11,5,11,9,13,4,2,1,3,2,3,3,1,2,2,3,15,12,7,11,12,9,13,10,1,20,1,1,18,1,1,13,1,15,13,1,15,1,76,20,8,11863270,5982,5982,2322,Mixed_Race,108,0,0,6080.0,Unknown,19335371,9111392.0,2.0,105,1549,11,2,0,4,38,5,0.5418100026462027,0.2429946524064171,0.4338235294117646,0.0058622624219419,0.0,0.0,0.0002500625156289,0.0002500625156289,0.0505924720131114,0.1428571428571428,0.581395348837209,0.0833333333333332,0,0,0,0,0,0,1,24,205,100000,0.0,100000.0,0.0,,100000.0,0,0,0.0,0.0
1287735,Oscar,Vargas,2024,41274,Unknown,Unknown,Belgium,31-01-06,Right Midfield,Midfield,Right,183.0,Unknown,Unknown,https://img.a.transfermarkt.technology/portrait/header/default.jpg?lm=1,BE1,Koninklijke Beerschot Voetbalclub Antwerpen,50000.0,50000.0,18,101,135,7,8,9,13,12,7,8,10,8,5,9,15,5,11,9,12,15,13,13,9,13,13,13,8,11,5,12,10,13,12,11,9,11,14,12,11,11,5,10,6,10,1,3,1,2,1,3,3,3,2,1,1,12,12,3,15,14,13,12,12,1,1,1,1,1,1,1,1,1,1,1,1,1,20,0,9,20,900211,5050,5050,3000,Northern_European,100,0,0,1677.0,Unknown,53159470,9111392.0,2.0,105,1549,8,3,1,7,121,9,0.418496956866896,0.3155080213903743,0.3749999999999999,0.0016106495997033,0.0,0.0,0.0,0.0,0.0505924720131114,0.1428571428571428,0.4651162790697669,0.0,16,3,0,3,0,11,0,0,0,50000,0.0,50000.0,0.0,50000.0,,0,0,0.0,0.0
